year,week,game_id,home_team,home_team_nickname,away_team,away_team_nickname,home_team_record,away_team_record,home_first_pos,home_team_halftime,away_team_halftime,home_team_final,away_team_final,home_team_q1,home_team_q2,home_team_q3,home_team_q4,away_team_q1,away_team_q2,away_team_q3,away_team_q4,homewins-awaywins,halftime_differential,final_differential,home_win_prob,predicted_diff
2017,1,NCAAF_20170903_TXAM@UCLA,UCLA,,Texas A&M,,1-0,0-1,,10,38,45,44,3,7,7,28,17,21,6,0,1,-28,1,,
2017,1,NCAAF_20170903_WVU@VATECH,Virginia Tech,,West Virginia,,1-0,0-1,,10,7,31,24,3,7,14,7,0,7,10,7,1,3,7,,
2017,1,NCAAF_20170902_AKRON@PSU,Penn State,,Akron,,1-0,0-1,,35,0,52,0,14,21,10,7,0,0,0,0,1,35,52,,
2017,1,NCAAF_20170902_BALLST@ILL,Illinois,,Ball St.,,1-0,0-1,,16,7,24,21,6,10,0,8,7,0,14,0,1,9,3,,
2017,1,NCAAF_20170902_BGREEN@MICHST,Michigan St.,,Bowling Green,,1-0,0-1,,14,3,35,10,0,14,21,0,3,0,0,7,1,11,25,,
2017,1,NCAAF_20170902_KENTST@CLEM,Clemson,,Kent St.,,1-0,0-1,,28,3,56,3,21,7,21,7,0,3,0,0,1,25,53,,
2017,1,NCAAF_20170902_MD@TEXAS,Texas,,Maryland,,0-1,1-0,,14,30,41,51,7,7,20,7,14,16,7,14,-1,-16,-10,,
2017,1,NCAAF_20170902_MOST@MIZZOU,Missouri,,Missouri St.,,1-0,0-1,,48,35,72,43,20,28,10,14,21,14,0,8,1,13,29,,
2017,1,NCAAF_20170902_WYO@IOWA,Iowa,,Wyoming,,1-0,0-1,,14,3,24,3,0,14,7,3,0,3,0,0,1,11,21,,
2017,1,NCAAF_20170902_CAL@UNC,North Carolina,,California,,0-1,1-0,,17,14,30,35,7,10,7,6,7,7,7,14,-1,3,-5,,
2017,1,NCAAF_20170902_BTHN@MIAMI,Miami (Fla.),,Bethune-Cook.,,1-0,0-1,,24,6,41,13,3,21,14,3,3,3,7,0,1,18,28,,
2017,1,NCAAF_20170902_PORTST@OREGST,Oregon State,,Portland St.,,1-1,0-2,,14,6,35,32,7,7,14,7,6,0,20,6,1,8,3,,
2017,1,NCAAF_20170902_VMI@AF,Air Force,,VMI,,1-0,0-1,,35,0,62,0,14,21,14,13,0,0,0,0,1,35,62,,
2017,1,NCAAF_20170902_NCST@SC,South Carolina,,NC State,,1-0,0-1,,21,21,35,28,14,7,14,0,14,7,0,7,1,0,7,,
2017,1,NCAAF_20170902_ALAM@UAB,UAB,,Alabama A&M,,1-0,0-1,,10,7,38,7,7,3,14,14,0,7,0,0,1,3,31,,
2017,1,NCAAF_20170902_MICH@FLA,Florida,,Michigan,,0-1,1-0,,17,13,17,33,3,14,0,0,10,3,13,7,-1,4,-16,,
2017,1,NCAAF_20170902_NEVADA@NWEST,Northwestern,,Nevada,,1-0,0-1,,7,17,31,20,7,0,10,14,7,10,0,3,1,-10,11,,
2017,1,NCAAF_20170902_TEMPLE@ND,Notre Dame,,Temple,,1-0,0-1,,28,10,49,16,21,7,7,14,3,7,0,6,1,18,33,,
2017,1,NCAAF_20170902_UTEP@OKLA,Oklahoma,,UTEP,,1-0,0-1,,35,7,56,7,14,21,14,7,7,0,0,0,1,28,49,,
2017,1,NCAAF_20170902_WMMARY@UVA,Virginia,,William & Mary,,1-0,0-1,,14,0,28,10,7,7,7,7,0,0,3,7,1,14,18,,
2017,1,NCAAF_20170902_TROY@BOISE,Boise St.,,Troy,,1-0,0-1,,17,10,24,13,7,10,0,7,3,7,0,3,1,7,11,,
2017,1,NCAAF_20170902_CHARSO@MISSST,Miss. State,,Charleston So.,,1-0,0-1,,35,0,49,0,23,12,7,7,0,0,0,0,1,35,49,,
2017,1,NCAAF_20170902_EWASH@TXTECH,Texas Tech,,E. Washington,,1-0,0-1,,28,10,56,10,7,21,21,7,0,10,0,0,1,18,46,,
2017,1,NCAAF_20170902_STONYBRK@SFLA,South Florida,,Stony Brook,,2-0,0-1,,7,10,31,17,7,0,10,14,7,3,0,7,2,-3,14,,
2017,1,NCAAF_20170902_UK@USM,So. Miss,,Kentucky,,0-1,1-0,,3,14,17,24,0,3,7,7,0,14,10,0,-1,-11,-7,,
2017,1,NCAAF_20170902_WMICH@USC,USC,,W. Michigan,,1-0,0-1,,14,14,49,31,7,7,7,28,7,7,7,10,1,0,18,,
2017,1,NCAAF_20170902_ALBANY@ODU,Old Dominion,,Albany,,1-0,0-1,,21,3,31,17,7,14,3,7,3,0,0,14,1,18,14,,
2017,1,NCAAF_20170902_JMAD@ECU,East Carolina,,James Madison,,0-1,1-0,,0,7,14,34,0,0,7,7,7,0,14,13,-1,-7,-20,,
2017,1,NCAAF_20170902_NCCEN@DUKE,Duke,,NC Central,,1-0,0-1,,47,7,60,7,21,26,6,7,0,7,0,0,1,40,53,,
2017,1,NCAAF_20170902_APLST@UGA,Georgia,,App. St.,,1-0,0-1,,21,0,31,10,7,14,10,0,0,0,0,10,1,21,21,,
2017,1,NCAAF_20170902_MIAOH@MRSHL,Marshall,,Miami-OH,,1-0,0-1,,21,13,31,26,7,14,7,3,3,10,7,6,1,8,5,,
2017,1,NCAAF_20170902_EKY@WKY,W. Kentucky,,E. Kentucky,,1-0,0-1,,17,0,31,17,0,17,7,7,0,0,14,3,1,17,14,,
2017,1,NCAAF_20170902_HAMP@OHIO,Ohio,,Hampton,,1-0,0-1,,20,0,59,0,7,13,26,13,0,0,0,0,1,20,59,,
2017,1,NCAAF_20170902_HOUBP@TXSTSM,Texas St.,,Houston Christian,,1-0,0-1,,10,9,20,11,0,10,7,3,9,0,0,2,1,1,9,,
2017,1,NCAAF_20170902_LAMAR@NTEXAS,North Texas,,Lamar,,1-0,0-1,,38,14,59,14,17,21,14,7,7,7,0,0,1,24,45,,
2017,1,NCAAF_20170902_LIB@BAYLOR,Baylor,,Liberty,,0-1,1-0,,17,17,45,48,0,17,14,14,6,11,17,14,-1,0,-3,,
2017,1,NCAAF_20170902_MA@CSTCAR,C. Carolina,,UMass,,1-0,0-2,,21,14,38,28,14,7,10,7,7,7,7,7,1,7,10,,
2017,1,NCAAF_20170902_NWST@LATECH,Louisiana Tech,,Northwestern St.,,1-0,0-1,,24,10,52,24,10,14,7,21,7,3,14,0,1,14,28,,
2017,1,NCAAF_20170902_SELOU@LALAF,Louisiana,,SE Louisiana,,1-0,0-1,,35,35,51,48,21,14,7,9,21,14,0,13,1,0,3,,
2017,1,NCAAF_20170902_SEMOST@KANSAS,Kansas,,SE Missouri St.,,1-0,0-1,,21,7,38,16,14,7,14,3,0,7,3,6,1,14,22,,
2017,1,NCAAF_20170902_SFA@SMU,SMU,,S.F. Austin,,1-0,0-1,,38,7,58,14,21,17,6,14,0,7,0,7,1,31,44,,
2017,1,NCAAF_20170902_CAR@KSTATE,Kansas State,,Cent. Ark.,,1-0,0-1,,38,16,55,19,10,28,10,7,10,6,3,0,1,22,36,,
2017,1,NCAAF_20170902_CPOLY@SJST,San Jose St.,,Cal-Poly,,1-0,0-2,,7,6,34,13,0,7,13,14,3,3,0,7,1,1,21,,
2017,1,NCAAF_20170902_GAS@AUBURN,Auburn,,Ga. Southern,,1-0,0-1,,24,7,41,7,10,14,10,7,7,0,0,0,1,17,34,,
2017,1,NCAAF_20170902_LVILLE@PURDUE,Purdue,,Louisville,,0-1,1-0,,14,10,28,35,7,7,7,7,7,3,15,10,-1,4,-7,,
2017,1,NCAAF_20170902_SALA@MISS,Ole Miss,,South Alabama,,1-0,0-1,,13,10,47,27,10,3,27,7,0,10,3,14,1,3,20,,
2017,1,NCAAF_20170902_ABIL@NMEX,New Mexico,,Abil Christian,,1-0,0-1,,14,7,38,14,7,7,10,14,7,0,0,7,1,7,24,,
2017,1,NCAAF_20170902_ARKST@NEB,Nebraska,,Arkansas St.,,1-0,0-1,,27,26,43,36,17,10,7,9,14,12,0,10,1,1,7,,
2017,1,NCAAF_20170902_FSU@BAMA,Alabama,,Florida State,,1-0,0-1,,10,7,24,7,3,7,11,3,0,7,0,0,1,3,17,,
2017,1,NCAAF_20170902_GRAM@TULANE,Tulane,,Grambling,,1-0,0-1,,24,0,43,14,14,10,7,12,0,0,7,7,1,24,29,,
2017,1,NCAAF_20170902_JACKST@TCU,TCU,,Jackson St.,,1-0,0-1,,35,0,63,0,21,14,21,7,0,0,0,0,1,35,63,,
2017,1,NCAAF_20170902_NOIOWA@IOWAST,Iowa St.,,Northern Iowa,,1-0,0-1,,21,10,42,24,14,7,14,7,7,3,7,7,1,11,18,,
2017,1,NCAAF_20170902_VANDY@MTSU,Middle Tenn.,,Vanderbilt,,0-1,1-0,,0,21,6,28,0,0,0,6,14,7,7,0,-1,-21,-22,,
2017,1,NCAAF_20170902_SUT@OREG,Oregon,,So. Utah,,1-0,0-1,,42,21,77,21,21,21,21,14,7,14,0,0,1,21,56,,
2017,1,NCAAF_20170902_DAVIS@SDGST,San Diego St.,,UC-Davis,,1-0,0-1,,24,3,38,17,10,14,14,0,3,0,0,14,1,21,21,,
2017,1,NCAAF_20170902_HOW@UNLV,UNLV,,Howard,,0-1,1-0,,19,21,40,43,6,13,14,7,7,14,7,15,-1,-2,-3,,
2017,1,NCAAF_20170902_BYU@LSU,LSU,,BYU,,1-0,1-1,,14,0,27,0,0,14,6,7,0,0,0,0,0,14,27,,
2017,1,NCAAF_20170902_UIW@FRESNO,Fresno St.,,Incarnate Word,,1-0,0-1,,34,0,66,0,17,17,32,0,0,0,0,0,1,34,66,,
2017,1,NCAAF_20170902_MTST@WASHST,Washington St.,,Montana St.,,1-0,0-1,,14,0,31,0,7,7,7,10,0,0,0,0,1,14,31,,
2017,1,NCAAF_20170902_NAZ@ARIZ,Arizona,,N. Arizona,,1-0,0-1,,34,14,62,24,14,20,14,14,7,7,0,10,1,20,38,,
2017,1,NCAAF_20170902_WCAR@HAWAII,Hawaii,,W. Carolina,,2-0,0-1,,21,10,41,18,7,14,13,7,0,10,8,0,2,11,23,,
2017,1,NCAAF_20170901_FORD@ARMY,Army,,Fordham,,1-0,0-1,,34,6,64,6,21,13,17,13,0,6,0,0,1,28,58,,
2017,1,NCAAF_20170901_CHARLO@EMICH,E. Michigan,,Charlotte,,1-0,0-1,,17,7,24,7,14,3,7,0,7,0,0,0,1,10,17,,
2017,1,NCAAF_20170901_CCTST@CUSE,Syracuse,,CCSU,,1-0,0-1,,31,0,50,7,21,10,13,6,0,0,7,0,1,31,43,,
2017,1,NCAAF_20170901_COLOST@COLO,Colorado,,Colorado St.,,1-0,1-1,,17,3,17,3,10,7,0,0,0,3,0,0,0,14,14,,
2017,1,NCAAF_20170901_NAVY@FAU,FAU,,Navy,,0-1,1-0,,10,21,19,42,3,7,3,6,7,14,14,7,-1,-11,-23,,
2017,1,NCAAF_20170901_WASH@RUT,Rutgers,,Washington,,0-1,1-0,,7,10,14,30,7,0,0,7,3,7,10,10,-1,-3,-16,,
2017,1,NCAAF_20170901_UTAHST@WISC,Wisconsin,,Utah St.,,1-0,0-1,,10,10,59,10,0,10,28,21,10,0,0,0,1,0,49,,
2017,1,NCAAF_20170901_BC@NILL,N. Illinois,,Boston College,,0-1,1-0,,10,13,20,23,3,7,7,3,3,10,7,3,-1,-3,-3,,
2017,1,NCAAF_20170831_FIU@UCF,UCF,,FIU,,1-0,0-1,,40,10,61,17,14,26,14,7,7,3,7,0,1,30,44,,
2017,1,NCAAF_20170831_PRESBY@WAKE,Wake Forest,,Presbyterian,,1-0,0-1,,37,0,51,7,16,21,14,0,0,0,0,7,1,37,44,,
2017,1,NCAAF_20170831_AP@CINCY,Cincinnati,,Austin Peay,,1-0,0-1,,14,7,26,14,0,14,6,6,0,7,0,7,1,7,12,,
2017,1,NCAAF_20170831_BUFF@MINN,Minnesota,,Buffalo,,1-0,0-1,,14,7,17,7,14,0,0,3,7,0,0,0,1,7,10,,
2017,1,NCAAF_20170831_ELON@TOLEDO,Toledo,,Elon,,1-0,0-1,,19,7,47,13,13,6,21,7,0,7,0,6,1,12,34,,
2017,1,NCAAF_20170831_TNST@GAST,Georgia St.,,Tennessee St.,,0-1,1-0,,3,10,10,17,0,3,0,7,3,7,7,0,-1,-7,-7,,
2017,1,NCAAF_20170831_HOLY@UCONN,UConn,,Holy Cross,,1-0,0-1,,7,20,27,20,7,0,7,13,3,17,0,0,1,-13,7,,
2017,1,NCAAF_20170831_NDK@UTAH,Utah,,North Dakota,,1-0,0-1,,17,9,37,16,0,17,10,10,3,6,0,7,1,8,21,,
2017,1,NCAAF_20170831_TULSA@OKLAST,Oklahoma State,,Tulsa,,1-0,0-1,,38,17,59,24,21,17,14,7,0,17,0,7,1,21,35,,
2017,1,NCAAF_20170831_FAMU@ARK,Arkansas,,Florida A&M,,1-0,1-1,,21,0,49,7,7,14,14,14,0,0,0,7,0,21,42,,
2017,1,NCAAF_20170831_OHIOST@IND,Indiana,,Ohio State,,0-1,1-0,,14,13,21,49,7,7,7,0,3,10,22,14,-1,1,-28,,
2017,1,NCAAF_20170831_LAMON@MEMP,Memphis,,UL-Monroe,,1-0,0-1,,20,7,37,29,7,13,17,0,7,0,7,15,1,13,8,,
2017,1,NCAAF_20170831_SACST@IDAHO,Idaho,,Sacramento St.,,1-0,0-1,,14,6,28,6,0,14,7,7,0,6,0,0,1,8,22,,
2017,1,NCAAF_20170831_NMEXST@ARIZST,Arizona St.,,New Mexico St.,,1-0,0-1,,14,13,37,31,14,0,16,7,0,13,0,18,1,1,6,,
2017,1,NCAAF_20170826_OREGST@COLOST,Colorado St.,,Oregon State,,1-1,1-1,,24,20,58,27,7,17,10,24,10,10,0,7,0,4,31,,
2017,1,NCAAF_20170826_PORTST@BYU,BYU,,Portland St.,,1-1,0-2,,14,6,20,6,7,7,0,6,0,6,0,0,1,8,14,,
2017,1,NCAAF_20170826_HAWAII@MA,UMass,,Hawaii,,0-2,2-0,,14,14,35,38,7,7,14,7,7,7,7,17,-2,0,-3,,
2017,1,NCAAF_20170826_SFLA@SJST,San Jose St.,,South Florida,,1-0,2-0,,16,28,22,42,16,0,0,6,0,28,7,7,-1,-12,-20,,
2017,1,NCAAF_20170826_STNFRD@RICE,Rice,,Stanford,,0-1,1-0,,0,38,7,62,0,0,0,7,21,17,14,10,-1,-38,-55,,
2017,2,NCAAF_20170909_BUFF@ARMY,Army,,Buffalo,,2-0,0-2,,7,17,21,17,7,0,0,14,3,14,0,0,2,-10,4,,
2017,2,NCAAF_20170909_CHARLO@KSTATE,Kansas State,,Charlotte,,2-0,0-2,,38,7,55,7,21,17,10,7,7,0,0,0,2,31,48,,
2017,2,NCAAF_20170909_CINCY@MICH,Michigan,,Cincinnati,,2-0,1-1,,17,7,36,14,14,3,7,12,7,0,7,0,1,10,22,,
2017,2,NCAAF_20170909_ECU@WVU,West Virginia,,East Carolina,,1-1,0-2,,49,3,56,20,21,28,7,0,3,0,10,7,1,46,36,,
2017,2,NCAAF_20170909_EKY@UK,Kentucky,,E. Kentucky,,2-0,0-2,,10,13,27,16,3,7,7,10,7,6,3,0,2,-3,11,,
2017,2,NCAAF_20170909_FAU@WISC,Wisconsin,,FAU,,2-0,0-2,,24,14,31,14,14,10,7,0,7,7,0,0,2,10,17,,
2017,2,NCAAF_20170909_LVILLE@UNC,North Carolina,,Louisville,,0-2,2-0,,14,20,35,47,7,7,14,7,10,10,7,20,-2,-6,-12,,
2017,2,NCAAF_20170909_NWEST@DUKE,Duke,,Northwestern,,2-0,1-1,,21,10,41,17,7,14,10,10,3,7,0,7,1,11,24,,
2017,2,NCAAF_20170909_TNMART@MISS,Ole Miss,,UT Martin,,2-0,1-1,,17,16,45,23,7,10,21,7,9,7,0,7,1,1,22,,
2017,2,NCAAF_20170909_TWST@MD,Maryland,,Towson,,2-0,1-1,,28,7,63,17,21,7,21,14,0,7,0,10,1,21,46,,
2017,2,NCAAF_20170909_JAXST@GATECH,Georgia Tech,,Jacksonville St.,,1-1,1-1,,10,7,37,10,3,7,20,7,0,7,3,0,0,3,27,,
2017,2,NCAAF_20170909_WAKE@BC,Boston College,,Wake Forest,,1-1,2-0,,7,21,10,34,0,7,3,0,7,14,10,3,-1,-14,-24,,
2017,2,NCAAF_20170909_TXSTSM@COLO,Colorado,,Texas St.,,2-0,1-1,,14,0,37,3,7,7,17,6,0,0,3,0,1,14,34,,
2017,2,NCAAF_20170909_UAB@BALLST,Ball St.,,UAB,,1-1,1-1,,21,17,51,31,7,14,17,13,3,14,7,7,0,4,20,,
2017,2,NCAAF_20170909_ABIL@COLOST,Colorado St.,,Abil Christian,,2-1,0-2,,17,0,38,10,10,7,14,7,0,0,10,0,2,17,28,,
2017,2,NCAAF_20170909_AP@MIAOH,Miami-OH,,Austin Peay,,1-1,0-2,,21,7,31,10,7,14,0,10,7,0,3,0,1,14,21,,
2017,2,NCAAF_20170909_DE@VATECH,Virginia Tech,,Delaware,,2-0,1-1,,17,0,27,0,7,10,0,10,0,0,0,0,1,17,27,,
2017,2,NCAAF_20170909_EIL@NILL,N. Illinois,,E. Illinois,,1-1,1-1,,31,3,38,10,7,24,7,0,3,0,0,7,0,28,28,,
2017,2,NCAAF_20170909_EMICH@RUT,Rutgers,,E. Michigan,,0-2,2-0,,3,10,13,16,3,0,10,0,7,3,3,3,-2,-7,-3,,
2017,2,NCAAF_20170909_FRESNO@BAMA,Alabama,,Fresno St.,,2-0,1-1,,28,3,41,10,14,14,3,10,3,0,0,7,1,25,31,,
2017,2,NCAAF_20170909_HOW@KENTST,Kent St.,,Howard,,1-1,1-1,,21,14,38,31,14,7,2,15,7,7,10,7,0,7,7,,
2017,2,NCAAF_20170909_IND@UVA,Virginia,,Indiana,,1-1,1-1,,3,17,17,34,0,3,7,7,0,17,10,7,0,-14,-17,,
2017,2,NCAAF_20170909_MTSU@CUSE,Syracuse,,Middle Tenn.,,1-1,1-1,,13,9,23,30,3,10,3,7,2,7,7,14,0,4,-7,,
2017,2,NCAAF_20170909_NOVA@TEMPLE,Temple,,Villanova,,1-1,1-1,,10,0,16,13,3,7,3,3,0,0,3,10,0,10,3,,
2017,2,NCAAF_20170909_ODU@MA,UMass,,Old Dominion,,0-3,2-0,,0,10,7,17,0,0,7,0,3,7,0,7,-2,-10,-10,,
2017,2,NCAAF_20170909_PITT@PSU,Penn State,,Pittsburgh,,2-0,1-1,,14,3,33,14,14,0,7,12,0,3,3,8,1,11,19,,
2017,2,NCAAF_20170909_SAV@APLST,App. St.,,Savannah St.,,1-1,0-1,,45,0,54,7,14,31,2,7,0,0,0,7,1,45,47,,
2017,2,NCAAF_20170909_SJST@TEXAS,Texas,,San Jose St.,,1-1,1-2,,21,0,56,0,7,14,14,21,0,0,0,0,0,21,56,,
2017,2,NCAAF_20170909_TCU@ARK,Arkansas,,TCU,,1-1,2-0,,7,14,7,28,7,0,0,0,7,7,0,14,-1,-7,-21,,
2017,2,NCAAF_20170909_TULANE@NAVY,Navy,,Tulane,,2-0,1-1,,14,13,23,21,7,7,9,0,0,13,0,8,1,1,2,,
2017,2,NCAAF_20170909_WMICH@MICHST,Michigan St.,,W. Michigan,,2-0,0-2,,14,0,28,14,7,7,7,7,0,0,7,7,2,14,14,,
2017,2,NCAAF_20170909_ALAM@VANDY,Vanderbilt,,Alabama A&M,,2-0,0-2,,35,0,42,0,14,21,7,0,0,0,0,0,2,35,42,,
2017,2,NCAAF_20170909_CMICH@KANSAS,Kansas,,C. Michigan,,1-1,2-0,,6,24,27,45,3,3,14,7,0,24,7,14,-1,-18,-18,,
2017,2,NCAAF_20170909_GRDWB@WYO,Wyoming,,Gardner-Webb,,1-1,0-2,,24,0,27,0,14,10,0,3,0,0,0,0,1,24,27,,
2017,2,NCAAF_20170909_INST@TENN,Tennessee,,Indiana St.,,2-0,0-2,,28,0,42,7,14,14,7,7,0,0,7,0,2,28,35,,
2017,2,NCAAF_20170909_LALAF@TULSA,Tulsa,,Louisiana,,1-1,1-1,,38,23,66,42,10,28,7,21,10,13,12,7,0,15,24,,
2017,2,NCAAF_20170909_NH@GAS,Ga. Southern,,New Hamp.,,0-2,2-0,,0,22,12,22,0,0,5,7,15,7,0,0,-2,-22,-10,,
2017,2,NCAAF_20170909_NEB@OREG,Oregon,,Nebraska,,2-0,1-1,,42,14,42,35,21,21,0,0,7,7,14,7,1,28,7,,
2017,2,NCAAF_20170909_HAWAII@UCLA,UCLA,,Hawaii,,2-0,2-1,,35,7,56,23,14,21,14,7,0,7,7,9,0,28,33,,
2017,2,NCAAF_20170909_WBRST@CAL,California,,Weber St.,,2-0,1-1,,17,20,33,20,7,10,0,16,10,10,0,0,1,-3,13,,
2017,2,NCAAF_20170909_ALST@TROY,Troy,,Alabama St.,,1-1,0-2,,20,7,34,7,7,13,7,7,7,0,0,0,1,13,27,,
2017,2,NCAAF_20170909_MRSHL@NCST,NC State,,Marshall,,1-1,1-1,,23,20,37,20,3,20,7,7,10,10,0,0,0,3,17,,
2017,2,NCAAF_20170909_SD@BGREEN,Bowling Green,,South Dakota,,0-2,2-0,,9,21,27,35,3,6,7,11,21,0,7,7,-2,-12,-8,,
2017,2,NCAAF_20170909_ARPB@AKRON,Akron,,Ark.-Pine Bluff,,1-1,1-1,,31,3,52,3,14,17,14,7,0,3,0,0,0,28,49,,
2017,2,NCAAF_20170909_AUBURN@CLEM,Clemson,,Auburn,,2-0,1-1,,7,6,14,6,0,7,7,0,3,3,0,0,1,1,8,,
2017,2,NCAAF_20170909_NICHST@TXAM,Texas A&M,,Nicholls St.,,1-1,1-1,,14,6,24,14,14,0,0,10,0,6,0,8,0,8,10,,
2017,2,NCAAF_20170909_NTEXAS@SMU,SMU,,North Texas,,2-0,1-1,,24,10,54,32,10,14,16,14,10,0,7,15,1,14,22,,
2017,2,NCAAF_20170909_SC@MIZZOU,Missouri,,South Carolina,,1-1,2-0,,10,14,13,31,3,7,3,0,0,14,10,7,-1,-4,-18,,
2017,2,NCAAF_20170909_SO@USM,So. Miss,,Southern U.,,1-1,1-1,,35,0,45,0,28,7,10,0,0,0,0,0,0,35,45,,
2017,2,NCAAF_20170909_TOLEDO@NEVADA,Nevada,,Toledo,,0-2,2-0,,10,20,24,37,3,7,14,0,17,3,14,3,-2,-10,-13,,
2017,2,NCAAF_20170909_UNLV@IDAHO,Idaho,,UNLV,,1-1,1-1,,3,10,16,44,0,3,7,6,7,3,24,10,0,-7,-28,,
2017,2,NCAAF_20170909_MISSST@LATECH,Louisiana Tech,,Miss. State,,1-1,2-0,,14,36,21,57,9,5,0,7,16,20,21,0,-1,-22,-36,,
2017,2,NCAAF_20170909_OKLA@OHIOST,Ohio State,,Oklahoma,,1-1,2-0,,3,3,16,31,0,3,10,3,0,3,14,14,-1,0,-15,,
2017,2,NCAAF_20170909_TNCHAT@LSU,LSU,,Chattanooga,,2-0,0-2,,28,3,45,10,14,14,14,3,3,0,0,7,2,25,35,,
2017,2,NCAAF_20170909_UGA@ND,Notre Dame,,Georgia,,1-0,1-0,,13,10,19,20,3,10,3,3,3,7,7,3,0,3,-1,,
2017,2,NCAAF_20170909_MT@WASH,Washington,,Montana,,2-0,1-1,,35,7,63,7,21,14,14,14,7,0,0,0,1,28,56,,
2017,2,NCAAF_20170909_NMEXST@NMEX,New Mexico,,New Mexico St.,,1-1,1-1,,5,23,28,30,2,3,0,23,13,10,7,0,0,-18,-2,,
2017,2,NCAAF_20170909_RICE@UTEP,UTEP,,Rice,,0-2,1-1,,7,10,14,31,7,0,0,7,3,7,7,14,-1,-3,-17,,
2017,2,NCAAF_20170909_TXSA@BAYLOR,Baylor,,UTSA,,0-2,1-0,,7,7,10,17,0,7,0,3,0,7,7,3,-1,0,-7,,
2017,2,NCAAF_20170909_WKY@ILL,Illinois,,W. Kentucky,,2-0,1-1,,13,0,20,7,3,10,7,0,0,0,0,7,1,13,13,,
2017,2,NCAAF_20170909_STNFRD@USC,USC,,Stanford,,2-0,1-1,,28,17,42,24,14,14,0,14,7,10,0,7,1,11,18,,
2017,2,NCAAF_20170909_MINN@OREGST,Oregon State,,Minnesota,,1-2,2-0,,14,20,14,48,0,14,0,0,10,10,14,14,-1,-6,-34,,
2017,2,NCAAF_20170909_UTAH@BYU,BYU,,Utah,,1-2,2-0,,0,9,13,19,0,0,6,7,3,6,10,0,-1,-9,-6,,
2017,2,NCAAF_20170909_HOU@ARIZ,Arizona,,Houston,,1-1,1-0,,10,17,16,19,3,7,3,3,3,14,2,0,0,-7,-3,,
2017,2,NCAAF_20170909_SDGST@ARIZST,Arizona St.,,San Diego St.,,0-2,2-0,,14,20,20,30,7,7,0,6,7,13,7,3,-2,-6,-10,,
2017,2,NCAAF_20170908_ALCORN@FIU,FIU,,Alcorn St.,,1-1,1-1,,7,7,17,10,0,7,3,7,0,7,0,3,0,0,7,,
2017,2,NCAAF_20170908_OHIO@PURDUE,Purdue,,Ohio,,1-1,1-1,,34,7,44,21,10,24,7,3,7,0,7,7,0,27,23,,
2017,2,NCAAF_20170908_OKLAST@SALA,South Alabama,,Oklahoma State,,0-2,2-0,,0,20,7,44,0,0,0,7,17,3,21,3,-2,-20,-37,,
2017,2,NCAAF_20170907_IDST@UTAHST,Utah St.,,Idaho State,,1-1,1-1,,38,6,51,13,17,21,7,6,0,6,7,0,0,32,38,,
2017,3,NCAAF_20170916_AF@MICH,Michigan,,Air Force,,3-0,1-1,,9,6,29,13,3,6,10,10,3,3,7,0,2,3,16,,
2017,3,NCAAF_20170916_DEST@WVU,West Virginia,,Delaware St.,,2-1,0-3,,45,10,59,16,24,21,7,7,10,0,0,6,2,35,43,,
2017,3,NCAAF_20170916_IOWAST@AKRON,Akron,,Iowa St.,,1-2,2-1,,14,20,14,41,0,14,0,0,14,6,14,7,-1,-6,-27,,
2017,3,NCAAF_20170916_KANSAS@OHIO,Ohio,,Kansas,,2-1,1-2,,25,14,42,30,11,14,14,3,0,14,0,16,1,11,12,,
2017,3,NCAAF_20170916_LALAF@TXAM,Texas A&M,,Louisiana,,2-1,1-2,,14,21,45,21,7,7,17,14,0,21,0,0,1,-7,24,,
2017,3,NCAAF_20170916_NILL@NEB,Nebraska,,N. Illinois,,1-2,2-1,,0,14,17,21,0,0,10,7,14,0,0,7,-1,-14,-4,,
2017,3,NCAAF_20170916_OKLAST@PITT,Pittsburgh,,Oklahoma State,,1-2,3-0,,14,49,21,59,0,14,7,0,21,28,7,3,-2,-35,-38,,
2017,3,NCAAF_20170916_UCLA@MEMP,Memphis,,UCLA,,2-0,2-1,,27,24,48,45,7,20,14,7,7,17,14,7,0,3,3,,
2017,3,NCAAF_20170916_UCONN@UVA,Virginia,,UConn,,2-1,1-1,,24,0,38,18,7,17,7,7,0,0,6,12,1,24,20,,
2017,3,NCAAF_20170916_FUR@NCST,NC State,,Furman,,2-1,0-3,,28,13,49,16,14,14,21,0,3,10,0,3,2,15,33,,
2017,3,NCAAF_20170916_BAYLOR@DUKE,Duke,,Baylor,,3-0,0-3,,14,7,34,20,7,7,10,10,7,0,13,0,3,7,14,,
2017,3,NCAAF_20170916_CSTCAR@UAB,UAB,,C. Carolina,,2-1,1-1,,16,5,30,23,13,3,7,7,2,3,8,10,1,11,7,,
2017,3,NCAAF_20170916_NCO@COLO,Colorado,,N. Colorado,,3-0,1-1,,28,14,41,21,14,14,3,10,7,7,7,0,2,14,20,,
2017,3,NCAAF_20170916_TNTECH@BALLST,Ball St.,,Tenn. Tech,,2-1,0-3,,21,7,28,13,7,14,7,0,0,7,6,0,2,14,15,,
2017,3,NCAAF_20170916_UTAHST@WAKE,Wake Forest,,Utah St.,,3-0,1-2,,29,0,46,10,14,15,17,0,0,0,10,0,2,29,36,,
2017,3,NCAAF_20170916_CMICH@CUSE,Syracuse,,C. Michigan,,2-1,2-1,,24,17,41,17,10,14,17,0,10,7,0,0,0,7,24,,
2017,3,NCAAF_20170916_MRGNST@RUT,Rutgers,,Morgan St.,,1-2,0-3,,34,0,65,0,7,27,17,14,0,0,0,0,1,34,65,,
2017,3,NCAAF_20170916_MTSU@MINN,Minnesota,,Middle Tenn.,,3-0,1-2,,20,3,34,3,3,17,7,7,0,3,0,0,2,17,31,,
2017,3,NCAAF_20170916_ND@BC,Boston College,,Notre Dame,,1-2,2-1,,10,14,20,49,3,7,3,7,7,7,14,21,-1,-4,-29,,
2017,3,NCAAF_20170916_NTEXAS@IOWA,Iowa,,North Texas,,3-0,1-2,,10,14,31,14,7,3,7,14,7,7,0,0,2,-4,17,,
2017,3,NCAAF_20170916_SMU@TCU,TCU,,SMU,,3-0,2-1,,28,22,56,36,7,21,7,21,16,6,7,7,1,6,20,,
2017,3,NCAAF_20170916_TENN@FLA,Florida,,Tennessee,,1-1,2-1,,6,3,26,20,3,3,0,20,0,3,0,17,-1,3,6,,
2017,3,NCAAF_20170916_UNC@ODU,Old Dominion,,North Carolina,,2-1,1-2,,7,39,23,53,0,7,10,6,11,28,7,7,1,-32,-30,,
2017,3,NCAAF_20170916_VATECH@ECU,East Carolina,,Virginia Tech,,0-3,3-0,,17,23,17,64,17,0,0,0,7,16,34,7,-3,-6,-47,,
2017,3,NCAAF_20170916_WISC@BYU,BYU,,Wisconsin,,1-3,3-0,,6,24,6,40,3,3,0,0,10,14,7,9,-2,-18,-34,,
2017,3,NCAAF_20170916_MERCER@AUBURN,Auburn,,Mercer,,2-1,1-2,,10,3,24,10,7,3,7,7,0,3,0,7,1,7,14,,
2017,3,NCAAF_20170916_PURDUE@MIZZOU,Missouri,,Purdue,,1-2,2-1,,3,28,3,35,0,3,0,0,14,14,7,0,-1,-25,-32,,
2017,3,NCAAF_20170916_ARMY@OHIOST,Ohio State,,Army,,2-1,2-1,,17,7,38,7,14,3,14,7,0,7,0,0,0,10,31,,
2017,3,NCAAF_20170916_OREGST@WASHST,Washington St.,,Oregon State,,3-0,1-3,,28,9,52,23,7,21,14,10,2,7,7,7,2,19,29,,
2017,3,NCAAF_20170916_COLG@BUFF,Buffalo,,Colgate,,1-2,1-2,,30,3,33,10,20,10,0,3,3,0,7,0,0,27,23,,
2017,3,NCAAF_20170916_NCAT@CHARLO,Charlotte,,NC A&T,,0-3,3-0,,10,21,31,35,7,3,7,14,14,7,7,7,-3,-11,-4,,
2017,3,NCAAF_20170916_TULANE@OKLA,Oklahoma,,Tulane,,3-0,1-2,,28,14,56,14,14,14,7,21,14,0,0,0,2,14,42,,
2017,3,NCAAF_20170916_BTHN@FAU,FAU,,Bethune-Cook.,,1-2,1-2,,21,0,45,0,14,7,17,7,0,0,0,0,0,21,45,,
2017,3,NCAAF_20170916_KENTST@MRSHL,Marshall,,Kent St.,,2-1,1-2,,7,0,21,0,0,7,0,14,0,0,0,0,1,7,21,,
2017,3,NCAAF_20170916_ALAM@SALA,South Alabama,,Alabama A&M,,1-2,0-3,,31,0,45,0,24,7,14,0,0,0,0,0,1,31,45,,
2017,3,NCAAF_20170916_APLST@TXSTSM,Texas St.,,App. St.,,1-2,2-1,,10,7,13,20,7,3,0,3,0,7,10,3,-1,3,-7,,
2017,3,NCAAF_20170916_ARPB@ARKST,Arkansas St.,,Ark.-Pine Bluff,,1-1,1-2,,20,3,48,3,13,7,21,7,0,3,0,0,0,17,45,,
2017,3,NCAAF_20170916_COLOST@BAMA,Alabama,,Colorado St.,,3-0,2-2,,24,10,41,23,17,7,14,3,0,10,0,13,1,14,18,,
2017,3,NCAAF_20170916_IDAHO@WMICH,W. Michigan,,Idaho,,1-2,1-2,,6,14,37,28,3,3,13,18,7,7,14,0,0,-8,9,,
2017,3,NCAAF_20170916_IDST@NEVADA,Nevada,,Idaho State,,0-3,2-1,,7,23,28,30,0,7,7,14,10,13,7,0,-2,-16,-2,,
2017,3,NCAAF_20170916_LATECH@WKY,W. Kentucky,,Louisiana Tech,,1-2,2-1,,15,13,22,23,8,7,7,0,3,10,0,10,-1,2,-1,,
2017,3,NCAAF_20170916_LSU@MISSST,Miss. State,,LSU,,3-0,2-1,,17,7,37,7,0,17,13,7,0,7,0,0,1,10,30,,
2017,3,NCAAF_20170916_OREG@WYO,Wyoming,,Oregon,,1-2,3-0,,10,42,13,49,10,0,3,0,14,28,0,7,-2,-32,-36,,
2017,3,NCAAF_20170916_SO@TXSA,UTSA,,Southern U.,,2-0,1-2,,48,0,51,17,21,27,3,0,0,0,7,10,1,48,34,,
2017,3,NCAAF_20170916_TULSA@TOLEDO,Toledo,,Tulsa,,3-0,1-2,,14,28,54,51,7,7,22,18,21,7,9,14,2,-14,3,,
2017,3,NCAAF_20170916_USM@LAMON,UL-Monroe,,So. Miss,,0-2,2-1,,10,21,17,28,0,10,7,0,7,14,7,0,-2,-11,-11,,
2017,3,NCAAF_20170916_BGREEN@NWEST,Northwestern,,Bowling Green,,2-1,0-3,,35,7,49,7,14,21,0,14,7,0,0,0,2,28,42,,
2017,3,NCAAF_20170916_GAST@PSU,Penn State,,Georgia St.,,3-0,0-2,,35,0,56,0,14,21,14,7,0,0,0,0,3,35,56,,
2017,3,NCAAF_20170916_KSTATE@VANDY,Vanderbilt,,Kansas State,,3-0,2-1,,7,7,14,7,7,0,0,7,0,7,0,0,1,0,7,,
2017,3,NCAAF_20170916_SAMF@UGA,Georgia,,Samford,,3-0,2-1,,21,7,42,14,14,7,21,0,0,7,0,7,1,14,28,,
2017,3,NCAAF_20170916_UK@SC,South Carolina,,Kentucky,,2-1,3-0,,6,14,13,23,6,0,0,7,7,7,3,6,-1,-8,-10,,
2017,3,NCAAF_20170916_ARIZST@TXTECH,Texas Tech,,Arizona St.,,2-0,1-2,,35,17,52,45,21,14,10,7,3,14,21,7,1,18,7,,
2017,3,NCAAF_20170916_CINCY@MIAOH,Miami-OH,,Cincinnati,,1-2,2-1,,7,3,17,21,7,0,7,3,3,0,0,18,-1,4,-4,,
2017,3,NCAAF_20170916_CLEM@LVILLE,Louisville,,Clemson,,2-1,3-0,,7,19,21,47,7,0,0,14,7,12,14,14,-1,-12,-26,,
2017,3,NCAAF_20170916_RICE@HOU,Houston,,Rice,,2-0,1-2,,38,0,38,3,17,21,0,0,0,0,0,3,1,38,35,,
2017,3,NCAAF_20170916_TROY@NMEXST,New Mexico St.,,Troy,,1-2,2-1,,3,13,24,27,3,0,13,8,13,0,14,0,-1,-10,-3,,
2017,3,NCAAF_20170916_FRESNO@WASH,Washington,,Fresno St.,,3-0,1-2,,41,7,48,16,27,14,7,0,0,7,6,3,2,34,32,,
2017,3,NCAAF_20170916_SJST@UTAH,Utah,,San Jose St.,,3-0,1-3,,30,13,54,16,9,21,7,17,3,10,0,3,2,17,38,,
2017,3,NCAAF_20170916_MISS@CAL,California,,Ole Miss,,3-0,2-1,,7,16,27,16,7,0,10,10,10,6,0,0,1,-9,11,,
2017,3,NCAAF_20170916_STNFRD@SDGST,San Diego St.,,Stanford,,3-0,1-2,,10,7,20,17,0,10,3,7,0,7,3,7,2,3,3,,
2017,3,NCAAF_20170915_ILL@SFLA,South Florida,,Illinois,,3-0,2-1,,23,9,47,23,9,14,14,10,2,7,0,14,1,14,24,,
2017,3,NCAAF_20170915_MA@TEMPLE,Temple,,UMass,,2-1,0-4,,16,7,29,21,3,13,6,7,0,7,7,7,2,9,8,,
2017,3,NCAAF_20170915_ARIZ@UTEP,UTEP,,Arizona,,0-3,2-1,,9,35,16,63,0,9,7,0,0,35,14,14,-2,-26,-47,,
2017,3,NCAAF_20170914_NMEX@BOISE,Boise St.,,New Mexico,,2-1,1-2,,14,7,28,14,7,7,0,14,0,7,0,7,1,7,14,,
2017,4,NCAAF_20170924_ECU@UCONN,UConn,,East Carolina,,1-2,1-3,,14,27,38,41,7,7,17,7,21,6,14,0,0,-13,-3,,
2017,4,NCAAF_20170923_ARMY@TULANE,Tulane,,Army,,2-2,2-2,,14,10,21,17,7,7,0,7,0,10,0,7,0,4,4,,
2017,4,NCAAF_20170923_KENTST@LVILLE,Louisville,,Kent St.,,3-1,1-3,,28,3,42,3,21,7,14,0,0,3,0,0,2,25,39,,
2017,4,NCAAF_20170923_MA@TENN,Tennessee,,UMass,,3-1,0-5,,14,6,17,13,0,14,3,0,0,6,7,0,3,8,4,,
2017,4,NCAAF_20170923_NCST@FSU,Florida State,,NC State,,0-2,3-1,,10,17,21,27,0,10,3,8,10,7,3,7,-3,-7,-6,,
2017,4,NCAAF_20170923_TXTECH@HOU,Houston,,Texas Tech,,2-1,3-0,,10,13,24,27,0,10,0,14,6,7,7,7,-1,-3,-3,,
2017,4,NCAAF_20170923_UNLV@OHIOST,Ohio State,,UNLV,,3-1,1-2,,44,7,54,21,16,28,10,0,0,7,7,7,2,37,33,,
2017,4,NCAAF_20170923_WVU@KANSAS,Kansas,,West Virginia,,1-3,3-1,,13,35,34,56,3,10,14,7,7,28,0,21,-2,-22,-22,,
2017,4,NCAAF_20170923_PITT@GATECH,Georgia Tech,,Pittsburgh,,2-1,1-3,,21,17,35,17,7,14,7,7,7,10,0,0,1,4,18,,
2017,4,NCAAF_20170923_NMEX@TULSA,Tulsa,,New Mexico,,1-3,2-2,,10,13,13,16,3,7,0,3,7,6,0,3,-1,-3,-3,,
2017,4,NCAAF_20170923_ODU@VATECH,Virginia Tech,,Old Dominion,,4-0,2-2,,17,0,38,0,3,14,14,7,0,0,0,0,2,17,38,,
2017,4,NCAAF_20170923_UCF@MD,Maryland,,UCF,,2-1,2-0,,3,14,10,38,3,0,7,0,0,14,7,17,0,-11,-28,,
2017,4,NCAAF_20170923_BAMA@VANDY,Vanderbilt,,Alabama,,3-1,4-0,,0,31,0,59,0,0,0,0,21,10,21,7,-1,-31,-59,,
2017,4,NCAAF_20170923_BC@CLEM,Clemson,,Boston College,,4-0,1-3,,7,0,34,7,0,7,0,27,0,0,7,0,3,7,27,,
2017,4,NCAAF_20170923_CINCY@NAVY,Navy,,Cincinnati,,3-0,2-2,,21,17,42,32,14,7,14,7,7,10,7,8,1,4,10,,
2017,4,NCAAF_20170923_DUKE@UNC,North Carolina,,Duke,,1-3,4-0,,10,10,17,27,3,7,7,0,7,3,3,14,-3,0,-10,,
2017,4,NCAAF_20170923_GAS@IND,Indiana,,Ga. Southern,,2-1,0-3,,31,7,52,17,21,10,14,7,0,7,10,0,2,24,35,,
2017,4,NCAAF_20170923_LATECH@SC,South Carolina,,Louisiana Tech,,3-1,2-2,,0,6,17,16,0,0,0,17,3,3,7,3,1,-6,1,,
2017,4,NCAAF_20170923_MIAOH@CMICH,C. Michigan,,Miami-OH,,2-2,2-2,,14,28,14,31,0,14,0,0,14,14,3,0,0,-14,-17,,
2017,4,NCAAF_20170923_RUT@NEB,Nebraska,,Rutgers,,2-2,1-3,,14,10,27,17,7,7,7,6,7,3,7,0,1,4,10,,
2017,4,NCAAF_20170923_TCU@OKLAST,Oklahoma State,,TCU,,3-1,4-0,,10,20,31,44,7,3,7,14,6,14,14,10,-1,-10,-13,,
2017,4,NCAAF_20170923_TOLEDO@MIAMI,Miami (Fla.),,Toledo,,2-0,3-1,,10,16,52,30,10,0,14,28,0,16,0,14,-1,-6,22,,
2017,4,NCAAF_20170923_USC@CAL,California,,USC,,3-1,4-0,,13,13,20,30,3,10,0,7,3,10,0,17,-1,0,-10,,
2017,4,NCAAF_20170923_WAKE@APLST,App. St.,,Wake Forest,,2-2,4-0,,9,3,19,20,6,3,7,3,3,0,14,3,-2,6,-1,,
2017,4,NCAAF_20170923_MICH@PURDUE,Purdue,,Michigan,,2-2,4-0,,10,7,10,28,0,10,0,0,0,7,7,14,-2,3,-18,,
2017,4,NCAAF_20170923_AKRON@TROY,Troy,,Akron,,3-1,1-3,,16,10,22,17,7,9,0,6,10,0,7,0,2,6,5,,
2017,4,NCAAF_20170923_GAST@CHARLO,Charlotte,,Georgia St.,,0-4,1-2,,0,14,0,28,0,0,0,0,0,14,0,14,-1,-14,-28,,
2017,4,NCAAF_20170923_NEVADA@WASHST,Washington St.,,Nevada,,4-0,0-4,,35,0,45,7,14,21,3,7,0,0,0,7,4,35,38,,
2017,4,NCAAF_20170923_OKLA@BAYLOR,Baylor,,Oklahoma,,0-4,4-0,,17,28,41,49,7,10,14,10,21,7,7,14,-4,-11,-8,,
2017,4,NCAAF_20170923_UAB@NTEXAS,North Texas,,UAB,,2-2,2-2,,30,14,46,43,10,20,7,9,7,7,15,14,0,16,3,,
2017,4,NCAAF_20170923_WIL@CSTCAR,C. Carolina,,W. Illinois,,1-2,3-0,,10,21,10,52,10,0,0,0,7,14,21,10,-2,-11,-42,,
2017,4,NCAAF_20170923_ARKST@SMU,SMU,,Arkansas St.,,3-1,1-2,,30,14,44,21,10,20,7,7,14,0,0,7,2,16,23,,
2017,4,NCAAF_20170923_BALLST@WKY,W. Kentucky,,Ball St.,,2-2,2-2,,17,7,33,21,7,10,0,16,7,0,7,7,0,10,12,,
2017,4,NCAAF_20170923_BGREEN@MTSU,Middle Tenn.,,Bowling Green,,2-2,0-4,,21,10,24,13,7,14,0,3,7,3,3,0,2,11,11,,
2017,4,NCAAF_20170923_CUSE@LSU,LSU,,Syracuse,,3-1,2-2,,14,3,35,26,7,7,14,7,3,0,16,7,1,11,9,,
2017,4,NCAAF_20170923_FAU@BUFF,Buffalo,,FAU,,2-2,1-3,,17,17,34,31,14,3,7,10,7,10,0,14,1,0,3,,
2017,4,NCAAF_20170923_MISSST@UGA,Georgia,,Miss. State,,4-0,3-1,,14,3,31,3,14,0,17,0,0,3,0,0,1,11,28,,
2017,4,NCAAF_20170923_SDGST@AF,Air Force,,San Diego St.,,1-2,4-0,,9,7,24,28,6,3,0,15,0,7,7,14,-3,2,-4,,
2017,4,NCAAF_20170923_WAG@WMICH,W. Michigan,,Wagner,,2-2,1-3,,21,7,49,14,7,14,28,0,0,7,0,7,1,14,35,,
2017,4,NCAAF_20170923_AUBURN@MIZZOU,Missouri,,Auburn,,1-3,3-1,,7,31,14,51,0,7,0,7,14,17,17,3,-2,-24,-37,,
2017,4,NCAAF_20170923_FIU@RICE,Rice,,FIU,,1-3,2-1,,7,10,7,13,0,7,0,0,0,10,3,0,-1,-3,-6,,
2017,4,NCAAF_20170923_FLA@UK,Kentucky,,Florida,,3-1,2-1,,14,14,27,28,7,7,10,3,0,14,0,14,1,0,-1,,
2017,4,NCAAF_20170923_PSU@IOWA,Iowa,,Penn State,,3-1,4-0,,7,5,19,21,0,7,0,12,3,2,10,6,-1,2,-2,,
2017,4,NCAAF_20170923_TXSA@TXSTSM,Texas St.,,UTSA,,1-3,3-0,,14,27,14,44,7,7,0,0,10,17,3,14,-2,-13,-30,,
2017,4,NCAAF_20170923_UTAHST@SJST,San Jose St.,,Utah St.,,1-4,2-2,,0,38,10,61,0,0,7,3,14,24,17,6,-1,-38,-51,,
2017,4,NCAAF_20170923_ND@MICHST,Michigan St.,,Notre Dame,,2-1,3-1,,7,28,18,38,7,0,3,8,14,14,7,3,-1,-21,-20,,
2017,4,NCAAF_20170923_SIL@MEMP,Memphis,,S. Illinois,,3-0,2-1,,17,21,44,31,7,10,17,10,14,7,3,7,1,-4,13,,
2017,4,NCAAF_20170923_UTEP@NMEXST,New Mexico St.,,UTEP,,2-2,0-4,,21,7,41,14,7,14,13,7,7,0,0,7,2,14,27,,
2017,4,NCAAF_20170923_OREG@ARIZST,Arizona St.,,Oregon,,0-1,3-1,,17,14,37,35,17,0,14,6,7,7,14,7,-3,3,2,,
2017,4,NCAAF_20170923_WASH@COLO,Colorado,,Washington,,3-1,4-0,,7,10,10,37,7,0,3,0,0,10,14,13,-1,-3,-27,,
2017,4,NCAAF_20170923_UCLA@STNFRD,Stanford,,UCLA,,2-2,2-2,,23,13,58,34,6,17,14,21,3,10,14,7,0,10,24,,
2017,4,NCAAF_20170922_UVA@BOISE,Boise St.,,Virginia,,2-2,3-1,,14,21,23,42,7,7,0,9,7,14,14,7,-1,-7,-19,,
2017,4,NCAAF_20170922_UTAH@ARIZ,Arizona,,Utah,,2-2,4-0,,10,13,24,30,3,7,7,7,10,3,14,3,-2,-3,-6,,
2017,4,NCAAF_20170921_TEMPLE@SFLA,South Florida,,Temple,,4-0,2-2,,20,7,43,7,3,17,13,10,0,7,0,0,2,13,36,,
2017,5,NCAAF_20170930_HOU@TEMPLE,Temple,,Houston,,2-3,3-1,,0,13,13,20,0,0,3,10,7,6,7,0,-1,-13,-7,,
2017,5,NCAAF_20170930_MD@MINN,Minnesota,,Maryland,,3-1,3-1,,10,17,24,31,0,10,7,7,7,10,0,14,0,-7,-7,,
2017,5,NCAAF_20170930_NMEXST@ARK,Arkansas,,New Mexico St.,,2-2,2-3,,28,10,42,24,14,14,7,7,0,10,7,7,0,18,18,,
2017,5,NCAAF_20170930_NWEST@WISC,Wisconsin,,Northwestern,,4-0,2-2,,7,10,33,24,7,0,14,12,3,7,0,14,2,-3,9,,
2017,5,NCAAF_20170930_RICE@PITT,Pittsburgh,,Rice,,2-3,1-4,,28,0,42,10,21,7,0,14,0,0,10,0,1,28,32,,
2017,5,NCAAF_20170930_SFLA@ECU,East Carolina,,South Florida,,1-4,5-0,,24,31,31,61,10,14,7,0,21,10,17,13,-4,-7,-30,,
2017,5,NCAAF_20170930_UNC@GATECH,Georgia Tech,,North Carolina,,3-1,1-4,,10,0,33,7,7,3,14,9,0,0,0,7,2,10,26,,
2017,5,NCAAF_20170930_VANDY@FLA,Florida,,Vanderbilt,,3-1,3-2,,17,17,38,24,7,10,7,14,7,10,0,7,0,0,14,,
2017,5,NCAAF_20170930_CUSE@NCST,NC State,,Syracuse,,4-1,2-3,,26,7,33,25,13,13,0,7,0,7,10,8,2,19,8,,
2017,5,NCAAF_20170930_CMICH@BC,Boston College,,C. Michigan,,2-3,2-3,,21,8,28,8,14,7,7,0,2,6,0,0,0,13,20,,
2017,5,NCAAF_20170930_BAYLOR@KSTATE,Kansas State,,Baylor,,3-1,0-5,,20,3,33,20,7,13,0,13,3,0,10,7,3,17,13,,
2017,5,NCAAF_20170930_BUFF@KENTST,Kent St.,,Buffalo,,1-4,3-2,,13,20,13,27,0,13,0,0,7,13,7,0,-2,-7,-14,,
2017,5,NCAAF_20170930_FSU@WAKE,Wake Forest,,Florida State,,4-1,1-2,,12,13,19,26,3,9,0,7,3,10,3,10,3,-1,-7,,
2017,5,NCAAF_20170930_IND@PSU,Penn State,,Indiana,,5-0,2-2,,28,14,45,14,28,0,10,7,0,14,0,0,3,14,31,,
2017,5,NCAAF_20170930_MURYST@LVILLE,Louisville,,Murray St.,,4-1,1-4,,35,3,55,10,14,21,10,10,3,0,7,0,3,32,45,,
2017,5,NCAAF_20170930_NAVY@TULSA,Tulsa,,Navy,,1-4,4-0,,14,14,21,31,14,0,0,7,0,14,3,14,-3,0,-10,,
2017,5,NCAAF_20170930_OHIO@MA,UMass,,Ohio,,0-6,4-1,,27,27,50,58,10,17,2,21,7,20,14,17,-4,0,-8,,
2017,5,NCAAF_20170930_UGA@TENN,Tennessee,,Georgia,,3-2,5-0,,0,24,0,41,0,0,0,0,10,14,7,10,-2,-24,-41,,
2017,5,NCAAF_20170930_UTEP@ARMY,Army,,UTEP,,3-2,0-5,,14,14,35,21,0,14,14,7,7,7,0,7,3,0,14,,
2017,5,NCAAF_20170930_ARIZST@STNFRD,Stanford,,Arizona St.,,3-2,2-3,,24,17,34,24,7,17,7,3,3,14,0,7,1,7,10,,
2017,5,NCAAF_20170930_EMICH@UK,Kentucky,,E. Michigan,,4-1,2-2,,14,14,24,20,7,7,3,7,7,7,0,6,2,0,4,,
2017,5,NCAAF_20170930_IOWA@MICHST,Michigan St.,,Iowa,,3-1,3-2,,17,7,17,10,14,3,0,0,0,7,0,3,0,10,7,,
2017,5,NCAAF_20170930_TXSTSM@WYO,Wyoming,,Texas St.,,3-2,1-4,,31,10,45,10,0,31,14,0,0,10,0,0,2,21,35,,
2017,5,NCAAF_20170930_UCONN@SMU,SMU,,UConn,,4-1,1-3,,21,10,49,28,7,14,7,21,7,3,10,8,3,11,21,,
2017,5,NCAAF_20170930_MIAOH@ND,Notre Dame,,Miami-OH,,4-1,2-3,,45,14,52,17,28,17,0,7,7,7,3,0,2,31,35,,
2017,5,NCAAF_20170930_AKRON@BGREEN,Bowling Green,,Akron,,0-5,2-3,,13,20,23,34,6,7,10,0,13,7,7,7,-2,-7,-11,,
2017,5,NCAAF_20170930_MISSST@AUBURN,Auburn,,Miss. State,,4-1,3-2,,21,10,49,10,14,7,7,21,3,7,0,0,1,11,39,,
2017,5,NCAAF_20170930_AF@NMEX,New Mexico,,Air Force,,3-2,1-3,,14,21,56,38,7,7,21,21,0,21,3,14,2,-7,18,,
2017,5,NCAAF_20170930_BALLST@WMICH,W. Michigan,,Ball St.,,3-2,2-3,,31,0,55,3,14,17,17,7,0,0,3,0,1,31,52,,
2017,5,NCAAF_20170930_CHARLO@FIU,FIU,,Charlotte,,3-1,0-5,,14,26,30,29,7,7,7,9,12,14,3,0,3,-12,1,,
2017,5,NCAAF_20170930_CSTCAR@LAMON,UL-Monroe,,C. Carolina,,2-2,1-3,,31,22,51,43,10,21,14,6,15,7,8,13,1,9,8,,
2017,5,NCAAF_20170930_MEMP@UCF,UCF,,Memphis,,3-0,3-1,,23,7,40,13,6,17,7,10,7,0,0,6,0,16,27,,
2017,5,NCAAF_20170930_MRSHL@CINCY,Cincinnati,,Marshall,,2-3,3-1,,0,24,21,38,0,0,7,14,7,17,7,7,-1,-24,-17,,
2017,5,NCAAF_20170930_MTSU@FAU,FAU,,Middle Tenn.,,2-3,2-3,,24,6,38,20,14,10,0,14,6,0,7,7,0,18,18,,
2017,5,NCAAF_20170930_NTEXAS@USM,So. Miss,,North Texas,,2-2,3-2,,21,17,28,43,14,7,7,0,7,10,16,10,-1,4,-15,,
2017,5,NCAAF_20170930_SALA@LATECH,Louisiana Tech,,South Alabama,,3-2,1-4,,17,13,34,16,14,3,0,17,7,6,3,0,2,4,18,,
2017,5,NCAAF_20170930_TROY@LSU,LSU,,Troy,,3-2,4-1,,0,10,21,24,0,0,7,14,7,3,7,7,-1,-10,-3,,
2017,5,NCAAF_20170930_OHIOST@RUT,Rutgers,,Ohio State,,1-4,4-1,,0,35,0,56,0,0,0,0,7,28,7,14,-3,-35,-56,,
2017,5,NCAAF_20170930_SC@TXAM,Texas A&M,,South Carolina,,4-1,3-2,,7,10,24,17,0,7,3,14,0,10,7,0,1,-3,7,,
2017,5,NCAAF_20170930_CLEM@VATECH,Virginia Tech,,Clemson,,4-1,5-0,,3,17,17,31,0,3,0,14,10,7,7,7,-1,-14,-14,,
2017,5,NCAAF_20170930_OKLAST@TXTECH,Texas Tech,,Oklahoma State,,3-1,4-1,,17,21,34,41,7,10,3,14,7,14,13,7,-1,-4,-7,,
2017,5,NCAAF_20170930_WASH@OREGST,Oregon State,,Washington,,1-4,5-0,,0,7,7,42,0,0,0,7,7,0,21,14,-4,-7,-35,,
2017,5,NCAAF_20170930_MISS@BAMA,Alabama,,Ole Miss,,5-0,2-2,,35,3,66,3,21,14,24,7,3,0,0,0,3,32,63,,
2017,5,NCAAF_20170930_NEVADA@FRESNO,Fresno St.,,Nevada,,2-2,0-5,,31,14,41,21,10,21,7,3,0,14,0,7,2,17,20,,
2017,5,NCAAF_20170930_CAL@OREG,Oregon,,California,,4-1,3-2,,17,7,45,24,17,0,7,21,0,7,7,10,1,10,21,,
2017,5,NCAAF_20170930_COLO@UCLA,UCLA,,Colorado,,3-2,3-2,,14,10,27,23,7,7,7,6,7,3,10,3,0,4,4,,
2017,5,NCAAF_20170930_NILL@SDGST,San Diego St.,,N. Illinois,,5-0,2-2,,31,14,34,28,14,17,0,3,14,0,14,0,3,17,6,,
2017,5,NCAAF_20170930_SJST@UNLV,UNLV,,San Jose St.,,2-2,1-5,,35,13,41,13,14,21,6,0,3,10,0,0,1,22,28,,
2017,5,NCAAF_20170930_COLOST@HAWAII,Hawaii,,Colorado St.,,2-3,3-2,,7,31,21,51,0,7,7,7,14,17,13,7,-1,-24,-30,,
2017,5,NCAAF_20170929_MIAMI@DUKE,Duke,,Miami (Fla.),,4-1,3-0,,6,17,6,31,3,3,0,0,14,3,0,14,1,-11,-25,,
2017,5,NCAAF_20170929_BYU@UTAHST,Utah St.,,BYU,,3-2,1-4,,24,21,40,24,7,17,3,13,7,14,0,3,2,3,16,,
2017,5,NCAAF_20170929_NEB@ILL,Illinois,,Nebraska,,2-2,3-2,,3,21,6,28,0,3,3,0,7,14,0,7,-1,-18,-22,,
2017,5,NCAAF_20170929_USC@WASHST,Washington St.,,USC,,5-0,4-1,,17,17,30,27,3,14,3,10,7,10,3,7,1,0,3,,
2017,5,NCAAF_20170928_TEXAS@IOWAST,Iowa St.,,Texas,,2-2,2-2,,0,14,7,17,0,0,7,0,7,7,0,3,0,-14,-10,,
2017,6,NCAAF_20171007_TULSA@TULANE,Tulane,,Tulsa,,3-2,1-5,,48,7,62,28,21,27,7,7,7,0,14,7,2,41,34,,
2017,6,NCAAF_20171007_EMICH@TOLEDO,Toledo,,E. Michigan,,4-1,2-3,,10,6,20,15,3,7,7,3,6,0,3,6,2,4,5,,
2017,6,NCAAF_20171007_ILL@IOWA,Iowa,,Illinois,,4-2,2-3,,17,13,45,16,7,10,7,21,3,10,3,0,2,4,29,,
2017,6,NCAAF_20171007_IOWAST@OKLA,Oklahoma,,Iowa St.,,4-1,3-2,,24,13,31,38,14,10,0,7,3,10,11,14,1,11,-7,,
2017,6,NCAAF_20171007_MISS@AUBURN,Auburn,,Ole Miss,,5-1,2-3,,35,3,44,23,14,21,6,3,3,0,7,13,3,32,21,,
2017,6,NCAAF_20171007_PSU@NWEST,Northwestern,,Penn State,,2-3,6-0,,0,10,7,31,0,0,0,7,3,7,14,7,-4,-10,-24,,
2017,6,NCAAF_20171007_TEMPLE@ECU,East Carolina,,Temple,,1-5,3-3,,3,24,10,34,3,0,7,0,0,24,7,3,-2,-21,-24,,
2017,6,NCAAF_20171007_TXTECH@KANSAS,Kansas,,Texas Tech,,1-4,4-1,,10,35,19,65,7,3,9,0,21,14,13,17,-3,-25,-46,,
2017,6,NCAAF_20171007_UGA@VANDY,Vanderbilt,,Georgia,,3-3,6-0,,7,21,14,45,0,7,0,7,7,14,17,7,-3,-14,-31,,
2017,6,NCAAF_20171007_WAKE@CLEM,Clemson,,Wake Forest,,6-0,4-2,,14,0,28,14,14,0,7,7,0,0,0,14,2,14,14,,
2017,6,NCAAF_20171007_DUKE@UVA,Virginia,,Duke,,4-1,4-2,,14,14,28,21,7,7,7,7,7,7,0,7,0,0,7,,
2017,6,NCAAF_20171007_PITT@CUSE,Syracuse,,Pittsburgh,,3-3,2-4,,10,10,27,24,3,7,10,7,0,10,3,11,1,0,3,,
2017,6,NCAAF_20171007_CMICH@OHIO,Ohio,,C. Michigan,,4-2,3-3,,14,13,23,26,7,7,0,9,7,6,6,7,1,1,-3,,
2017,6,NCAAF_20171007_BGREEN@MIAOH,Miami-OH,,Bowling Green,,2-4,1-5,,19,17,29,37,6,13,10,0,3,14,7,13,1,2,-8,,
2017,6,NCAAF_20171007_FIU@MTSU,Middle Tenn.,,FIU,,3-3,3-2,,17,3,37,17,3,14,10,10,3,0,7,7,0,14,20,,
2017,6,NCAAF_20171007_LAMON@TXSTSM,Texas St.,,UL-Monroe,,1-5,3-2,,20,26,27,45,20,0,0,7,19,7,9,10,-2,-6,-18,,
2017,6,NCAAF_20171007_AF@NAVY,Navy,,Air Force,,5-0,1-4,,28,10,48,45,7,21,10,10,7,3,14,21,4,18,3,,
2017,6,NCAAF_20171007_BALLST@AKRON,Akron,,Ball St.,,3-3,2-4,,17,3,31,3,7,10,0,14,3,0,0,0,1,14,28,,
2017,6,NCAAF_20171007_CHARSO@IND,Indiana,,Charleston So.,,3-2,2-3,,24,0,27,0,10,14,3,0,0,0,0,0,1,24,27,,
2017,6,NCAAF_20171007_KENTST@NILL,N. Illinois,,Kent St.,,3-2,1-5,,14,3,24,3,7,7,10,0,0,3,0,0,2,11,21,,
2017,6,NCAAF_20171007_LSU@FLA,Florida,,LSU,,3-2,4-2,,3,10,16,17,0,3,13,0,7,3,7,0,-1,-7,-1,,
2017,6,NCAAF_20171007_MIAMI@FSU,Florida State,,Miami (Fla.),,1-3,4-0,,3,0,20,24,3,0,0,17,0,0,10,14,-3,3,-4,,
2017,6,NCAAF_20171007_MINN@PURDUE,Purdue,,Minnesota,,3-2,3-2,,6,14,31,17,6,0,7,18,7,7,0,3,0,-8,14,,
2017,6,NCAAF_20171007_ND@UNC,North Carolina,,Notre Dame,,1-5,5-1,,7,16,10,33,0,7,0,3,0,16,10,7,-4,-9,-23,,
2017,6,NCAAF_20171007_NMEXST@APLST,App. St.,,New Mexico St.,,3-2,2-4,,17,14,45,31,3,14,0,28,7,7,3,14,1,3,14,,
2017,6,NCAAF_20171007_WVU@TCU,TCU,,West Virginia,,5-0,3-2,,7,3,31,24,0,7,17,7,3,0,14,7,2,4,7,,
2017,6,NCAAF_20171007_ARK@SC,South Carolina,,Arkansas,,4-2,2-3,,17,10,48,22,3,14,17,14,3,7,0,12,2,7,26,,
2017,6,NCAAF_20171007_LATECH@UAB,UAB,,Louisiana Tech,,3-2,3-3,,16,10,23,22,13,3,0,7,7,3,0,12,0,6,1,,
2017,6,NCAAF_20171007_MD@OHIOST,Ohio State,,Maryland,,5-1,3-2,,41,7,62,14,20,21,14,7,7,0,0,7,2,34,48,,
2017,6,NCAAF_20171007_OREGST@USC,USC,,Oregon State,,5-1,1-5,,21,3,38,10,14,7,7,10,0,3,0,7,4,18,28,,
2017,6,NCAAF_20171007_COLOST@UTAHST,Utah St.,,Colorado St.,,3-3,4-2,,7,24,14,27,0,7,0,7,17,7,0,3,-1,-17,-13,,
2017,6,NCAAF_20171007_LALAF@IDAHO,Idaho,,Louisiana,,2-3,2-3,,10,14,16,21,7,3,3,3,7,7,7,0,0,-4,-5,,
2017,6,NCAAF_20171007_FAU@ODU,Old Dominion,,FAU,,2-3,3-3,,14,31,28,58,7,7,7,7,17,14,14,13,-1,-17,-30,,
2017,6,NCAAF_20171007_MRSHL@CHARLO,Charlotte,,Marshall,,0-6,4-1,,0,7,3,14,0,0,3,0,7,0,7,0,-4,-7,-11,,
2017,6,NCAAF_20171007_ARMY@RICE,Rice,,Army,,1-5,4-2,,0,35,12,49,0,0,6,6,21,14,7,7,-3,-35,-37,,
2017,6,NCAAF_20171007_GAST@CSTCAR,C. Carolina,,Georgia St.,,1-4,2-2,,7,21,21,27,0,7,0,14,14,7,0,6,-1,-14,-6,,
2017,6,NCAAF_20171007_SMU@HOU,Houston,,SMU,,4-1,4-2,,21,12,35,22,7,14,7,7,9,3,10,0,0,9,13,,
2017,6,NCAAF_20171007_USM@TXSA,UTSA,,So. Miss,,3-1,3-2,,13,7,29,31,3,10,0,16,7,0,14,10,0,6,-2,,
2017,6,NCAAF_20171007_BAMA@TXAM,Texas A&M,,Alabama,,4-2,6-0,,3,17,19,27,3,0,7,9,7,10,7,3,-2,-14,-8,,
2017,6,NCAAF_20171007_VATECH@BC,Boston College,,Virginia Tech,,2-4,5-1,,3,17,10,23,3,0,0,7,7,10,3,3,-3,-14,-13,,
2017,6,NCAAF_20171007_FRESNO@SJST,San Jose St.,,Fresno St.,,1-6,3-2,,0,21,10,27,0,0,7,3,14,7,0,6,-2,-21,-17,,
2017,6,NCAAF_20171007_MICHST@MICH,Michigan,,Michigan St.,,4-1,4-1,,3,14,10,14,3,0,7,0,7,7,0,0,0,-11,-4,,
2017,6,NCAAF_20171007_MIZZOU@UK,Kentucky,,Missouri,,5-1,1-4,,20,14,40,34,10,10,7,13,0,14,13,7,4,6,6,,
2017,6,NCAAF_20171007_ARIZ@COLO,Colorado,,Arizona,,3-3,3-2,,14,21,42,45,7,7,7,21,14,7,14,10,0,-7,-3,,
2017,6,NCAAF_20171007_WASHST@OREG,Oregon,,Washington St.,,4-2,6-0,,10,13,10,33,10,0,0,0,7,6,10,10,-2,-3,-23,,
2017,6,NCAAF_20171007_WISC@NEB,Nebraska,,Wisconsin,,3-3,5-0,,10,17,17,38,0,10,7,0,10,7,7,14,-2,-7,-21,,
2017,6,NCAAF_20171007_WKY@UTEP,UTEP,,W. Kentucky,,0-6,3-2,,14,8,14,15,0,14,0,0,0,8,7,0,-3,6,-1,,
2017,6,NCAAF_20171007_STNFRD@UTAH,Utah,,Stanford,,4-1,4-2,,10,13,20,23,7,3,3,7,3,10,3,7,0,-3,-3,,
2017,6,NCAAF_20171007_HAWAII@NEVADA,Nevada,,Hawaii,,1-5,2-4,,21,14,35,21,7,14,7,7,7,7,7,0,-1,7,14,,
2017,6,NCAAF_20171007_CAL@WASH,Washington,,California,,6-0,3-3,,24,0,38,7,7,17,7,7,0,0,7,0,3,24,31,,
2017,6,NCAAF_20171007_SDGST@UNLV,UNLV,,San Diego St.,,2-3,6-0,,10,20,10,41,3,7,0,0,3,17,7,14,-4,-10,-31,,
2017,6,NCAAF_20171006_MEMP@UCONN,UConn,,Memphis,,1-4,4-1,,24,35,31,70,14,10,0,7,7,28,21,14,-3,-11,-39,,
2017,6,NCAAF_20171006_BOISE@BYU,BYU,,Boise St.,,1-5,3-2,,7,17,7,24,7,0,0,0,0,17,0,7,-2,-10,-17,,
2017,6,NCAAF_20171005_LVILLE@NCST,NC State,,Louisville,,5-1,4-2,,17,10,39,25,0,17,7,15,0,10,3,12,1,7,14,,
2017,6,NCAAF_20171004_ARKST@GAS,Ga. Southern,,Arkansas St.,,0-4,2-2,,17,22,25,43,0,17,0,8,3,19,14,7,-2,-5,-18,,
2017,7,NCAAF_20171015_SJST@HAWAII,Hawaii,,San Jose St.,,3-4,1-7,,14,13,37,26,0,14,7,16,10,3,7,6,2,1,11,,
2017,7,NCAAF_20171015_AKRON@WMICH,W. Michigan,,Akron,,4-3,4-3,,3,14,13,14,0,3,0,10,7,7,0,0,0,-11,-1,,
2017,7,NCAAF_20171014_BYU@MISSST,Miss. State,,BYU,,4-2,1-6,,21,3,35,10,7,14,7,7,0,3,7,0,3,18,25,,
2017,7,NCAAF_20171014_EMICH@ARMY,Army,,E. Michigan,,5-2,2-4,,14,14,28,27,7,7,7,7,7,7,0,13,3,0,1,,
2017,7,NCAAF_20171014_FSU@DUKE,Duke,,Florida State,,4-3,2-3,,3,7,10,17,0,3,7,0,7,0,3,7,2,-4,-7,,
2017,7,NCAAF_20171014_KANSAS@IOWAST,Iowa St.,,Kansas,,4-2,1-5,,24,0,45,0,14,10,14,7,0,0,0,0,3,24,45,,
2017,7,NCAAF_20171014_NCST@PITT,Pittsburgh,,NC State,,2-5,6-1,,14,14,17,35,7,7,0,3,14,0,7,14,-4,0,-18,,
2017,7,NCAAF_20171014_RUT@ILL,Illinois,,Rutgers,,2-4,2-4,,10,21,24,35,3,7,0,14,7,14,7,7,0,-11,-11,,
2017,7,NCAAF_20171014_SC@TENN,Tennessee,,South Carolina,,3-3,5-2,,9,3,9,15,6,3,0,0,0,3,6,6,-2,6,-6,,
2017,7,NCAAF_20171014_TCU@KSTATE,Kansas State,,TCU,,3-3,6-0,,3,13,6,26,0,3,3,0,10,3,7,6,-3,-10,-20,,
2017,7,NCAAF_20171014_TXTECH@WVU,West Virginia,,Texas Tech,,4-2,4-2,,17,28,46,35,10,7,7,22,14,14,7,0,0,-11,11,,
2017,7,NCAAF_20171014_UCONN@TEMPLE,Temple,,UConn,,3-4,2-4,,7,14,24,28,7,0,7,10,0,14,14,0,1,-7,-4,,
2017,7,NCAAF_20171014_BC@LVILLE,Louisville,,Boston College,,4-3,3-4,,21,14,42,45,14,7,0,21,7,7,14,17,1,7,-3,,
2017,7,NCAAF_20171014_UNLV@AF,Air Force,,UNLV,,2-4,2-4,,7,27,34,30,0,7,13,14,17,10,3,0,0,-20,4,,
2017,7,NCAAF_20171014_ODU@MRSHL,Marshall,,Old Dominion,,5-1,2-4,,7,3,35,3,0,7,7,21,0,3,0,0,3,4,32,,
2017,7,NCAAF_20171014_AUBURN@LSU,LSU,,Auburn,,5-2,5-2,,14,23,27,23,0,14,0,13,17,6,0,0,0,-9,4,,
2017,7,NCAAF_20171014_BAYLOR@OKLAST,Oklahoma State,,Baylor,,5-1,0-6,,35,10,59,16,7,28,10,14,7,3,6,0,5,25,43,,
2017,7,NCAAF_20171014_GATECH@MIAMI,Miami (Fla.),,Georgia Tech,,5-0,3-2,,13,14,25,24,3,10,3,9,7,7,10,0,2,-1,1,,
2017,7,NCAAF_20171014_MIAOH@KENTST,Kent St.,,Miami-OH,,2-5,2-5,,3,14,17,14,0,3,14,0,0,14,0,0,0,-11,3,,
2017,7,NCAAF_20171014_NILL@BUFF,Buffalo,,N. Illinois,,3-4,4-2,,13,14,13,14,3,10,0,0,0,14,0,0,-1,-1,-1,,
2017,7,NCAAF_20171014_NWEST@MD,Maryland,,Northwestern,,3-3,3-3,,14,24,21,37,7,7,7,0,3,21,3,10,0,-10,-16,,
2017,7,NCAAF_20171014_OHIO@BGREEN,Bowling Green,,Ohio,,1-6,5-2,,16,21,30,48,6,10,7,7,0,21,6,21,-4,-5,-18,,
2017,7,NCAAF_20171014_OKLA@TEXAS,Texas,,Oklahoma,,3-3,5-1,,10,20,24,29,0,10,7,7,10,10,3,6,-2,-10,-5,,
2017,7,NCAAF_20171014_PURDUE@WISC,Wisconsin,,Purdue,,6-0,3-3,,17,6,17,9,14,3,0,0,3,3,3,0,3,11,8,,
2017,7,NCAAF_20171014_TOLEDO@CMICH,C. Michigan,,Toledo,,3-4,5-1,,0,17,10,30,0,0,3,7,7,10,0,13,-2,-17,-20,,
2017,7,NCAAF_20171014_UVA@UNC,North Carolina,,Virginia,,1-6,5-1,,0,10,14,20,0,0,14,0,0,10,7,3,-4,-10,-6,,
2017,7,NCAAF_20171014_VANDY@MISS,Ole Miss,,Vanderbilt,,3-3,3-4,,35,21,57,35,7,28,12,10,0,21,0,14,0,14,22,,
2017,7,NCAAF_20171014_NAVY@MEMP,Memphis,,Navy,,5-1,5-1,,10,10,30,27,7,3,10,10,10,0,9,8,0,0,3,,
2017,7,NCAAF_20171014_COLO@OREGST,Oregon State,,Colorado,,1-6,4-3,,19,14,33,36,10,9,7,7,7,7,7,15,-3,5,-3,,
2017,7,NCAAF_20171014_HOU@TULSA,Tulsa,,Houston,,2-5,4-2,,7,10,45,17,0,7,17,21,3,7,0,7,-2,-3,28,,
2017,7,NCAAF_20171014_CHARLO@WKY,W. Kentucky,,Charlotte,,4-2,0-7,,38,14,45,14,14,24,0,7,7,7,0,0,4,24,31,,
2017,7,NCAAF_20171014_WYO@UTAHST,Utah St.,,Wyoming,,3-4,4-2,,16,9,23,28,6,10,0,7,3,6,7,12,-1,7,-5,,
2017,7,NCAAF_20171014_APLST@IDAHO,Idaho,,App. St.,,2-4,4-2,,17,0,20,23,0,17,3,0,0,0,7,16,-2,17,-3,,
2017,7,NCAAF_20171014_GAST@LAMON,UL-Monroe,,Georgia St.,,3-3,3-2,,10,26,37,47,10,0,14,13,13,13,14,7,0,-16,-10,,
2017,7,NCAAF_20171014_NMEXST@GAS,Ga. Southern,,New Mexico St.,,0-5,3-4,,24,21,27,35,14,10,3,0,14,7,0,14,-3,3,-8,,
2017,7,NCAAF_20171014_MTSU@UAB,UAB,,Middle Tenn.,,4-2,3-4,,22,20,25,23,9,13,0,3,10,10,3,0,1,2,2,,
2017,7,NCAAF_20171014_CSTCAR@ARKST,Arkansas St.,,C. Carolina,,3-2,1-5,,17,7,51,17,7,10,17,17,0,7,0,10,2,10,34,,
2017,7,NCAAF_20171014_ECU@UCF,UCF,,East Carolina,,5-0,1-6,,42,14,63,21,21,21,7,14,7,7,0,7,4,28,42,,
2017,7,NCAAF_20171014_TULANE@FIU,FIU,,Tulane,,4-2,3-3,,10,3,23,10,7,3,3,10,0,3,7,0,1,7,13,,
2017,7,NCAAF_20171014_TXAM@FLA,Florida,,Texas A&M,,3-3,5-2,,10,3,17,19,3,7,0,7,3,0,7,9,-2,7,-2,,
2017,7,NCAAF_20171014_TXSA@NTEXAS,North Texas,,UTSA,,4-2,3-2,,16,17,29,26,16,0,0,13,7,10,3,6,1,-1,3,,
2017,7,NCAAF_20171014_UTEP@USM,So. Miss,,UTEP,,4-2,0-7,,14,0,24,0,7,7,0,10,0,0,0,0,4,14,24,,
2017,7,NCAAF_20171014_ARK@BAMA,Alabama,,Arkansas,,7-0,2-4,,24,0,41,9,17,7,7,10,0,0,3,6,5,24,32,,
2017,7,NCAAF_20171014_CINCY@SFLA,South Florida,,Cincinnati,,6-0,2-5,,23,3,33,3,3,20,7,3,3,0,0,0,4,20,30,,
2017,7,NCAAF_20171014_MIZZOU@UGA,Georgia,,Missouri,,7-0,1-5,,34,21,53,28,14,20,13,6,14,7,0,7,6,13,25,,
2017,7,NCAAF_20171014_OHIOST@NEB,Nebraska,,Ohio State,,3-4,6-1,,0,35,14,56,0,0,14,0,14,21,14,7,-3,-35,-42,,
2017,7,NCAAF_20171014_MICHST@MINN,Minnesota,,Michigan St.,,3-3,5-1,,6,17,27,30,6,0,0,21,10,7,6,7,-2,-11,-3,,
2017,7,NCAAF_20171014_UTAH@USC,USC,,Utah,,6-1,4-2,,7,21,28,27,7,0,7,14,7,14,0,6,2,-14,1,,
2017,7,NCAAF_20171014_UCLA@ARIZ,Arizona,,UCLA,,4-2,3-3,,30,14,47,30,17,13,10,7,7,7,16,0,1,16,17,,
2017,7,NCAAF_20171014_NMEX@FRESNO,Fresno St.,,New Mexico,,4-2,3-3,,21,0,38,0,14,7,10,7,0,0,0,0,1,21,38,,
2017,7,NCAAF_20171014_NEVADA@COLOST,Colorado St.,,Nevada,,5-2,1-6,,28,21,44,42,14,14,10,6,14,7,21,0,4,7,2,,
2017,7,NCAAF_20171014_BOISE@SDGST,San Diego St.,,Boise St.,,6-1,4-2,,0,21,14,31,0,0,7,7,14,7,0,10,2,-21,-17,,
2017,7,NCAAF_20171014_WASH@ARIZST,Arizona St.,,Washington,,1-2,6-1,,13,0,13,7,7,6,0,0,0,0,0,7,-5,13,6,,
2017,7,NCAAF_20171014_OREG@STNFRD,Stanford,,Oregon,,5-2,4-3,,28,7,49,7,21,7,7,14,7,0,0,0,1,21,42,,
2017,7,NCAAF_20171013_CLEM@CUSE,Syracuse,,Clemson,,4-3,6-1,,17,14,27,24,14,3,7,3,7,7,10,0,-2,3,3,,
2017,7,NCAAF_20171013_WASHST@CAL,California,,Washington St.,,4-3,6-1,,17,3,37,3,10,7,3,17,0,3,0,0,-2,14,34,,
2017,7,NCAAF_20171012_TXSTSM@LALAF,Louisiana,,Texas St.,,3-3,1-6,,14,0,24,7,14,0,3,7,0,0,7,0,2,14,17,,
2017,7,NCAAF_20171011_SALA@TROY,Troy,,South Alabama,,4-2,2-4,,0,9,8,19,0,0,0,8,7,2,7,3,2,-9,-11,,
2017,8,NCAAF_20171021_AKRON@TOLEDO,Toledo,,Akron,,6-1,4-4,,24,7,48,21,21,3,14,10,0,7,0,14,2,17,27,,
2017,8,NCAAF_20171021_IDAHO@MIZZOU,Missouri,,Idaho,,2-5,2-5,,51,14,68,21,34,17,14,3,7,7,0,7,0,37,47,,
2017,8,NCAAF_20171021_IOWAST@TXTECH,Texas Tech,,Iowa St.,,4-3,5-2,,6,24,13,31,6,0,7,0,7,17,0,7,-1,-18,-18,,
2017,8,NCAAF_20171021_LVILLE@FSU,Florida State,,Louisville,,2-4,5-3,,14,14,28,31,7,7,0,14,7,7,14,3,-3,0,-3,,
2017,8,NCAAF_20171021_MD@WISC,Wisconsin,,Maryland,,7-0,3-4,,21,3,38,13,7,14,7,10,0,3,10,0,4,18,25,,
2017,8,NCAAF_20171021_PURDUE@RUT,Rutgers,,Purdue,,3-4,3-4,,7,3,14,12,7,0,7,0,0,3,3,6,0,4,2,,
2017,8,NCAAF_20171021_TULSA@UCONN,UConn,,Tulsa,,3-4,2-6,,3,0,20,14,3,0,14,3,0,0,0,14,1,3,6,,
2017,8,NCAAF_20171021_PITT@DUKE,Duke,,Pittsburgh,,4-4,3-5,,3,7,17,24,0,3,14,0,7,0,7,10,1,-4,-7,,
2017,8,NCAAF_20171021_BC@UVA,Virginia,,Boston College,,5-2,4-4,,7,24,10,41,0,7,0,3,17,7,10,7,1,-17,-31,,
2017,8,NCAAF_20171021_KENTST@OHIO,Ohio,,Kent St.,,6-2,2-6,,13,3,48,3,0,13,28,7,3,0,0,0,4,10,45,,
2017,8,NCAAF_20171021_NILL@BGREEN,Bowling Green,,N. Illinois,,1-7,5-2,,7,31,17,48,7,0,3,7,14,17,10,7,-4,-24,-31,,
2017,8,NCAAF_20171021_TROY@GAST,Georgia St.,,Troy,,3-3,5-2,,3,21,10,34,3,0,0,7,7,14,10,3,-2,-18,-24,,
2017,8,NCAAF_20171021_BUFF@MIAOH,Miami-OH,,Buffalo,,3-5,3-5,,10,7,24,14,10,0,14,0,0,7,0,7,0,3,10,,
2017,8,NCAAF_20171021_CMICH@BALLST,Ball St.,,C. Michigan,,2-5,4-4,,6,28,9,56,3,3,3,0,7,21,7,21,-2,-22,-47,,
2017,8,NCAAF_20171021_ARIZST@UTAH,Utah,,Arizona St.,,4-3,4-3,,0,16,10,30,0,0,3,7,9,7,7,7,0,-16,-20,,
2017,8,NCAAF_20171021_CSTCAR@APLST,App. St.,,C. Carolina,,5-2,1-6,,17,19,37,29,14,3,6,14,3,16,3,7,4,-2,8,,
2017,8,NCAAF_20171021_CUSE@MIAMI,Miami (Fla.),,Syracuse,,6-0,4-4,,13,3,27,19,3,10,7,7,0,3,10,6,2,10,8,,
2017,8,NCAAF_20171021_GAS@MA,UMass,,Ga. Southern,,1-6,0-6,,48,17,55,20,28,20,0,7,7,10,3,0,1,31,35,,
2017,8,NCAAF_20171021_ILL@MINN,Minnesota,,Illinois,,4-3,2-5,,7,7,24,17,7,0,3,14,7,0,0,10,2,0,7,,
2017,8,NCAAF_20171021_IND@MICHST,Michigan St.,,Indiana,,6-1,3-4,,3,3,17,9,0,3,0,14,3,0,3,3,3,0,8,,
2017,8,NCAAF_20171021_TENN@BAMA,Alabama,,Tennessee,,8-0,3-4,,21,0,45,7,7,14,10,14,0,0,7,0,5,21,38,,
2017,8,NCAAF_20171021_UCF@NAVY,Navy,,UCF,,5-2,6-0,,7,14,21,31,0,7,7,7,7,7,10,7,-1,-7,-10,,
2017,8,NCAAF_20171021_UNC@VATECH,Virginia Tech,,North Carolina,,6-1,1-7,,35,0,59,7,14,21,17,7,0,0,0,7,5,35,52,,
2017,8,NCAAF_20171021_OKLA@KSTATE,Kansas State,,Oklahoma,,3-4,6-1,,21,10,35,42,14,7,0,14,7,3,10,22,-3,11,-7,,
2017,8,NCAAF_20171021_OREG@UCLA,UCLA,,Oregon,,4-3,4-4,,14,14,31,14,14,0,10,7,0,14,0,0,0,0,17,,
2017,8,NCAAF_20171021_UK@MISSST,Miss. State,,Kentucky,,5-2,5-2,,17,7,45,7,7,10,7,21,0,7,0,0,0,10,38,,
2017,8,NCAAF_20171021_LAMON@SALA,South Alabama,,UL-Monroe,,3-4,3-4,,24,20,33,23,14,10,6,3,7,13,3,0,0,4,10,,
2017,8,NCAAF_20171021_NTEXAS@FAU,FAU,,North Texas,,4-3,4-3,,41,7,69,31,24,17,21,7,0,7,10,14,0,34,38,,
2017,8,NCAAF_20171021_UTAHST@UNLV,UNLV,,Utah St.,,2-5,4-4,,28,28,28,52,14,14,0,0,7,21,7,17,-2,0,-24,,
2017,8,NCAAF_20171021_BYU@ECU,East Carolina,,BYU,,2-6,1-7,,10,10,33,17,7,3,9,14,7,3,0,7,1,0,16,,
2017,8,NCAAF_20171021_RICE@TXSA,UTSA,,Rice,,4-2,1-6,,10,7,20,7,10,0,10,0,0,7,0,0,3,3,13,,
2017,8,NCAAF_20171021_SFLA@TULANE,Tulane,,South Florida,,3-4,7-0,,7,20,28,34,0,7,7,14,7,13,14,0,-4,-13,-6,,
2017,8,NCAAF_20171021_LSU@MISS,Ole Miss,,LSU,,3-4,6-2,,6,13,24,40,3,3,10,8,10,3,17,10,-3,-7,-16,,
2017,8,NCAAF_20171021_AUBURN@ARK,Arkansas,,Auburn,,2-5,6-2,,6,17,20,52,3,3,7,7,10,7,28,7,-4,-11,-32,,
2017,8,NCAAF_20171021_MICH@PSU,Penn State,,Michigan,,7-0,5-2,,21,13,42,13,14,7,7,14,0,13,0,0,2,8,29,,
2017,8,NCAAF_20171021_USC@ND,Notre Dame,,USC,,6-1,6-2,,28,0,49,14,14,14,14,7,0,0,14,0,0,28,35,,
2017,8,NCAAF_20171021_WAKE@GATECH,Georgia Tech,,Wake Forest,,4-2,4-3,,13,21,38,24,3,10,12,13,7,14,3,0,0,-8,14,,
2017,8,NCAAF_20171021_KANSAS@TCU,TCU,,Kansas,,7-0,1-6,,24,0,43,0,10,14,19,0,0,0,0,0,6,24,43,,
2017,8,NCAAF_20171021_WVU@BAYLOR,Baylor,,West Virginia,,0-7,5-2,,6,17,36,38,0,6,7,23,10,7,21,0,-5,-11,-2,,
2017,8,NCAAF_20171021_WYO@BOISE,Boise St.,,Wyoming,,5-2,4-3,,3,7,24,14,0,3,7,14,7,0,7,0,1,-4,10,,
2017,8,NCAAF_20171021_FRESNO@SDGST,San Diego St.,,Fresno St.,,6-2,5-2,,3,17,3,27,0,3,0,0,7,10,10,0,1,-14,-24,,
2017,8,NCAAF_20171021_COLO@WASHST,Washington St.,,Colorado,,7-1,4-4,,14,0,28,0,0,14,7,7,0,0,0,0,3,14,28,,
2017,8,NCAAF_20171020_WKY@ODU,Old Dominion,,W. Kentucky,,2-5,5-2,,14,21,31,35,7,7,17,0,7,14,0,14,-3,-7,-4,,
2017,8,NCAAF_20171020_MRSHL@MTSU,Middle Tenn.,,Marshall,,3-5,6-1,,10,31,10,38,3,7,0,0,7,24,0,7,-3,-21,-28,,
2017,8,NCAAF_20171020_AF@NEVADA,Nevada,,Air Force,,1-7,3-4,,20,28,42,45,14,6,8,14,7,21,7,10,-2,-8,-3,,
2017,8,NCAAF_20171020_COLOST@NMEX,New Mexico,,Colorado St.,,3-4,6-2,,10,21,24,27,7,3,7,7,0,21,0,6,-3,-11,-3,,
2017,8,NCAAF_20171019_LALAF@ARKST,Arkansas St.,,Louisiana,,4-2,3-4,,34,3,47,3,14,20,3,10,3,0,0,0,1,31,44,,
2017,8,NCAAF_20171019_MEMP@HOU,Houston,,Memphis,,4-3,6-1,,17,0,38,42,7,10,14,7,0,0,21,21,-2,17,-4,,
2017,9,NCAAF_20171028_BUFF@AKRON,Akron,,Buffalo,,5-4,3-6,,14,13,21,20,7,7,0,7,7,6,0,7,2,1,1,,
2017,9,NCAAF_20171028_ARK@MISS,Ole Miss,,Arkansas,,3-5,3-5,,31,21,37,38,21,10,0,6,7,14,7,10,0,10,-1,,
2017,9,NCAAF_20171028_MIAMI@UNC,North Carolina,,Miami (Fla.),,1-8,7-0,,6,7,19,24,3,3,7,6,0,7,10,7,-6,-1,-5,,
2017,9,NCAAF_20171028_OKLAST@WVU,West Virginia,,Oklahoma State,,5-3,7-1,,10,23,39,50,0,10,14,15,13,10,7,20,-2,-13,-11,,
2017,9,NCAAF_20171028_RUT@MICH,Michigan,,Rutgers,,6-2,3-5,,21,7,35,14,0,21,7,7,0,7,7,0,3,14,21,,
2017,9,NCAAF_20171028_TEXAS@BAYLOR,Baylor,,Texas,,0-8,4-4,,7,21,7,38,0,7,0,0,7,14,3,14,-4,-14,-31,,
2017,9,NCAAF_20171028_WISC@ILL,Illinois,,Wisconsin,,2-6,8-0,,3,17,10,24,0,3,0,7,7,10,0,7,-6,-14,-14,,
2017,9,NCAAF_20171028_LVILLE@WAKE,Wake Forest,,Louisville,,5-3,5-4,,28,10,42,32,14,14,7,7,3,7,7,15,0,18,10,,
2017,9,NCAAF_20171028_UVA@PITT,Pittsburgh,,Virginia,,4-5,5-3,,21,7,31,14,7,14,7,3,0,7,0,7,-1,14,17,,
2017,9,NCAAF_20171028_CAL@COLO,Colorado,,California,,5-4,4-5,,27,14,44,28,14,13,0,17,7,7,0,14,1,13,16,,
2017,9,NCAAF_20171028_FIU@MRSHL,Marshall,,FIU,,6-2,5-2,,7,28,30,41,0,7,7,16,14,14,7,6,1,-21,-11,,
2017,9,NCAAF_20171028_AF@COLOST,Colorado St.,,Air Force,,6-3,4-4,,21,28,28,45,14,7,7,0,7,21,3,14,2,-7,-17,,
2017,9,NCAAF_20171028_KSTATE@KANSAS,Kansas,,Kansas State,,1-7,4-4,,6,10,20,30,6,0,0,14,7,3,10,10,-3,-4,-10,,
2017,9,NCAAF_20171028_SJST@BYU,BYU,,San Jose St.,,2-7,1-8,,24,6,41,20,14,10,7,10,3,3,0,14,1,18,21,,
2017,9,NCAAF_20171028_GAS@TROY,Troy,,Ga. Southern,,6-2,0-7,,28,10,38,16,14,14,3,7,7,3,0,6,6,18,22,,
2017,9,NCAAF_20171028_IND@MD,Maryland,,Indiana,,4-4,3-5,,28,23,42,39,7,21,0,14,16,7,10,6,1,5,3,,
2017,9,NCAAF_20171028_LATECH@RICE,Rice,,Louisiana Tech,,1-7,4-4,,7,21,28,42,0,7,7,14,7,14,7,14,-3,-14,-14,,
2017,9,NCAAF_20171028_NCST@ND,Notre Dame,,NC State,,7-1,6-2,,21,14,35,14,7,14,14,0,7,7,0,0,1,7,21,,
2017,9,NCAAF_20171028_PSU@OHIOST,Ohio State,,Penn State,,7-1,7-1,,17,28,39,38,3,14,3,19,14,14,7,3,0,-11,1,,
2017,9,NCAAF_20171028_TCU@IOWAST,Iowa St.,,TCU,,6-2,7-1,,14,0,14,7,7,7,0,0,0,0,7,0,-1,14,7,,
2017,9,NCAAF_20171028_UCLA@WASH,Washington,,UCLA,,7-1,4-4,,20,9,44,23,3,17,17,7,3,6,0,14,3,11,21,,
2017,9,NCAAF_20171028_UGA@FLA,Florida,,Georgia,,3-4,8-0,,0,21,7,42,0,0,0,7,21,0,14,7,-5,-21,-35,,
2017,9,NCAAF_20171028_HOU@SFLA,South Florida,,Houston,,7-1,5-3,,7,0,24,28,0,7,7,10,0,0,14,14,2,7,-4,,
2017,9,NCAAF_20171028_VANDY@SC,South Carolina,,Vanderbilt,,6-2,3-5,,24,13,34,27,14,10,7,3,7,6,7,7,3,11,7,,
2017,9,NCAAF_20171028_FAU@WKY,W. Kentucky,,FAU,,5-3,5-3,,21,20,28,42,7,14,7,0,10,10,0,22,0,1,-14,,
2017,9,NCAAF_20171028_AP@UCF,UCF,,Austin Peay,,7-0,5-4,,45,26,73,33,14,31,14,14,7,19,7,0,2,19,40,,
2017,9,NCAAF_20171028_LAMON@IDAHO,Idaho,,UL-Monroe,,3-5,3-5,,28,7,31,23,14,14,3,0,0,7,6,10,0,21,8,,
2017,9,NCAAF_20171028_UTAH@OREG,Oregon,,Utah,,5-4,4-4,,17,6,41,20,7,10,10,14,0,6,7,7,1,11,21,,
2017,9,NCAAF_20171028_TXSTSM@CSTCAR,C. Carolina,,Texas St.,,1-7,2-6,,7,17,7,27,7,0,0,0,7,10,3,7,-1,-10,-20,,
2017,9,NCAAF_20171028_MINN@IOWA,Iowa,,Minnesota,,5-3,4-4,,7,0,17,10,7,0,7,3,0,0,0,10,1,7,7,,
2017,9,NCAAF_20171028_MIZZOU@UCONN,UConn,,Missouri,,3-5,3-5,,5,31,12,52,2,3,7,0,21,10,14,7,0,-26,-40,,
2017,9,NCAAF_20171028_ODU@NTEXAS,North Texas,,Old Dominion,,5-3,2-6,,35,23,45,38,14,21,0,10,10,13,15,0,3,12,7,,
2017,9,NCAAF_20171028_UAB@USM,So. Miss,,UAB,,5-3,5-3,,12,7,12,30,9,3,0,0,7,0,6,17,0,5,-18,,
2017,9,NCAAF_20171028_MISSST@TXAM,Texas A&M,,Miss. State,,5-3,6-2,,0,14,14,35,0,0,7,7,7,7,14,7,-1,-14,-21,,
2017,9,NCAAF_20171028_DUKE@VATECH,Virginia Tech,,Duke,,7-1,4-5,,17,3,24,3,7,10,7,0,0,3,0,0,3,14,21,,
2017,9,NCAAF_20171028_NEB@PURDUE,Purdue,,Nebraska,,3-5,4-4,,14,6,24,25,0,14,3,7,3,3,6,13,-1,8,-1,,
2017,9,NCAAF_20171028_NMEX@WYO,Wyoming,,New Mexico,,5-3,3-5,,42,0,42,3,7,35,0,0,0,0,0,3,2,42,39,,
2017,9,NCAAF_20171028_TENN@UK,Kentucky,,Tennessee,,6-2,3-5,,21,20,29,26,7,14,0,8,6,14,3,3,3,1,3,,
2017,9,NCAAF_20171028_ARKST@NMEXST,New Mexico St.,,Arkansas St.,,3-5,5-2,,14,7,21,37,0,14,0,7,7,0,10,20,-2,7,-16,,
2017,9,NCAAF_20171028_GATECH@CLEM,Clemson,,Georgia Tech,,7-1,4-3,,21,3,24,10,14,7,3,0,3,0,0,7,3,18,14,,
2017,9,NCAAF_20171028_TXSA@UTEP,UTEP,,UTSA,,0-8,5-2,,14,17,14,31,0,14,0,0,3,14,7,7,-5,-3,-17,,
2017,9,NCAAF_20171028_TXTECH@OKLA,Oklahoma,,Texas Tech,,7-1,4-4,,28,20,49,27,14,14,21,0,20,0,7,0,3,8,22,,
2017,9,NCAAF_20171028_WASHST@ARIZ,Arizona,,Washington St.,,6-2,7-2,,23,14,58,37,10,13,14,21,7,7,13,10,-1,9,21,,
2017,9,NCAAF_20171028_BOISE@UTAHST,Utah St.,,Boise St.,,4-5,6-2,,7,28,14,41,7,0,7,0,14,14,7,6,-2,-21,-27,,
2017,9,NCAAF_20171028_UNLV@FRESNO,Fresno St.,,UNLV,,5-3,3-5,,9,9,16,26,9,0,7,0,3,6,7,10,2,0,-10,,
2017,9,NCAAF_20171028_USC@ARIZST,Arizona St.,,USC,,0-5,7-2,,10,31,17,48,3,7,7,0,14,17,7,10,-7,-21,-31,,
2017,9,NCAAF_20171028_SDGST@HAWAII,Hawaii,,San Diego St.,,3-5,7-2,,7,14,7,28,0,7,0,0,7,7,7,7,-4,-7,-21,,
2017,9,NCAAF_20171027_FSU@BC,Boston College,,Florida State,,5-4,2-5,,21,3,35,3,7,14,14,0,0,3,0,0,3,18,32,,
2017,9,NCAAF_20171027_TULANE@MEMP,Memphis,,Tulane,,7-1,3-5,,35,12,56,26,14,21,0,21,0,12,7,7,4,23,30,,
2017,9,NCAAF_20171027_TULSA@SMU,SMU,,Tulsa,,6-2,2-7,,21,28,38,34,7,14,7,10,14,14,6,0,4,-7,4,,
2017,9,NCAAF_20171026_TOLEDO@BALLST,Ball St.,,Toledo,,2-6,7-1,,10,24,17,58,7,3,7,0,3,21,27,7,-5,-14,-41,,
2017,9,NCAAF_20171026_SALA@GAST,Georgia St.,,South Alabama,,4-3,3-5,,14,3,21,13,7,7,0,7,0,3,3,7,1,11,8,,
2017,9,NCAAF_20171026_STNFRD@OREGST,Oregon State,,Stanford,,1-7,6-2,,7,6,14,15,0,7,7,0,0,6,3,6,-5,1,-1,,
2017,10,NCAAF_20171104_AUBURN@TXAM,Texas A&M,,Auburn,,5-4,7-2,,13,21,27,42,3,10,7,7,0,21,14,7,-2,-8,-15,,
2017,10,NCAAF_20171104_BAYLOR@KANSAS,Kansas,,Baylor,,1-8,1-8,,6,21,9,38,0,6,3,0,0,21,7,10,0,-15,-29,,
2017,10,NCAAF_20171104_ECU@HOU,Houston,,East Carolina,,6-3,2-7,,28,10,52,27,21,7,17,7,0,10,7,10,4,18,25,,
2017,10,NCAAF_20171104_FLA@MIZZOU,Missouri,,Florida,,4-5,3-5,,28,6,45,16,7,21,7,10,0,6,3,7,1,22,29,,
2017,10,NCAAF_20171104_ILL@PURDUE,Purdue,,Illinois,,4-5,2-7,,13,10,29,10,7,6,3,13,7,3,0,0,2,3,19,,
2017,10,NCAAF_20171104_MA@MISSST,Miss. State,,UMass,,7-2,2-7,,13,20,34,23,10,3,14,7,3,17,0,3,5,-7,11,,
2017,10,NCAAF_20171104_PSU@MICHST,Michigan St.,,Penn State,,7-2,7-2,,14,14,27,24,7,7,7,6,14,0,10,0,0,0,3,,
2017,10,NCAAF_20171104_WISC@IND,Indiana,,Wisconsin,,3-6,9-0,,10,14,17,45,7,3,7,0,0,14,10,21,-6,-4,-28,,
2017,10,NCAAF_20171104_WKY@VANDY,Vanderbilt,,W. Kentucky,,4-5,5-4,,21,14,31,17,14,7,7,3,7,7,3,0,-1,7,14,,
2017,10,NCAAF_20171104_CUSE@FSU,Florida State,,Syracuse,,3-5,4-5,,21,14,27,24,7,14,3,3,0,14,3,7,-1,7,3,,
2017,10,NCAAF_20171104_APLST@LAMON,UL-Monroe,,App. St.,,4-5,5-4,,28,24,52,45,14,14,7,17,0,24,14,7,-1,4,7,,
2017,10,NCAAF_20171104_GAST@GAS,Ga. Southern,,Georgia St.,,0-8,5-3,,10,7,17,21,7,3,7,0,7,0,7,7,-5,3,-4,,
2017,10,NCAAF_20171104_GATECH@UVA,Virginia,,Georgia Tech,,6-3,4-4,,13,14,40,36,3,10,15,12,7,7,14,8,2,-1,4,,
2017,10,NCAAF_20171104_NMEXST@TXSTSM,Texas St.,,New Mexico St.,,2-7,4-5,,21,17,35,45,14,7,7,7,7,10,14,14,-2,4,-10,,
2017,10,NCAAF_20171104_RICE@UAB,UAB,,Rice,,6-3,1-8,,42,7,52,21,21,21,7,3,0,7,0,14,5,35,31,,
2017,10,NCAAF_20171104_ARMY@AF,Air Force,,Army,,4-5,7-2,,0,14,0,21,0,0,0,0,7,7,0,7,-3,-14,-21,,
2017,10,NCAAF_20171104_CHARLO@ODU,Old Dominion,,Charlotte,,3-6,1-8,,3,0,6,0,3,0,3,0,0,0,0,0,2,3,6,,
2017,10,NCAAF_20171104_CLEM@NCST,NC State,,Clemson,,6-3,8-1,,21,17,31,38,14,7,0,10,7,10,14,7,-2,4,-7,,
2017,10,NCAAF_20171104_IOWAST@WVU,West Virginia,,Iowa St.,,6-3,6-3,,20,3,20,16,10,10,0,0,0,3,10,3,0,17,4,,
2017,10,NCAAF_20171104_MD@RUT,Rutgers,,Maryland,,4-5,4-5,,17,14,31,24,0,17,0,14,7,7,10,0,0,3,7,,
2017,10,NCAAF_20171104_NTEXAS@LATECH,Louisiana Tech,,North Texas,,4-5,6-3,,17,10,23,24,3,14,3,3,7,3,7,7,-2,7,-1,,
2017,10,NCAAF_20171104_OHIOST@IOWA,Iowa,,Ohio State,,6-3,7-2,,31,17,55,24,10,21,7,17,10,7,0,7,-1,14,31,,
2017,10,NCAAF_20171104_SC@UGA,Georgia,,South Carolina,,9-0,6-3,,14,7,24,10,7,7,7,3,0,7,3,0,3,7,14,,
2017,10,NCAAF_20171104_SFLA@UCONN,UConn,,South Florida,,3-6,8-1,,7,17,20,37,0,7,0,13,7,10,17,3,-5,-10,-17,,
2017,10,NCAAF_20171104_STNFRD@WASHST,Washington St.,,Stanford,,8-2,6-3,,14,7,24,21,0,14,3,7,0,7,14,0,2,7,3,,
2017,10,NCAAF_20171104_WAKE@ND,Notre Dame,,Wake Forest,,8-1,5-4,,31,10,48,37,7,24,10,7,3,7,13,14,3,21,11,,
2017,10,NCAAF_20171104_CINCY@TULANE,Tulane,,Cincinnati,,3-6,3-6,,13,10,16,17,7,6,0,3,3,7,7,0,0,3,-1,,
2017,10,NCAAF_20171104_CSTCAR@ARK,Arkansas,,C. Carolina,,4-5,1-8,,17,14,39,38,7,10,8,14,7,7,17,7,3,3,1,,
2017,10,NCAAF_20171104_LALAF@SALA,South Alabama,,Louisiana,,3-6,4-4,,7,19,14,19,0,7,0,7,3,16,0,0,-1,-12,-5,,
2017,10,NCAAF_20171104_MISS@UK,Kentucky,,Ole Miss,,6-3,4-5,,20,17,34,37,3,17,7,7,7,10,10,10,2,3,-3,,
2017,10,NCAAF_20171104_OKLA@OKLAST,Oklahoma State,,Oklahoma,,7-2,8-1,,38,38,52,62,10,28,0,14,14,24,10,14,-1,0,-10,,
2017,10,NCAAF_20171104_OREGST@CAL,California,,Oregon State,,5-5,1-8,,20,13,37,23,14,6,10,7,7,6,7,3,4,7,14,,
2017,10,NCAAF_20171104_UTAHST@NMEX,New Mexico,,Utah St.,,3-6,5-5,,3,14,10,24,0,3,0,7,7,7,3,7,-2,-11,-14,,
2017,10,NCAAF_20171104_HAWAII@UNLV,UNLV,,Hawaii,,4-5,3-6,,7,6,31,23,7,0,21,3,0,6,7,10,1,1,8,,
2017,10,NCAAF_20171104_COLOST@WYO,Wyoming,,Colorado St.,,6-3,6-4,,6,10,16,13,0,6,3,7,3,7,0,3,0,-4,3,,
2017,10,NCAAF_20171104_NEVADA@BOISE,Boise St.,,Nevada,,7-2,1-8,,31,14,41,14,10,21,7,3,7,7,0,0,6,17,27,,
2017,10,NCAAF_20171104_TXSA@FIU,FIU,,UTSA,,6-2,5-3,,0,0,14,7,0,0,14,0,0,0,0,7,1,0,7,,
2017,10,NCAAF_20171104_TEXAS@TCU,TCU,,Texas,,8-1,4-5,,17,7,24,7,7,10,0,7,0,7,0,0,4,10,17,,
2017,10,NCAAF_20171104_UCF@SMU,SMU,,UCF,,6-3,8-0,,14,21,24,31,7,7,10,0,7,14,7,3,-2,-7,-7,,
2017,10,NCAAF_20171104_MINN@MICH,Michigan,,Minnesota,,7-2,4-5,,20,7,33,10,13,7,13,0,7,0,0,3,3,13,23,,
2017,10,NCAAF_20171104_USM@TENN,Tennessee,,So. Miss,,4-5,5-4,,10,3,24,10,7,3,14,0,0,3,0,7,-1,7,14,,
2017,10,NCAAF_20171104_UTEP@MTSU,Middle Tenn.,,UTEP,,4-5,0-9,,17,0,30,3,10,7,7,6,0,0,3,0,4,17,27,,
2017,10,NCAAF_20171104_LSU@BAMA,Alabama,,LSU,,9-0,6-3,,14,3,24,10,7,7,7,3,0,3,7,0,3,11,14,,
2017,10,NCAAF_20171104_VATECH@MIAMI,Miami (Fla.),,Virginia Tech,,8-0,7-2,,14,3,28,10,0,14,7,7,0,3,7,0,1,11,18,,
2017,10,NCAAF_20171104_COLO@ARIZST,Arizona St.,,Colorado,,1-4,5-5,,14,17,41,30,0,14,3,24,3,14,10,3,-4,-3,11,,
2017,10,NCAAF_20171104_OREG@WASH,Washington,,Oregon,,8-1,5-5,,17,3,38,3,0,17,21,0,3,0,0,0,3,14,35,,
2017,10,NCAAF_20171104_SDGST@SJST,San Jose St.,,San Diego St.,,1-9,8-2,,0,35,7,52,0,0,7,0,21,14,14,3,-7,-35,-45,,
2017,10,NCAAF_20171104_ARIZ@USC,USC,,Arizona,,8-2,6-3,,21,6,49,35,7,14,7,21,0,6,14,15,2,15,14,,
2017,10,NCAAF_20171104_BYU@FRESNO,Fresno St.,,BYU,,6-3,2-8,,10,6,20,13,10,0,3,7,0,6,7,0,4,4,7,,
2017,10,NCAAF_20171103_MRSHL@FAU,FAU,,Marshall,,6-3,6-3,,16,3,30,25,13,3,7,7,0,3,13,9,0,13,5,,
2017,10,NCAAF_20171103_MEMP@TULSA,Tulsa,,Memphis,,2-8,8-1,,14,21,14,41,7,7,0,0,14,7,10,10,-6,-7,-27,,
2017,10,NCAAF_20171103_UCLA@UTAH,Utah,,UCLA,,4-4,4-4,,17,10,48,17,7,10,21,10,0,10,0,7,0,7,31,,
2017,10,NCAAF_20171102_BALLST@EMICH,E. Michigan,,Ball St.,,3-6,2-7,,35,14,56,14,14,21,14,7,7,7,0,0,1,21,42,,
2017,10,NCAAF_20171102_NILL@TOLEDO,Toledo,,N. Illinois,,8-1,6-3,,10,7,27,17,7,3,14,3,7,0,7,3,2,3,10,,
2017,10,NCAAF_20171102_NAVY@TEMPLE,Temple,,Navy,,4-5,5-3,,17,6,34,26,10,7,14,3,3,3,7,13,-1,11,8,,
2017,10,NCAAF_20171102_IDAHO@TROY,Troy,,Idaho,,7-2,3-6,,10,7,24,21,0,10,7,7,7,0,0,14,4,3,3,,
2017,10,NCAAF_20171101_CMICH@WMICH,W. Michigan,,C. Michigan,,5-4,5-4,,21,7,28,35,14,7,7,0,7,0,7,21,0,14,-7,,
2017,10,NCAAF_20171031_BGREEN@KENTST,Kent St.,,Bowling Green,,2-7,2-7,,9,20,16,44,0,9,0,7,17,3,14,10,0,-11,-28,,
2017,10,NCAAF_20171031_MIAOH@OHIO,Ohio,,Miami-OH,,7-2,3-6,,28,21,45,28,14,14,7,10,14,7,7,0,4,7,17,,
2017,11,NCAAF_20171111_ARK@LSU,LSU,,Arkansas,,7-3,4-6,,7,7,33,10,7,0,12,14,0,7,3,0,3,0,23,,
2017,11,NCAAF_20171111_DUKE@ARMY,Army,,Duke,,8-2,4-6,,21,10,21,16,7,14,0,0,3,7,0,6,4,11,5,,
2017,11,NCAAF_20171111_FLA@SC,South Carolina,,Florida,,7-3,3-6,,21,13,28,20,14,7,7,0,0,13,0,7,4,8,8,,
2017,11,NCAAF_20171111_IND@ILL,Illinois,,Indiana,,2-8,4-6,,0,14,14,24,0,0,7,7,0,14,3,7,-2,-14,-10,,
2017,11,NCAAF_20171111_LALAF@MISS,Ole Miss,,Louisiana,,5-5,4-5,,35,10,50,22,21,14,7,8,0,10,0,12,1,25,28,,
2017,11,NCAAF_20171111_MICHST@OHIOST,Ohio State,,Michigan St.,,8-2,7-3,,35,3,48,3,14,21,13,0,0,3,0,0,1,32,45,,
2017,11,NCAAF_20171111_NCST@BC,Boston College,,NC State,,5-5,7-3,,7,10,14,17,0,7,7,0,0,10,0,7,-2,-3,-3,,
2017,11,NCAAF_20171111_NEB@MINN,Minnesota,,Nebraska,,5-5,4-6,,30,14,54,21,14,16,10,14,7,7,0,7,1,16,33,,
2017,11,NCAAF_20171111_OKLAST@IOWAST,Iowa St.,,Oklahoma State,,6-4,8-2,,21,21,42,49,14,7,7,14,7,14,10,18,-2,0,-7,,
2017,11,NCAAF_20171111_RUT@PSU,Penn State,,Rutgers,,8-2,4-6,,14,6,35,6,0,14,14,7,3,3,0,0,4,8,29,,
2017,11,NCAAF_20171111_TXTECH@BAYLOR,Baylor,,Texas Tech,,1-9,5-5,,7,21,24,38,7,0,7,10,14,7,10,7,-4,-14,-14,,
2017,11,NCAAF_20171111_UCONN@UCF,UCF,,UConn,,9-0,3-7,,28,10,49,24,21,7,0,21,3,7,7,7,6,18,25,,
2017,11,NCAAF_20171111_VATECH@GATECH,Georgia Tech,,Virginia Tech,,5-4,7-3,,14,9,28,22,7,7,7,7,3,6,7,6,-2,5,6,,
2017,11,NCAAF_20171111_MTSU@CHARLO,Charlotte,,Middle Tenn.,,1-9,5-5,,7,28,21,35,7,0,7,7,14,14,0,7,-4,-21,-14,,
2017,11,NCAAF_20171111_WAKE@CUSE,Syracuse,,Wake Forest,,4-6,6-4,,38,24,43,64,14,24,5,0,21,3,16,24,-2,14,-21,,
2017,11,NCAAF_20171111_FAU@LATECH,Louisiana Tech,,FAU,,4-6,7-3,,9,20,23,48,3,6,7,7,6,14,22,6,-3,-11,-25,,
2017,11,NCAAF_20171111_FSU@CLEM,Clemson,,Florida State,,9-1,3-6,,17,0,31,14,7,10,0,14,0,0,7,7,6,17,17,,
2017,11,NCAAF_20171111_IOWA@WISC,Wisconsin,,Iowa,,10-0,6-4,,17,7,38,14,3,14,7,14,7,0,7,0,4,10,24,,
2017,11,NCAAF_20171111_MICH@MD,Maryland,,Michigan,,4-6,8-2,,0,28,10,35,0,0,3,7,7,21,0,7,-4,-28,-25,,
2017,11,NCAAF_20171111_SMU@NAVY,Navy,,SMU,,6-3,6-4,,34,11,43,40,13,21,6,3,5,6,21,8,0,23,3,,
2017,11,NCAAF_20171111_UGA@AUBURN,Auburn,,Georgia,,7-2,9-0,,16,7,40,17,6,10,14,10,7,0,3,7,-2,9,23,,
2017,11,NCAAF_20171111_USM@RICE,Rice,,So. Miss,,1-9,6-4,,14,22,34,43,0,14,13,7,10,12,14,7,-5,-8,-9,,
2017,11,NCAAF_20171111_UVA@LVILLE,Louisville,,Virginia,,6-4,6-4,,17,14,38,21,7,10,14,7,7,7,0,7,0,3,17,,
2017,11,NCAAF_20171111_WVU@KSTATE,Kansas State,,West Virginia,,5-5,7-3,,20,28,23,28,6,14,0,3,7,21,0,0,-2,-8,-5,,
2017,11,NCAAF_20171111_GAST@TXSTSM,Texas St.,,Georgia St.,,2-8,6-3,,14,13,30,33,7,7,3,13,10,3,10,10,-4,1,-3,,
2017,11,NCAAF_20171111_ME@MA,UMass,,Maine,,3-7,4-5,,24,16,44,31,21,3,13,7,7,9,8,7,-1,8,13,,
2017,11,NCAAF_20171111_SJST@NEVADA,Nevada,,San Jose St.,,2-8,1-10,,38,7,59,14,14,24,14,7,7,0,0,7,1,31,45,,
2017,11,NCAAF_20171111_UK@VANDY,Vanderbilt,,Kentucky,,4-6,7-3,,7,20,21,44,7,0,14,0,7,13,21,3,-3,-13,-23,,
2017,11,NCAAF_20171111_USC@COLO,Colorado,,USC,,5-6,9-2,,0,20,24,38,0,0,14,10,0,20,10,8,-4,-20,-14,,
2017,11,NCAAF_20171111_TROY@CSTCAR,C. Carolina,,Troy,,1-9,8-2,,10,28,17,42,10,0,7,0,14,14,7,7,-7,-18,-25,,
2017,11,NCAAF_20171111_ARKST@SALA,South Alabama,,Arkansas St.,,4-6,5-3,,10,6,24,19,10,0,7,7,0,6,6,7,-1,4,5,,
2017,11,NCAAF_20171111_UTEP@NTEXAS,North Texas,,UTEP,,7-3,0-10,,14,7,45,10,7,7,14,17,7,0,3,0,7,7,35,,
2017,11,NCAAF_20171111_WASHST@UTAH,Utah,,Washington St.,,5-4,8-2,,10,20,25,33,0,10,0,15,13,7,6,7,-3,-10,-8,,
2017,11,NCAAF_20171111_KANSAS@TEXAS,Texas,,Kansas,,5-5,1-9,,35,17,42,27,28,7,0,7,7,10,3,7,4,18,15,,
2017,11,NCAAF_20171111_WKY@MRSHL,Marshall,,W. Kentucky,,7-3,5-5,,13,7,30,23,0,13,17,0,7,0,3,13,2,6,7,,
2017,11,NCAAF_20171111_BAMA@MISSST,Miss. State,,Alabama,,7-3,10-0,,14,14,24,31,7,7,7,3,7,7,3,14,-3,0,-7,,
2017,11,NCAAF_20171111_NMEX@TXAM,Texas A&M,,New Mexico,,6-4,3-7,,48,7,55,14,13,35,0,7,0,7,7,0,3,41,41,,
2017,11,NCAAF_20171111_ODU@FIU,FIU,,Old Dominion,,6-3,4-6,,14,24,30,37,7,7,9,7,7,17,7,6,2,-10,-7,,
2017,11,NCAAF_20171111_PURDUE@NWEST,Northwestern,,Purdue,,7-3,4-6,,14,0,23,13,0,14,6,3,0,0,7,6,3,14,10,,
2017,11,NCAAF_20171111_UAB@TXSA,UTSA,,UAB,,5-4,7-3,,6,21,19,24,3,3,0,13,14,7,0,3,-2,-15,-5,,
2017,11,NCAAF_20171111_TENN@MIZZOU,Missouri,,Tennessee,,5-5,4-6,,24,17,50,17,14,10,17,9,10,7,0,0,1,7,33,,
2017,11,NCAAF_20171111_ND@MIAMI,Miami (Fla.),,Notre Dame,,9-0,8-2,,27,0,41,8,14,13,7,7,0,0,8,0,1,27,33,,
2017,11,NCAAF_20171111_TCU@OKLA,Oklahoma,,TCU,,9-1,8-2,,38,14,38,20,17,21,0,0,7,7,0,6,1,24,18,,
2017,11,NCAAF_20171111_ARIZST@UCLA,UCLA,,Arizona St.,,5-5,5-5,,20,21,44,37,7,13,14,10,14,7,13,3,0,-1,7,,
2017,11,NCAAF_20171111_OREGST@ARIZ,Arizona,,Oregon State,,7-3,1-9,,28,0,49,28,14,14,14,7,0,0,14,14,6,28,21,,
2017,11,NCAAF_20171111_WYO@AF,Air Force,,Wyoming,,4-6,7-3,,7,21,14,28,0,7,7,0,7,14,0,7,-3,-14,-14,,
2017,11,NCAAF_20171111_FRESNO@HAWAII,Hawaii,,Fresno St.,,3-7,7-3,,7,21,21,31,7,0,0,14,0,21,10,0,-4,-14,-10,,
2017,11,NCAAF_20171110_TEMPLE@CINCY,Cincinnati,,Temple,,3-7,5-5,,0,13,24,35,0,0,14,10,3,10,15,7,-2,-13,-11,,
2017,11,NCAAF_20171110_BYU@UNLV,UNLV,,BYU,,4-6,3-8,,7,14,21,31,0,7,7,7,0,14,14,3,1,-7,-10,,
2017,11,NCAAF_20171110_WASH@STNFRD,Stanford,,Washington,,7-3,8-2,,10,14,30,22,0,10,10,10,7,7,0,8,-1,-4,8,,
2017,11,NCAAF_20171109_BALLST@NILL,N. Illinois,,Ball St.,,7-3,2-8,,35,7,63,17,21,14,14,14,7,0,10,0,5,28,46,,
2017,11,NCAAF_20171109_GAS@APLST,App. St.,,Ga. Southern,,6-4,0-9,,10,3,27,6,0,10,3,14,3,0,3,0,6,7,21,,
2017,11,NCAAF_20171109_UNC@PITT,Pittsburgh,,North Carolina,,4-6,2-8,,17,24,31,34,3,14,7,7,14,10,3,7,2,-7,-3,,
2017,11,NCAAF_20171108_KENTST@WMICH,W. Michigan,,Kent St.,,6-4,2-8,,31,14,48,20,21,10,3,14,14,0,0,6,4,17,28,,
2017,11,NCAAF_20171108_TOLEDO@OHIO,Ohio,,Toledo,,8-2,8-2,,10,7,38,10,7,3,14,14,0,7,3,0,0,3,28,,
2017,11,NCAAF_20171108_EMICH@CMICH,C. Michigan,,E. Michigan,,6-4,3-7,,28,17,42,30,14,14,7,7,7,10,0,13,3,11,12,,
2017,11,NCAAF_20171107_AKRON@MIAOH,Miami-OH,,Akron,,4-6,5-5,,10,7,24,14,7,3,14,0,7,0,0,7,-1,3,10,,
2017,11,NCAAF_20171107_BGREEN@BUFF,Buffalo,,Bowling Green,,4-6,2-8,,21,14,38,28,21,0,7,10,7,7,7,7,2,7,10,,
2017,12,NCAAF_20171118_CINCY@ECU,East Carolina,,Cincinnati,,3-8,3-8,,24,13,48,20,14,10,14,10,0,13,7,0,0,11,28,,
2017,12,NCAAF_20171118_DEST@FSU,Florida State,,Delaware St.,,4-6,2-9,,56,6,77,6,21,35,7,14,6,0,0,0,2,50,71,,
2017,12,NCAAF_20171118_LAMON@AUBURN,Auburn,,UL-Monroe,,8-2,4-5,,14,7,42,14,7,7,14,14,7,0,0,7,4,7,28,,
2017,12,NCAAF_20171118_MERCER@BAMA,Alabama,,Mercer,,10-0,5-5,,35,0,56,0,14,21,14,7,0,0,0,0,5,35,56,,
2017,12,NCAAF_20171118_MICH@WISC,Wisconsin,,Michigan,,11-0,8-3,,7,7,24,10,7,0,14,3,0,7,3,0,3,0,14,,
2017,12,NCAAF_20171118_MINN@NWEST,Northwestern,,Minnesota,,8-3,5-6,,25,0,39,0,0,25,7,7,0,0,0,0,3,25,39,,
2017,12,NCAAF_20171118_MISSST@ARK,Arkansas,,Miss. State,,4-6,7-3,,14,14,21,28,14,0,7,0,0,14,0,14,-3,0,-7,,
2017,12,NCAAF_20171118_RUT@IND,Indiana,,Rutgers,,5-6,4-7,,20,0,41,0,17,3,14,7,0,0,0,0,1,20,41,,
2017,12,NCAAF_20171118_SMU@MEMP,Memphis,,SMU,,9-1,6-5,,31,24,66,45,10,21,14,21,10,14,14,7,3,7,21,,
2017,12,NCAAF_20171118_TCU@TXTECH,Texas Tech,,TCU,,5-6,9-2,,3,10,3,27,3,0,0,0,0,10,7,10,-4,-7,-24,,
2017,12,NCAAF_20171118_TEXAS@WVU,West Virginia,,Texas,,7-4,6-5,,0,14,14,28,0,0,7,7,0,14,7,7,1,-14,-14,,
2017,12,NCAAF_20171118_UCF@TEMPLE,Temple,,UCF,,5-6,10-0,,13,31,19,45,3,10,0,6,7,24,14,0,-5,-18,-26,,
2017,12,NCAAF_20171118_UVA@MIAMI,Miami (Fla.),,Virginia,,10-0,6-5,,14,21,44,28,7,7,17,13,14,7,7,0,4,-7,16,,
2017,12,NCAAF_20171118_CIT@CLEM,Clemson,,The Citadel,,10-1,5-6,,38,0,61,3,21,17,20,3,0,0,0,3,5,38,58,,
2017,12,NCAAF_20171118_PITT@VATECH,Virginia Tech,,Pittsburgh,,8-3,4-7,,10,7,20,14,7,3,0,10,7,0,0,7,4,3,6,,
2017,12,NCAAF_20171118_FRESNO@WYO,Wyoming,,Fresno St.,,7-4,8-3,,0,10,7,13,0,0,0,7,3,7,3,0,-1,-10,-6,,
2017,12,NCAAF_20171118_RICE@ODU,Old Dominion,,Rice,,5-6,1-10,,10,7,24,21,7,3,7,7,7,0,0,14,4,3,3,,
2017,12,NCAAF_20171118_IOWAST@BAYLOR,Baylor,,Iowa St.,,1-10,7-4,,10,17,13,23,7,3,3,0,7,10,3,3,-6,-7,-10,,
2017,12,NCAAF_20171118_ARIZST@OREGST,Oregon State,,Arizona St.,,1-10,6-5,,7,30,24,40,0,7,3,14,16,14,3,7,-5,-23,-16,,
2017,12,NCAAF_20171118_CHARLO@USM,So. Miss,,Charlotte,,7-4,1-10,,38,7,66,21,13,25,14,14,0,7,7,7,6,31,45,,
2017,12,NCAAF_20171118_HAWAII@UTAHST,Utah St.,,Hawaii,,6-5,3-8,,21,0,38,0,14,7,14,3,0,0,0,0,3,21,38,,
2017,12,NCAAF_20171118_LATECH@UTEP,UTEP,,Louisiana Tech,,0-11,5-6,,0,28,21,42,0,0,14,7,7,21,0,14,-5,-28,-21,,
2017,12,NCAAF_20171118_MA@BYU,BYU,,UMass,,3-9,4-7,,0,3,10,16,0,0,3,7,0,3,13,0,-1,-3,-6,,
2017,12,NCAAF_20171118_SALA@GAS,Ga. Southern,,South Alabama,,1-9,4-7,,31,0,52,0,21,10,14,7,0,0,0,0,-3,31,52,,
2017,12,NCAAF_20171118_TXSTSM@ARKST,Arkansas St.,,Texas St.,,6-3,2-9,,16,6,30,12,16,0,14,0,6,0,6,0,4,10,18,,
2017,12,NCAAF_20171118_WCAR@UNC,North Carolina,,W. Carolina,,3-8,7-5,,42,7,65,10,7,35,10,13,7,0,0,3,-4,35,55,,
2017,12,NCAAF_20171118_CUSE@LVILLE,Louisville,,Syracuse,,7-4,4-7,,35,3,56,10,7,28,14,7,3,0,0,7,3,32,46,,
2017,12,NCAAF_20171118_GATECH@DUKE,Duke,,Georgia Tech,,5-6,5-5,,20,20,43,20,3,17,10,13,7,13,0,0,0,0,23,,
2017,12,NCAAF_20171118_ILL@OHIOST,Ohio State,,Illinois,,9-2,2-9,,38,0,52,14,28,10,7,7,0,0,7,7,7,38,38,,
2017,12,NCAAF_20171118_KSTATE@OKLAST,Oklahoma State,,Kansas State,,8-3,6-5,,13,28,40,45,10,3,7,20,7,21,14,3,2,-15,-5,,
2017,12,NCAAF_20171118_NAVY@ND,Notre Dame,,Navy,,9-2,6-4,,10,10,24,17,3,7,7,7,0,10,7,0,3,0,7,,
2017,12,NCAAF_20171118_OKLA@KANSAS,Kansas,,Oklahoma,,1-10,10-1,,3,21,3,41,0,3,0,0,7,14,7,13,-9,-18,-38,,
2017,12,NCAAF_20171118_PURDUE@IOWA,Iowa,,Purdue,,6-5,5-6,,9,7,15,24,0,9,0,6,7,0,14,3,1,2,-9,,
2017,12,NCAAF_20171118_SJST@COLOST,Colorado St.,,San Jose St.,,7-5,1-11,,28,7,42,14,14,14,7,7,7,0,0,7,6,21,28,,
2017,12,NCAAF_20171118_UK@UGA,Georgia,,Kentucky,,10-1,7-4,,21,6,42,13,7,14,7,14,6,0,7,0,3,15,29,,
2017,12,NCAAF_20171118_HOU@TULANE,Tulane,,Houston,,5-6,6-4,,13,3,20,17,3,10,0,7,3,0,7,7,-1,10,3,,
2017,12,NCAAF_20171118_MD@MICHST,Michigan St.,,Maryland,,8-3,4-7,,14,0,17,7,7,7,3,0,0,0,0,7,4,14,10,,
2017,12,NCAAF_20171118_NEB@PSU,Penn State,,Nebraska,,9-2,4-7,,42,10,56,44,14,28,0,14,10,0,14,20,5,32,12,,
2017,12,NCAAF_20171118_UAB@FLA,Florida,,UAB,,4-6,7-4,,19,0,36,7,6,13,14,3,0,0,0,7,-3,19,29,,
2017,12,NCAAF_20171118_WOFF@SC,South Carolina,,Wofford,,8-3,9-2,,14,3,31,10,0,14,7,10,3,0,7,0,-1,11,21,,
2017,12,NCAAF_20171118_CSTCAR@IDAHO,Idaho,,C. Carolina,,3-7,2-9,,7,10,7,13,7,0,0,0,0,10,0,3,1,-3,-6,,
2017,12,NCAAF_20171118_NMEXST@LALAF,Louisiana,,New Mexico St.,,5-5,4-6,,31,17,47,34,14,17,3,13,7,10,14,3,1,14,13,,
2017,12,NCAAF_20171118_ARMY@NTEXAS,North Texas,,Army,,8-3,8-3,,28,20,52,49,14,14,7,17,7,13,8,21,0,8,3,,
2017,12,NCAAF_20171118_ARIZ@OREG,Oregon,,Arizona,,6-5,7-4,,28,21,48,28,14,14,7,13,7,14,7,0,-1,7,20,,
2017,12,NCAAF_20171118_BC@UCONN,UConn,,Boston College,,3-8,6-5,,3,14,16,39,3,0,0,13,0,14,19,6,-3,-11,-23,,
2017,12,NCAAF_20171118_FIU@FAU,FAU,,FIU,,8-3,6-4,,21,10,52,24,14,7,16,15,0,10,7,7,2,11,28,,
2017,12,NCAAF_20171118_LSU@TENN,Tennessee,,LSU,,4-7,8-3,,10,17,10,30,0,10,0,0,3,14,13,0,-4,-7,-20,,
2017,12,NCAAF_20171118_MRSHL@TXSA,UTSA,,Marshall,,6-4,7-4,,6,0,9,7,3,3,0,3,0,0,0,7,-1,6,2,,
2017,12,NCAAF_20171118_TXAM@MISS,Ole Miss,,Texas A&M,,5-6,7-4,,24,21,24,31,14,10,0,0,14,7,7,3,-2,3,-7,,
2017,12,NCAAF_20171118_MIZZOU@VANDY,Vanderbilt,,Missouri,,4-7,6-5,,0,35,17,45,0,0,17,0,7,28,3,7,-2,-35,-28,,
2017,12,NCAAF_20171118_NCST@WAKE,Wake Forest,,NC State,,7-4,7-4,,21,14,30,24,14,7,3,6,7,7,7,3,0,7,6,,
2017,12,NCAAF_20171118_CAL@STNFRD,Stanford,,California,,8-3,5-6,,10,6,17,14,3,7,7,0,3,3,8,0,3,4,3,,
2017,12,NCAAF_20171118_UCLA@USC,USC,,UCLA,,10-2,5-6,,14,7,28,23,14,0,7,7,7,0,7,9,5,7,5,,
2017,12,NCAAF_20171118_AF@BOISE,Boise St.,,Air Force,,9-2,4-7,,27,10,44,19,17,10,10,7,7,3,0,9,5,17,25,,
2017,12,NCAAF_20171118_NEVADA@SDGST,San Diego St.,,Nevada,,9-2,2-9,,21,17,42,23,14,7,7,14,10,7,0,6,7,4,19,,
2017,12,NCAAF_20171118_UTAH@WASH,Washington,,Utah,,9-2,5-6,,16,13,33,30,6,10,7,10,7,6,10,7,4,3,3,,
2017,12,NCAAF_20171117_UNLV@NMEX,New Mexico,,UNLV,,3-7,4-6,,14,24,35,38,0,14,7,14,10,14,3,11,-1,-10,-3,,
2017,12,NCAAF_20171116_BUFF@BALLST,Ball St.,,Buffalo,,2-9,5-6,,10,23,24,40,0,10,7,7,10,13,14,3,-3,-13,-16,,
2017,12,NCAAF_20171116_TULSA@SFLA,South Florida,,Tulsa,,9-1,2-9,,24,17,27,20,21,3,3,0,7,10,0,3,7,7,7,,
2017,12,NCAAF_20171115_EMICH@MIAOH,Miami-OH,,E. Michigan,,4-7,4-7,,17,13,24,27,0,17,0,7,7,6,14,0,0,4,-3,,
2017,12,NCAAF_20171115_WMICH@NILL,N. Illinois,,W. Michigan,,8-3,6-5,,21,14,35,31,14,7,0,14,7,7,14,3,2,7,4,,
2017,12,NCAAF_20171115_TOLEDO@BGREEN,Bowling Green,,Toledo,,2-9,9-2,,21,24,37,66,7,14,7,9,14,10,28,14,-7,-3,-29,,
2017,12,NCAAF_20171114_CMICH@KENTST,Kent St.,,C. Michigan,,2-9,7-4,,17,28,23,42,3,14,0,6,7,21,0,14,-5,-11,-19,,
2017,12,NCAAF_20171114_OHIO@AKRON,Akron,,Ohio,,6-5,8-3,,30,24,37,34,10,20,0,7,14,10,3,7,-2,6,3,,
2017,13,NCAAF_20171125_FSU@FLA,Florida,,Florida State,,4-7,5-6,,13,24,22,38,7,6,3,6,7,17,0,14,-1,-11,-16,,
2017,13,NCAAF_20171125_IND@PURDUE,Purdue,,Indiana,,6-6,5-7,,21,10,31,24,7,14,3,7,7,3,0,14,1,11,7,,
2017,13,NCAAF_20171125_LVILLE@UK,Kentucky,,Louisville,,7-5,8-4,,10,31,17,44,7,3,0,7,17,14,3,10,-1,-21,-27,,
2017,13,NCAAF_20171125_UCONN@CINCY,Cincinnati,,UConn,,4-8,3-9,,7,6,22,21,0,7,0,15,3,3,9,6,1,1,1,,
2017,13,NCAAF_20171125_UGA@GATECH,Georgia Tech,,Georgia,,5-6,11-1,,7,17,7,38,0,7,0,0,7,10,14,7,-6,-10,-31,,
2017,13,NCAAF_20171125_ECU@MEMP,Memphis,,East Carolina,,10-1,3-9,,49,0,70,13,28,21,14,7,0,0,13,0,7,49,57,,
2017,13,NCAAF_20171125_KANSAS@OKLAST,Oklahoma State,,Kansas,,9-3,1-11,,34,10,58,17,10,24,14,10,3,7,7,0,8,24,41,,
2017,13,NCAAF_20171125_OHIOST@MICH,Michigan,,Ohio State,,8-4,10-2,,14,14,20,31,7,7,6,0,0,14,7,10,-2,0,-11,,
2017,13,NCAAF_20171125_TULANE@SMU,SMU,,Tulane,,7-5,5-7,,27,21,41,38,14,13,7,7,7,14,17,0,2,6,3,,
2017,13,NCAAF_20171125_BC@CUSE,Syracuse,,Boston College,,4-8,7-5,,14,28,14,42,7,7,0,0,14,14,7,7,-3,-14,-28,,
2017,13,NCAAF_20171125_DUKE@WAKE,Wake Forest,,Duke,,7-5,6-6,,17,10,23,31,10,7,6,0,3,7,7,14,1,7,-8,,
2017,13,NCAAF_20171125_NTEXAS@RICE,Rice,,North Texas,,1-11,9-3,,14,24,14,30,7,7,0,0,7,17,3,3,-8,-10,-16,,
2017,13,NCAAF_20171125_UTEP@UAB,UAB,,UTEP,,8-4,0-12,,14,7,28,7,3,11,14,0,7,0,0,0,8,7,21,,
2017,13,NCAAF_20171125_APLST@GAST,Georgia St.,,App. St.,,6-4,7-4,,7,10,10,31,0,7,0,3,0,10,14,7,-1,-3,-21,,
2017,13,NCAAF_20171125_FAU@CHARLO,Charlotte,,FAU,,1-11,9-3,,6,24,12,31,0,6,6,0,10,14,7,0,-8,-18,-19,,
2017,13,NCAAF_20171125_USM@MRSHL,Marshall,,So. Miss,,7-5,8-4,,14,14,27,28,0,14,7,6,0,14,7,7,-1,0,-1,,
2017,13,NCAAF_20171125_ARKST@LAMON,UL-Monroe,,Arkansas St.,,4-7,7-3,,21,28,50,67,14,7,14,15,7,21,21,18,-3,-7,-17,,
2017,13,NCAAF_20171125_ODU@MTSU,Middle Tenn.,,Old Dominion,,6-6,5-7,,24,3,41,10,3,21,7,10,3,0,0,7,1,21,31,,
2017,13,NCAAF_20171125_UNLV@NEVADA,Nevada,,UNLV,,3-9,5-7,,9,13,23,16,6,3,7,7,0,13,3,0,-2,-4,7,,
2017,13,NCAAF_20171125_BAMA@AUBURN,Auburn,,Alabama,,10-2,11-1,,10,7,26,14,7,3,10,6,0,7,7,0,-1,3,12,,
2017,13,NCAAF_20171125_IOWAST@KSTATE,Kansas State,,Iowa St.,,7-5,7-5,,7,6,20,19,0,7,0,13,3,3,6,7,0,1,1,,
2017,13,NCAAF_20171125_PSU@MD,Maryland,,Penn State,,4-8,10-2,,0,31,3,66,0,0,3,0,14,17,21,14,-6,-31,-63,,
2017,13,NCAAF_20171125_UNC@NCST,NC State,,North Carolina,,8-4,3-9,,12,14,33,21,6,6,7,14,7,7,0,7,5,-2,12,,
2017,13,NCAAF_20171125_BOISE@FRESNO,Fresno St.,,Boise St.,,9-3,9-3,,10,7,28,17,7,3,6,12,7,0,3,7,0,3,11,,
2017,13,NCAAF_20171125_WISC@MINN,Minnesota,,Wisconsin,,5-7,12-0,,0,17,0,31,0,0,0,0,7,10,7,7,-7,-17,-31,,
2017,13,NCAAF_20171125_WVU@OKLA,Oklahoma,,West Virginia,,11-1,7-5,,45,10,59,31,14,31,14,0,3,7,14,7,4,35,28,,
2017,13,NCAAF_20171125_MICHST@RUT,Rutgers,,Michigan St.,,4-8,9-3,,7,16,7,40,0,7,0,0,13,3,3,21,-5,-9,-33,,
2017,13,NCAAF_20171125_NWEST@ILL,Illinois,,Northwestern,,2-10,9-3,,7,14,7,42,7,0,0,0,0,14,14,14,-7,-7,-35,,
2017,13,NCAAF_20171125_VANDY@TENN,Tennessee,,Vanderbilt,,4-8,5-7,,14,21,24,42,14,0,3,7,7,14,0,21,-1,-7,-18,,
2017,13,NCAAF_20171125_IDAHO@NMEXST,New Mexico St.,,Idaho,,5-6,3-8,,14,7,17,10,14,0,0,3,0,7,3,0,2,7,7,,
2017,13,NCAAF_20171125_TEMPLE@TULSA,Tulsa,,Temple,,2-10,6-6,,13,31,22,43,7,6,7,2,10,21,6,6,-4,-18,-21,,
2017,13,NCAAF_20171125_ARIZ@ARIZST,Arizona St.,,Arizona,,7-5,7-5,,14,24,42,30,7,7,21,7,14,10,0,6,0,-10,12,,
2017,13,NCAAF_20171125_GAS@LALAF,Louisiana,,Ga. Southern,,5-6,2-9,,7,17,24,34,0,7,3,14,14,3,10,7,3,-10,-10,,
2017,13,NCAAF_20171125_WYO@SJST,San Jose St.,,Wyoming,,2-11,7-5,,13,7,20,17,7,6,0,7,0,7,3,7,-5,6,3,,
2017,13,NCAAF_20171125_OREGST@OREG,Oregon,,Oregon State,,7-5,1-11,,52,7,69,10,17,35,10,7,7,0,3,0,6,45,59,,
2017,13,NCAAF_20171125_CLEM@SC,South Carolina,,Clemson,,8-4,11-1,,0,20,10,34,0,0,0,10,7,13,14,0,-3,-20,-24,,
2017,13,NCAAF_20171125_TXAM@LSU,LSU,,Texas A&M,,9-3,7-5,,20,7,45,21,13,7,14,11,0,7,14,0,2,13,24,,
2017,13,NCAAF_20171125_TXSA@LATECH,Louisiana Tech,,UTSA,,6-6,6-5,,10,0,20,6,7,3,3,7,0,0,3,3,0,10,14,,
2017,13,NCAAF_20171125_ND@STNFRD,Stanford,,Notre Dame,,9-3,9-3,,14,10,38,20,7,7,3,21,7,3,10,0,0,4,18,,
2017,13,NCAAF_20171125_WASHST@WASH,Washington,,Washington St.,,10-2,9-3,,24,0,41,14,7,17,10,7,0,0,0,14,1,24,27,,
2017,13,NCAAF_20171125_BYU@HAWAII,Hawaii,,BYU,,3-9,4-9,,7,13,20,30,7,0,0,13,7,6,7,10,-1,-6,-10,,
2017,13,NCAAF_20171125_COLO@UTAH,Utah,,Colorado,,6-6,5-7,,28,0,34,13,14,14,3,3,0,0,7,6,1,28,21,,
2017,13,NCAAF_20171125_UTAHST@AF,Air Force,,Utah St.,,5-7,6-6,,17,21,38,35,10,7,7,14,14,7,0,14,-1,-4,3,,
2017,13,NCAAF_20171124_WMICH@TOLEDO,Toledo,,W. Michigan,,10-2,6-6,,17,3,37,10,3,14,14,6,0,3,7,0,4,14,27,,
2017,13,NCAAF_20171124_BAYLOR@TCU,TCU,,Baylor,,10-2,1-11,,21,19,45,22,14,7,14,10,9,10,3,0,9,2,23,,
2017,13,NCAAF_20171124_MIAMI@PITT,Pittsburgh,,Miami (Fla.),,5-7,10-1,,10,7,24,14,3,7,7,7,0,7,0,7,-5,3,10,,
2017,13,NCAAF_20171124_NAVY@HOU,Houston,,Navy,,7-4,6-5,,7,14,24,14,7,0,7,10,0,14,0,0,1,-7,10,,
2017,13,NCAAF_20171124_NILL@CMICH,C. Michigan,,N. Illinois,,8-4,8-4,,0,17,31,24,0,0,17,14,14,3,0,7,0,-17,7,,
2017,13,NCAAF_20171124_OHIO@BUFF,Buffalo,,Ohio,,6-6,8-4,,24,10,31,24,24,0,0,7,7,3,14,0,-2,14,7,,
2017,13,NCAAF_20171124_MIZZOU@ARK,Arkansas,,Missouri,,4-8,7-5,,28,31,45,48,21,7,7,10,7,24,0,17,-3,-3,-3,,
2017,13,NCAAF_20171124_NMEX@SDGST,San Diego St.,,New Mexico,,10-2,3-9,,14,0,35,10,7,7,7,14,0,0,10,0,7,14,25,,
2017,13,NCAAF_20171124_SFLA@UCF,UCF,,South Florida,,11-0,9-2,,21,20,49,42,21,0,7,21,7,13,14,8,2,1,7,,
2017,13,NCAAF_20171124_IOWA@NEB,Nebraska,,Iowa,,4-8,7-5,,14,14,14,56,7,7,0,0,7,7,28,14,-3,0,-42,,
2017,13,NCAAF_20171124_TXSTSM@TROY,Troy,,Texas St.,,9-2,2-10,,41,0,62,9,17,24,14,7,0,0,6,3,7,41,53,,
2017,13,NCAAF_20171124_WKY@FIU,FIU,,W. Kentucky,,7-4,6-6,,13,10,41,17,3,10,21,7,3,7,7,0,1,3,24,,
2017,13,NCAAF_20171124_TXTECH@TEXAS,Texas,,Texas Tech,,6-6,6-6,,20,10,23,27,7,13,0,3,7,3,3,14,0,10,-4,,
2017,13,NCAAF_20171124_VATECH@UVA,Virginia,,Virginia Tech,,6-6,9-3,,0,3,0,10,0,0,0,0,0,3,7,0,-3,-3,-10,,
2017,13,NCAAF_20171124_CAL@UCLA,UCLA,,California,,6-6,5-7,,17,9,30,27,7,10,7,6,3,6,8,10,1,8,3,,
2017,13,NCAAF_20171123_MISS@MISSST,Miss. State,,Ole Miss,,8-4,6-6,,6,10,28,31,0,6,0,22,7,3,14,7,2,-4,-3,,
2017,13,NCAAF_20171121_BGREEN@EMICH,E. Michigan,,Bowling Green,,5-7,2-10,,20,17,34,31,13,7,14,0,10,7,14,0,3,3,3,,
2017,13,NCAAF_20171121_KENTST@AKRON,Akron,,Kent St.,,7-5,2-10,,24,7,24,14,10,14,0,0,0,7,7,0,5,17,10,,
2017,13,NCAAF_20171121_MIAOH@BALLST,Ball St.,,Miami-OH,,2-10,5-7,,0,28,7,28,0,0,0,7,14,14,0,0,-3,-28,-21,,
2017,14,NCAAF_20171202_AKRON@TOLEDO,Toledo,,Akron,,11-2,7-6,,28,0,45,28,7,21,10,7,0,0,7,21,4,28,17,,
2017,14,NCAAF_20171202_LAMON@FSU,Florida State,,UL-Monroe,,6-6,4-8,,14,0,42,10,7,7,14,14,0,0,10,0,2,14,32,,
2017,14,NCAAF_20171202_MA@FIU,FIU,,UMass,,8-4,4-8,,35,21,63,45,14,21,7,21,14,7,10,14,4,14,18,,
2017,14,NCAAF_20171202_NTEXAS@FAU,FAU,,North Texas,,10-3,9-4,,27,0,41,17,10,17,7,7,0,0,9,8,1,27,24,,
2017,14,NCAAF_20171202_TCU@OKLA,Oklahoma,,TCU,,12-1,10-3,,24,17,41,17,17,7,17,0,0,17,0,0,2,7,24,,
2017,14,NCAAF_20171202_GAS@CSTCAR,C. Carolina,,Ga. Southern,,3-9,2-10,,14,10,28,17,7,7,14,0,3,7,7,0,1,4,11,,
2017,14,NCAAF_20171202_IDAHO@GAST,Georgia St.,,Idaho,,6-5,4-8,,10,14,10,24,7,3,0,0,7,7,3,7,2,-4,-14,,
2017,14,NCAAF_20171202_LALAF@APLST,App. St.,,Louisiana,,8-4,5-7,,35,7,63,14,14,21,14,14,7,0,0,7,3,28,49,,
2017,14,NCAAF_20171202_UGA@AUBURN,Auburn,,Georgia,,10-3,12-1,,7,10,7,28,7,0,0,0,0,10,3,15,-2,-3,-21,,
2017,14,NCAAF_20171202_SALA@NMEXST,New Mexico St.,,South Alabama,,6-6,4-8,,13,7,22,17,0,13,0,9,0,7,0,10,2,6,5,,
2017,14,NCAAF_20171202_TROY@ARKST,Arkansas St.,,Troy,,7-4,10-2,,10,7,25,32,0,10,3,12,0,7,10,15,-3,3,-7,,
2017,14,NCAAF_20171202_FRESNO@BOISE,Boise St.,,Fresno St.,,10-3,9-4,,10,14,17,14,3,7,0,7,0,14,0,0,1,-4,3,,
2017,14,NCAAF_20171202_MIAMI@CLEM,Clemson,,Miami (Fla.),,12-1,10-2,,21,0,38,3,14,7,17,0,0,0,0,3,2,21,35,,
2017,14,NCAAF_20171202_OHIOST@WISC,Wisconsin,,Ohio State,,12-1,11-2,,10,21,21,27,7,3,3,8,14,7,3,3,1,-11,-6,,
2017,14,NCAAF_20171201_STNFRD@USC,USC,,Stanford,,11-2,9-4,,17,14,31,28,7,10,7,7,0,14,7,7,2,3,3,,
2017,15,NCAAF_20171209_ARMY@NAVY,Navy,,Army,,6-6,9-3,,10,7,13,14,3,7,3,0,7,0,0,7,-3,3,-1,,
2018,2,NCAAF_20180909_RICE@HAWAII,Hawaii,,Rice,,3-0,1-2,,21,10,43,29,14,7,7,15,7,3,3,16,2,11,14,0.6214011248977447,[4.52603014]
2018,2,NCAAF_20180908_ARIZ@HOU,Houston,,Arizona,,2-0,0-2,,31,0,45,18,21,10,7,7,0,0,10,8,2,31,27,0.4437655892212051,[-2.07046682]
2018,2,NCAAF_20180908_DUKE@NWEST,Northwestern,,Duke,,1-1,2-0,,7,21,7,21,7,0,0,0,0,21,0,0,-1,-14,-14,0.6523886294854404,[5.73547818]
2018,2,NCAAF_20180908_EMICH@PURDUE,Purdue,,E. Michigan,,0-2,2-0,,12,10,19,20,6,6,0,7,7,3,0,10,-2,2,-1,0.8956219609292133,[18.40192549]
2018,2,NCAAF_20180908_GATECH@SFLA,South Florida,,Georgia Tech,,2-0,1-1,,21,17,49,38,14,7,7,21,17,0,14,7,1,4,11,0.32701547114493024,[-6.56103757]
2018,2,NCAAF_20180908_LIB@ARMY,Army,Black Knights,Liberty,Flames,1-1,1-1,1,17,0,38,14,14,3,7,14,0,0,14,0,0,17,24,0.4827509424853992,[-0.63317099]
2018,2,NCAAF_20180908_MISSST@KSTATE,Kansas State,Wildcats,Miss. State,Bulldogs,1-1,2-0,1,3,17,10,31,3,0,7,0,3,14,7,7,-1,-14,-21,0.3338190159551815,[-6.28614204]
2018,2,NCAAF_20180908_NEVADA@VANDY,Vanderbilt,,Nevada,,2-0,1-1,,17,10,41,10,0,17,17,7,0,10,0,0,1,7,31,0.5878221467036504,[3.24921299]
2018,2,NCAAF_20180908_NMEX@WISC,Wisconsin,Badgers,New Mexico,Lobos,2-0,1-1,1,10,7,45,14,3,7,14,21,7,0,0,7,1,3,31,0.9987598408940946,[44.29562332]
2018,2,NCAAF_20180908_TWST@WAKE,Wake Forest,,Towson,,2-0,1-1,,38,20,51,20,14,24,3,10,14,6,0,0,1,18,31,0.9999952508740085,[64.82858049]
2018,2,NCAAF_20180908_WMICH@MICH,Michigan,Wolverines,W. Michigan,Broncos,1-1,0-2,1,35,0,49,3,21,14,7,7,0,0,0,3,1,35,46,0.9072212373041821,[19.38047868]
2018,2,NCAAF_20180908_GAST@NCST,NC State,,Georgia St.,,2-0,1-1,,20,7,41,7,10,10,7,14,7,0,0,0,1,13,34,0.987297765090184,[32.72246216]
2018,2,NCAAF_20180908_HOLY@BC,Boston College,,Holy Cross,,2-0,0-2,,34,0,62,14,21,13,14,14,0,0,7,7,2,34,48,0.9920706179911651,[35.31299855]
2018,2,NCAAF_20180908_UCLA@OKLA,Oklahoma,Sooners,UCLA,Bruins,2-0,0-2,1,21,7,49,21,14,7,14,14,7,0,0,14,2,14,28,0.9454858996961023,[23.4611379]
2018,2,NCAAF_20180908_AF@FAU,FAU,,Air Force,,1-1,1-1,,19,7,33,27,6,13,6,8,0,7,13,7,0,12,6,0.8366600831166829,[14.35889904]
2018,2,NCAAF_20180908_PORTST@OREG,Oregon,Ducks,Portland St.,Vikings,2-0,0-2,1,35,7,62,14,14,21,14,13,0,7,0,7,2,28,48,0.9856924330532506,[32.0424826]
2018,2,NCAAF_20180908_WMMARY@VATECH,Virginia Tech,Hokies,William & Mary,Tribe,1-0,1-0,1,38,7,62,17,17,21,17,7,0,7,7,3,0,31,45,0.9896559351139294,[33.87067682]
2018,2,NCAAF_20180908_KANSAS@CMICH,C. Michigan,Chippewas,Kansas,Jayhawks,0-2,1-1,1,0,7,7,31,0,0,7,0,0,7,14,10,-1,-7,-24,0.8425435908636737,[14.71235013]
2018,2,NCAAF_20180908_ARKST@BAMA,Alabama,Crimson Tide,Arkansas St.,Red Wolves,2-0,1-1,1,40,0,57,7,19,21,10,7,0,0,7,0,1,40,50,0.9915865737396667,[34.99560489]
2018,2,NCAAF_20180908_BALLST@ND,Notre Dame,Fighting Irish,Ball St.,Cardinals,2-0,1-1,1,14,6,24,16,7,7,10,0,3,3,0,10,1,8,8,0.9999463775200705,[56.70791376]
2018,2,NCAAF_20180908_BUFF@TEMPLE,Temple,,Buffalo,,0-2,2-0,,7,12,29,36,0,7,7,15,6,6,10,14,-2,-5,-7,0.524520420436125,[0.90037181]
2018,2,NCAAF_20180908_COLO@NEB,Nebraska,,Colorado,,0-1,2-0,,21,17,28,33,7,14,7,0,14,3,10,6,-2,4,-5,0.5366509130926602,[1.34684417]
2018,2,NCAAF_20180908_HOW@KENTST,Kent St.,,Howard,,1-1,0-2,,26,0,54,14,16,10,21,7,0,0,14,0,1,26,40,0.39261989550871557,[-3.98925931]
2018,2,NCAAF_20180908_MEMP@NAVY,Navy,Midshipmen,Memphis,Tigers,1-1,1-1,1,9,7,22,21,3,6,0,13,0,7,14,0,0,2,1,0.23649357945220506,[-10.50580255]
2018,2,NCAAF_20180908_MRGNST@AKRON,Akron,,Morgan St.,,1-0,0-2,,27,0,41,7,17,10,14,0,0,0,0,7,1,27,34,0.9999900562264418,[62.45488298]
2018,2,NCAAF_20180908_RUT@OHIOST,Ohio State,Buckeyes,Rutgers,Scarlet Knights,2-0,1-1,1,35,0,52,3,14,21,10,7,0,0,3,0,1,35,49,0.9949583515675835,[37.66719607]
2018,2,NCAAF_20180908_UGA@SC,South Carolina,Gamecocks,Georgia,Bulldogs,1-0,1-0,1,10,20,17,41,7,3,0,7,17,3,21,0,0,-10,-24,0.06109944332171169,[-22.62716381]
2018,2,NCAAF_20180908_UNC@ECU,East Carolina,,North Carolina,,1-1,0-2,,21,19,41,19,7,14,7,13,6,13,0,0,1,2,22,0.10704972688260606,[-18.18787116]
2018,2,NCAAF_20180908_WAG@CUSE,Syracuse,,Wagner,,2-0,1-1,,45,7,62,10,21,24,14,3,7,0,0,3,1,38,52,0.9976687228333576,[41.42237749]
2018,2,NCAAF_20180908_ETNST@TENN,Tennessee,Volunteers,ETSU,Buccaneers,1-1,1-1,1,38,0,59,3,10,28,7,14,0,0,3,0,0,38,56,,
2018,2,NCAAF_20180908_LAMAR@TXTECH,Texas Tech,,Lamar,,1-1,1-1,,42,0,77,0,14,28,14,21,0,0,0,0,0,42,77,0.999992957545255,[63.57311377]
2018,2,NCAAF_20180908_SIL@MISS,Ole Miss,,S. Illinois,,2-0,1-1,,35,38,76,41,14,21,14,27,21,17,3,0,1,-3,35,0.4537091399555424,[-1.70252528]
2018,2,NCAAF_20180908_IOWAST@IOWA,Iowa,Hawkeyes,Iowa St.,Cyclones,2-0,0-1,1,3,3,13,3,0,3,3,7,3,0,0,0,2,0,10,0.5832649533882611,[3.07802999]
2018,2,NCAAF_20180908_NDK@WASH,Washington,Huskies,North Dakota,Fighting Hawks,1-1,1-1,1,17,0,45,3,10,7,7,21,0,0,3,0,0,17,42,0.9921929500293799,[35.39590527]
2018,2,NCAAF_20180908_APLST@CHARLO,Charlotte,,App. St.,,1-1,1-1,,9,24,9,45,0,9,0,0,10,14,7,14,0,-15,-36,0.024244524402033618,[-28.88484163]
2018,2,NCAAF_20180908_MA@GAS,Ga. Southern,,UMass,,2-0,1-2,,17,10,34,13,0,17,10,7,3,7,3,0,1,7,21,0.3588551558517875,[-5.29253044]
2018,2,NCAAF_20180908_MD@BGREEN,Bowling Green,,Maryland,,0-2,2-0,,14,10,14,45,7,7,0,0,0,10,7,28,-2,4,-31,0.1888588698478586,[-12.91375934]
2018,2,NCAAF_20180908_SAV@MIAMI,Miami (Fla.),Hurricanes,Savannah St.,Tigers,1-1,0-2,1,28,0,77,0,7,21,21,28,0,0,0,0,1,28,77,0.9999980244048304,[67.54631242]
2018,2,NCAAF_20180908_SCST@UCF,UCF,Knights,SC State,Bulldogs,2-0,0-2,1,24,0,38,0,14,10,14,0,0,0,0,0,2,24,38,,
2018,2,NCAAF_20180908_YST@WVU,West Virginia,Mountaineers,Youngstown St.,Penguins,2-0,0-2,1,21,7,52,17,7,14,21,10,0,7,10,0,2,14,35,,
2018,2,NCAAF_20180908_EKY@MRSHL,Marshall,,E. Kentucky,,2-0,1-1,,20,6,32,16,13,7,7,5,0,6,7,3,1,14,16,0.8739866043565931,[16.76883143]
2018,2,NCAAF_20180908_BAYLOR@TXSA,UTSA,,Baylor,,0-2,2-0,,13,20,20,37,3,10,0,7,10,10,7,10,-2,-7,-17,0.25520688992800455,[-9.63571467]
2018,2,NCAAF_20180908_CLEM@TXAM,Texas A&M,Aggies,Clemson,Tigers,1-1,2-0,1,3,14,26,28,3,0,10,13,7,7,14,0,-1,-11,-2,0.04437453528800994,[-24.91715472]
2018,2,NCAAF_20180908_FAMU@TROY,Troy,,Florida A&M,,1-1,1-1,,38,7,59,7,21,17,14,7,0,7,0,0,0,31,52,0.9989679593632722,[45.10257926]
2018,2,NCAAF_20180908_INST@LVILLE,Louisville,,Indiana St.,,1-1,1-1,,7,7,31,7,7,0,7,17,7,0,0,0,0,0,24,0.9999845751632235,[61.00485964]
2018,2,NCAAF_20180908_LAMON@USM,So. Miss,,UL-Monroe,,1-1,2-0,,17,14,20,21,10,7,3,0,14,0,7,0,-1,3,-1,0.5848472207139515,[3.13741622]
2018,2,NCAAF_20180908_SELOU@LSU,LSU,Tigers,SE Louisiana,Lions,2-0,0-2,1,24,0,31,0,14,10,0,7,0,0,0,0,2,24,31,0.9967275107379212,[39.80738007]
2018,2,NCAAF_20180908_SO@LATECH,Louisiana Tech,,Southern U.,,2-0,0-2,,31,14,54,17,21,10,14,9,7,7,3,0,2,17,37,0.9975374412138788,[41.16506609]
2018,2,NCAAF_20180908_TNMART@MTSU,Middle Tenn.,,UT Martin,,1-1,0-2,,26,17,61,37,14,12,21,14,7,10,7,13,1,9,24,0.7884490712170049,[11.72710287]
2018,2,NCAAF_20180908_TXSO@TXSTSM,Texas St.,,Texas Southern,,1-1,1-1,,16,0,36,20,3,13,10,10,0,0,7,13,0,16,16,,
2018,2,NCAAF_20180908_UAB@CSTCAR,C. Carolina,,UAB,,1-1,1-1,,20,24,47,24,7,13,7,20,14,10,0,0,0,-4,23,0.3452737214555255,[-5.82821903]
2018,2,NCAAF_20180908_WYO@MIZZOU,Missouri,,Wyoming,,2-0,1-2,,16,0,40,13,3,13,14,10,0,0,10,3,1,16,27,0.776572541630639,[11.13591538]
2018,2,NCAAF_20180908_SAMF@FSU,Florida State,Seminoles,Samford,Bulldogs,1-1,1-1,1,21,23,36,26,7,14,0,15,16,7,0,3,0,-2,10,0.7787588922586115,[11.24336399]
2018,2,NCAAF_20180908_ALST@AUBURN,Auburn,Tigers,Alabama St.,Hornets,2-0,1-1,1,42,2,63,9,21,21,7,14,0,2,7,0,1,40,54,0.999887873785508,[54.02028903]
2018,2,NCAAF_20180908_ARK@COLOST,Colorado St.,Rams,Arkansas,Razorbacks,1-2,1-1,1,9,13,34,27,3,6,8,17,7,6,14,0,0,-4,7,0.5113829515380874,[0.41776695]
2018,2,NCAAF_20180908_FIU@ODU,Old Dominion,,FIU,,0-2,1-1,,20,14,20,28,7,13,0,0,0,14,14,0,-1,6,-8,0.2444109443282263,[-10.13332038]
2018,2,NCAAF_20180908_FRESNO@MINN,Minnesota,,Fresno St.,,2-0,1-1,,10,0,21,14,7,3,0,11,0,0,7,7,1,10,7,0.5741422034790542,[2.73658601]
2018,2,NCAAF_20180908_ME@WKY,W. Kentucky,,Maine,,0-2,2-0,,21,14,28,31,21,0,0,7,0,14,14,3,-2,7,-3,0.7401001206174759,[9.42286268]
2018,2,NCAAF_20180908_UIW@NTEXAS,North Texas,,Incarnate Word,,2-0,0-2,,41,6,58,16,10,31,14,3,6,0,10,0,2,35,42,0.9999132564941225,[54.96876126]
2018,2,NCAAF_20180908_UK@FLA,Florida,Gators,Kentucky,Wildcats,1-1,2-0,1,10,7,16,27,0,10,0,6,7,0,14,6,-1,3,-11,0.5363752762981044,[1.33668679]
2018,2,NCAAF_20180908_UTAH@NILL,N. Illinois,,Utah,,0-2,2-0,,3,0,6,17,3,0,0,3,0,0,7,10,-2,3,-11,0.34494982962224996,[-5.84108708]
2018,2,NCAAF_20180908_UVA@IND,Indiana,,Virginia,,2-0,1-1,,20,9,20,16,13,7,0,0,9,0,7,0,1,11,4,0.5792599944426651,[2.92793815]
2018,2,NCAAF_20180908_WIL@ILL,Illinois,,W. Illinois,,2-0,0-2,,14,7,34,14,0,14,10,10,7,0,7,0,2,7,20,0.014055721042397051,[-32.14465683]
2018,2,NCAAF_20180908_CINCY@MIAOH,Miami-OH,,Cincinnati,,0-2,2-0,,0,7,0,21,0,0,0,0,7,0,0,14,-2,-7,-21,0.6597615888980877,[6.02878641]
2018,2,NCAAF_20180908_NICHST@TULANE,Tulane,,Nicholls St.,,1-1,1-1,,21,10,42,17,7,14,7,14,3,7,0,7,0,11,25,0.5091796744850074,[0.33688825]
2018,2,NCAAF_20180908_NMEXST@UTAHST,Utah St.,,New Mexico St.,,1-1,0-3,,33,10,60,13,16,17,14,13,7,3,3,0,1,23,47,0.7851550831640428,[11.56125143]
2018,2,NCAAF_20180908_PSU@PITT,Pittsburgh,Panthers,Penn State,Nittany Lions,1-1,2-0,1,6,14,6,51,6,0,0,0,7,7,16,21,-1,-8,-45,0.0396807297380114,[-25.68382536]
2018,2,NCAAF_20180908_SALA@OKLAST,Oklahoma State,,South Alabama,,2-0,0-2,,31,13,55,13,14,17,10,14,7,6,0,0,2,18,42,0.9975601156729924,[41.208607]
2018,2,NCAAF_20180908_SUT@OREGST,Oregon State,,So. Utah,,1-1,0-2,,41,7,48,25,17,24,0,7,0,7,9,9,1,34,23,0.9794530893641884,[29.90266183]
2018,2,NCAAF_20180908_TULSA@TEXAS,Texas,Longhorns,Tulsa,Golden Hurricane,1-1,1-1,1,21,0,28,21,14,7,0,7,0,0,7,14,0,21,7,0.929832000082469,[21.58674491]
2018,2,NCAAF_20180908_USC@STNFRD,Stanford,Cardinal,USC,Trojans,2-0,1-1,1,14,0,17,3,7,7,3,0,0,0,3,0,1,14,14,0.5476824967268826,[1.75395008]
2018,2,NCAAF_20180908_SACST@SDGST,San Diego St.,,Sacramento St.,,1-1,1-1,,13,7,28,14,7,6,0,15,0,7,7,0,0,6,14,0.9990861558904167,[45.6301615]
2018,2,NCAAF_20180908_UTEP@UNLV,UNLV,,UTEP,,1-1,0-2,,38,10,52,24,14,24,7,7,10,0,7,7,1,28,28,0.9242141120934112,[20.99326505]
2018,2,NCAAF_20180908_CAL@BYU,BYU,,California,,1-1,2-0,,3,7,18,21,0,3,7,8,7,0,7,7,-1,-4,-3,0.14314835274088,[-15.60996497]
2018,2,NCAAF_20180908_UCONN@BOISE,Boise St.,Broncos,UConn,Huskies,2-0,0-2,1,41,0,62,7,24,17,14,7,0,0,7,0,2,41,55,0.9237072759328812,[20.94139483]
2018,2,NCAAF_20180908_MICHST@ARIZST,Arizona St.,Sun Devils,Michigan St.,Spartans,2-0,1-1,1,0,3,16,13,0,0,3,13,0,3,10,0,1,-3,3,0.2956080708594315,[-7.86257621]
2018,2,NCAAF_20180908_SJST@WASHST,Washington St.,,San Jose St.,,2-0,0-2,,24,0,31,0,14,10,0,7,0,0,0,0,2,24,31,0.9981881425569054,[42.58942455]
2018,2,NCAAF_20180907_TCU@SMU,SMU,Mustangs,TCU,Horned Frogs,0-2,2-0,1,12,14,12,42,9,3,0,0,0,14,14,14,-2,-2,-30,0.11433587698218961,[-17.62301133]
2018,3,NCAAF_20180915_BALLST@IND,Indiana,Hoosiers,Ball St.,Cardinals,3-0,1-2,1,24,3,38,10,3,21,7,7,3,0,7,0,2,21,28,0.9948394607844198,[38.22063084]
2018,3,NCAAF_20180915_FSU@CUSE,Syracuse,,Florida State,,3-0,1-2,,6,0,30,7,3,3,14,10,0,0,0,7,2,6,23,0.24179986721211433,[-10.43887748]
2018,3,NCAAF_20180915_GAS@CLEM,Clemson,Tigers,Ga. Southern,Eagles,3-0,2-1,1,21,0,38,7,0,21,3,14,0,0,0,7,1,21,31,0.9988253397668402,[45.33192992]
2018,3,NCAAF_20180915_HAWAII@ARMY,Army,Black Knights,Hawaii,Rainbow Warriors,2-1,3-1,1,21,14,28,21,7,14,0,7,7,7,0,7,-1,7,7,0.9436705943874315,[23.63909071]
2018,3,NCAAF_20180915_KENTST@PSU,Penn State,Nittany Lions,Kent St.,Golden Flashes,3-0,1-2,1,28,10,63,10,21,7,21,14,7,3,0,0,2,18,53,0.9999575686873714,[58.5664627]
2018,3,NCAAF_20180915_MIAMI@TOLEDO,Toledo,Rockets,Miami (Fla.),Hurricanes,1-1,2-1,1,7,21,24,49,0,7,14,3,7,14,14,14,-1,-14,-25,0.2059474474393369,[-12.22763983]
2018,3,NCAAF_20180915_MTSU@UGA,Georgia,Bulldogs,Middle Tenn.,Blue Raiders,3-0,1-2,1,42,7,49,7,14,28,7,0,0,7,0,0,2,35,42,0.9969688521716826,[40.89560736]
2018,3,NCAAF_20180915_MURYST@UK,Kentucky,Wildcats,Murray St.,Racers,3-0,0-3,1,17,3,48,10,7,10,17,14,0,3,0,7,3,14,38,0.9841770820514574,[32.02120422]
2018,3,NCAAF_20180915_OKLA@IOWAST,Iowa St.,Cyclones,Oklahoma,Sooners,0-1,2-0,1,10,24,27,37,0,10,14,3,10,14,10,3,-2,-14,-10,0.22962754281250342,[-11.0282233]
2018,3,NCAAF_20180915_RI@UCONN,UConn,Huskies,Rhode Island,Rams,1-2,2-1,1,42,28,56,49,14,28,7,7,7,21,14,7,-1,14,7,,
2018,3,NCAAF_20180915_RUT@KANSAS,Kansas,,Rutgers,,2-1,1-2,,31,14,55,14,17,14,10,14,7,7,0,0,1,17,41,0.25489230257269435,[-9.82267751]
2018,3,NCAAF_20180915_TEMPLE@MD,Maryland,Terrapins,Temple,Owls,2-1,1-2,1,7,21,14,35,0,7,0,7,7,14,7,7,1,-14,-21,0.6375881760437168,[5.24562333]
2018,3,NCAAF_20180915_TROY@NEB,Nebraska,,Troy,,0-2,2-1,,7,17,19,24,0,7,6,6,3,14,0,7,-2,-10,-5,0.5075133396760375,[0.28065904]
2018,3,NCAAF_20180915_UTEP@TENN,Tennessee,Volunteers,UTEP,Miners,1-1,0-2,1,10,0,24,0,3,7,7,7,0,0,0,0,1,10,24,0.9671313529817105,[27.42192716]
2018,3,NCAAF_20180915_GATECH@PITT,Pittsburgh,,Georgia Tech,,2-1,1-2,,21,0,24,19,14,7,3,0,0,0,6,13,1,21,5,0.31578054132136546,[-7.14573452]
2018,3,NCAAF_20180915_TULANE@UAB,UAB,,Tulane,,2-1,1-2,,21,7,31,24,7,14,3,7,0,7,14,3,1,14,7,0.14009911291144406,[-16.0917598]
2018,3,NCAAF_20180915_DAVIS@STNFRD,Stanford,Cardinal,UC-Davis,Aggies,3-0,2-1,1,17,3,30,10,0,17,10,3,3,0,0,7,1,14,20,0.9859623079143512,[32.7271732]
2018,3,NCAAF_20180915_VANDY@ND,Notre Dame,Fighting Irish,Vanderbilt,Commodores,2-0,2-0,1,16,3,22,17,10,6,0,6,0,3,7,7,0,13,5,0.9461664360760565,[23.9730757]
2018,3,NCAAF_20180915_BOISE@OKLAST,Oklahoma State,Cowboys,Boise St.,Broncos,3-0,2-1,1,17,7,44,21,0,17,17,10,0,7,14,0,1,10,23,0.7946591351090206,[12.25939401]
2018,3,NCAAF_20180915_BYU@WISC,Wisconsin,Badgers,BYU,Cougars,2-1,2-1,1,14,14,21,24,7,7,0,7,7,7,7,3,0,0,-3,0.994553173307169,[37.9406228]
2018,3,NCAAF_20180915_CMICH@NILL,N. Illinois,,C. Michigan,,1-2,0-3,,14,3,24,16,0,14,7,3,0,3,7,6,1,11,8,0.6887980115715617,[7.33819331]
2018,3,NCAAF_20180915_DUKE@BAYLOR,Baylor,,Duke,,2-1,3-0,,0,23,27,40,0,0,13,14,7,16,7,10,-1,-23,-13,0.1957209863986311,[-12.77067604]
2018,3,NCAAF_20180915_LEH@NAVY,Navy,Midshipmen,Lehigh,Mountain Hawks,2-1,1-2,1,34,7,51,21,21,13,14,3,7,0,0,14,1,27,30,,
2018,3,NCAAF_20180915_LSU@AUBURN,Auburn,Tigers,LSU,Tigers,2-1,3-0,1,14,10,21,22,0,14,7,0,7,3,3,9,-1,4,-1,0.8330544086804765,[14.3994195]
2018,3,NCAAF_20180915_MIAOH@MINN,Minnesota,,Miami-OH,,3-0,0-3,,19,3,26,3,7,12,7,0,0,3,0,0,3,16,23,0.869431729187968,[16.74496387]
2018,3,NCAAF_20180915_SFLA@ILL,Illinois,,South Florida,,2-1,3-0,,16,7,19,25,10,6,3,0,7,0,0,18,-1,9,-6,0.11659319777610477,[-17.76544963]
2018,3,NCAAF_20180915_SMU@MICH,Michigan,Wolverines,SMU,Mustangs,2-1,0-3,1,21,7,45,20,0,21,14,10,0,7,6,7,2,14,25,0.8602059353437446,[16.11218809]
2018,3,NCAAF_20180915_COLOST@FLA,Florida,,Colorado St.,,2-1,1-3,,27,3,48,10,6,21,0,21,0,3,7,0,1,24,38,0.5605137292903772,[2.26908083]
2018,3,NCAAF_20180915_EKY@BGREEN,Bowling Green,,E. Kentucky,,1-2,1-2,,28,21,42,35,0,28,6,8,14,7,14,0,0,7,7,0.6083196055841509,[4.09705226]
2018,3,NCAAF_20180915_NTEXAS@ARK,Arkansas,,North Texas,,1-2,3-0,,10,34,17,44,0,10,0,7,17,17,3,7,-2,-24,-27,0.6872588958865746,[7.27336174]
2018,3,NCAAF_20180915_TXSA@KSTATE,Kansas State,,UTSA,,2-1,0-3,,27,7,41,17,10,17,14,0,7,0,0,10,2,20,24,0.9281457525615137,[21.78779268]
2018,3,NCAAF_20180915_WOFF@WYO,Wyoming,,Wofford,,2-2,2-1,,10,7,17,14,0,10,0,7,0,7,0,7,0,3,3,0.7570540769812641,[10.38423494]
2018,3,NCAAF_20180915_HOU@TXTECH,Texas Tech,,Houston,,2-1,2-1,,35,28,63,49,14,21,14,14,21,7,14,7,0,7,14,0.6106279311488092,[4.18666998]
2018,3,NCAAF_20180915_OHIO@UVA,Virginia,,Ohio,,2-1,1-1,,38,21,45,31,21,17,0,7,7,14,7,3,1,17,14,0.5609555827510141,[2.28577907]
2018,3,NCAAF_20180915_NH@COLO,Colorado,,New Hamp.,,3-0,0-3,,28,0,45,14,7,21,10,7,0,0,14,0,3,28,31,0.635022008472239,[5.14376548]
2018,3,NCAAF_20180915_SJST@OREG,Oregon,Ducks,San Jose St.,Spartans,3-0,0-3,1,21,6,35,22,14,7,7,7,0,6,6,10,3,15,13,0.9966828683702799,[40.45263421]
2018,3,NCAAF_20180915_BTHN@FAU,FAU,,Bethune-Cook.,,2-1,1-2,,36,14,49,28,29,7,7,6,0,14,7,7,1,22,21,0.9796265733955105,[30.48993936]
2018,3,NCAAF_20180915_EMICH@BUFF,Buffalo,,E. Michigan,,3-0,2-1,,28,21,35,28,14,14,0,7,0,21,0,7,1,7,7,0.46419602270654037,[-1.33917048]
2018,3,NCAAF_20180915_IDST@CAL,California,,Idaho State,,3-0,1-1,,28,3,45,23,7,21,3,14,0,3,6,14,2,25,22,0.957900490382654,[25.73231344]
2018,3,NCAAF_20180915_ALAM@CINCY,Cincinnati,,Alabama A&M,,3-0,1-2,,42,0,63,7,28,14,14,7,0,0,7,0,2,42,56,0.9968117796902813,[40.64787551]
2018,3,NCAAF_20180915_ARKST@TULSA,Tulsa,Golden Hurricane,Arkansas St.,Red Wolves,1-2,2-1,1,7,13,20,29,7,0,3,10,3,10,14,2,-1,-6,-9,0.4524345918331666,[-1.78092009]
2018,3,NCAAF_20180915_BAMA@MISS,Ole Miss,Rebels,Alabama,Crimson Tide,2-1,3-0,1,7,49,7,62,7,0,0,0,28,21,10,3,-1,-42,-55,0.015896306159556173,[-31.99367591]
2018,3,NCAAF_20180915_DEST@WMICH,W. Michigan,,Delaware St.,,1-2,0-3,,28,0,68,0,14,14,16,24,0,0,0,0,1,28,68,0.9955863035240692,[39.02211125]
2018,3,NCAAF_20180915_OREGST@NEVADA,Nevada,,Oregon State,,2-1,1-2,,30,21,37,35,16,14,0,7,7,14,0,14,1,9,2,0.6597977436909497,[6.1381005]
2018,3,NCAAF_20180915_TXSTSM@SALA,South Alabama,,Texas St.,,1-2,1-2,,16,24,41,31,3,13,7,18,17,7,7,0,0,-8,10,0.7573631223495951,[10.39895607]
2018,3,NCAAF_20180915_AKRON@NWEST,Northwestern,,Akron,,1-2,2-0,,21,3,34,39,7,14,7,6,0,3,23,13,-1,18,-5,0.9541493132693268,[25.13126107]
2018,3,NCAAF_20180915_LALAF@MISSST,Miss. State,Bulldogs,Louisiana,Ragin' Cajuns,3-0,1-1,1,35,3,56,10,14,21,14,7,3,0,0,7,2,32,46,0.9967368326269711,[40.53351993]
2018,3,NCAAF_20180915_LAMON@TXAM,Texas A&M,,UL-Monroe,,2-1,2-1,,24,10,48,10,7,17,10,14,3,7,0,0,0,14,38,0.9352991845063015,[22.59763527]
2018,3,NCAAF_20180915_MA@FIU,FIU,,UMass,,2-1,1-3,,42,10,63,24,14,28,14,7,7,3,14,0,1,32,39,0.5471250980866925,[1.7643566]
2018,3,NCAAF_20180915_MIZZOU@PURDUE,Purdue,,Missouri,,0-3,3-0,,24,27,37,40,7,17,3,10,13,14,10,3,-3,-3,-3,0.5770229286268895,[2.89511377]
2018,3,NCAAF_20180915_NOIOWA@IOWA,Iowa,,Northern Iowa,,3-0,0-2,,21,0,38,14,7,14,17,0,0,0,0,14,3,21,24,0.931046252982298,[22.10831149]
2018,3,NCAAF_20180915_WKY@LVILLE,Louisville,,W. Kentucky,,2-1,0-3,,3,14,20,17,0,3,3,14,7,7,0,3,2,-11,3,0.9820082253223527,[31.25016286]
2018,3,NCAAF_20180915_EWASH@WASHST,Washington St.,,E. Washington,,3-0,2-1,,28,10,59,24,14,14,7,24,0,10,14,0,1,18,35,0.998269617932703,[43.56516354]
2018,3,NCAAF_20180915_NMEX@NMEXST,New Mexico St.,,New Mexico,,0-4,2-1,,17,21,25,42,17,0,0,8,7,14,7,14,-2,-4,-17,0.44721362949091525,[-1.97749467]
2018,3,NCAAF_20180915_OHIOST@TCU,TCU,Horned Frogs,Ohio State,Buckeyes,2-1,3-0,1,14,13,28,40,7,7,14,0,10,3,20,7,-1,1,-12,0.23148150886432184,[-10.93736217]
2018,3,NCAAF_20180915_USC@TEXAS,Texas,Longhorns,USC,Trojans,2-1,1-2,1,16,14,37,14,3,13,21,0,14,0,0,0,1,2,23,0.5253772800921868,[0.94854646]
2018,3,NCAAF_20180915_PRARIE@UNLV,UNLV,,Prairie View,,2-1,1-3,,34,0,46,17,20,14,0,12,0,0,14,3,1,34,29,,
2018,3,NCAAF_20180915_WASH@UTAH,Utah,Utes,Washington,Huskies,2-0,1-1,1,7,14,7,21,7,0,0,0,7,7,7,0,1,-7,-14,0.16160388791608105,[-14.7210186]
2018,3,NCAAF_20180915_ARIZST@SDGST,San Diego St.,Aztecs,Arizona St.,Sun Devils,1-1,2-0,1,14,14,28,21,0,14,3,11,7,7,0,7,-1,0,7,0.4556031881101389,[-1.66177232]
2018,3,NCAAF_20180915_FRESNO@UCLA,UCLA,,Fresno St.,,0-3,2-1,,7,16,14,38,0,7,7,0,13,3,15,7,-2,-9,-24,0.507137964678194,[0.26663546]
2018,3,NCAAF_20180915_SUT@ARIZ,Arizona,,So. Utah,,1-2,0-3,,24,17,62,31,7,17,24,14,0,17,0,14,1,7,31,0.9991513189752357,[46.77042698]
2018,3,NCAAF_20180914_GAST@MEMP,Memphis,Tigers,Georgia St.,Panthers,2-1,1-2,1,38,10,59,22,21,17,7,14,3,7,6,6,1,28,37,0.9786211084932157,[30.19148565]
2018,3,NCAAF_20180913_ODU@CHARLO,Charlotte,49ers,Old Dominion,Monarchs,2-1,0-3,1,13,12,28,25,7,6,8,7,6,6,6,7,2,1,3,0.2894463891654313,[-8.27038129]
2018,3,NCAAF_20180913_BC@WAKE,Wake Forest,Demon Deacons,Boston College,Eagles,2-1,3-0,1,21,21,34,41,7,14,3,10,7,14,7,13,-1,0,-7,0.5274182621682311,[1.02494977]
2018,3,NCAAF_20180913_TNTECH@UTAHST,Utah St.,Aggies,Tenn. Tech,Golden Eagles,2-1,0-3,1,45,6,73,12,17,28,7,21,3,3,3,3,2,39,61,0.9987564588252287,[45.07571867]
2018,3,NCAAF_20180912_CSTCAR@CAMP,Campbell,,C. Carolina,,2-1,2-1,,21,24,21,58,14,7,0,0,7,17,21,13,0,-3,-37,,
2018,4,NCAAF_20180923_DUQ@HAWAII,Hawaii,,Duquesne,,4-1,3-2,,21,14,42,21,7,14,7,14,14,0,0,7,1,7,21,,
2018,4,NCAAF_20180922_AKRON@IOWAST,Iowa St.,,Akron,,1-2,2-1,,17,10,26,13,7,10,0,9,7,3,3,0,-1,7,13,0.9670124290464165,[27.60522122]
2018,4,NCAAF_20180922_BC@PURDUE,Purdue,Boilermakers,Boston College,Eagles,1-3,3-1,1,23,7,30,13,7,16,7,0,7,0,0,6,-2,16,17,0.445158794344953,[-2.07051045]
2018,4,NCAAF_20180922_BUFF@RUT,Rutgers,,Buffalo,,1-3,4-0,,6,35,13,42,3,3,0,7,14,21,0,7,-3,-29,-29,0.3552917678872429,[-5.57140216]
2018,4,NCAAF_20180922_KENTST@MISS,Ole Miss,,Kent St.,,3-1,1-3,,7,7,38,17,7,0,17,14,0,7,10,0,2,0,21,0.9432725262443967,[23.76546724]
2018,4,NCAAF_20180922_MINN@MD,Maryland,Terrapins,Minnesota,Golden Gophers,3-1,3-1,1,21,10,42,13,14,7,14,7,0,10,3,0,0,11,29,0.32162778465958075,[-6.95391039]
2018,4,NCAAF_20180922_NAVY@SMU,SMU,,Navy,,1-3,2-2,,10,7,31,30,7,3,7,14,0,7,7,16,-1,3,1,0.4308032369701825,[-2.61744016]
2018,4,NCAAF_20180922_ND@WAKE,Wake Forest,Demon Deacons,Notre Dame,Fighting Irish,2-2,4-0,1,13,28,27,56,3,10,7,7,7,21,21,7,-2,-15,-29,0.35314634241483,[-5.65799384]
2018,4,NCAAF_20180922_NEB@MICH,Michigan,Wolverines,Nebraska,Cornhuskers,3-1,0-3,1,39,0,56,10,20,19,10,7,0,0,3,7,3,39,46,0.9110381052133036,[20.22692412]
2018,4,NCAAF_20180922_NEVADA@TOLEDO,Toledo,Rockets,Nevada,Wolf Pack,2-1,2-2,1,35,24,63,44,14,21,14,14,7,17,14,6,0,11,19,0.8624133225624757,[16.38402242]
2018,4,NCAAF_20180922_OHIO@CINCY,Cincinnati,,Ohio,,4-0,1-2,,7,24,34,30,0,7,14,13,14,10,3,3,3,-17,4,0.2328780300045491,[-10.9514704]
2018,4,NCAAF_20180922_UGA@MIZZOU,Missouri,Tigers,Georgia,Bulldogs,3-1,4-0,1,7,20,29,43,7,0,15,7,7,13,13,10,-1,-13,-14,0.08732382606232114,[-20.3807486]
2018,4,NCAAF_20180922_PITT@UNC,North Carolina,Tar Heels,Pittsburgh,Panthers,1-2,2-2,1,21,28,38,35,7,14,17,0,7,21,0,7,-1,-7,3,0.2519474753750536,[-10.03518136]
2018,4,NCAAF_20180922_LVILLE@UVA,Virginia,,Louisville,,3-1,2-2,,6,0,27,3,0,6,7,14,0,0,3,0,1,6,24,0.29748594583303145,[-7.98228952]
2018,4,NCAAF_20180922_WMICH@GAST,Georgia St.,,W. Michigan,,1-3,2-2,,9,20,15,34,0,9,6,0,3,17,14,0,-1,-11,-19,0.1903492977818395,[-13.16170283]
2018,4,NCAAF_20180922_ILST@COLOST,Colorado St.,,Illinois St.,,1-4,3-0,,6,14,19,35,6,0,7,6,0,14,7,14,-2,-8,-16,,
2018,4,NCAAF_20180922_ME@CMICH,C. Michigan,,Maine,,1-3,2-1,,10,0,17,5,0,10,0,7,0,0,3,2,-1,10,12,0.843593284055791,[15.15449907]
2018,4,NCAAF_20180922_MIAOH@BGREEN,Bowling Green,,Miami-OH,,1-3,1-3,,3,24,23,38,0,3,0,20,7,17,7,7,0,-21,-15,0.35076394419574697,[-5.75437117]
2018,4,NCAAF_20180922_WKY@BALLST,Ball St.,,W. Kentucky,,1-3,1-3,,10,7,20,28,7,3,3,7,0,7,7,14,0,3,-8,0.1681003054651029,[-14.4392654]
2018,4,NCAAF_20180922_CHARLO@MA,UMass,,Charlotte,,2-3,2-2,,35,10,49,31,28,7,7,7,0,10,7,14,0,25,18,0.8100723179590104,[13.1850199]
2018,4,NCAAF_20180922_CLEM@GATECH,Georgia Tech,Yellow Jackets,Clemson,Tigers,1-3,4-0,1,7,28,21,49,0,7,7,7,7,21,14,7,-3,-21,-28,0.12699996940564962,[-17.12665194]
2018,4,NCAAF_20180922_FIU@MIAMI,Miami (Fla.),Hurricanes,FIU,Panthers,3-1,2-2,1,24,0,31,17,7,17,7,0,0,0,0,17,1,24,14,0.9658816603072162,[27.37772601]
2018,4,NCAAF_20180922_GRDWB@APLST,App. St.,,Gardner-Webb,,2-1,1-3,,52,7,72,7,28,24,14,6,7,0,0,0,1,45,65,0.9702829213745134,[28.30151771]
2018,4,NCAAF_20180922_KANSAS@BAYLOR,Baylor,,Kansas,,3-1,2-2,,23,0,26,7,7,16,3,0,0,0,7,0,1,23,19,0.7232222628780223,[8.89509678]
2018,4,NCAAF_20180922_KSTATE@WVU,West Virginia,Mountaineers,Kansas State,Wildcats,3-0,2-2,1,21,0,35,6,7,14,14,0,0,0,3,3,1,21,29,0.5226354204908592,[0.85234901]
2018,4,NCAAF_20180922_NCCEN@DUKE,Duke,,NC Central,,4-0,1-2,,27,13,55,13,20,7,21,7,7,6,0,0,3,14,42,0.9997921909412033,[53.]
2018,4,NCAAF_20180922_NILL@FSU,Florida State,,N. Illinois,,2-2,1-3,,20,7,37,19,14,6,3,14,0,7,6,6,1,13,18,0.6874242733928427,[7.33543527]
2018,4,NCAAF_20180922_TULANE@OHIOST,Ohio State,Buckeyes,Tulane,Green Wave,4-0,1-3,1,42,6,49,6,21,21,0,7,0,6,0,0,3,36,43,0.9893501634705982,[34.57242871]
2018,4,NCAAF_20180922_TXAM@BAMA,Alabama,Crimson Tide,Texas A&M,Aggies,4-0,2-2,1,31,13,45,23,14,17,14,0,7,6,3,7,2,18,22,0.95521168667633,[25.48884317]
2018,4,NCAAF_20180922_VATECH@ODU,Old Dominion,Monarchs,Virginia Tech,Hokies,1-3,2-1,1,14,14,49,35,7,7,7,28,7,7,14,7,-1,0,14,0.0023681787481270034,[-42.40702687]
2018,4,NCAAF_20180922_ARIZ@OREGST,Oregon State,,Arizona,,1-3,2-2,,7,14,14,35,7,0,0,7,7,7,7,14,-1,-7,-21,0.09411246705285303,[-19.75657218]
2018,4,NCAAF_20180922_SC@VANDY,Vanderbilt,Commodores,South Carolina,Gamecocks,2-2,2-1,1,14,20,14,37,0,14,0,0,10,10,10,7,0,-6,-23,0.238140149036714,[-10.69467107]
2018,4,NCAAF_20180922_UCONN@CUSE,Syracuse,,UConn,,4-0,1-3,,31,14,51,21,24,7,10,10,7,7,0,7,3,17,30,0.9031334570266734,[19.51283315]
2018,4,NCAAF_20180922_TCU@TEXAS,Texas,Longhorns,TCU,Horned Frogs,3-1,2-2,1,10,13,31,16,7,3,14,7,6,7,3,0,1,-3,15,0.3112277050676022,[-7.39265284]
2018,4,NCAAF_20180922_MCN@BYU,BYU,Cougars,McNeese St.,Cowboys,3-1,3-1,1,24,3,30,3,0,24,6,0,3,0,0,0,0,21,27,,
2018,4,NCAAF_20180922_NTEXAS@LIB,Liberty,,North Texas,,1-2,4-0,,7,21,7,47,0,7,0,0,14,7,6,20,-3,-14,-40,0.4268878863443669,[-2.76718446]
2018,4,NCAAF_20180922_CSTCAR@LALAF,Louisiana,,C. Carolina,,1-2,3-1,,7,16,28,30,7,0,14,7,3,13,7,7,-2,-9,-2,0.38702689593307915,[-4.31025827]
2018,4,NCAAF_20180922_FLA@TENN,Tennessee,Volunteers,Florida,Gators,2-2,3-1,1,3,26,21,47,0,3,10,8,14,12,7,14,-1,-23,-26,0.2576844161835342,[-9.76682775]
2018,4,NCAAF_20180922_LATECH@LSU,LSU,Tigers,Louisiana Tech,Bulldogs,4-0,2-1,1,24,7,38,21,7,17,0,14,0,7,7,7,2,17,17,0.9460915521366835,[24.14428417]
2018,4,NCAAF_20180922_MISSST@UK,Kentucky,Wildcats,Miss. State,Bulldogs,4-0,3-1,1,7,7,28,7,0,7,7,14,0,7,0,0,1,0,21,0.14239205993678872,[-16.05982875]
2018,4,NCAAF_20180922_NCST@MRSHL,Marshall,,NC State,,2-1,3-0,,7,23,20,37,0,7,13,0,3,20,14,0,-1,-16,-17,0.13079417037357088,[-16.85575257]
2018,4,NCAAF_20180922_RICE@USM,So. Miss,,Rice,,2-1,1-3,,24,15,40,22,10,14,10,6,8,7,0,7,1,9,18,0.8685143707869155,[16.80697187]
2018,4,NCAAF_20180922_TROY@LAMON,UL-Monroe,,Troy,,2-2,3-1,,7,35,27,35,7,0,7,13,7,28,0,0,-1,-28,-8,0.14722164441772767,[-15.74137652]
2018,4,NCAAF_20180922_TXSTSM@TXSA,UTSA,,Texas St.,,1-3,1-3,,17,7,25,21,14,3,0,8,7,0,7,7,0,10,4,0.8774254967433497,[17.44983899]
2018,4,NCAAF_20180922_TXTECH@OKLAST,Oklahoma State,Cowboys,Texas Tech,Red Raiders,3-1,3-1,1,17,24,17,41,10,7,0,0,7,17,10,7,0,-7,-24,0.7822954856184482,[11.71070855]
2018,4,NCAAF_20180922_UNLV@ARKST,Arkansas St.,,UNLV,,3-1,2-2,,13,7,27,20,6,7,6,8,7,0,13,0,1,6,7,0.6503691463333483,[5.8002922]
2018,4,NCAAF_20180922_ARK@AUBURN,Auburn,Tigers,Arkansas,Razorbacks,3-1,1-3,1,17,0,34,3,10,7,7,10,0,0,3,0,2,17,31,0.9846148251063195,[32.4313867]
2018,4,NCAAF_20180922_MICHST@IND,Indiana,Hoosiers,Michigan St.,Spartans,3-1,2-1,1,7,21,21,35,0,7,0,14,14,7,7,7,1,-14,-14,0.35625874791833323,[-5.53243448]
2018,4,NCAAF_20180922_NMEXST@UTEP,UTEP,,New Mexico St.,,0-4,1-4,,10,17,20,27,7,3,7,3,10,7,7,3,-1,-7,-7,0.15701209734321409,[-15.11662926]
2018,4,NCAAF_20180922_ECU@SFLA,South Florida,,East Carolina,,4-0,1-2,,13,10,20,13,6,7,0,7,7,3,3,0,3,3,7,0.9428777953121825,[23.71361636]
2018,4,NCAAF_20180922_SALA@MEMP,Memphis,,South Alabama,,3-1,1-3,,21,21,52,35,7,14,10,21,7,14,6,8,2,0,17,0.9828431985664409,[31.77581746]
2018,4,NCAAF_20180922_TXSO@HOU,Houston,,Texas Southern,,3-1,1-3,,42,0,70,14,14,28,7,21,0,0,7,7,2,42,56,0.9996939980757359,[51.4426427]
2018,4,NCAAF_20180922_WISC@IOWA,Iowa,Hawkeyes,Wisconsin,Badgers,3-1,3-1,1,7,7,17,28,0,7,10,0,0,7,7,14,0,0,-11,0.41020445076194334,[-3.40853778]
2018,4,NCAAF_20180922_AF@UTAHST,Utah St.,,Air Force,,3-1,1-2,,21,14,42,32,7,14,14,7,0,14,3,15,2,7,10,0.6919131660366485,[7.52638839]
2018,4,NCAAF_20180922_ARIZST@WASH,Washington,Huskies,Arizona St.,Sun Devils,3-1,2-2,1,17,10,27,20,14,3,3,7,10,0,3,7,1,7,7,0.8663684371619467,[16.65669924]
2018,4,NCAAF_20180921_FAU@UCF,UCF,Knights,FAU,Owls,3-0,2-2,1,21,17,56,36,14,7,21,14,7,10,6,13,1,4,20,0.8517168454185324,[15.672327]
2018,4,NCAAF_20180921_PSU@ILL,Illinois,Fighting Illini,Penn State,Nittany Lions,2-2,4-0,1,17,21,24,63,7,10,7,0,7,14,7,35,-2,-4,-39,0.003609460759596894,[-40.33707064]
2018,4,NCAAF_20180921_WASHST@USC,USC,Trojans,Washington St.,Cougars,2-2,3-1,1,17,24,39,36,7,10,7,15,3,21,6,6,-1,-7,3,0.5750455919722466,[2.84123191]
2018,4,NCAAF_20180920_TULSA@TEMPLE,Temple,Owls,Tulsa,Golden Hurricane,2-2,1-3,1,21,10,31,17,7,14,7,3,7,3,0,7,1,11,14,0.6161010397591811,[4.43307679]
2018,5,NCAAF_20180929_ARK@TXAM,Texas A&M,,Arkansas,,3-2,1-4,,17,7,24,17,14,3,0,7,0,7,3,7,2,10,7,0.8543280926136538,[15.91519452]
2018,5,NCAAF_20180929_ARMY@BUFF,Buffalo,Bulls,Army,Black Knights,4-1,3-2,1,7,21,13,42,7,0,6,0,7,14,7,14,1,-14,-29,0.45291487628964455,[-1.7843162]
2018,5,NCAAF_20180929_BGREEN@GATECH,Georgia Tech,,Bowling Green,,2-3,1-4,,28,10,63,17,14,14,21,14,3,7,7,0,1,18,46,0.9530301427191543,[25.2635101]
2018,5,NCAAF_20180929_CMICH@MICHST,Michigan St.,Spartans,C. Michigan,Chippewas,3-1,1-4,1,17,3,31,20,0,17,14,0,3,0,0,17,2,14,11,0.892135728776,[18.67217724]
2018,5,NCAAF_20180929_CUSE@CLEM,Clemson,Tigers,Syracuse,Orange,5-0,4-1,1,7,16,27,23,7,0,6,14,6,10,0,7,1,-9,4,0.9389124521146587,[23.31382809]
2018,5,NCAAF_20180929_IND@RUT,Rutgers,,Indiana,,1-4,4-1,,7,24,17,24,7,0,0,10,7,17,0,0,-3,-17,-7,0.13074091142651068,[-16.93657219]
2018,5,NCAAF_20180929_LALAF@BAMA,Alabama,Crimson Tide,Louisiana,Ragin' Cajuns,5-0,1-3,1,49,0,56,14,28,21,7,0,0,0,0,14,4,49,42,0.9999470894514436,[58.47418925]
2018,5,NCAAF_20180929_OKLAST@KANSAS,Kansas,Jayhawks,Oklahoma State,Cowboys,2-3,4-1,1,7,24,28,48,0,7,7,14,14,10,10,14,-2,-17,-20,0.01420134479678492,[-33.05697286]
2018,5,NCAAF_20180929_TEMPLE@BC,Boston College,,Temple,,4-1,2-3,,31,21,45,35,13,18,7,7,14,7,7,7,2,10,10,0.7854194293226863,[11.92499703]
2018,5,NCAAF_20180929_WVU@TXTECH,Texas Tech,Red Raiders,West Virginia,Mountaineers,3-2,4-0,1,10,35,34,42,7,3,7,17,28,7,0,7,-1,-25,-8,0.5848762675978327,[3.23354487]
2018,5,NCAAF_20180929_UVA@NCST,NC State,,Virginia,,4-0,3-2,,20,7,35,21,3,17,7,8,7,0,7,7,1,13,14,0.7072627652106386,[8.22632488]
2018,5,NCAAF_20180929_LAMON@GAST,Georgia St.,,UL-Monroe,,2-3,2-3,,30,14,46,14,14,16,6,10,7,7,0,0,0,16,32,0.4068539085531667,[-3.55422689]
2018,5,NCAAF_20180929_MA@OHIO,Ohio,,UMass,,2-2,2-4,,35,28,58,42,14,21,17,6,21,7,7,7,0,7,16,0.8392836053316794,[14.95500816]
2018,5,NCAAF_20180929_KENTST@BALLST,Ball St.,,Kent St.,,2-3,1-4,,35,17,52,24,21,14,7,10,7,10,7,0,1,18,28,0.37890959154112414,[-4.65076322]
2018,5,NCAAF_20180929_BAYLOR@OKLA,Oklahoma,Sooners,Baylor,Bears,5-0,3-2,1,28,9,66,33,14,14,21,17,6,3,14,10,2,19,33,0.9792913743418187,[30.75907829]
2018,5,NCAAF_20180929_CINCY@UCONN,UConn,Huskies,Cincinnati,Bearcats,1-4,5-0,1,7,21,7,49,7,0,0,0,7,14,21,7,-4,-14,-42,0.3119188239223226,[-7.39695788]
2018,5,NCAAF_20180929_CSTCAR@TROY,Troy,,C. Carolina,,4-1,3-2,,24,14,45,21,21,3,14,7,0,14,7,0,1,10,24,0.8997012076633419,[19.30391948]
2018,5,NCAAF_20180929_FSU@LVILLE,Louisville,,Florida State,,2-3,3-2,,21,7,24,28,7,14,3,0,7,0,7,14,-1,14,-4,0.5030783478310028,[0.11638528]
2018,5,NCAAF_20180929_ODU@ECU,East Carolina,,Old Dominion,,2-2,1-4,,21,20,37,35,14,7,7,9,14,6,7,8,1,1,2,0.6480788333403747,[5.73361338]
2018,5,NCAAF_20180929_PITT@UCF,UCF,Knights,Pittsburgh,Panthers,4-0,2-3,1,31,7,45,14,14,17,7,7,7,0,0,7,2,24,31,0.9007904105395086,[19.39769848]
2018,5,NCAAF_20180929_PURDUE@NEB,Nebraska,,Purdue,,0-4,2-3,,7,20,28,42,7,0,14,7,10,10,15,7,-2,-13,-14,0.15913689496613503,[-15.05295155]
2018,5,NCAAF_20180929_RICE@WAKE,Wake Forest,,Rice,,3-2,1-4,,42,3,56,24,21,21,14,0,0,3,14,7,2,39,32,0.9936990303329688,[37.62930083]
2018,5,NCAAF_20180929_SALA@APLST,App. St.,,South Alabama,,3-1,1-4,,42,7,52,7,21,21,3,7,7,0,0,0,2,35,45,0.8814999381561791,[17.835857]
2018,5,NCAAF_20180929_TENN@UGA,Georgia,Bulldogs,Tennessee,Volunteers,5-0,2-3,1,17,0,38,12,7,10,7,14,0,0,6,6,3,17,26,0.9934096224223893,[37.3883225]
2018,5,NCAAF_20180929_TEXAS@KSTATE,Kansas State,Wildcats,Texas,Longhorns,2-3,4-1,1,0,19,14,19,0,0,7,7,7,12,0,0,-2,-19,-5,0.23538192730526664,[-10.87837392]
2018,5,NCAAF_20180929_WMICH@MIAOH,Miami-OH,,W. Michigan,,1-4,3-2,,27,14,39,40,17,10,6,6,14,0,13,13,-2,13,-1,0.34830373580688745,[-5.8809016]
2018,5,NCAAF_20180929_NEVADA@AF,Air Force,,Nevada,,1-3,3-2,,7,21,25,28,0,7,10,8,7,14,7,0,-2,-14,-3,0.6473942872030255,[5.70580307]
2018,5,NCAAF_20180929_TNST@VANDY,Vanderbilt,,Tennessee St.,,3-2,2-1,,10,13,31,27,0,10,14,7,0,13,7,7,1,-3,4,0.7109029646287126,[8.38648731]
2018,5,NCAAF_20180929_USM@AUBURN,Auburn,Tigers,So. Miss,Golden Eagles,4-1,2-2,1,14,3,24,13,7,7,7,3,0,3,3,7,2,11,11,0.9915793314592469,[36.05055037]
2018,5,NCAAF_20180929_MICH@NWEST,Northwestern,Wildcats,Michigan,Wolverines,1-3,4-1,1,17,7,17,20,10,7,0,0,0,7,6,7,-3,10,-3,0.2613340160241926,[-9.64159303]
2018,5,NCAAF_20180929_ARKST@GAS,Ga. Southern,,Arkansas St.,,3-1,3-2,,7,3,28,21,0,7,7,14,0,3,11,7,0,4,7,0.1981102300237496,[-12.79622853]
2018,5,NCAAF_20180929_FLA@MISSST,Miss. State,Bulldogs,Florida,Gators,3-2,4-1,1,6,3,6,13,3,3,0,0,0,3,7,3,-1,3,-7,0.7424959030177283,[9.81989144]
2018,5,NCAAF_20180929_LIB@NMEX,New Mexico,,Liberty,,2-2,2-2,,10,42,43,52,7,3,13,20,21,21,0,10,0,-32,-9,0.7180136255832293,[8.70211547]
2018,5,NCAAF_20180929_UTAH@WASHST,Washington St.,,Utah,,4-1,2-2,,21,21,28,24,7,14,0,7,14,7,3,0,2,0,4,0.509090041232216,[0.34369997]
2018,5,NCAAF_20180929_BOISE@WYO,Wyoming,Cowboys,Boise St.,Broncos,2-3,3-1,1,0,24,14,34,0,0,7,7,7,17,3,7,-1,-24,-20,0.1575469390721791,[-15.1521886]
2018,5,NCAAF_20180929_CHARLO@UAB,UAB,,Charlotte,,3-1,2-3,,21,0,28,7,14,7,0,7,0,0,0,7,1,21,21,0.8448102957316983,[15.30053441]
2018,5,NCAAF_20180929_FAU@MTSU,Middle Tenn.,,FAU,,2-2,2-3,,10,21,25,24,0,10,7,8,14,7,3,0,0,-11,1,0.145936336465588,[-15.89776071]
2018,5,NCAAF_20180929_HOUBP@SMU,SMU,,Houston Christian,,2-3,1-3,,35,10,63,27,21,14,14,14,3,7,10,7,1,25,36,0.9962089088734573,[40.27342603]
2018,5,NCAAF_20180929_IOWAST@TCU,TCU,,Iowa St.,,3-2,1-3,,7,7,17,14,0,7,7,3,0,7,0,7,2,0,3,0.6088799000269064,[4.16893868]
2018,5,NCAAF_20180929_UTEP@TXSA,UTSA,,UTEP,,2-3,0-5,,24,7,30,21,7,17,0,6,7,0,7,7,2,17,9,0.9035800065314896,[19.64136473]
2018,5,NCAAF_20180929_VATECH@DUKE,Duke,Blue Devils,Virginia Tech,Hokies,4-1,3-1,1,7,17,14,31,7,0,0,7,3,14,7,7,1,-10,-17,0.32894299760759327,[-6.67923664]
2018,5,NCAAF_20180929_ARPB@FIU,FIU,,Ark.-Pine Bluff,,3-2,1-4,,38,3,55,9,17,21,17,0,3,0,3,3,2,35,46,0.9986982846152533,[45.41555026]
2018,5,NCAAF_20180929_LATECH@NTEXAS,North Texas,,Louisiana Tech,,4-1,3-1,,21,26,27,29,21,0,6,0,6,20,3,0,1,-5,-2,0.5803322095578485,[3.05796775]
2018,5,NCAAF_20180929_MRSHL@WKY,W. Kentucky,,Marshall,,1-4,3-1,,10,10,17,20,3,7,0,7,7,3,0,10,-2,0,-3,0.23852146652127493,[-10.72497867]
2018,5,NCAAF_20180929_OHIOST@PSU,Penn State,Nittany Lions,Ohio State,Buckeyes,4-1,5-0,1,13,7,26,27,3,10,0,13,0,7,7,13,-1,6,-1,0.5038347038353922,[0.14498216]
2018,5,NCAAF_20180929_SC@UK,Kentucky,Wildcats,South Carolina,Gamecocks,5-0,2-2,1,24,3,24,10,3,21,0,0,3,0,7,0,3,21,14,0.35854971575002303,[-5.46512452]
2018,5,NCAAF_20180929_STNFRD@ND,Notre Dame,Fighting Irish,Stanford,Cardinal,5-0,4-1,1,21,14,38,17,14,7,3,14,7,7,3,0,1,7,21,0.627189714102178,[4.89319897]
2018,5,NCAAF_20180929_BYU@WASH,Washington,Huskies,BYU,Cougars,4-1,3-2,1,21,0,35,7,7,14,14,0,0,0,0,7,1,21,28,0.9675950761422258,[27.85167465]
2018,5,NCAAF_20180929_MISS@LSU,LSU,Tigers,Ole Miss,Rebels,5-0,3-2,1,28,6,45,16,14,14,7,10,3,3,7,3,2,22,29,0.8240793581245784,[14.04257915]
2018,5,NCAAF_20180929_OREGST@ARIZST,Arizona St.,,Oregon State,,1-2,1-4,,31,17,52,24,10,21,7,14,0,17,7,0,0,14,28,0.9457724406037915,[24.21077726]
2018,5,NCAAF_20180929_OREG@CAL,California,Golden Bears,Oregon,Ducks,3-1,4-1,1,10,28,24,42,3,7,7,7,7,21,7,7,-1,-18,-18,0.3453590712061748,[-6.0012121]
2018,5,NCAAF_20180929_TOLEDO@FRESNO,Fresno St.,,Toledo,,3-1,2-2,,28,13,49,27,7,21,21,0,7,6,0,14,1,15,22,0.5057504483607105,[0.21741665]
2018,5,NCAAF_20180929_USC@ARIZ,Arizona,,USC,,2-3,3-2,,0,17,20,24,0,0,7,13,7,10,7,0,-1,-17,-4,0.27407891879471546,[-9.05765264]
2018,5,NCAAF_20180928_MEMP@TULANE,Tulane,Green Wave,Memphis,Tigers,2-3,3-2,1,17,7,40,24,14,3,7,16,7,0,7,10,-1,10,16,0.16740082973806392,[-14.54730855]
2018,5,NCAAF_20180928_UCLA@COLO,Colorado,Buffaloes,UCLA,Bruins,4-0,0-4,1,14,13,38,16,7,7,14,10,10,3,3,0,4,1,22,0.4231557686718901,[-2.92347813]
2018,5,NCAAF_20180927_UNC@MIAMI,Miami (Fla.),Hurricanes,North Carolina,Tar Heels,4-1,1-3,1,33,10,47,10,14,19,0,14,10,0,0,0,3,23,37,0.921002848721507,[21.2948461]
2018,6,NCAAF_20181007_WYO@HAWAII,Hawaii,,Wyoming,,6-1,2-4,,3,3,17,13,0,3,7,7,3,0,7,3,4,0,4,0.15989312970526504,[-14.93652553]
2018,6,NCAAF_20181006_BAMA@ARK,Arkansas,Razorbacks,Alabama,Crimson Tide,1-5,6-0,1,14,41,31,65,7,7,3,14,21,20,7,17,-5,-27,-34,0.004564856780690851,[-39.14161828]
2018,6,NCAAF_20181006_BUFF@CMICH,C. Michigan,Chippewas,Buffalo,Bulls,1-5,5-1,1,3,17,24,34,3,0,14,7,7,10,7,10,-4,-14,-10,0.45988842809022623,[-1.51204494]
2018,6,NCAAF_20181006_ECU@TEMPLE,Temple,,East Carolina,,3-3,2-3,,35,3,49,6,14,21,7,7,0,3,0,3,1,32,43,0.7859300502054896,[11.8960878]
2018,6,NCAAF_20181006_EMICH@WMICH,W. Michigan,,E. Michigan,,4-2,2-4,,14,10,27,24,7,7,0,13,0,10,7,7,2,4,3,0.4728920185398453,[-1.02092326]
2018,6,NCAAF_20181006_ILL@RUT,Rutgers,Scarlet Knights,Illinois,Fighting Illini,1-5,3-2,1,14,24,17,38,7,7,0,3,10,14,0,14,-2,-10,-21,0.43039891681688025,[-2.6326829]
2018,6,NCAAF_20181006_KANSAS@WVU,West Virginia,Mountaineers,Kansas,Jayhawks,5-0,2-4,1,21,7,38,22,14,7,7,10,7,0,7,8,3,14,16,0.9390942741794984,[23.22854413]
2018,6,NCAAF_20181006_MD@MICH,Michigan,Wolverines,Maryland,Terrapins,5-1,3-2,1,17,7,42,21,3,14,10,15,7,0,0,14,2,10,21,0.9091735625344742,[20.0527899]
2018,6,NCAAF_20181006_MIZZOU@SC,South Carolina,Gamecocks,Missouri,Tigers,3-2,3-2,1,14,23,37,35,7,7,17,6,14,9,0,12,0,-9,2,0.43301255916359305,[-2.53285892]
2018,6,NCAAF_20181006_NWEST@MICHST,Michigan St.,Spartans,Northwestern,Wildcats,3-2,2-3,1,6,14,19,29,3,3,13,0,7,7,8,7,1,-8,-10,0.5206745789208813,[0.77838152]
2018,6,NCAAF_20181006_TEXAS@OKLA,Oklahoma,Sooners,Texas,Longhorns,5-1,5-1,1,17,24,45,48,7,10,7,21,10,14,21,3,0,-7,-3,0.7853832464439638,[11.86794227]
2018,6,NCAAF_20181006_TULANE@CINCY,Cincinnati,,Tulane,,6-0,2-4,,24,14,37,21,3,21,6,7,7,7,0,7,4,10,16,0.337680110865199,[-6.28754347]
2018,6,NCAAF_20181006_BC@NCST,NC State,Wolfpack,Boston College,Eagles,5-0,4-2,1,21,3,28,23,7,14,7,0,3,0,7,13,1,18,5,0.5561727386119367,[2.12094589]
2018,6,NCAAF_20181006_NILL@BALLST,Ball St.,,N. Illinois,,2-4,3-3,,6,14,16,24,0,6,3,7,7,7,7,3,-1,-8,-8,0.04046017520775258,[-26.20348591]
2018,6,NCAAF_20181006_BGREEN@TOLEDO,Toledo,,Bowling Green,,3-2,1-5,,24,21,52,36,17,7,7,21,7,14,7,8,2,3,16,0.9282411992515851,[21.96146044]
2018,6,NCAAF_20181006_CLEM@WAKE,Wake Forest,Demon Deacons,Clemson,Tigers,3-3,6-0,1,0,28,3,63,0,0,3,0,7,21,21,14,-3,-28,-60,0.15167402862091883,[-15.45272092]
2018,6,NCAAF_20181006_FSU@MIAMI,Miami (Fla.),Hurricanes,Florida State,Seminoles,5-1,3-3,1,7,20,28,27,0,7,14,7,7,13,7,0,2,-13,1,0.7157797642267165,[8.56273817]
2018,6,NCAAF_20181006_IOWA@MINN,Minnesota,Golden Gophers,Iowa,Hawkeyes,3-2,4-1,1,17,28,31,48,7,10,7,7,14,14,10,10,-1,-11,-17,0.12700312373302736,[-17.12506907]
2018,6,NCAAF_20181006_IOWAST@OKLAST,Oklahoma State,Cowboys,Iowa St.,Cyclones,4-2,2-3,1,21,30,42,48,7,14,7,14,9,21,10,8,2,-9,-6,0.5809960886536933,[3.06932078]
2018,6,NCAAF_20181006_KSTATE@BAYLOR,Baylor,,Kansas State,,4-2,2-4,,12,14,37,34,3,9,8,17,7,7,0,20,2,-2,3,0.27398669864570147,[-9.01988679]
2018,6,NCAAF_20181006_LSU@FLA,Florida,Gators,LSU,Tigers,5-1,5-1,1,14,10,27,19,0,14,0,13,7,3,3,6,0,4,8,0.2987148289122833,[-7.92844217]
2018,6,NCAAF_20181006_MIAOH@AKRON,Akron,,Miami-OH,,2-2,2-4,,10,14,17,41,0,10,7,0,0,14,10,17,0,-4,-24,0.5525204054319216,[1.98221021]
2018,6,NCAAF_20181006_NAVY@AF,Air Force,Falcons,Navy,Midshipmen,2-3,2-3,1,14,7,35,7,0,14,14,7,0,7,0,0,0,7,28,0.20717744655582648,[-12.25453059]
2018,6,NCAAF_20181006_OHIO@KENTST,Kent St.,,Ohio,,1-5,3-2,,17,7,26,27,14,3,6,3,7,0,7,13,-2,10,-1,0.04665746817758909,[-25.19451328]
2018,6,NCAAF_20181006_SALA@GAS,Ga. Southern,,South Alabama,,4-1,1-5,,17,6,48,13,7,10,10,21,0,6,0,7,3,11,35,0.6108868431665905,[4.22816706]
2018,6,NCAAF_20181006_SDGST@BOISE,Boise St.,,San Diego St.,,3-2,4-1,,7,13,13,19,7,0,0,6,3,10,0,6,-1,-6,-6,0.6261426255675686,[4.82903633]
2018,6,NCAAF_20181006_SFLA@MA,UMass,,South Florida,,2-5,5-0,,14,20,42,58,7,7,14,14,10,10,28,10,-3,-6,-16,0.052517008462383385,[-24.33514438]
2018,6,NCAAF_20181006_ARIZST@COLO,Colorado,Buffaloes,Arizona St.,Sun Devils,5-0,3-3,1,14,14,28,21,7,7,14,0,7,7,7,0,2,0,7,0.34686807907765327,[-5.91202076]
2018,6,NCAAF_20181006_IND@OHIOST,Ohio State,Buckeyes,Indiana,Hoosiers,6-0,4-2,1,28,20,49,26,7,21,7,14,3,17,6,0,2,8,23,0.9647894121027918,[27.16164304]
2018,6,NCAAF_20181006_LAMON@MISS,Ole Miss,,UL-Monroe,,4-2,2-4,,49,7,70,21,21,28,14,7,0,7,7,7,2,42,49,0.8421726864992212,[15.06459234]
2018,6,NCAAF_20181006_NMEX@UNLV,UNLV,,New Mexico,,2-3,3-2,,0,29,14,50,0,0,0,14,0,29,7,14,-1,-29,-36,0.6170526708149945,[4.47014739]
2018,6,NCAAF_20181006_ODU@FAU,FAU,,Old Dominion,,3-3,1-5,,26,7,52,33,6,20,6,20,0,7,14,12,2,19,19,0.9447191717754239,[23.95606416]
2018,6,NCAAF_20181006_LALAF@TXSTSM,Texas St.,,Louisiana,,1-4,2-3,,0,28,27,42,0,0,13,14,7,21,7,7,-1,-28,-15,0.3663592555099888,[-5.1271588]
2018,6,NCAAF_20181006_SMU@UCF,UCF,Knights,SMU,Mustangs,5-0,2-4,1,27,10,48,20,21,6,7,14,3,7,3,7,3,17,28,0.9209786631922596,[21.19381959]
2018,6,NCAAF_20181006_TXSA@RICE,Rice,,UTSA,,1-5,3-3,,0,13,3,20,0,0,3,0,3,10,0,7,-2,-13,-17,0.18203720780342836,[-13.62635193]
2018,6,NCAAF_20181006_UAB@LATECH,Louisiana Tech,,UAB,,3-2,4-1,,7,7,7,28,7,0,0,0,0,7,7,14,-1,0,-21,0.6087984147382486,[4.14645739]
2018,6,NCAAF_20181006_UCONN@MEMP,Memphis,Tigers,UConn,Huskies,4-2,1-5,1,41,14,55,14,13,28,7,7,7,7,0,0,3,27,41,0.9700597859826051,[28.2498096]
2018,6,NCAAF_20181006_AUBURN@MISSST,Miss. State,Bulldogs,Auburn,Tigers,4-2,4-2,1,13,3,23,9,3,10,3,7,3,0,3,3,0,10,14,0.2526065836364513,[-10.00339706]
2018,6,NCAAF_20181006_NEB@WISC,Wisconsin,Badgers,Nebraska,Cornhuskers,4-1,0-5,1,20,3,41,24,3,17,14,7,0,3,14,7,4,17,17,0.9706231311878418,[28.37529799]
2018,6,NCAAF_20181006_NTEXAS@UTEP,UTEP,,North Texas,,0-6,5-1,,10,10,24,27,3,7,0,14,7,3,10,7,-5,0,-3,0.043382721576620153,[-25.71318302]
2018,6,NCAAF_20181006_VANDY@UGA,Georgia,Bulldogs,Vanderbilt,Commodores,6-0,3-3,1,21,6,41,13,7,14,17,3,3,3,0,7,3,15,28,0.9856809629445967,[32.85523925]
2018,6,NCAAF_20181006_WASH@UCLA,UCLA,Bruins,Washington,Huskies,0-5,5-1,1,7,24,24,31,0,7,3,14,7,17,0,7,-5,-17,-7,0.07832248279590515,[-21.26529406]
2018,6,NCAAF_20181006_LIB@NMEXST,New Mexico St.,,Liberty,,2-4,2-3,,21,14,49,41,7,14,14,14,7,7,14,13,0,7,8,0.49380059403160204,[-0.23330759]
2018,6,NCAAF_20181006_ND@VATECH,Virginia Tech,Hokies,Notre Dame,Fighting Irish,3-2,6-0,1,16,17,23,45,3,13,0,7,10,7,14,14,-3,-1,-22,0.39561737048146506,[-3.97409041]
2018,6,NCAAF_20181006_WASHST@OREGST,Oregon State,,Washington St.,,1-5,5-1,,24,28,37,56,14,10,6,7,14,14,7,21,-4,-4,-19,0.03919904705160526,[-26.42397656]
2018,6,NCAAF_20181006_CAL@ARIZ,Arizona,,California,,3-3,3-2,,10,14,24,17,10,0,7,7,0,14,0,3,0,-4,7,0.5571718362310376,[2.15892818]
2018,6,NCAAF_20181006_COLOST@SJST,San Jose St.,Spartans,Colorado St.,Rams,0-5,2-4,1,0,28,30,42,0,0,30,0,14,14,0,14,-2,-28,-12,0.053619998278861436,[-24.18200869]
2018,6,NCAAF_20181006_FRESNO@NEVADA,Nevada,,Fresno St.,,3-3,4-1,,3,7,3,21,0,3,0,0,0,7,7,7,-1,-4,-18,0.1182960263102133,[-17.76876451]
2018,6,NCAAF_20181006_UTAH@STNFRD,Stanford,Cardinal,Utah,Utes,4-2,3-2,1,7,24,21,40,0,7,14,0,7,17,3,13,1,-17,-19,0.6781904824208691,[6.94574763]
2018,6,NCAAF_20181005_GATECH@LVILLE,Louisville,Cardinals,Georgia Tech,Yellow Jackets,2-4,3-3,1,17,31,31,66,0,17,0,14,21,10,14,21,-1,-14,-35,0.4856886089510065,[-0.5386868]
2018,6,NCAAF_20181005_MTSU@MRSHL,Marshall,Thundering Herd,Middle Tenn.,Blue Raiders,3-2,3-2,1,17,10,24,34,3,14,0,7,3,7,14,10,0,7,-10,0.6104638184310252,[4.2116062]
2018,6,NCAAF_20181005_UTAHST@BYU,BYU,Cougars,Utah St.,Aggies,3-3,4-1,1,7,21,20,45,0,7,6,7,14,7,14,10,-1,-14,-25,0.28530291380282435,[-8.51484165]
2018,6,NCAAF_20181004_GAST@TROY,Troy,Trojans,Georgia St.,Panthers,5-1,2-4,1,23,3,37,20,14,9,0,14,0,3,3,14,3,20,17,0.8536425352709165,[15.79658664]
2018,6,NCAAF_20181004_TULSA@HOU,Houston,Cougars,Tulsa,Golden Hurricane,4-1,1-4,1,17,13,41,26,7,10,0,24,13,0,10,3,3,4,15,0.8323857046637719,[14.4671926]
2018,7,NCAAF_20181013_AKRON@BUFF,Buffalo,Bulls,Akron,Zips,6-1,2-3,1,10,6,24,6,7,3,7,7,3,3,0,0,4,4,18,0.6555733802871803,[6.06499048]
2018,7,NCAAF_20181013_FLA@VANDY,Vanderbilt,Commodores,Florida,Gators,3-4,6-1,1,21,13,27,37,7,14,0,6,0,13,7,17,-3,8,-10,0.2542650080644443,[-10.01403334]
2018,7,NCAAF_20181013_IOWA@IND,Indiana,,Iowa,,4-3,5-1,,10,21,16,42,3,7,6,0,14,7,14,7,-1,-11,-26,0.17310194088590647,[-14.26803095]
2018,7,NCAAF_20181013_MINN@OHIOST,Ohio State,Buckeyes,Minnesota,Golden Gophers,7-0,3-3,1,17,14,30,14,10,7,3,10,7,7,0,0,4,3,16,0.9708869583413157,[28.68807341]
2018,7,NCAAF_20181013_OKLAST@KSTATE,Kansas State,Wildcats,Oklahoma State,Cowboys,3-4,4-3,1,3,6,31,12,0,3,14,14,3,3,0,6,-1,-3,19,0.19270072969948626,[-13.14729703]
2018,7,NCAAF_20181013_RUT@MD,Maryland,,Rutgers,,4-2,1-6,,24,0,34,7,10,14,10,0,0,0,0,7,3,24,27,0.7811944203207211,[11.75751703]
2018,7,NCAAF_20181013_TENN@AUBURN,Auburn,Tigers,Tennessee,Volunteers,4-3,3-3,1,17,13,24,30,10,7,0,7,3,10,14,3,1,4,-6,0.9693865169689699,[28.35273542]
2018,7,NCAAF_20181013_TOLEDO@EMICH,E. Michigan,,Toledo,,3-4,3-3,,28,3,28,26,21,7,0,0,3,0,3,20,0,25,2,0.3343213128144724,[-6.48304254]
2018,7,NCAAF_20181013_DUKE@GATECH,Georgia Tech,,Duke,,3-4,5-1,,7,7,14,28,0,7,0,7,7,0,21,0,-2,0,-14,0.5852814217170985,[3.26299436]
2018,7,NCAAF_20181013_LVILLE@BC,Boston College,,Louisville,,5-2,2-5,,24,20,38,20,14,10,0,14,13,7,0,0,3,4,18,0.5822610340047361,[3.14572212]
2018,7,NCAAF_20181013_UAB@RICE,Rice,,UAB,,1-6,5-1,,0,28,0,42,0,0,0,0,14,14,14,0,-4,-28,-42,0.14598099634885542,[-15.96219852]
2018,7,NCAAF_20181013_TROY@LIB,Liberty,,Troy,,3-3,5-2,,14,10,22,16,0,14,0,8,7,3,3,3,-2,4,6,0.1118159140624787,[-18.43265708]
2018,7,NCAAF_20181013_USM@NTEXAS,North Texas,,So. Miss,,6-1,2-3,,10,7,30,7,0,10,6,14,0,7,0,0,4,3,23,0.5529286137950191,[2.01550468]
2018,7,NCAAF_20181013_KENTST@MIAOH,Miami-OH,,Kent St.,,3-4,1-6,,21,0,31,6,0,21,10,0,0,0,0,6,2,21,25,0.8607623881203006,[16.41544906]
2018,7,NCAAF_20181013_PITT@ND,Notre Dame,Fighting Irish,Pittsburgh,Panthers,7-0,3-4,1,6,7,19,14,0,6,6,7,7,0,7,0,4,-1,5,0.8845659507523289,[18.14786896]
2018,7,NCAAF_20181013_BALLST@CMICH,C. Michigan,,Ball St.,,1-6,3-4,,20,7,23,24,3,17,0,3,0,7,0,17,-2,13,-1,0.8952566159026287,[19.00900369]
2018,7,NCAAF_20181013_WMICH@BGREEN,Bowling Green,,W. Michigan,,1-6,5-2,,21,7,35,42,7,14,7,7,0,7,21,14,-4,14,-7,0.18374787759255573,[-13.64997854]
2018,7,NCAAF_20181013_ARMY@SJST,San Jose St.,,Army,,0-6,4-2,,3,14,3,52,3,0,0,0,0,14,24,14,-4,-11,-49,0.0236010906026769,[-30.05870956]
2018,7,NCAAF_20181013_BAYLOR@TEXAS,Texas,Longhorns,Baylor,Bears,6-1,4-3,1,23,10,23,17,3,20,0,0,7,3,7,0,2,13,6,0.9012319711079657,[19.51832211]
2018,7,NCAAF_20181013_MICHST@PSU,Penn State,Nittany Lions,Michigan St.,Spartans,4-2,4-2,1,14,7,17,21,7,7,0,3,0,7,7,7,0,7,-4,0.9158383092381532,[20.8665143]
2018,7,NCAAF_20181013_MRSHL@ODU,Old Dominion,,Marshall,,1-6,4-2,,3,14,20,42,0,3,7,10,0,14,7,21,-3,-11,-22,0.17927395902469856,[-13.90689114]
2018,7,NCAAF_20181013_OHIO@NILL,N. Illinois,,Ohio,,4-3,3-3,,9,7,24,21,3,6,0,15,0,7,14,0,1,2,3,0.5382021042525974,[1.45266621]
2018,7,NCAAF_20181013_PURDUE@ILL,Illinois,,Purdue,,3-3,3-3,,7,29,7,46,7,0,0,0,14,15,7,10,0,-22,-39,0.1214366008376686,[-17.68906451]
2018,7,NCAAF_20181013_TEMPLE@NAVY,Navy,Midshipmen,Temple,Owls,2-4,4-3,1,10,7,17,24,0,10,7,0,0,7,10,7,-2,3,-7,0.5503953724502393,[1.91850897]
2018,7,NCAAF_20181013_TXAM@SC,South Carolina,Gamecocks,Texas A&M,Aggies,3-3,5-2,1,0,13,23,26,0,0,16,7,3,10,3,10,-2,-13,-3,0.49767792207241845,[-0.08816423]
2018,7,NCAAF_20181013_UCF@MEMP,Memphis,Tigers,UCF,Knights,4-3,6-0,1,30,17,30,31,17,13,0,0,7,10,7,7,-2,13,-1,0.17383051268241534,[-14.22497985]
2018,7,NCAAF_20181013_UGA@LSU,LSU,Tigers,Georgia,Bulldogs,6-1,6-1,1,16,0,36,16,3,13,3,17,0,0,9,7,0,16,20,0.13951834004204233,[-16.3962869]
2018,7,NCAAF_20181013_WKY@CHARLO,Charlotte,,W. Kentucky,,3-3,1-5,,9,7,40,14,6,3,21,10,7,0,0,7,2,2,26,0.15444905922742025,[-15.41251112]
2018,7,NCAAF_20181013_NMEX@COLOST,Colorado St.,,New Mexico,,3-4,3-3,,14,3,20,18,7,7,3,3,0,3,8,7,0,11,2,0.7038469784657599,[8.11111439]
2018,7,NCAAF_20181013_UNLV@UTAHST,Utah St.,,UNLV,,5-1,2-4,,42,7,59,28,14,28,7,10,7,0,7,14,3,35,31,0.834949381675076,[14.7517003]
2018,7,NCAAF_20181013_ALST@SALA,South Alabama,,Alabama St.,,2-5,2-4,,28,7,45,7,7,21,10,7,0,7,0,0,0,21,38,0.6801810224252858,[7.09184712]
2018,7,NCAAF_20181013_NMEXST@LALAF,Louisiana,,New Mexico St.,,3-3,2-5,,45,21,66,38,28,17,7,14,14,7,10,7,1,24,28,0.35999560880166115,[-5.42971109]
2018,7,NCAAF_20181013_LAMON@CSTCAR,C. Carolina,,UL-Monroe,,3-3,3-4,,13,24,20,45,3,10,7,0,14,10,7,14,0,-11,-25,0.499918171110052,[-0.00310685]
2018,7,NCAAF_20181013_HOU@ECU,East Carolina,Pirates,Houston,Cougars,2-4,5-1,1,3,21,20,42,0,3,3,14,14,7,7,14,-3,-18,-22,0.08071121750065613,[-21.21023383]
2018,7,NCAAF_20181013_LATECH@TXSA,UTSA,,Louisiana Tech,,3-4,4-2,,0,17,3,31,0,0,3,0,7,10,7,7,-1,-17,-28,0.43046659897486617,[-2.65352732]
2018,7,NCAAF_20181013_MIAMI@UVA,Virginia,Cavaliers,Miami (Fla.),Hurricanes,4-2,5-2,1,13,6,16,13,0,13,0,3,0,6,0,7,-1,7,3,0.1727823073366621,[-14.28695442]
2018,7,NCAAF_20181013_MIZZOU@BAMA,Alabama,Crimson Tide,Missouri,Tigers,7-0,3-3,1,30,10,39,10,13,17,2,7,10,0,0,0,4,20,29,0.9314810657518666,[22.52209237]
2018,7,NCAAF_20181013_UCLA@CAL,California,,UCLA,,3-3,1-5,,0,13,7,37,0,0,7,0,7,6,7,17,2,-13,-30,0.4821493354007691,[-0.67797329]
2018,7,NCAAF_20181013_VATECH@UNC,North Carolina,,Virginia Tech,,1-4,4-2,,9,7,19,22,6,3,7,3,7,0,7,8,-3,2,-3,0.08556840312563896,[-20.72942018]
2018,7,NCAAF_20181013_WVU@IOWAST,Iowa St.,Cyclones,West Virginia,Mountaineers,3-3,5-1,1,20,14,30,14,13,7,0,10,7,7,0,0,-2,6,16,0.6507253368315311,[5.86607664]
2018,7,NCAAF_20181013_MISS@ARK,Arkansas,Razorbacks,Ole Miss,Rebels,1-6,5-2,1,27,17,33,37,17,10,6,0,3,14,7,13,-4,10,-4,0.3425882840309087,[-6.14068935]
2018,7,NCAAF_20181013_MTSU@FIU,FIU,,Middle Tenn.,,4-2,3-3,,13,14,24,21,3,10,0,11,0,14,7,0,1,-1,3,0.4832556701588735,[-0.63592887]
2018,7,NCAAF_20181013_WISC@MICH,Michigan,Wolverines,Wisconsin,Badgers,6-1,4-2,1,13,7,38,13,0,13,8,17,0,7,0,6,2,6,25,0.4022522630067925,[-3.74918165]
2018,7,NCAAF_20181013_HAWAII@BYU,BYU,,Hawaii,,4-3,6-2,,28,3,49,23,14,14,7,14,0,3,14,6,-2,25,26,0.7507092514378099,[10.25024926]
2018,7,NCAAF_20181013_BOISE@NEVADA,Nevada,Wolf Pack,Boise St.,Broncos,3-4,4-2,1,17,17,27,31,10,7,10,0,7,10,14,0,-1,0,-4,0.08006935289403261,[-21.27539044]
2018,7,NCAAF_20181013_COLO@USC,USC,Trojans,Colorado,Buffaloes,4-2,5-1,1,21,7,31,20,0,21,7,3,0,7,0,13,-1,14,11,0.7321326076487807,[9.38009561]
2018,7,NCAAF_20181013_WYO@FRESNO,Fresno St.,,Wyoming,,5-1,2-5,,13,3,27,3,6,7,14,0,3,0,0,0,3,10,24,0.7875172848800875,[12.08473452]
2018,7,NCAAF_20181012_SFLA@TULSA,Tulsa,Golden Hurricane,South Florida,Bulls,1-5,6-0,1,10,3,24,25,7,3,14,0,3,0,7,15,-5,7,-1,0.13469773778851624,[-16.72906218]
2018,7,NCAAF_20181012_AF@SDGST,San Diego St.,Aztecs,Air Force,Falcons,5-1,2-4,1,14,9,21,17,7,7,0,7,2,7,0,8,3,5,4,0.7650802431071189,[10.94726103]
2018,7,NCAAF_20181012_ARIZ@UTAH,Utah,Utes,Arizona,Wildcats,4-2,3-4,1,28,0,42,10,14,14,7,7,0,0,3,7,1,28,32,0.6460351830130381,[5.67459936]
2018,7,NCAAF_20181011_GAS@TXSTSM,Texas St.,Bobcats,Ga. Southern,Eagles,1-5,5-1,1,0,10,13,15,0,0,7,6,0,10,5,0,-4,-10,-2,0.15616963119159222,[-15.30328521]
2018,7,NCAAF_20181011_TXTECH@TCU,TCU,Horned Frogs,Texas Tech,Red Raiders,3-3,4-2,1,7,3,14,17,0,7,0,7,3,0,7,7,-1,4,-3,0.6847344382673974,[7.28533892]
2018,7,NCAAF_20181009_APLST@ARKST,Arkansas St.,Red Wolves,App. St.,Mountaineers,3-3,4-1,1,9,21,9,35,3,6,0,0,0,21,7,7,-1,-12,-26,0.31078207736769903,[-7.47702767]
2018,8,NCAAF_20181021_NEVADA@HAWAII,Hawaii,,Nevada,,6-3,4-4,,14,20,22,40,14,0,0,8,10,10,7,13,2,-6,-18,0.28048340402321636,[-8.89726869]
2018,8,NCAAF_20181020_AUBURN@MISS,Ole Miss,Rebels,Auburn,Tigers,5-3,5-3,1,6,10,16,31,3,3,3,7,7,3,21,0,0,-4,-15,0.0944405813728868,[-20.10657865]
2018,8,NCAAF_20181020_BUFF@TOLEDO,Toledo,,Buffalo,,3-4,7-1,,17,7,17,31,7,10,0,0,0,7,10,14,-4,10,-14,0.6113280230070285,[4.32741858]
2018,8,NCAAF_20181020_ILL@WISC,Wisconsin,Badgers,Illinois,Fighting Illini,5-2,3-4,1,28,10,49,20,14,14,14,7,0,10,7,3,2,18,29,0.9800483295854125,[31.44385131]
2018,8,NCAAF_20181020_MD@IOWA,Iowa,Hawkeyes,Maryland,Terrapins,6-1,4-3,1,13,0,23,0,3,10,10,0,0,0,0,0,2,13,23,0.8971444608243635,[19.36516318]
2018,8,NCAAF_20181020_MICH@MICHST,Michigan St.,Spartans,Michigan,Wolverines,4-3,7-1,1,0,7,7,21,0,0,7,0,0,7,7,7,-3,-7,-14,0.2660322193450714,[-9.56221029]
2018,8,NCAAF_20181020_NWEST@RUT,Rutgers,,Northwestern,,1-7,4-3,,12,7,15,18,0,12,3,0,7,0,3,8,-3,5,-3,0.05231273102810685,[-24.83422056]
2018,8,NCAAF_20181020_OKLA@TCU,TCU,Horned Frogs,Oklahoma,Sooners,3-4,6-1,1,24,28,27,52,7,17,3,0,14,14,10,14,-3,-4,-25,0.3099242959059155,[-7.59129174]
2018,8,NCAAF_20181020_TULSA@ARK,Arkansas,,Tulsa,,2-6,1-6,,10,0,23,0,0,10,10,3,0,0,0,0,1,10,23,0.5304556684781109,[1.16938553]
2018,8,NCAAF_20181020_UVA@DUKE,Duke,Blue Devils,Virginia,Cavaliers,5-2,5-2,1,0,14,14,28,0,0,7,7,7,7,6,8,0,-14,-14,0.6495305061978943,[5.87717441]
2018,8,NCAAF_20181020_BGREEN@OHIO,Ohio,,Bowling Green,,4-3,1-7,,35,14,49,14,14,21,7,7,7,7,0,0,3,21,35,0.8417455146569406,[15.32838691]
2018,8,NCAAF_20181020_IDST@LIB,Liberty,,Idaho State,,4-3,4-3,,20,17,48,41,7,13,14,14,0,17,14,10,0,3,7,0.702892722491498,[8.15250915]
2018,8,NCAAF_20181020_FAU@MRSHL,Marshall,,FAU,,5-2,3-4,,10,7,31,7,0,10,14,7,0,7,0,0,2,3,24,0.26338522606158044,[-9.68594907]
2018,8,NCAAF_20181020_UTAHST@WYO,Wyoming,,Utah St.,,2-6,6-1,,3,10,16,24,3,0,10,3,7,3,14,0,-4,-7,-8,0.25988570944279665,[-9.85052024]
2018,8,NCAAF_20181020_CHARLO@MTSU,Middle Tenn.,,Charlotte,,4-3,3-4,,14,6,21,13,0,14,0,7,6,0,0,7,1,8,8,0.896852179944652,[19.34022011]
2018,8,NCAAF_20181020_EMICH@BALLST,Ball St.,,E. Michigan,,3-5,4-4,,6,21,20,42,0,6,7,7,7,14,14,7,-1,-15,-22,0.08232361342015881,[-21.26523516]
2018,8,NCAAF_20181020_WMICH@CMICH,C. Michigan,,W. Michigan,,1-7,6-2,,0,21,10,35,0,0,10,0,7,14,0,14,-5,-21,-25,0.4477727086231854,[-2.00914287]
2018,8,NCAAF_20181020_BAMA@TENN,Tennessee,Volunteers,Alabama,Crimson Tide,3-4,8-0,1,14,42,21,58,0,14,7,0,28,14,16,0,-5,-28,-37,0.007987253804704886,[-36.87258763]
2018,8,NCAAF_20181020_COLO@WASH,Washington,Huskies,Colorado,Buffaloes,6-2,5-2,1,14,13,27,13,0,14,3,10,7,6,0,0,1,1,14,0.8979966397162262,[19.4381829]
2018,8,NCAAF_20181020_CSTCAR@MA,UMass,,C. Carolina,,2-6,4-3,,6,3,13,24,3,3,7,0,3,0,14,7,-2,3,-11,0.6629668690454704,[6.43605066]
2018,8,NCAAF_20181020_HOU@NAVY,Navy,Midshipmen,Houston,Cougars,2-5,6-1,1,24,21,36,49,10,14,0,12,7,14,14,14,-4,3,-13,0.408769097606989,[-3.53059734]
2018,8,NCAAF_20181020_KANSAS@TXTECH,Texas Tech,Red Raiders,Kansas,Jayhawks,5-2,2-5,1,24,3,48,16,3,21,3,21,3,0,6,7,3,21,32,0.9496924323648671,[25.12570325]
2018,8,NCAAF_20181020_LALAF@APLST,App. St.,,Louisiana,,5-1,3-4,,17,10,27,17,7,10,7,3,7,3,0,7,2,7,10,0.9322785564105907,[22.84707558]
2018,8,NCAAF_20181020_MINN@NEB,Nebraska,,Minnesota,,1-6,3-4,,28,8,53,28,14,14,8,17,0,8,14,6,-2,20,25,0.30513387577193374,[-7.79981609]
2018,8,NCAAF_20181020_NCST@CLEM,Clemson,Tigers,NC State,Wolfpack,7-0,5-1,1,24,0,41,7,14,10,7,10,0,0,0,7,2,24,34,0.8391990875992132,[15.16791788]
2018,8,NCAAF_20181020_PSU@IND,Indiana,Hoosiers,Penn State,Nittany Lions,4-4,5-2,1,14,17,28,33,14,0,7,7,7,10,9,7,-1,-3,-5,0.04510523318016357,[-25.92773143]
2018,8,NCAAF_20181020_SMU@TULANE,Tulane,,SMU,,2-5,3-4,,9,7,23,27,2,7,7,7,0,7,7,13,-1,2,-4,0.4248174727121887,[-2.90121126]
2018,8,NCAAF_20181020_UTEP@LATECH,Louisiana Tech,,UTEP,,5-2,0-7,,17,7,31,24,14,3,7,7,7,0,14,3,5,10,7,0.9225271052088441,[21.76513669]
2018,8,NCAAF_20181020_WAKE@FSU,Florida State,,Wake Forest,,4-3,3-4,,21,10,38,17,7,14,10,7,10,0,0,7,1,11,21,0.5346072258862449,[1.3291673]
2018,8,NCAAF_20181020_CAL@OREGST,Oregon State,,California,,1-6,4-3,,0,21,7,49,0,0,7,0,7,14,7,21,-3,-21,-42,0.14009787291275688,[-16.5254209]
2018,8,NCAAF_20181020_MEMP@MIZZOU,Missouri,Tigers,Memphis,Tigers,4-3,4-4,1,48,20,65,33,21,27,14,3,3,17,7,6,0,28,32,0.489000755263176,[-0.42197331]
2018,8,NCAAF_20181020_GAS@NMEXST,New Mexico St.,,Ga. Southern,,2-6,6-1,,17,24,31,48,14,3,7,7,10,14,21,3,-4,-7,-17,0.4115538757764009,[-3.42098464]
2018,8,NCAAF_20181020_MISSST@LSU,LSU,Tigers,Miss. State,Bulldogs,7-1,4-3,1,10,3,19,3,7,3,6,3,3,0,0,0,3,7,16,0.5073451440210286,[0.28176817]
2018,8,NCAAF_20181020_TXSA@USM,So. Miss,,UTSA,,3-3,3-5,,20,3,27,17,6,14,7,0,0,3,7,7,0,17,10,0.600326477717413,[3.88990894]
2018,8,NCAAF_20181020_TXSTSM@LAMON,UL-Monroe,,Texas St.,,4-4,1-6,,17,7,20,14,7,10,3,0,7,0,0,7,3,10,6,0.7504005919793453,[10.34102945]
2018,8,NCAAF_20181020_UCF@ECU,East Carolina,Pirates,UCF,Knights,2-5,7-0,1,3,20,10,37,3,0,7,0,0,20,3,14,-5,-17,-27,0.006478740959813933,[-38.02702138]
2018,8,NCAAF_20181020_UCONN@SFLA,South Florida,Bulls,UConn,Huskies,7-0,1-6,1,7,7,38,30,0,7,17,14,7,0,7,16,6,0,8,0.9607557307109182,[26.92603172]
2018,8,NCAAF_20181020_FRESNO@NMEX,New Mexico,,Fresno St.,,3-4,6-1,,7,24,7,38,0,7,0,0,10,14,14,0,-3,-17,-31,0.10980454141853968,[-18.7855016]
2018,8,NCAAF_20181020_NTEXAS@UAB,UAB,,North Texas,,6-1,6-2,,10,21,29,21,3,7,9,10,7,14,0,0,0,-11,8,0.40043686110626253,[-3.85967419]
2018,8,NCAAF_20181020_ODU@WKY,W. Kentucky,,Old Dominion,,1-6,2-6,,24,17,34,37,7,17,3,7,14,3,2,18,-1,7,-3,0.5733555054956723,[2.82988898]
2018,8,NCAAF_20181020_OHIOST@PURDUE,Purdue,Boilermakers,Ohio State,Buckeyes,4-3,7-1,1,14,3,49,20,7,7,7,28,0,3,3,14,-3,11,29,0.10576374747311856,[-19.11922954]
2018,8,NCAAF_20181020_OREG@WASHST,Washington St.,Cougars,Oregon,Ducks,6-1,5-2,1,27,0,34,20,7,20,0,7,0,0,17,3,1,27,14,0.5008316142129525,[0.0318999]
2018,8,NCAAF_20181020_RICE@FIU,FIU,,Rice,,5-2,1-7,,16,10,36,17,0,16,10,10,7,3,7,0,4,6,19,0.9145641945312134,[20.95608601]
2018,8,NCAAF_20181020_VANDY@UK,Kentucky,Wildcats,Vanderbilt,Commodores,6-1,3-5,1,7,7,14,7,0,7,0,7,7,0,0,0,3,0,7,0.6906538688533976,[7.6163835]
2018,8,NCAAF_20181020_USC@UTAH,Utah,Utes,USC,Trojans,5-2,4-3,1,20,14,41,28,7,13,14,7,14,0,0,14,1,6,13,0.4914968006676581,[-0.32619878]
2018,8,NCAAF_20181020_ARIZ@UCLA,UCLA,,Arizona,,2-5,3-5,,17,7,31,30,7,10,7,7,0,7,13,10,-1,10,1,0.5249920497175469,[0.95929751]
2018,8,NCAAF_20181020_SJST@SDGST,San Diego St.,Aztecs,San Jose St.,Spartans,6-1,0-7,1,10,6,16,13,0,10,3,3,6,0,7,0,6,4,3,0.988202370079229,[34.64077816]
2018,8,NCAAF_20181019_COLOST@BOISE,Boise St.,Broncos,Colorado St.,Rams,5-2,3-5,1,35,7,56,28,21,14,7,14,0,7,7,14,2,28,28,0.8114542815904109,[13.51666932]
2018,8,NCAAF_20181019_AF@UNLV,UNLV,Rebels,Air Force,Falcons,2-5,3-4,1,21,20,35,41,7,14,7,7,3,17,21,0,-1,1,-6,0.2662124189534566,[-9.55380929]
2018,8,NCAAF_20181018_GAST@ARKST,Arkansas St.,Red Wolves,Georgia St.,Panthers,4-3,2-5,1,34,7,51,35,20,14,7,10,7,0,14,14,2,27,16,0.7231431295569134,[9.06251536]
2018,8,NCAAF_20181018_STNFRD@ARIZST,Arizona St.,Sun Devils,Stanford,Cardinal,0-4,5-2,1,3,6,13,20,3,0,3,7,0,6,14,0,-5,-3,-7,0.3185151715047324,[-7.22080535]
2018,9,NCAAF_20181027_ARMY@EMICH,E. Michigan,Eagles,Army,Black Knights,4-5,6-2,1,0,16,22,37,0,0,14,8,3,13,7,14,-2,-16,-15,0.34160570136535306,[-6.25491188]
2018,9,NCAAF_20181027_BTHN@NEB,Nebraska,,Bethune-Cook.,,2-6,4-5,,38,3,45,9,28,10,0,7,3,0,0,6,-2,35,36,0.9263236035024228,[22.20868348]
2018,9,NCAAF_20181027_CLEM@FSU,Florida State,Seminoles,Clemson,Tigers,4-4,8-0,1,0,28,10,59,0,0,3,7,0,28,24,7,-4,-28,-49,0.11136578224149196,[-18.68874703]
2018,9,NCAAF_20181027_CMICH@AKRON,Akron,,C. Michigan,,4-3,1-8,,17,0,17,10,7,10,0,0,0,0,10,0,3,17,7,0.44614800874450644,[-2.07533314]
2018,9,NCAAF_20181027_MA@UCONN,UConn,,UMass,,1-7,3-6,,7,3,17,22,7,0,7,3,3,0,6,13,-2,4,-5,0.4048274242235256,[-3.69195035]
2018,9,NCAAF_20181027_PURDUE@MICHST,Michigan St.,Spartans,Purdue,Boilermakers,5-3,4-4,1,13,6,23,13,6,7,3,7,3,3,7,0,1,7,10,0.41713817938246267,[-3.20681811]
2018,9,NCAAF_20181027_TXTECH@IOWAST,Iowa St.,Cyclones,Texas Tech,Red Raiders,4-3,5-3,1,14,17,40,31,0,14,17,9,10,7,7,7,-1,-3,9,0.5864459657376141,[3.34770647]
2018,9,NCAAF_20181027_VANDY@ARK,Arkansas,Razorbacks,Vanderbilt,Commodores,2-7,4-5,1,14,21,31,45,7,7,3,14,7,14,3,21,-2,-7,-14,0.42858411539286234,[-2.75864057]
2018,9,NCAAF_20181027_WAKE@LVILLE,Louisville,,Wake Forest,,2-6,4-4,,21,35,35,56,7,14,14,0,21,14,21,0,-2,-14,-21,0.49543014625779747,[-0.17557897]
2018,9,NCAAF_20181027_WISC@NWEST,Northwestern,Wildcats,Wisconsin,Badgers,5-3,5-3,1,14,10,31,17,7,7,10,7,7,3,0,7,0,4,14,0.21105097467257972,[-12.30459305]
2018,9,NCAAF_20181027_UNC@UVA,Virginia,,North Carolina,,6-2,1-6,,17,14,31,21,14,3,7,7,7,7,0,7,5,3,10,0.743099144708526,[10.00776419]
2018,9,NCAAF_20181027_CSTCAR@GAST,Georgia St.,,C. Carolina,,2-6,5-3,,13,20,34,37,7,6,21,0,17,3,7,10,-3,-7,-3,0.569991526596128,[2.7030408]
2018,9,NCAAF_20181027_USM@CHARLO,Charlotte,,So. Miss,,4-4,3-4,,14,0,20,17,14,0,3,3,0,0,3,14,1,14,3,0.1473214533532483,[-16.06305581]
2018,9,NCAAF_20181027_TCU@KANSAS,Kansas,,TCU,,3-5,3-5,,7,10,27,26,7,0,10,10,0,10,7,9,0,-3,1,0.022037252500104132,[-30.8600651]
2018,9,NCAAF_20181027_ARIZST@USC,USC,,Arizona St.,,4-4,4-4,,14,24,35,38,7,7,14,7,14,10,7,7,0,-10,-3,0.6226562925039925,[4.78929581]
2018,9,NCAAF_20181027_DUKE@PITT,Pittsburgh,,Duke,,4-4,5-3,,17,21,54,45,7,10,18,19,7,14,21,3,-1,-4,9,0.36036015288837375,[-5.47951712]
2018,9,NCAAF_20181027_FLA@UGA,Georgia,Bulldogs,Florida,Gators,7-1,6-2,1,13,7,36,17,10,3,10,13,0,7,7,3,1,6,19,0.9009228152620753,[19.72382475]
2018,9,NCAAF_20181027_ILL@MD,Maryland,,Illinois,,5-3,3-5,,28,9,63,33,14,14,21,14,3,6,10,14,2,19,30,0.712156248590763,[8.57871361]
2018,9,NCAAF_20181027_IOWA@PSU,Penn State,Nittany Lions,Iowa,Hawkeyes,6-2,6-2,1,17,17,30,24,7,10,10,3,12,5,0,7,0,0,6,0.7164994630442443,[8.77457964]
2018,9,NCAAF_20181027_KSTATE@OKLA,Oklahoma,Sooners,Kansas State,Wildcats,7-1,3-5,1,34,7,51,14,17,17,14,3,0,7,0,7,4,27,37,0.9085586525062033,[20.41515338]
2018,9,NCAAF_20181027_MTSU@ODU,Old Dominion,,Middle Tenn.,,2-7,5-3,,10,31,17,51,7,3,7,0,17,14,14,6,-3,-21,-34,0.23703031179428113,[-10.97275603]
2018,9,NCAAF_20181027_NILL@BYU,BYU,,N. Illinois,,4-4,5-3,,3,0,6,7,3,0,3,0,0,0,7,0,-1,3,-1,0.3172328589540716,[-7.28746202]
2018,9,NCAAF_20181027_SFLA@HOU,Houston,Cougars,South Florida,Bulls,7-1,7-1,1,28,21,57,36,14,14,15,14,0,21,15,0,0,7,21,0.5003028540862162,[0.01163574]
2018,9,NCAAF_20181027_NMEX@UTAHST,Utah St.,,New Mexico,,7-1,3-5,,52,5,61,19,28,24,9,0,3,2,14,0,4,47,42,0.8497248305134133,[15.86783372]
2018,9,NCAAF_20181027_RICE@NTEXAS,North Texas,,Rice,,7-2,1-8,,17,10,41,17,10,7,3,21,7,3,7,0,6,7,24,0.9269301295866932,[22.27546711]
2018,9,NCAAF_20181027_UK@MIZZOU,Missouri,Tigers,Kentucky,Wildcats,4-4,7-1,1,14,3,14,15,0,14,0,0,3,0,0,12,-3,11,-1,0.6665285813140911,[6.5961435]
2018,9,NCAAF_20181027_UNLV@SJST,San Jose St.,,UNLV,,1-7,2-6,,24,21,50,37,7,17,17,9,7,14,7,9,-1,3,13,0.18433449511375577,[-13.77893447]
2018,9,NCAAF_20181027_WASH@CAL,California,Golden Bears,Washington,Huskies,5-3,6-3,1,6,7,12,10,3,3,6,0,7,0,0,3,-1,-1,2,0.08777195330475085,[-20.76265835]
2018,9,NCAAF_20181027_ARKST@LALAF,Louisiana,,Arkansas St.,,4-4,4-4,,31,21,47,43,21,10,3,13,14,7,7,15,0,10,4,0.20717827037000835,[-12.51107214]
2018,9,NCAAF_20181027_BOISE@AF,Air Force,Falcons,Boise St.,Broncos,3-5,6-2,1,28,28,38,48,7,21,3,7,14,14,10,10,-3,0,-10,0.1762749537197973,[-14.24926332]
2018,9,NCAAF_20181027_NCST@CUSE,Syracuse,Orange,NC State,Wolfpack,6-2,5-2,1,27,20,51,41,24,3,14,10,7,13,7,14,1,7,10,0.3248117912145072,[-6.96304691]
2018,9,NCAAF_20181027_NMEXST@TXSTSM,Texas St.,,New Mexico St.,,2-6,2-7,,20,13,27,20,13,7,7,0,0,13,7,0,0,7,7,0.27603016883589304,[-9.1148782]
2018,9,NCAAF_20181027_TULANE@TULSA,Tulsa,,Tulane,,1-7,3-5,,10,7,17,24,3,7,7,0,0,7,7,10,-2,3,-7,0.34087757187401113,[-6.28532827]
2018,9,NCAAF_20181027_TXAM@MISSST,Miss. State,Bulldogs,Texas A&M,Aggies,5-3,5-3,1,7,10,28,13,7,0,7,14,0,10,3,0,0,-3,15,0.6365235424109059,[5.35207523]
2018,9,NCAAF_20181027_WASHST@STNFRD,Stanford,Cardinal,Washington St.,Cougars,5-3,7-1,1,28,17,38,41,14,14,3,7,14,3,7,17,-2,11,-3,0.6014304533512871,[3.93995017]
2018,9,NCAAF_20181027_FIU@WKY,W. Kentucky,,FIU,,1-7,6-2,,3,14,17,38,0,3,0,14,7,7,14,10,-5,-11,-21,0.3002872265185288,[-8.02507909]
2018,9,NCAAF_20181027_TENN@SC,South Carolina,Gamecocks,Tennessee,Volunteers,4-3,3-5,1,9,14,27,24,3,6,15,3,7,7,10,0,1,-5,3,0.7824464773386623,[11.96282662]
2018,9,NCAAF_20181027_UAB@UTEP,UTEP,,UAB,,0-8,7-1,,0,10,0,19,0,0,0,0,10,0,2,7,-7,-10,-19,0.08589539321451523,[-20.94457578]
2018,9,NCAAF_20181027_ND@NAVY,Navy,Midshipmen,Notre Dame,Fighting Irish,2-6,8-0,1,0,27,22,44,0,0,14,8,13,14,10,7,-6,-27,-22,0.10735957320675116,[-19.01669837]
2018,9,NCAAF_20181027_TEXAS@OKLAST,Oklahoma State,Cowboys,Texas,Longhorns,5-3,6-2,1,31,14,38,35,17,14,0,7,7,7,7,14,-1,17,3,0.5198680564844389,[0.76365239]
2018,9,NCAAF_20181027_HAWAII@FRESNO,Fresno St.,,Hawaii,,7-1,6-4,,37,13,50,20,14,23,10,3,3,10,0,7,1,24,30,0.963155136553602,[27.41373482]
2018,9,NCAAF_20181027_OREG@ARIZ,Arizona,Wildcats,Oregon,Ducks,4-5,5-3,1,23,8,44,15,10,13,14,7,0,8,0,7,-1,15,29,0.3524661314524874,[-5.80407063]
2018,9,NCAAF_20181027_SDGST@NEVADA,Nevada,,San Diego St.,,5-4,6-2,,15,24,28,24,9,6,10,3,14,10,0,0,-1,-9,4,0.17407871654338936,[-14.37977041]
2018,9,NCAAF_20181026_LATECH@FAU,FAU,Owls,Louisiana Tech,Bulldogs,3-5,6-2,1,10,14,13,21,10,0,3,0,0,14,0,7,-3,-4,-8,0.7968218263709237,[12.7267547]
2018,9,NCAAF_20181026_MIAMI@BC,Boston College,Eagles,Miami (Fla.),Hurricanes,6-2,5-3,1,17,14,27,14,14,3,10,0,7,7,0,0,1,3,13,0.36048658319168925,[-5.47433941]
2018,9,NCAAF_20181026_IND@MINN,Minnesota,Golden Gophers,Indiana,Hoosiers,4-4,4-5,1,21,9,38,31,7,14,10,7,6,3,0,22,0,12,7,0.4110153304384643,[-3.44767052]
2018,9,NCAAF_20181026_WYO@COLOST,Colorado St.,Rams,Wyoming,Cowboys,3-6,3-6,1,0,3,21,34,0,0,7,14,0,3,21,10,0,-3,-13,0.5272100219860589,[1.04622892]
2018,9,NCAAF_20181026_UTAH@UCLA,UCLA,Bruins,Utah,Utes,2-6,6-2,1,7,17,10,41,7,0,3,0,3,14,21,3,-4,-10,-31,0.2890077597089554,[-8.52645878]
2018,9,NCAAF_20181025_BALLST@OHIO,Ohio,Bobcats,Ball St.,Cardinals,5-3,3-6,1,31,7,52,14,0,31,21,0,7,0,0,7,2,24,38,0.9325259479597219,[22.91260556]
2018,9,NCAAF_20181025_BAYLOR@WVU,West Virginia,Mountaineers,Baylor,Bears,6-1,4-4,1,41,0,58,14,10,31,10,7,0,0,14,0,2,41,44,0.7797400831002477,[11.8223257]
2018,9,NCAAF_20181025_TOLEDO@WMICH,W. Michigan,Broncos,Toledo,Rockets,6-3,4-4,1,17,23,24,51,7,10,7,0,14,9,21,7,2,-6,-27,0.37760411258400994,[-4.77879157]
2018,9,NCAAF_20181025_APLST@GAS,Ga. Southern,Eagles,App. St.,Mountaineers,7-1,5-2,1,17,7,34,14,0,17,10,7,0,7,0,7,2,10,20,0.14577441270918,[-16.16635285]
2018,9,NCAAF_20181025_GATECH@VATECH,Virginia Tech,Hokies,Georgia Tech,Yellow Jackets,4-3,4-4,1,21,28,28,49,14,7,0,7,14,14,14,7,0,-7,-21,0.5966427814624772,[3.75012543]
2018,9,NCAAF_20181023_TROY@SALA,South Alabama,Jaguars,Troy,Trojans,2-6,6-2,1,17,31,17,38,7,10,0,0,16,15,0,7,-4,-14,-21,0.10773946056444528,[-18.98522658]
2018,10,NCAAF_20181104_UTAHST@HAWAII,Hawaii,,Utah St.,,6-5,8-1,,3,28,17,56,3,0,14,0,28,0,28,0,-2,-25,-39,0.05834983906280078,[-24.13021152]
2018,10,NCAAF_20181103_AF@ARMY,Army,Black Knights,Air Force,Falcons,7-2,3-6,1,14,0,17,14,7,7,0,3,0,0,6,8,4,14,3,0.7264119935018897,[9.25963993]
2018,10,NCAAF_20181103_CMICH@EMICH,E. Michigan,,C. Michigan,,5-5,1-9,,7,7,17,7,7,0,0,10,0,7,0,0,4,0,10,0.6311617102390138,[5.15176382]
2018,10,NCAAF_20181103_CUSE@WAKE,Wake Forest,Demon Deacons,Syracuse,Orange,4-5,7-2,1,10,21,24,41,10,0,14,0,14,7,14,6,-3,-11,-17,0.5474271634331426,[1.8329203]
2018,10,NCAAF_20181103_IOWAST@KANSAS,Kansas,,Iowa St.,,3-6,5-3,,3,20,3,27,0,3,0,0,14,6,7,0,-2,-17,-24,0.03448940671733991,[-27.97221888]
2018,10,NCAAF_20181103_LVILLE@CLEM,Clemson,Tigers,Louisville,Cardinals,9-0,2-7,1,35,3,77,16,14,21,28,14,3,0,6,7,7,32,61,0.9490697548680619,[25.16265298]
2018,10,NCAAF_20181103_MEMP@ECU,East Carolina,,Memphis,,2-6,5-4,,17,24,41,59,14,3,17,7,10,14,14,21,-3,-7,-18,0.06548636313779854,[-23.23037845]
2018,10,NCAAF_20181103_MICHST@MD,Maryland,,Michigan St.,,5-4,6-3,,3,10,3,24,0,3,0,0,10,0,7,7,-1,-7,-21,0.23487246539379547,[-11.11922039]
2018,10,NCAAF_20181103_NEB@OHIOST,Ohio State,Buckeyes,Nebraska,Cornhuskers,8-1,2-7,1,16,21,36,31,16,0,14,6,7,14,0,10,6,-5,5,0.9742736759973281,[29.95838474]
2018,10,NCAAF_20181103_OKLAST@BAYLOR,Baylor,,Oklahoma State,,5-4,5-4,,14,10,35,31,0,14,7,14,7,3,14,7,0,4,4,0.09229276817304188,[-20.40772215]
2018,10,NCAAF_20181103_RUT@WISC,Wisconsin,,Rutgers,,6-3,1-8,,10,0,31,17,7,3,14,7,0,0,3,14,5,10,14,0.9836409889115526,[32.84767387]
2018,10,NCAAF_20181103_SC@MISS,Ole Miss,Rebels,South Carolina,Gamecocks,5-4,5-3,1,27,27,44,48,3,24,10,7,17,10,7,14,0,0,-4,0.31488658066094644,[-7.41460912]
2018,10,NCAAF_20181103_TXAM@AUBURN,Auburn,Tigers,Texas A&M,Aggies,6-3,5-4,1,14,17,28,24,7,7,0,14,3,14,7,0,1,-3,4,0.7807668845777067,[11.91739415]
2018,10,NCAAF_20181103_GATECH@UNC,North Carolina,,Georgia Tech,,1-7,5-4,,10,21,28,38,7,3,10,8,7,14,7,10,-4,-11,-10,0.13458379873537152,[-16.99631044]
2018,10,NCAAF_20181103_SJST@WYO,Wyoming,,San Jose St.,,4-6,1-8,,10,0,24,9,3,7,7,7,0,0,3,6,3,10,15,0.9048964196240189,[20.1492942]
2018,10,NCAAF_20181103_TXSTSM@GAST,Georgia St.,,Texas St.,,2-7,3-6,,10,13,31,40,7,3,0,21,13,0,20,7,-1,-3,-9,0.7431284115751027,[10.04445409]
2018,10,NCAAF_20181103_GAS@LAMON,UL-Monroe,,Ga. Southern,,5-4,7-2,,27,10,44,25,13,14,14,3,0,10,8,7,-2,17,19,0.3436989193689063,[-6.1893584]
2018,10,NCAAF_20181103_MRSHL@USM,So. Miss,,Marshall,,4-4,5-3,,17,10,26,24,3,14,3,6,3,7,7,7,-1,7,2,0.311331212103777,[-7.56895306]
2018,10,NCAAF_20181103_SALA@ARKST,Arkansas St.,,South Alabama,,5-4,2-7,,14,7,38,14,0,14,14,10,0,7,0,7,3,7,24,0.8074385263344933,[13.35879805]
2018,10,NCAAF_20181103_FSU@NCST,NC State,,Florida State,,6-2,4-5,,27,14,47,28,10,17,10,10,0,14,7,7,2,13,19,0.5641680987147444,[2.48481707]
2018,10,NCAAF_20181103_IOWA@PURDUE,Purdue,Boilermakers,Iowa,Hawkeyes,5-4,6-3,1,21,17,38,36,14,7,14,3,7,10,6,13,-1,4,2,0.33916460858738495,[-6.37940093]
2018,10,NCAAF_20181103_KSTATE@TCU,TCU,,Kansas State,,4-5,3-6,,7,7,14,13,7,0,7,0,7,0,0,6,1,0,1,0.7534785422942469,[10.54368888]
2018,10,NCAAF_20181103_LALAF@TROY,Troy,,Louisiana,,7-2,4-5,,23,3,26,16,10,13,3,0,3,0,13,0,3,20,10,0.8603340101573547,[16.64006939]
2018,10,NCAAF_20181103_MINN@ILL,Illinois,,Minnesota,,4-5,4-5,,24,17,55,31,14,10,21,10,7,10,0,14,0,7,24,0.2013251740564077,[-12.87276264]
2018,10,NCAAF_20181103_NAVY@CINCY,Cincinnati,,Navy,,8-1,2-7,,28,0,42,0,7,21,7,7,0,0,0,0,6,28,42,0.3407699825626678,[-6.31200641]
2018,10,NCAAF_20181103_TULANE@SFLA,South Florida,Bulls,Tulane,Green Wave,7-2,4-5,1,3,27,15,41,3,0,6,6,7,20,7,7,3,-24,-26,0.6832464126813733,[7.33385848]
2018,10,NCAAF_20181103_UGA@UK,Kentucky,Wildcats,Georgia,Bulldogs,7-2,8-1,1,3,14,17,34,0,3,7,7,7,7,14,6,-1,-11,-17,0.07127030552499913,[-22.55540954]
2018,10,NCAAF_20181103_UTEP@RICE,Rice,,UTEP,,1-9,1-8,,3,27,26,34,0,3,7,16,7,20,7,0,0,-24,-8,0.5233277759393156,[0.89993393]
2018,10,NCAAF_20181103_WVU@TEXAS,Texas,Longhorns,West Virginia,Mountaineers,6-3,7-1,1,28,27,41,42,14,14,3,10,10,17,0,15,-1,1,-1,0.6080068420231717,[4.21650788]
2018,10,NCAAF_20181103_BC@VATECH,Virginia Tech,Hokies,Boston College,Eagles,4-4,7-2,1,14,7,21,31,7,7,0,7,7,0,14,10,-3,7,-10,0.5222928488014122,[0.85996614]
2018,10,NCAAF_20181103_PSU@MICH,Michigan,Wolverines,Penn State,Nittany Lions,8-1,6-3,1,14,0,42,7,7,7,14,14,0,0,0,7,2,14,35,0.32291441735817894,[-7.06880706]
2018,10,NCAAF_20181103_ALCORN@NMEXST,New Mexico St.,,Alcorn St.,,3-7,7-3,,35,14,52,42,14,21,3,14,7,7,7,21,-4,21,10,0.35264088709554375,[-5.81730124]
2018,10,NCAAF_20181103_CHARLO@TENN,Tennessee,,Charlotte,,4-5,4-5,,14,3,14,3,14,0,0,0,0,3,0,0,0,11,11,0.9261871436748838,[22.27198437]
2018,10,NCAAF_20181103_MIZZOU@FLA,Florida,Gators,Missouri,Tigers,6-3,5-4,1,10,21,17,38,3,7,7,0,7,14,14,3,1,-11,-21,0.42374222704474496,[-2.95831597]
2018,10,NCAAF_20181103_UTAH@ARIZST,Arizona St.,Sun Devils,Utah,Utes,5-4,6-3,1,21,17,38,20,14,7,0,17,7,10,3,0,-1,4,18,0.3287791207086187,[-6.81843214]
2018,10,NCAAF_20181103_APLST@CSTCAR,C. Carolina,,App. St.,,5-4,6-2,,7,14,7,23,7,0,0,0,7,7,0,9,-1,-7,-16,0.10376594316936383,[-19.38659562]
2018,10,NCAAF_20181103_DUKE@MIAMI,Miami (Fla.),Hurricanes,Duke,Blue Devils,5-4,6-3,1,12,7,12,20,0,12,0,0,7,0,10,3,-1,5,-8,0.694694332220348,[7.83229248]
2018,10,NCAAF_20181103_HOU@SMU,SMU,Mustangs,Houston,Cougars,4-5,7-2,1,31,14,45,31,10,21,7,7,0,14,3,14,-3,17,14,0.3242192001044766,[-7.01294362]
2018,10,NCAAF_20181103_UCONN@TULSA,Tulsa,Golden Hurricane,UConn,Huskies,2-7,1-8,1,28,13,49,19,0,28,21,0,10,3,0,6,1,15,30,0.7425985211685776,[10.01918194]
2018,10,NCAAF_20181103_ND@NWEST,Northwestern,Wildcats,Notre Dame,Fighting Irish,5-4,9-0,1,7,7,21,31,0,7,0,14,7,0,14,10,-4,0,-10,0.3127375129908673,[-7.50781313]
2018,10,NCAAF_20181103_FAU@FIU,FIU,,FAU,,6-3,4-5,,7,14,14,49,0,7,7,0,7,7,7,28,2,-7,-35,0.2715459691792623,[-9.3541882]
2018,10,NCAAF_20181103_LATECH@MISSST,Miss. State,Bulldogs,Louisiana Tech,Bulldogs,6-3,6-3,1,31,3,45,3,21,10,7,7,3,0,0,0,0,28,42,0.9381432895400699,[23.6779076]
2018,10,NCAAF_20181103_TXSA@UAB,UAB,,UTSA,,8-1,3-6,,38,3,52,3,21,17,7,7,3,0,0,0,5,35,49,0.6464772488076639,[5.78079589]
2018,10,NCAAF_20181103_UCLA@OREG,Oregon,,UCLA,,6-3,2-7,,21,7,42,21,14,7,7,14,0,7,7,7,4,14,21,0.6061173526213992,[4.14091846]
2018,10,NCAAF_20181103_BAMA@LSU,LSU,Tigers,Alabama,Crimson Tide,7-2,9-0,1,0,16,0,29,0,0,0,0,6,10,6,7,-2,-16,-29,0.13979458731268746,[-16.63117079]
2018,10,NCAAF_20181103_OKLA@TXTECH,Texas Tech,Red Raiders,Oklahoma,Sooners,5-4,8-1,1,31,28,46,51,14,17,0,15,7,21,7,16,-3,3,-5,0.16881057982556213,[-14.74898523]
2018,10,NCAAF_20181103_STNFRD@WASH,Washington,Huskies,Stanford,Cardinal,7-3,5-4,1,21,0,27,23,14,7,3,3,0,0,14,9,2,21,4,0.6810089577002957,[7.23735075]
2018,10,NCAAF_20181103_USC@OREGST,Oregon State,,USC,,2-7,5-4,,14,21,21,38,0,14,7,0,7,14,7,10,-3,-7,-17,0.028584576921726113,[-29.25591246]
2018,10,NCAAF_20181103_BYU@BOISE,Boise St.,,BYU,,7-2,4-5,,14,6,21,16,14,0,7,0,0,6,7,3,3,8,5,0.8571523807777781,[16.42152118]
2018,10,NCAAF_20181103_SDGST@NMEX,New Mexico,,San Diego St.,,3-6,7-2,,10,7,23,31,7,3,6,7,7,0,7,17,-4,3,-8,0.12392306004909304,[-17.774851]
2018,10,NCAAF_20181103_FRESNO@UNLV,UNLV,Rebels,Fresno St.,Bulldogs,2-7,8-1,1,0,17,3,48,0,0,0,3,7,10,17,14,-6,-17,-45,0.07393053292909757,[-22.25904869]
2018,10,NCAAF_20181103_CAL@WASHST,Washington St.,Cougars,California,Golden Bears,8-1,5-4,1,13,10,19,13,3,10,0,6,0,10,3,0,3,3,6,0.7066456834808803,[8.36158332]
2018,10,NCAAF_20181102_PITT@UVA,Virginia,Cavaliers,Pittsburgh,Panthers,6-3,5-4,1,10,7,13,23,7,3,0,3,7,0,7,9,1,3,-10,0.5294574003412373,[1.13678729]
2018,10,NCAAF_20181102_WKY@MTSU,Middle Tenn.,Blue Raiders,W. Kentucky,Hilltoppers,6-3,1-8,1,20,3,29,10,10,10,3,6,3,0,7,0,5,17,19,0.7583084414880465,[10.78048092]
2018,10,NCAAF_20181102_COLO@ARIZ,Arizona,,Colorado,,5-5,5-4,,26,24,42,34,0,26,9,7,10,14,10,0,0,2,8,0.5442689469350754,[1.71034208]
2018,10,NCAAF_20181101_NILL@AKRON,Akron,,N. Illinois,,4-4,6-3,,10,24,26,36,7,3,16,0,7,17,5,7,-2,-14,-10,0.2959232044573654,[-8.24699797]
2018,10,NCAAF_20181101_OHIO@WMICH,W. Michigan,,Ohio,,6-4,6-3,,0,45,14,59,0,0,7,7,21,24,7,7,0,-45,-45,0.3793984439455932,[-4.72307021]
2018,10,NCAAF_20181101_TEMPLE@UCF,UCF,Knights,Temple,Owls,8-0,5-4,1,28,34,52,40,14,14,14,10,17,17,0,6,3,-6,12,0.9052848428025888,[20.18466757]
2018,10,NCAAF_20181031_BALLST@TOLEDO,Toledo,Rockets,Ball St.,Cardinals,5-4,3-7,1,28,7,45,13,21,7,3,14,0,7,0,6,2,21,32,0.9619472685407496,[27.28290697]
2018,10,NCAAF_20181030_KENTST@BGREEN,Bowling Green,,Kent St.,,1-8,2-7,,13,14,28,35,3,10,0,15,7,7,7,14,-1,-1,-7,0.6659622926794578,[6.5954614]
2018,10,NCAAF_20181030_MIAOH@BUFF,Buffalo,,Miami-OH,,8-1,3-6,,28,21,51,42,14,14,14,9,14,7,21,0,5,7,9,0.6606906562170091,[6.37331986]
2018,11,NCAAF_20181110_AKRON@EMICH,E. Michigan,,Akron,,6-5,4-5,,10,7,27,7,7,3,0,17,0,7,0,0,2,3,20,0.6649292553675887,[6.60787001]
2018,11,NCAAF_20181110_BYU@MA,UMass,,BYU,,4-7,5-5,,10,14,16,35,10,0,0,6,7,7,14,7,-1,-4,-19,0.30057222924810745,[-8.10956421]
2018,11,NCAAF_20181110_ILL@NEB,Nebraska,,Illinois,,3-7,4-6,,38,21,54,35,21,17,7,9,14,7,0,14,-1,17,19,0.6989909640883243,[8.09009823]
2018,11,NCAAF_20181110_KANSAS@KSTATE,Kansas State,Wildcats,Kansas,Jayhawks,4-6,3-7,1,0,3,21,17,0,0,14,7,0,3,7,7,1,-3,4,0.8675279340022364,[17.29372928]
2018,11,NCAAF_20181110_LAF@ARMY,Army,Black Knights,Lafayette,Leopards,8-2,3-7,1,17,6,31,13,3,14,14,0,3,3,0,7,5,11,18,,
2018,11,NCAAF_20181110_MD@IND,Indiana,,Maryland,,5-5,5-5,,21,15,34,32,0,21,10,3,6,9,8,9,0,6,2,0.6011731490419725,[3.97732687]
2018,11,NCAAF_20181110_MISS@TXAM,Texas A&M,Aggies,Ole Miss,Rebels,6-4,5-5,1,14,14,38,24,7,7,7,17,0,14,7,3,1,0,14,0.7023405175461594,[8.23969772]
2018,11,NCAAF_20181110_NAVY@UCF,UCF,Knights,Navy,Midshipmen,9-0,2-8,1,21,3,35,24,14,7,7,7,0,3,7,14,7,18,11,0.91785659721206,[21.57560097]
2018,11,NCAAF_20181110_OHIOST@MICHST,Michigan St.,Spartans,Ohio State,Buckeyes,6-4,9-1,1,3,7,6,26,0,3,3,0,0,7,2,17,-3,-4,-20,0.1746708810651787,[-14.51820798]
2018,11,NCAAF_20181110_SC@FLA,Florida,Gators,South Carolina,Gamecocks,7-3,5-4,1,14,21,35,31,0,14,7,14,14,7,10,0,2,-7,4,0.48747516845158523,[-0.48711573]
2018,11,NCAAF_20181110_SMU@UCONN,UConn,,SMU,,1-9,5-5,,10,31,50,62,7,3,14,26,17,14,14,17,-4,-21,-12,0.08624520311735795,[-21.16369032]
2018,11,NCAAF_20181110_TCU@WVU,West Virginia,Mountaineers,TCU,Horned Frogs,8-1,4-6,1,24,3,47,10,0,24,16,7,3,0,7,0,4,21,37,0.38361960482446433,[-4.5916961]
2018,11,NCAAF_20181110_TULSA@MEMP,Memphis,,Tulsa,,6-4,2-8,,27,0,47,21,17,10,7,13,0,0,14,7,4,27,26,0.8450414020143628,[15.75194999]
2018,11,NCAAF_20181110_VANDY@MIZZOU,Missouri,,Vanderbilt,,6-4,4-6,,13,21,33,28,7,6,13,7,14,7,7,0,2,-8,5,0.8171920901088088,[14.03496302]
2018,11,NCAAF_20181110_WISC@PSU,Penn State,Nittany Lions,Wisconsin,Badgers,7-3,6-4,1,16,7,22,10,10,6,3,3,7,0,3,0,1,9,12,0.6603332652188861,[6.4126997]
2018,11,NCAAF_20181110_UNC@DUKE,Duke,,North Carolina,,7-3,1-8,,35,28,42,35,14,21,7,0,14,14,0,7,6,7,7,0.8027881367788195,[13.21131409]
2018,11,NCAAF_20181110_TROY@GAS,Ga. Southern,,Troy,,7-3,8-2,,14,17,21,35,14,0,0,7,3,14,11,7,-1,-3,-14,0.23536509355463575,[-11.18947669]
2018,11,NCAAF_20181110_UCLA@ARIZST,Arizona St.,,UCLA,,6-4,2-8,,17,14,31,28,3,14,7,7,7,7,7,7,4,3,3,0.6455205003667874,[5.79034012]
2018,11,NCAAF_20181110_CHARLO@MRSHL,Marshall,,Charlotte,,6-3,4-6,,13,10,30,13,10,3,17,0,7,3,3,0,2,3,17,0.9126927270815197,[21.05943466]
2018,11,NCAAF_20181110_BGREEN@CMICH,C. Michigan,,Bowling Green,,1-10,2-8,,13,0,13,24,7,6,0,0,0,0,17,7,-1,13,-11,0.7484247521693628,[10.38666391]
2018,11,NCAAF_20181110_LIB@UVA,Virginia,Cavaliers,Liberty,Flames,7-3,4-5,1,24,17,45,24,14,10,14,7,7,10,7,0,3,7,21,0.89074706244055,[19.08905382]
2018,11,NCAAF_20181110_MTSU@UTEP,UTEP,,Middle Tenn.,,1-9,7-3,,10,27,32,48,0,10,0,22,14,13,7,14,-6,-17,-16,0.0669709970693374,[-23.25006964]
2018,11,NCAAF_20181110_BAYLOR@IOWAST,Iowa St.,Cyclones,Baylor,Bears,6-3,5-5,1,17,0,28,14,7,10,11,0,0,0,7,7,1,17,14,0.8929294841661699,[19.27130396]
2018,11,NCAAF_20181110_MICH@RUT,Rutgers,Scarlet Knights,Michigan,Wolverines,1-9,9-1,1,7,21,7,42,7,0,0,0,7,14,14,7,-8,-14,-35,0.012686345970813417,[-34.68236843]
2018,11,NCAAF_20181110_MISSST@BAMA,Alabama,Crimson Tide,Miss. State,Bulldogs,10-0,6-4,1,21,0,24,0,14,7,0,3,0,0,0,0,4,21,24,0.8787363299610721,[18.13006699]
2018,11,NCAAF_20181110_NMEX@AF,Air Force,Falcons,New Mexico,Lobos,4-6,3-7,1,21,17,42,24,7,14,14,7,0,17,7,0,1,4,18,0.7335262413913369,[9.67262648]
2018,11,NCAAF_20181110_NTEXAS@ODU,Old Dominion,,North Texas,,3-7,7-3,,10,28,34,31,0,10,14,10,14,14,3,0,-4,-18,3,0.18495052133391265,[-13.90996861]
2018,11,NCAAF_20181110_NWEST@IOWA,Iowa,Hawkeyes,Northwestern,Wildcats,6-4,6-4,1,3,0,10,14,0,3,7,0,0,0,7,7,0,3,-4,0.6931897302849559,[7.83275938]
2018,11,NCAAF_20181110_OKLAST@OKLA,Oklahoma,Sooners,Oklahoma State,Cowboys,9-1,5-5,1,34,28,48,47,14,20,7,7,14,14,7,12,4,6,1,0.7790792569321181,[11.93093841]
2018,11,NCAAF_20181110_PURDUE@MINN,Minnesota,,Purdue,,5-5,5-5,,13,3,41,10,3,10,21,7,3,0,0,7,0,10,31,0.19391449449589282,[-13.39652262]
2018,11,NCAAF_20181110_UK@TENN,Tennessee,Volunteers,Kentucky,Wildcats,5-5,7-3,1,17,0,24,7,3,14,7,0,0,0,7,0,-2,17,17,0.2730096563540936,[-9.36582175]
2018,11,NCAAF_20181110_VATECH@PITT,Pittsburgh,,Virginia Tech,,6-4,4-5,,31,7,52,22,10,21,7,14,0,7,8,7,2,24,30,0.2974665836768219,[-8.24833631]
2018,11,NCAAF_20181110_WASHST@COLO,Colorado,Buffaloes,Washington St.,Cougars,5-5,9-1,1,7,10,7,31,7,0,0,0,0,10,7,14,-4,-3,-24,0.3103983546562724,[-7.67467096]
2018,11,NCAAF_20181110_APLST@TXSTSM,Texas St.,,App. St.,,3-7,7-2,,0,21,7,38,0,0,7,0,7,14,7,10,-4,-21,-31,0.0447580300014897,[-26.34058428]
2018,11,NCAAF_20181110_ECU@TULANE,Tulane,,East Carolina,,5-5,2-7,,14,10,24,18,7,7,7,3,3,7,0,8,3,4,6,0.8280559462260372,[14.68332951]
2018,11,NCAAF_20181110_SJST@UTAHST,Utah St.,,San Jose St.,,9-1,1-9,,38,10,62,24,10,28,21,3,7,3,7,7,8,28,38,0.9753767423733233,[30.50578003]
2018,11,NCAAF_20181110_ARKST@CSTCAR,C. Carolina,,Arkansas St.,,5-5,6-4,,6,27,16,44,0,6,7,3,14,13,14,3,-1,-21,-28,0.22287871435318163,[-11.82885844]
2018,11,NCAAF_20181110_GAST@LALAF,Louisiana,,Georgia St.,,5-5,2-8,,13,7,36,22,7,6,3,20,0,7,7,8,3,6,14,0.5087047201786052,[0.3385152]
2018,11,NCAAF_20181110_LAMON@SALA,South Alabama,,UL-Monroe,,2-8,6-4,,10,24,10,38,7,3,0,0,10,14,14,0,-4,-14,-28,0.3870720554035385,[-4.45161942]
2018,11,NCAAF_20181110_WKY@FAU,FAU,,W. Kentucky,,5-5,1-9,,10,9,34,15,10,0,7,17,0,9,0,6,4,1,19,0.9061849709840479,[20.44042669]
2018,11,NCAAF_20181110_OREG@UTAH,Utah,Utes,Oregon,Ducks,7-3,6-4,1,19,7,32,25,10,9,3,10,0,7,10,8,1,12,7,0.6070321165713117,[4.21323714]
2018,11,NCAAF_20181110_AUBURN@UGA,Georgia,Bulldogs,Auburn,Tigers,9-1,6-4,1,20,10,27,10,3,17,0,7,7,3,0,0,3,10,17,0.6815143148054409,[7.32122054]
2018,11,NCAAF_20181110_FIU@TXSA,UTSA,,FIU,,3-7,7-3,,0,17,7,45,0,0,0,7,0,17,7,21,-4,-17,-38,0.32265461247144067,[-7.14050611]
2018,11,NCAAF_20181110_MIAMI@GATECH,Georgia Tech,,Miami (Fla.),,6-4,5-5,,17,14,27,21,14,3,10,0,7,7,0,7,1,3,6,0.4170644386666288,[-3.24858733]
2018,11,NCAAF_20181110_RICE@LATECH,Louisiana Tech,,Rice,,7-3,1-10,,7,3,28,13,0,7,14,7,0,3,7,3,6,4,15,0.9010387351628244,[19.97302376]
2018,11,NCAAF_20181110_SFLA@CINCY,Cincinnati,,South Florida,,9-1,7-3,,14,16,35,23,7,7,21,0,9,7,7,0,2,-2,12,0.36201438905653216,[-5.47736357]
2018,11,NCAAF_20181110_TEMPLE@HOU,Houston,Cougars,Temple,Owls,7-3,6-4,1,14,28,49,59,7,7,21,14,14,14,21,10,1,-14,-10,0.6250694202478226,[4.94592865]
2018,11,NCAAF_20181110_FSU@ND,Notre Dame,Fighting Irish,Florida State,Seminoles,10-0,4-6,1,32,6,42,13,17,15,3,7,0,6,7,0,6,26,29,0.7787051803308409,[11.91139588]
2018,11,NCAAF_20181110_LSU@ARK,Arkansas,Razorbacks,LSU,Tigers,2-8,8-2,1,3,14,17,24,0,3,0,14,7,7,10,0,-6,-11,-7,0.07895215014829682,[-21.90692187]
2018,11,NCAAF_20181110_TEXAS@TXTECH,Texas Tech,Red Raiders,Texas,Longhorns,5-5,7-3,1,10,17,34,41,7,3,0,24,0,17,10,14,-2,-7,-7,0.45306560568787113,[-1.82930308]
2018,11,NCAAF_20181110_CLEM@BC,Boston College,Eagles,Clemson,Tigers,7-3,10-0,1,7,13,7,27,7,0,0,0,10,3,7,7,-3,-6,-20,0.0959988330431023,[-20.23983843]
2018,11,NCAAF_20181110_OREGST@STNFRD,Stanford,Cardinal,Oregon State,Beavers,6-4,2-8,1,34,17,48,17,13,21,7,7,7,10,0,0,4,17,31,0.9764436642798248,[30.79796507]
2018,11,NCAAF_20181110_CAL@USC,USC,,California,,5-5,6-4,,14,0,14,15,0,14,0,0,0,0,15,0,-1,14,-1,0.6972156836208616,[8.0111146]
2018,11,NCAAF_20181110_COLOST@NEVADA,Nevada,,Colorado St.,,6-4,3-7,,28,0,49,10,7,21,21,0,0,0,0,10,3,28,39,0.41508574703910384,[-3.32727775]
2018,11,NCAAF_20181110_UNLV@SDGST,San Diego St.,,UNLV,,7-3,3-7,,14,13,24,27,0,14,10,0,6,7,0,14,4,1,-3,0.8825355293712669,[18.42581747]
2018,11,NCAAF_20181109_LVILLE@CUSE,Syracuse,Orange,Louisville,Cardinals,8-2,2-8,1,37,7,54,23,7,30,7,10,0,7,7,9,6,30,31,0.5873552232611607,[3.42447082]
2018,11,NCAAF_20181109_FRESNO@BOISE,Boise St.,Broncos,Fresno St.,Bulldogs,8-2,8-2,1,3,10,24,17,3,0,7,14,0,10,7,0,0,-7,7,0.5159986803093698,[0.62228526]
2018,11,NCAAF_20181108_WAKE@NCST,NC State,Wolfpack,Wake Forest,Demon Deacons,6-3,5-5,1,13,3,23,27,6,7,3,7,0,3,10,14,1,10,-4,0.6307016655395523,[5.17691667]
2018,11,NCAAF_20181107_OHIO@MIAOH,Miami-OH,RedHawks,Ohio,Bobcats,4-6,6-4,1,28,7,30,28,7,21,0,2,7,0,7,14,-2,21,2,0.2668885815312272,[-9.65304251]
2018,11,NCAAF_20181107_TOLEDO@NILL,N. Illinois,,Toledo,,7-3,5-5,,17,9,38,15,7,10,14,7,3,6,0,6,2,8,23,0.41633034692176707,[-3.2777715]
2018,11,NCAAF_20181106_KENTST@BUFF,Buffalo,Bulls,Kent St.,Golden Flashes,9-1,2-8,1,34,0,48,14,21,13,14,0,0,0,0,14,7,34,34,0.9328514185970155,[23.22886127]
2018,12,NCAAF_20181117_ARK@MISSST,Miss. State,Bulldogs,Arkansas,Razorbacks,7-4,2-9,1,17,3,52,6,3,14,21,14,0,3,3,0,5,14,46,0.9113080324710119,[20.92633367]
2018,12,NCAAF_20181117_CIT@BAMA,Alabama,Crimson Tide,The Citadel,Bulldogs,11-0,4-6,1,10,10,50,17,7,3,27,13,0,10,0,7,7,0,33,0.9999588758743267,[61.09092814]
2018,12,NCAAF_20181117_COLG@ARMY,Army,Black Knights,Colgate,Raiders,9-2,9-1,1,14,0,28,14,7,7,0,14,0,0,7,7,0,14,14,0.9598161917132401,[27.1273941]
2018,12,NCAAF_20181117_IDAHO@FLA,Florida,Gators,Idaho,Vandals,8-3,4-7,1,49,0,63,10,28,21,7,7,0,0,3,7,4,49,53,0.9521132037581315,[25.84190465]
2018,12,NCAAF_20181117_MICHST@NEB,Nebraska,Cornhuskers,Michigan St.,Spartans,4-7,6-5,1,0,3,9,6,0,0,0,9,3,0,0,3,-2,-3,3,0.2120973313272232,[-12.39837598]
2018,12,NCAAF_20181117_MTSU@UK,Kentucky,Wildcats,Middle Tenn.,Blue Raiders,8-3,7-4,1,24,10,34,23,17,7,7,3,0,10,6,7,1,14,11,0.7458942673599918,[10.26455904]
2018,12,NCAAF_20181117_NWEST@MINN,Minnesota,,Northwestern,,5-6,7-4,,7,13,14,24,0,7,0,7,7,6,0,11,-2,-6,-10,0.2764393915113913,[-9.2069074]
2018,12,NCAAF_20181117_PITT@WAKE,Wake Forest,,Pittsburgh,,5-6,7-4,,10,6,13,34,3,7,0,3,0,6,14,14,-2,4,-21,0.5426775544922722,[1.66283293]
2018,12,NCAAF_20181117_PSU@RUT,Rutgers,Scarlet Knights,Penn State,Nittany Lions,1-10,8-3,1,0,13,7,20,0,0,0,7,3,10,0,7,-7,-13,-13,0.00701824049861155,[-38.10787268]
2018,12,NCAAF_20181117_SFLA@TEMPLE,Temple,,South Florida,,7-4,7-4,,0,17,27,17,0,0,10,17,7,10,0,0,0,-17,10,0.49054085192377306,[-0.36788402]
2018,12,NCAAF_20181117_TCU@BAYLOR,Baylor,,TCU,,5-6,5-6,,6,9,9,16,6,0,3,0,3,6,7,0,0,-3,-7,0.13827259770104128,[-16.88116043]
2018,12,NCAAF_20181117_NCST@LVILLE,Louisville,Cardinals,NC State,Wolfpack,2-9,7-3,1,3,17,10,52,3,0,0,7,7,10,21,14,-5,-14,-42,0.26860990938385065,[-9.57258746]
2018,12,NCAAF_20181117_UTAH@COLO,Colorado,,Utah,,5-6,8-3,,7,7,7,30,7,0,0,0,0,7,17,6,-3,0,-23,0.24643311315159888,[-10.63894713]
2018,12,NCAAF_20181117_FIU@CHARLO,Charlotte,,FIU,,4-7,8-3,,14,20,35,42,7,7,7,14,10,10,7,15,-4,-6,-7,0.14860801180478245,[-16.17230347]
2018,12,NCAAF_20181117_UTAHST@COLOST,Colorado St.,,Utah St.,,3-8,10-1,,7,10,24,29,0,7,3,14,3,7,10,9,-7,-3,-5,0.19250755280188625,[-13.47704137]
2018,12,NCAAF_20181117_VMI@ODU,Old Dominion,,VMI,,4-7,1-10,,49,0,77,14,21,28,14,14,0,0,14,0,3,49,63,0.9988508887981058,[47.298256]
2018,12,NCAAF_20181117_CUSE@ND,Notre Dame,Fighting Irish,Syracuse,Orange,11-0,8-3,1,20,0,36,3,13,7,9,7,0,0,0,3,3,20,33,0.7902207154489431,[12.5228334]
2018,12,NCAAF_20181117_GAST@APLST,App. St.,,Georgia St.,,8-2,2-9,,17,7,45,17,14,3,14,14,7,0,3,7,6,10,28,0.89014563261699,[19.04057507]
2018,12,NCAAF_20181117_TXSA@MRSHL,Marshall,,UTSA,,7-3,3-8,,20,0,23,0,10,10,3,0,0,0,0,0,4,20,23,0.830822934833013,[14.85360344]
2018,12,NCAAF_20181117_LAMON@ARKST,Arkansas St.,,UL-Monroe,,7-4,6-5,,17,7,31,17,7,10,14,0,0,7,10,0,1,10,14,0.7426813287597556,[10.10955344]
2018,12,NCAAF_20181117_NEVADA@SJST,San Jose St.,,Nevada,,1-10,7-4,,6,7,12,21,6,0,6,0,0,7,7,7,-6,-1,-9,0.11291321201630744,[-18.79044061]
2018,12,NCAAF_20181117_WCAR@UNC,North Carolina,,W. Carolina,,2-8,3-8,,35,16,49,26,14,21,14,0,7,9,3,7,-1,19,23,0.9987923755004755,[47.06626938]
2018,12,NCAAF_20181117_BC@FSU,Florida State,Seminoles,Boston College,Eagles,5-6,7-4,1,6,7,22,21,0,6,7,9,0,7,7,7,-2,-1,1,0.38595303304363726,[-4.49728483]
2018,12,NCAAF_20181117_BGREEN@AKRON,Akron,,Bowling Green,,4-6,3-8,,6,7,6,21,3,3,0,0,0,7,7,7,1,-1,-15,0.6910146537174158,[7.7373532]
2018,12,NCAAF_20181117_IOWA@ILL,Illinois,Fighting Illini,Iowa,Hawkeyes,4-7,7-4,1,0,35,0,63,0,0,0,0,7,28,14,14,-3,-35,-63,0.03605224146858066,[-27.9015631]
2018,12,NCAAF_20181117_LATECH@USM,So. Miss,,Louisiana Tech,,5-5,7-4,,14,17,21,20,7,7,0,7,7,10,0,3,-2,-3,1,0.4907191964511497,[-0.36094661]
2018,12,NCAAF_20181117_MIAMI@VATECH,Virginia Tech,,Miami (Fla.),,4-6,6-5,,14,17,14,38,7,7,0,0,3,14,21,0,-2,-3,-24,0.40868426829335647,[-3.58269794]
2018,12,NCAAF_20181117_MIZZOU@TENN,Tennessee,Volunteers,Missouri,Tigers,5-6,7-4,1,10,26,17,50,0,10,7,0,6,20,14,10,-2,-16,-33,0.18396459004149035,[-13.96831527]
2018,12,NCAAF_20181117_TULSA@NAVY,Navy,Midshipmen,Tulsa,Golden Hurricane,3-8,2-9,1,27,16,37,29,7,20,3,7,7,9,0,13,1,11,8,0.7021061111030633,[8.22975908]
2018,12,NCAAF_20181117_TXSTSM@TROY,Troy,,Texas St.,,9-2,3-8,,9,0,12,7,3,6,0,3,0,0,0,7,6,9,5,0.943130163158598,[24.53727997]
2018,12,NCAAF_20181117_TXTECH@KSTATE,Kansas State,,Texas Tech,,5-6,5-6,,10,6,21,6,0,10,5,6,6,0,0,0,0,4,15,0.3174314834686569,[-7.36757203]
2018,12,NCAAF_20181117_USC@UCLA,UCLA,,USC,,3-8,5-6,,21,24,34,27,14,7,0,13,10,14,3,0,-2,-3,7,0.30119540186133653,[-8.08234224]
2018,12,NCAAF_20181117_WVU@OKLAST,Oklahoma State,Cowboys,West Virginia,Mountaineers,6-5,8-2,1,14,31,45,41,7,7,10,21,14,17,0,10,-2,-17,4,0.5616920434467645,[2.40873708]
2018,12,NCAAF_20181117_AF@WYO,Wyoming,,Air Force,,5-6,4-7,,14,17,35,27,14,0,0,21,7,10,7,3,1,-3,8,0.44190387447316226,[-2.2673007]
2018,12,NCAAF_20181117_IND@MICH,Michigan,Wolverines,Indiana,Hoosiers,10-1,5-6,1,15,17,31,20,3,12,10,6,7,10,0,3,5,-2,11,0.8974818615172095,[19.6616058]
2018,12,NCAAF_20181117_LIB@AUBURN,Auburn,Tigers,Liberty,Flames,7-4,4-6,1,32,0,53,0,15,17,21,0,0,0,0,0,3,32,53,0.9902242830505972,[36.22318471]
2018,12,NCAAF_20181117_MA@UGA,Georgia,Bulldogs,UMass,Minutemen,10-1,4-8,1,42,13,66,27,14,28,17,7,7,6,7,7,6,29,39,0.9977642513664208,[44.10411347]
2018,12,NCAAF_20181117_OREGST@WASH,Washington,Huskies,Oregon State,Beavers,8-3,2-9,1,35,16,42,23,28,7,7,0,3,13,0,7,6,19,19,0.9926954171030593,[37.88442154]
2018,12,NCAAF_20181117_GAS@CSTCAR,C. Carolina,,Ga. Southern,,5-6,8-3,,10,13,17,41,7,3,0,7,3,10,21,7,-3,-3,-24,0.35248390898103144,[-5.87401833]
2018,12,NCAAF_20181117_SALA@LALAF,Louisiana,,South Alabama,,6-5,2-9,,24,17,48,38,10,14,17,7,0,17,7,14,4,7,10,0.6354426223377335,[5.37260556]
2018,12,NCAAF_20181117_DUKE@CLEM,Clemson,Tigers,Duke,Blue Devils,11-0,7-4,1,14,6,35,6,0,14,14,7,6,0,0,0,4,8,29,0.9404614289594866,[24.18128333]
2018,12,NCAAF_20181117_UAB@TXAM,Texas A&M,,UAB,,7-4,9-2,,24,7,41,20,14,10,10,7,7,0,0,13,-2,17,21,0.8581568863790386,[16.6323474]
2018,12,NCAAF_20181117_UCONN@ECU,East Carolina,Pirates,UConn,Huskies,3-7,1-10,1,34,21,55,21,7,27,14,7,7,14,0,0,2,13,34,0.6191864472066464,[4.70613987]
2018,12,NCAAF_20181117_KANSAS@OKLA,Oklahoma,Sooners,Kansas,Jayhawks,10-1,3-8,1,21,10,55,40,7,14,14,20,7,3,7,23,7,11,15,0.9914428406671691,[36.98952067]
2018,12,NCAAF_20181117_RICE@LSU,LSU,Tigers,Rice,Owls,9-2,1-11,1,28,3,42,10,14,14,7,7,0,3,0,7,8,25,32,0.9980859346817061,[44.86675875]
2018,12,NCAAF_20181117_TNCHAT@SC,South Carolina,,Chattanooga,,6-4,6-5,,28,3,49,9,14,14,7,14,0,3,0,6,0,25,40,0.9605703893994951,[27.26371367]
2018,12,NCAAF_20181117_UTEP@WKY,W. Kentucky,,UTEP,,2-9,1-10,,40,0,40,16,27,13,0,0,0,0,8,8,1,40,24,0.7731927374491843,[11.6263535]
2018,12,NCAAF_20181117_CINCY@UCF,UCF,Knights,Cincinnati,Bearcats,10-0,9-2,1,21,6,38,13,7,14,7,10,6,0,0,7,1,15,25,0.9136610939217031,[21.15588134]
2018,12,NCAAF_20181117_IOWAST@TEXAS,Texas,Longhorns,Iowa St.,Cyclones,8-3,6-4,1,17,3,24,10,7,10,7,0,3,0,0,7,2,14,14,0.4818489139603813,[-0.70610736]
2018,12,NCAAF_20181117_NMEXST@BYU,BYU,,New Mexico St.,,6-5,3-8,,31,7,45,10,7,24,7,7,7,0,3,0,3,24,35,0.8027505254555614,[13.21010382]
2018,12,NCAAF_20181117_ARIZ@WASHST,Washington St.,Cougars,Arizona,Wildcats,10-1,5-6,1,55,14,69,28,21,34,0,14,7,7,14,0,5,41,41,0.6624578902068514,[6.50323348]
2018,12,NCAAF_20181117_ARIZST@OREG,Oregon,,Arizona St.,,7-4,6-5,,28,13,31,29,7,21,0,3,3,10,3,13,1,15,2,0.515043609791425,[0.58515811]
2018,12,NCAAF_20181117_SDGST@FRESNO,Fresno St.,Bulldogs,San Diego St.,Aztecs,9-2,7-4,1,10,14,23,14,7,3,7,6,7,7,0,0,2,-4,9,0.6606808324801079,[6.42785722]
2018,12,NCAAF_20181117_UNLV@HAWAII,Hawaii,,UNLV,,7-5,3-8,,6,21,35,28,3,3,7,22,7,14,0,7,4,-15,7,0.3494960240343732,[-5.99903801]
2018,12,NCAAF_20181116_BOISE@NMEX,New Mexico,Lobos,Boise St.,Broncos,3-8,9-2,1,7,24,14,45,0,7,0,7,14,10,7,14,-6,-17,-31,0.060735939162696706,[-24.02561722]
2018,12,NCAAF_20181116_MEMP@SMU,SMU,Mustangs,Memphis,Tigers,5-6,7-4,1,5,7,18,28,3,2,7,6,0,7,7,14,-2,-2,-10,0.3150944563468072,[-7.46946261]
2018,12,NCAAF_20181115_TOLEDO@KENTST,Kent St.,Golden Flashes,Toledo,Rockets,2-9,6-5,1,17,28,34,56,7,10,10,7,14,14,21,7,-4,-11,-22,0.0469587956401184,[-25.98753417]
2018,12,NCAAF_20181115_TULANE@HOU,Houston,Cougars,Tulane,Green Wave,8-3,5-6,1,31,9,48,17,14,17,10,7,6,3,0,8,3,22,31,0.655659211605705,[6.21566929]
2018,12,NCAAF_20181115_FAU@NTEXAS,North Texas,Mean Green,FAU,Owls,8-3,5-6,1,20,21,41,38,17,3,14,7,7,14,10,7,3,-1,3,0.2572789351678526,[-10.11146429]
2018,12,NCAAF_20181114_BUFF@OHIO,Ohio,Bobcats,Buffalo,Bulls,7-4,9-2,1,31,10,52,17,14,17,14,7,7,3,0,7,-2,21,35,0.5479875451019746,[1.87067395]
2018,12,NCAAF_20181114_MIAOH@NILL,N. Illinois,Huskies,Miami-OH,RedHawks,7-4,5-6,1,0,3,7,13,0,0,7,0,0,3,10,0,2,-3,-6,0.6701445780771721,[6.83107747]
2018,13,NCAAF_20181124_BAYLOR@TXTECH,Texas Tech,,Baylor,,5-7,6-6,,17,14,24,35,10,7,0,7,7,7,14,7,-1,3,-11,0.8245137855034297,[14.48349067]
2018,13,NCAAF_20181124_CUSE@BC,Boston College,Eagles,Syracuse,Orange,7-5,9-3,1,14,28,21,42,7,7,7,0,14,14,7,7,-2,-14,-21,0.6025433792716455,[4.03640995]
2018,13,NCAAF_20181124_FLA@FSU,Florida State,Seminoles,Florida,Gators,5-7,9-3,1,7,13,14,41,0,7,7,0,3,10,14,14,-4,-6,-27,0.44612853858103185,[-2.10331382]
2018,13,NCAAF_20181124_GATECH@UGA,Georgia,Bulldogs,Georgia Tech,Yellow Jackets,11-1,7-5,1,38,7,45,21,14,24,7,0,7,0,0,14,4,31,24,0.8665368023795046,[17.23923459]
2018,13,NCAAF_20181124_MICH@OHIOST,Ohio State,Buckeyes,Michigan,Wolverines,11-1,10-2,1,24,19,62,39,7,17,17,21,3,16,0,20,1,5,23,0.5860453730779518,[3.37564084]
2018,13,NCAAF_20181124_MRSHL@FIU,FIU,,Marshall,,8-4,8-3,,10,14,25,28,3,7,0,15,14,0,7,7,0,-4,-3,0.362035878381299,[-5.48190035]
2018,13,NCAAF_20181124_NAVY@TULANE,Tulane,,Navy,,6-6,3-9,,21,3,29,28,0,21,0,8,0,3,18,7,3,18,1,0.45163468065065693,[-1.88721375]
2018,13,NCAAF_20181124_PURDUE@IND,Indiana,,Purdue,,5-7,6-6,,7,14,21,28,0,7,0,14,7,7,7,7,-1,-7,-7,0.30669845339716084,[-7.8454646]
2018,13,NCAAF_20181124_WKY@LATECH,Louisiana Tech,Bulldogs,W. Kentucky,Hilltoppers,7-5,3-9,1,12,23,15,30,0,12,3,0,14,9,0,7,4,-11,-15,0.6689912517321537,[6.78795702]
2018,13,NCAAF_20181124_WAKE@DUKE,Duke,,Wake Forest,,7-5,6-6,,7,31,7,59,0,7,0,0,21,10,14,14,1,-24,-52,0.5323494556304469,[1.26055772]
2018,13,NCAAF_20181124_ODU@RICE,Rice,,Old Dominion,,2-11,4-8,,13,6,27,13,6,7,7,7,3,3,7,0,-2,7,14,0.2622022909233064,[-9.88497621]
2018,13,NCAAF_20181124_GAS@GAST,Georgia St.,,Ga. Southern,,2-10,9-3,,0,13,14,35,0,0,0,14,0,13,15,7,-7,-13,-21,0.338803090721703,[-6.45568637]
2018,13,NCAAF_20181124_NMEXST@LIB,Liberty,,New Mexico St.,,5-6,3-9,,28,14,28,21,17,11,0,0,14,0,0,7,2,14,7,0.5749264862083676,[2.93380938]
2018,13,NCAAF_20181124_TROY@APLST,App. St.,,Troy,,9-2,9-3,,21,3,21,10,7,14,0,0,0,3,7,0,0,18,11,0.6033543667445063,[4.06907054]
2018,13,NCAAF_20181124_WYO@NMEX,New Mexico,,Wyoming,,3-9,6-6,,3,14,3,31,0,3,0,0,7,7,3,14,-3,-11,-28,0.25746931094025094,[-10.11163785]
2018,13,NCAAF_20181124_LALAF@LAMON,UL-Monroe,,Louisiana,,6-6,7-5,,21,24,28,31,0,21,0,7,14,10,0,7,-1,-3,-3,0.5185673835387102,[0.72298049]
2018,13,NCAAF_20181124_STNFRD@UCLA,UCLA,Bruins,Stanford,Cardinal,3-9,7-4,1,20,27,42,49,6,14,16,6,10,17,14,8,-4,-7,-7,0.23255961183536789,[-11.34267785]
2018,13,NCAAF_20181124_UAB@MTSU,Middle Tenn.,,UAB,,8-4,9-3,,13,3,27,3,0,13,7,7,3,0,0,0,-1,10,24,0.5394934477981023,[1.53976786]
2018,13,NCAAF_20181124_USM@UTEP,UTEP,,So. Miss,,1-11,6-5,,0,19,7,39,0,0,0,7,16,3,7,13,-5,-19,-32,0.10299630566181528,[-19.6382793]
2018,13,NCAAF_20181124_ARIZST@ARIZ,Arizona,,Arizona St.,,5-7,7-5,,22,14,40,41,10,12,18,0,7,7,7,20,-2,8,-1,0.40398107769404157,[-3.77428836]
2018,13,NCAAF_20181124_AUBURN@BAMA,Alabama,Crimson Tide,Auburn,Tigers,12-0,7-5,1,17,14,52,21,7,10,21,14,7,7,7,0,5,3,31,0.8024508530678178,[13.20554673]
2018,13,NCAAF_20181124_ILL@NWEST,Northwestern,Wildcats,Illinois,Fighting Illini,8-4,4-8,1,21,6,24,16,7,14,3,0,3,3,0,10,4,15,8,0.9313224561921348,[23.07086806]
2018,13,NCAAF_20181124_MD@PSU,Penn State,Nittany Lions,Maryland,Terrapins,9-3,5-7,1,17,3,38,3,14,3,7,14,3,0,0,0,4,14,35,0.948373237463609,[25.30026517]
2018,13,NCAAF_20181124_MINN@WISC,Wisconsin,Badgers,Minnesota,Golden Gophers,7-5,6-6,1,7,17,15,37,0,7,0,8,3,14,6,14,1,-10,-22,0.8664859035739891,[17.23556601]
2018,13,NCAAF_20181124_PITT@MIAMI,Miami (Fla.),,Pittsburgh,,7-5,7-5,,10,0,24,3,3,7,7,7,0,0,3,0,0,10,21,0.6987434654089976,[8.08707909]
2018,13,NCAAF_20181124_SMU@TULSA,Tulsa,,SMU,,3-9,5-7,,21,7,27,24,7,14,3,3,0,7,7,10,-2,14,3,0.27903994699757306,[-9.09496919]
2018,13,NCAAF_20181124_TEMPLE@UCONN,UConn,,Temple,,1-11,8-4,,7,40,7,57,7,0,0,0,13,27,7,10,-7,-33,-50,0.06594205896549987,[-23.39697566]
2018,13,NCAAF_20181124_ARKST@TXSTSM,Texas St.,,Arkansas St.,,3-9,8-4,,0,7,7,33,0,0,7,0,7,0,21,5,-5,-7,-26,0.09967644954778632,[-19.92921507]
2018,13,NCAAF_20181124_RUT@MICHST,Michigan St.,,Rutgers,,7-5,1-11,,7,7,14,10,0,7,0,7,7,0,0,3,6,0,4,0.9185005200017081,[21.66310413]
2018,13,NCAAF_20181124_TENN@VANDY,Vanderbilt,,Tennessee,,6-6,5-7,,17,0,38,13,7,10,0,21,0,0,7,6,1,17,25,0.5513956791907925,[2.00609866]
2018,13,NCAAF_20181124_CHARLO@FAU,FAU,,Charlotte,,5-7,5-7,,21,10,24,27,7,14,0,3,10,0,7,10,0,11,-3,0.952379780062055,[25.90740209]
2018,13,NCAAF_20181124_COLO@CAL,California,,Colorado,,7-4,5-7,,24,7,33,21,21,3,3,6,0,7,14,0,2,17,12,0.5482793134633077,[1.88384127]
2018,13,NCAAF_20181124_KSTATE@IOWAST,Iowa St.,Cyclones,Kansas State,Wildcats,7-4,5-7,1,14,21,42,38,7,7,7,21,0,21,10,7,2,-7,4,0.7079991869918674,[8.50260555]
2018,13,NCAAF_20181124_NTEXAS@TXSA,UTSA,,North Texas,,3-9,9-3,,14,17,21,24,0,14,0,7,10,7,7,0,-6,-3,-3,0.227354824534728,[-11.60888384]
2018,13,NCAAF_20181124_SC@CLEM,Clemson,Tigers,South Carolina,Gamecocks,12-0,6-5,1,28,21,56,35,14,14,14,14,7,14,0,14,6,7,21,0.935719622251457,[23.60022016]
2018,13,NCAAF_20181124_SJST@FRESNO,Fresno St.,,San Jose St.,,10-2,1-11,,3,0,31,13,0,3,14,14,0,0,0,13,9,3,18,0.9856896130373713,[33.98673944]
2018,13,NCAAF_20181124_UK@LVILLE,Louisville,Cardinals,Kentucky,Wildcats,2-10,9-3,1,10,35,10,56,7,3,0,0,14,21,0,21,-7,-25,-46,0.38203667014392595,[-4.66065864]
2018,13,NCAAF_20181124_ND@USC,USC,Trojans,Notre Dame,Fighting Irish,5-7,12-0,1,10,7,17,24,7,3,0,7,0,7,10,7,-7,3,-7,0.18143050871981303,[-14.12978644]
2018,13,NCAAF_20181124_OKLAST@TCU,TCU,,Oklahoma State,,6-6,6-6,,7,3,31,24,0,7,17,7,3,0,7,14,0,4,7,0.4411665110628442,[-2.29840737]
2018,13,NCAAF_20181124_NEVADA@UNLV,UNLV,Rebels,Nevada,Wolf Pack,4-8,7-5,1,21,26,34,29,0,21,7,6,20,6,0,3,-3,-5,5,0.3068170533805332,[-7.84022021]
2018,13,NCAAF_20181124_BYU@UTAH,Utah,Utes,BYU,Cougars,9-3,6-6,1,0,20,35,27,0,0,14,21,13,7,7,0,3,-20,8,0.8492026694644013,[16.04123028]
2018,13,NCAAF_20181124_UTAHST@BOISE,Boise St.,Broncos,Utah St.,Aggies,10-2,10-2,1,17,14,33,24,7,10,3,13,7,7,0,10,0,3,9,0.6191007834326637,[4.7069936]
2018,13,NCAAF_20181123_AKRON@OHIO,Ohio,,Akron,,8-4,4-7,,28,7,49,28,21,7,7,14,0,7,7,14,4,21,21,0.825547346863474,[14.54575983]
2018,13,NCAAF_20181123_BUFF@BGREEN,Bowling Green,,Buffalo,,3-9,10-2,,7,34,14,44,7,0,0,7,13,21,7,3,-7,-27,-30,0.1636421473892613,[-15.21168103]
2018,13,NCAAF_20181123_CMICH@TOLEDO,Toledo,,C. Michigan,,7-5,1-11,,24,0,51,13,14,10,13,14,0,0,0,13,6,24,38,0.7493667046246171,[10.44287727]
2018,13,NCAAF_20181123_EMICH@KENTST,Kent St.,,E. Michigan,,2-10,7-5,,10,21,20,28,10,0,7,3,7,14,7,0,-5,-11,-8,0.07839575248937514,[-21.98748446]
2018,13,NCAAF_20181123_HOU@MEMP,Memphis,,Houston,,8-4,8-4,,17,21,52,31,3,14,14,21,7,14,10,0,0,-4,21,0.5460706943526134,[1.79726657]
2018,13,NCAAF_20181123_NEB@IOWA,Iowa,Hawkeyes,Nebraska,Cornhuskers,8-4,4-8,1,21,13,31,28,7,14,7,3,7,6,0,15,4,8,3,0.8989747636711467,[19.8101749]
2018,13,NCAAF_20181123_TEXAS@KANSAS,Kansas,Jayhawks,Texas,Longhorns,3-9,9-3,1,0,7,17,24,0,0,0,17,7,0,14,3,-6,-7,-7,0.05172925879508228,[-25.28523326]
2018,13,NCAAF_20181123_ARK@MIZZOU,Missouri,Tigers,Arkansas,Razorbacks,8-4,2-10,1,28,0,38,0,7,21,10,0,0,0,0,0,6,28,38,0.8909083941700138,[19.1213631]
2018,13,NCAAF_20181123_CSTCAR@SALA,South Alabama,,C. Carolina,,3-9,5-7,,24,7,31,28,10,14,7,0,0,7,7,14,-2,17,3,0.43982663145516476,[-2.3511488]
2018,13,NCAAF_20181123_ECU@CINCY,Cincinnati,Bearcats,East Carolina,Pirates,10-2,3-8,1,42,6,56,6,21,21,7,7,0,6,0,0,7,36,50,0.7781358714291899,[11.89346273]
2018,13,NCAAF_20181123_OREG@OREGST,Oregon State,Beavers,Oregon,Ducks,2-10,8-4,1,3,21,15,55,0,3,6,6,14,7,13,21,-6,-18,-40,0.055716998611774926,[-24.71794017]
2018,13,NCAAF_20181123_UCF@SFLA,South Florida,Bulls,UCF,Knights,7-5,11-0,1,3,17,10,38,0,3,7,0,7,10,7,14,-4,-14,-28,0.11396721328977444,[-18.72264292]
2018,13,NCAAF_20181123_OKLA@WVU,West Virginia,Mountaineers,Oklahoma,Sooners,8-3,11-1,1,28,35,56,59,14,14,21,7,14,21,10,14,-3,-7,-3,0.2168152614600254,[-12.15871261]
2018,13,NCAAF_20181123_WASH@WASHST,Washington St.,Cougars,Washington,Huskies,10-2,9-3,1,7,14,15,28,0,7,8,0,7,7,6,8,1,-7,-13,0.324874094774667,[-7.05167142]
2018,13,NCAAF_20181122_COLOST@AF,Air Force,Falcons,Colorado St.,Rams,5-7,3-9,1,17,13,27,19,7,10,0,10,0,13,0,6,2,4,8,0.5763128640183385,[2.98876317]
2018,13,NCAAF_20181122_MISSST@MISS,Ole Miss,Rebels,Miss. State,Bulldogs,5-7,8-4,1,3,21,3,35,0,3,0,0,7,14,7,7,-3,-18,-32,0.15054823788652927,[-16.05777057]
2018,13,NCAAF_20181120_BALLST@MIAOH,Miami-OH,RedHawks,Ball St.,Cardinals,6-6,4-8,1,21,21,42,21,7,14,14,7,14,7,0,0,2,0,21,0.8930825614683833,[19.3032942]
2018,13,NCAAF_20181120_NILL@WMICH,W. Michigan,Broncos,N. Illinois,Huskies,7-5,7-5,1,13,7,28,21,7,6,8,7,7,0,14,0,0,6,7,0.32751382007176044,[-6.93795089]
2018,14,NCAAF_20181201_AKRON@SC,South Carolina,Gamecocks,Akron,Zips,7-5,4-8,1,28,3,28,3,14,14,0,0,3,0,0,0,3,25,25,0.9114148128127766,[21.07840426]
2018,14,NCAAF_20181201_DRA@IOWAST,Iowa St.,Cyclones,Drake,Bulldogs,8-4,7-4,1,20,14,27,24,7,13,7,0,7,7,10,0,1,6,3,,
2018,14,NCAAF_20181201_ECU@NCST,NC State,Wolfpack,East Carolina,Pirates,9-3,3-9,1,27,0,58,3,17,10,14,17,0,0,0,3,6,27,55,0.9630621366559157,[27.91748056]
2018,14,NCAAF_20181201_LALAF@APLST,App. St.,Mountaineers,Louisiana,Ragin' Cajuns,10-2,7-6,1,14,6,30,19,7,7,6,10,3,3,10,3,3,8,11,0.8759310619741569,[18.03836603]
2018,14,NCAAF_20181201_MRSHL@VATECH,Virginia Tech,Hokies,Marshall,Thundering Herd,6-6,8-4,1,31,6,41,20,10,21,3,7,6,0,0,14,-2,25,21,0.7465328459366243,[10.36519492]
2018,14,NCAAF_20181201_TEXAS@OKLA,Oklahoma,Sooners,Texas,Longhorns,12-1,9-4,1,20,14,39,27,3,17,7,12,7,7,13,0,3,6,12,0.7417164802052386,[10.13133569]
2018,14,NCAAF_20181201_UAB@MTSU,Middle Tenn.,Blue Raiders,UAB,Blazers,8-5,10-3,1,16,24,25,27,13,3,6,3,3,21,0,3,-2,-8,-2,0.592172709806086,[3.64142231]
2018,14,NCAAF_20181201_NRFST@LIB,Liberty,Flames,Norfolk St.,Spartans,6-6,4-7,1,38,10,52,17,10,28,7,7,3,7,0,7,2,28,35,,
2018,14,NCAAF_20181201_STNFRD@CAL,California,Golden Bears,Stanford,Cardinal,7-5,8-4,1,6,13,13,23,0,6,0,7,10,3,0,10,-1,-7,-10,0.25977394658538455,[-10.05942801]
2018,14,NCAAF_20181201_MEMP@UCF,UCF,Knights,Memphis,Tigers,12-0,8-5,1,21,38,56,41,7,14,14,21,24,14,3,0,4,-17,15,0.7837179614411909,[12.2581281]
2018,14,NCAAF_20181201_BAMA@UGA,Georgia,Bulldogs,Alabama,Crimson Tide,11-2,13-0,1,21,14,28,35,7,14,7,0,0,14,7,14,-2,7,-7,0.36485222667502115,[-5.39672561]
2018,14,NCAAF_20181201_CLEM@PITT,Pittsburgh,Panthers,Clemson,Tigers,7-6,13-0,1,10,28,10,42,3,7,0,0,14,14,0,14,-6,-18,-32,0.04397253527248213,[-26.65164214]
2018,14,NCAAF_20181201_NWEST@OHIOST,Ohio State,Buckeyes,Northwestern,Wildcats,12-1,8-5,1,24,7,45,24,14,10,7,14,7,0,14,3,4,17,21,0.856233166117451,[16.6117632]
2018,14,NCAAF_20181130_NILL@BUFF,Buffalo,Bulls,N. Illinois,Huskies,10-3,8-5,1,22,10,29,30,7,15,7,0,0,10,7,13,2,12,-1,0.5085648361567034,[0.33535218]
2018,14,NCAAF_20181130_UTAH@WASH,Washington,Huskies,Utah,Utes,10-3,9-4,1,3,0,10,3,0,3,7,0,0,0,3,0,1,3,7,0.6870597807429079,[7.61488026]
2018,15,NCAAF_20181208_NAVY@ARMY,Army,Black Knights,Navy,Midshipmen,10-2,3-10,1,7,0,17,10,7,0,3,7,0,0,0,10,7,7,7,0.6027371191549672,[4.05333489]
2019,1,NCAAF_20190902_ND@LVILLE,Louisville,Cardinals,Notre Dame,Fighting Irish,0-1,1-0,0,14,21,17,35,14,0,0,3,14,7,7,7,-1,-7,-18,0.07441691749975077,[-22.4601524]
2019,1,NCAAF_20190901_HOU@OKLA,Oklahoma,Sooners,Houston,Cougars,1-0,0-1,0,21,10,49,31,7,14,21,7,0,10,7,14,1,11,18,0.9216055698036706,[22.02907082]
2019,1,NCAAF_20190831_AKRON@ILL,Illinois,Fighting Illini,Akron,Zips,1-0,0-1,1,28,3,42,3,14,14,14,0,3,0,0,0,1,25,39,0.5544926179060361,[2.13172791]
2019,1,NCAAF_20190831_BOISE@FSU,Florida State,Seminoles,Boise St.,Broncos,0-1,1-0,0,31,19,31,36,21,10,0,0,6,13,7,10,-1,12,-5,0.43237615554608766,[-2.64991887]
2019,1,NCAAF_20190831_ECU@NCST,NC State,Wolfpack,East Carolina,Pirates,1-0,0-1,0,17,3,34,6,7,10,7,10,3,0,0,3,1,14,28,0.976120473647409,[30.79667022]
2019,1,NCAAF_20190831_FAU@OHIOST,Ohio State,Buckeyes,FAU,Owls,1-0,0-1,1,28,3,45,21,28,0,7,10,0,3,3,15,1,25,24,0.959683005264523,[27.17969761]
2019,1,NCAAF_20190831_HOW@MD,Maryland,Terrapins,Howard,Bison,1-0,0-1,1,56,0,79,0,28,28,16,7,0,0,0,0,1,56,79,0.9909267755344332,[36.75700387]
2019,1,NCAAF_20190831_IND@BALLST,Ball St.,Cardinals,Indiana,Hoosiers,0-1,1-0,1,10,16,24,34,3,7,7,7,10,6,7,11,-1,-6,-10,0.024802824440116722,[-30.54530011]
2019,1,NCAAF_20190831_INST@KANSAS,Kansas,Jayhawks,Indiana St.,Sycamores,1-0,0-1,1,10,3,24,17,7,3,6,8,0,3,0,14,1,7,7,0.9372112447564013,[23.83100832]
2019,1,NCAAF_20190831_MISS@MEMP,Memphis,Tigers,Ole Miss,Rebels,1-0,0-1,0,13,0,15,10,7,6,0,2,0,0,3,7,1,13,5,0.670027420168739,[6.84523905]
2019,1,NCAAF_20190831_MISSST@LALAF,Louisiana,Ragin' Cajuns,Miss. State,Bulldogs,0-1,1-0,0,14,21,28,38,7,7,0,14,7,14,7,10,-1,-7,-10,0.011149872074114886,[-35.55294155]
2019,1,NCAAF_20190831_SALA@NEB,Nebraska,Cornhuskers,South Alabama,Jaguars,1-0,0-1,1,14,7,35,21,7,7,14,7,7,0,14,0,1,7,14,0.9472151814665486,[25.17916016]
2019,1,NCAAF_20190831_TOLEDO@UK,Kentucky,Wildcats,Toledo,Rockets,1-0,0-1,0,14,14,38,24,0,14,10,14,7,7,3,7,1,0,14,0.6403207874374577,[5.59015599]
2019,1,NCAAF_20190831_JMAD@WVU,West Virginia,Mountaineers,James Madison,Dukes,1-0,0-1,0,3,7,20,13,0,3,7,10,7,0,3,3,1,-4,7,0.7710341849681981,[11.54785248]
2019,1,NCAAF_20190831_RI@OHIO,Ohio,Bobcats,Rhode Island,Rams,1-0,0-1,0,17,6,41,20,7,10,17,7,0,6,7,7,1,11,21,0.9838561837191337,[33.30653035]
2019,1,NCAAF_20190831_BUCK@TEMPLE,Temple,Owls,Bucknell,Bison,1-0,0-1,1,35,9,56,12,21,14,7,14,0,9,3,0,1,26,44,,
2019,1,NCAAF_20190831_EWASH@WASH,Washington,Huskies,E. Washington,Eagles,1-0,0-1,0,28,7,47,14,21,7,14,5,0,7,0,7,1,21,33,0.998831784390915,[47.35403763]
2019,1,NCAAF_20190831_COLG@AF,Air Force,Falcons,Colgate,Raiders,1-0,0-2,0,35,0,48,7,7,28,13,0,0,0,7,0,1,35,41,0.7779570059130815,[11.90653084]
2019,1,NCAAF_20190831_DUKE@BAMA,Alabama,Crimson Tide,Duke,Blue Devils,1-0,0-1,1,14,3,42,3,0,14,21,7,0,3,0,0,1,11,39,0.9760295794909223,[30.77156532]
2019,1,NCAAF_20190831_EMICH@CSTCAR,C. Carolina,Chanticleers,E. Michigan,Eagles,0-1,1-0,1,13,7,23,30,10,3,0,10,0,7,16,7,-1,6,-7,0.1161256755144977,[-18.58497516]
2019,1,NCAAF_20190831_ETNST@APLST,App. St.,Mountaineers,ETSU,Buccaneers,1-0,0-1,0,14,0,42,7,7,7,14,14,0,0,7,0,1,14,35,0.9999228896262623,[58.87322928]
2019,1,NCAAF_20190831_GAST@TENN,Tennessee,Volunteers,Georgia St.,Panthers,0-1,1-0,1,17,14,30,38,14,3,3,10,7,7,7,17,-1,3,-8,0.873398086038909,[17.77632326]
2019,1,NCAAF_20190831_HOLY@NAVY,Navy,Midshipmen,Holy Cross,Crusaders,1-0,0-1,1,24,7,45,7,10,14,14,7,0,7,0,0,1,17,38,0.982049443256733,[32.64087924]
2019,1,NCAAF_20190831_IDAHO@PSU,Penn State,Nittany Lions,Idaho,Vandals,1-0,0-1,0,44,0,79,7,20,24,14,21,0,0,0,7,1,44,72,0.9988182325205368,[47.30002533]
2019,1,NCAAF_20190831_SC@UNC,North Carolina,Tar Heels,South Carolina,Gamecocks,1-0,0-1,0,6,13,24,20,3,3,3,15,10,3,7,0,1,-7,4,0.14871050406177355,[-16.21086723]
2019,1,NCAAF_20190831_MTST@TXTECH,Texas Tech,Red Raiders,Montana St.,Bobcats,1-0,0-1,0,28,7,45,10,14,14,3,14,0,7,0,3,1,21,35,0.9812949431938526,[32.37973243]
2019,1,NCAAF_20190831_NWEST@STNFRD,Stanford,Cardinal,Northwestern,Wildcats,1-0,0-1,1,10,0,17,7,0,10,0,7,0,0,0,7,1,10,10,0.496295343085682,[-0.14447446]
2019,1,NCAAF_20190831_PORTST@ARK,Arkansas,Razorbacks,Portland St.,Vikings,1-0,0-1,0,10,6,20,13,10,0,7,3,3,3,0,7,1,4,7,0.9089728374283292,[20.76114525]
2019,1,NCAAF_20190831_VATECH@BC,Boston College,Eagles,Virginia Tech,Hokies,1-0,0-1,1,28,14,35,28,7,21,0,7,7,7,7,7,1,14,7,0.5270207526831816,[1.05454897]
2019,1,NCAAF_20190831_CAMP@TROY,Troy,Trojans,Campbell,Fighting Camels,1-0,0-1,1,20,7,43,14,17,3,16,7,7,0,0,7,1,13,29,0.9997421204066427,[54.02329724]
2019,1,NCAAF_20190831_CUSE@LIB,Liberty,Flames,Syracuse,Orange,0-1,1-0,0,0,10,0,24,0,0,0,0,3,7,7,7,-1,-10,-24,0.0460497660090563,[-26.20587324]
2019,1,NCAAF_20190831_SAMST@NMEX,New Mexico,Lobos,Sam Houston,Bearkats,1-0,0-1,1,22,16,39,31,13,9,10,7,0,16,7,8,1,6,8,,
2019,1,NCAAF_20190831_UIW@TXSA,UTSA,Roadrunners,Incarnate Word,Cardinals,1-0,0-1,1,21,7,35,7,7,14,7,7,0,7,0,0,1,14,28,0.9898528270822491,[36.1073862]
2019,1,NCAAF_20190831_DAVIS@CAL,California,Golden Bears,UC-Davis,Aggies,1-0,0-1,1,13,10,27,13,0,13,7,7,10,0,3,0,1,3,14,0.8443242756452489,[15.75052067]
2019,1,NCAAF_20190831_VMI@MRSHL,Marshall,Thundering Herd,VMI,Keydets,1-0,0-1,0,35,7,56,17,14,21,14,7,0,7,0,10,1,28,39,0.9999983914929319,[72.44397557]
2019,1,NCAAF_20190831_ALCORN@USM,So. Miss,Golden Eagles,Alcorn St.,Braves,1-0,0-1,1,13,0,38,10,10,3,15,10,0,0,10,0,1,13,28,0.8108186139596851,[13.70508973]
2019,1,NCAAF_20190831_ILST@NILL,N. Illinois,,Illinois St.,,1-0,0-1,,3,3,24,10,3,0,7,14,0,3,0,7,1,0,14,0.2967395730291651,[-8.30474666]
2019,1,NCAAF_20190831_MONNJ@WMICH,W. Michigan,,Monmouth,,1-0,0-1,,31,7,48,13,21,10,14,3,0,7,6,0,1,24,35,,
2019,1,NCAAF_20190831_NICHST@KSTATE,Kansas State,Wildcats,Nicholls St.,Colonels,1-0,0-1,1,28,0,49,14,14,14,0,21,0,0,7,7,1,28,35,0.9223359174056588,[22.1069589]
2019,1,NCAAF_20190831_NRFST@ODU,Old Dominion,Monarchs,Norfolk St.,Spartans,1-0,0-1,1,14,6,24,21,14,0,3,7,0,6,0,15,1,8,3,0.9841561081788813,[33.42314498]
2019,1,NCAAF_20190831_SFA@BAYLOR,Baylor,Bears,S.F. Austin,Lumberjacks,1-0,0-1,0,35,7,56,17,14,21,14,7,7,0,0,10,1,28,39,0.9979680212641608,[44.69982742]
2019,1,NCAAF_20190831_SMU@ARKST,Arkansas St.,Red Wolves,SMU,Mustangs,0-1,1-0,0,9,16,30,37,7,2,14,7,3,13,14,7,-1,-7,-7,0.368127554345555,[-5.24011103]
2019,1,NCAAF_20190831_ABIL@NTEXAS,North Texas,Mean Green,Abil Christian,Wildcats,1-0,0-1,1,38,10,51,31,17,21,10,3,0,10,7,14,1,28,20,0.977746327593665,[31.25990024]
2019,1,NCAAF_20190831_GAS@LSU,LSU,Tigers,Ga. Southern,Eagles,1-0,0-1,1,42,3,55,3,21,21,10,3,0,3,0,0,1,39,52,0.9666273269768241,[28.52335292]
2019,1,NCAAF_20190831_MIAOH@IOWA,Iowa,Hawkeyes,Miami-OH,RedHawks,1-0,0-1,1,10,7,38,14,3,7,14,14,0,7,0,7,1,3,24,0.9503857322417489,[25.64859566]
2019,1,NCAAF_20190831_MIZZOU@WYO,Wyoming,Cowboys,Missouri,Tigers,1-0,0-1,1,27,17,37,31,0,27,7,3,14,3,0,14,1,10,6,0.10599221415519788,[-19.41805881]
2019,1,NCAAF_20190831_MTSU@MICH,Michigan,Wolverines,Middle Tenn.,Blue Raiders,1-0,0-1,1,27,14,40,21,10,17,6,7,7,7,0,7,1,13,19,0.9631103353561656,[27.81694492]
2019,1,NCAAF_20190831_OREG@AUBURN,Auburn,Tigers,Oregon,Ducks,1-0,0-1,0,6,14,27,21,3,3,7,14,14,0,7,0,1,-8,6,0.8115882464523161,[13.74938678]
2019,1,NCAAF_20190831_UGA@VANDY,Vanderbilt,Commodores,Georgia,Bulldogs,0-1,1-0,0,6,21,6,30,0,6,0,0,14,7,3,6,-1,-15,-24,0.033752254512432245,[-28.44424591]
2019,1,NCAAF_20190831_UVA@PITT,Pittsburgh,Panthers,Virginia,Cavaliers,0-1,1-0,1,14,13,14,30,0,14,0,0,10,3,10,7,-1,1,-16,0.5639080557642624,[2.50301109]
2019,1,NCAAF_20190831_ARPB@TCU,TCU,Horned Frogs,Ark.-Pine Bluff,Golden Lions,1-0,0-1,0,16,0,39,7,10,6,13,10,0,0,7,0,1,16,32,0.9999967956586665,[70.20339501]
2019,1,NCAAF_20190831_GRAM@LAMON,UL-Monroe,Warhawks,Grambling,Tigers,1-0,0-1,0,17,9,31,9,7,10,7,7,6,3,0,0,1,8,22,0.8263601286403125,[14.62240341]
2019,1,NCAAF_20190831_HOUBP@UTEP,UTEP,Miners,Houston Christian,Huskies,1-0,0-1,0,20,17,36,34,3,17,13,3,0,17,11,6,1,3,2,0.6614260286380058,[6.47759801]
2019,1,NCAAF_20190831_LATECH@TEXAS,Texas,Longhorns,Louisiana Tech,Bulldogs,1-0,0-1,1,24,0,45,14,7,17,14,7,0,0,0,14,1,24,31,0.9582451553548927,[26.92542191]
2019,1,NCAAF_20190831_WBRST@SDGST,San Diego St.,Aztecs,Weber St.,Wildcats,1-0,0-1,1,3,0,6,0,0,3,0,3,0,0,0,0,1,3,6,0.7880354703562323,[12.44034372]
2019,1,NCAAF_20190831_NMEXST@WASHST,Washington St.,Cougars,New Mexico St.,Aggies,1-0,0-1,0,35,7,58,7,14,21,13,10,7,0,0,0,1,28,51,0.979419980929343,[31.76760077]
2019,1,NCAAF_20190831_SUT@UNLV,UNLV,Rebels,So. Utah,Thunderbirds,1-0,0-1,0,35,7,56,23,7,28,21,0,0,7,0,16,1,28,33,0.9452905507826437,[24.90501682]
2019,1,NCAAF_20190831_FRESNO@USC,USC,Trojans,Fresno St.,Bulldogs,1-0,0-1,1,17,10,31,23,14,3,14,0,3,7,3,10,1,7,8,0.503430651592204,[0.13378851]
2019,1,NCAAF_20190830_RICE@ARMY,Army,Black Knights,Rice,Owls,1-0,0-1,0,7,7,14,7,0,7,0,7,0,7,0,0,1,0,7,0.9758537858463154,[30.72323734]
2019,1,NCAAF_20190830_TULSA@MICHST,Michigan St.,Spartans,Tulsa,Golden Hurricane,1-0,0-1,1,25,7,28,7,7,18,3,0,0,7,0,0,1,18,21,0.9083527615718028,[20.70238577]
2019,1,NCAAF_20190830_WISC@SFLA,South Florida,Bulls,Wisconsin,Badgers,0-1,1-0,0,0,28,0,49,0,0,0,0,7,21,14,7,-1,-28,-49,0.11531856309512523,[-18.64938007]
2019,1,NCAAF_20190830_MA@RUT,Rutgers,Scarlet Knights,UMass,Minutemen,1-0,0-1,0,38,21,48,21,7,31,3,7,21,0,0,0,1,17,27,0.6571119175076542,[6.29457003]
2019,1,NCAAF_20190830_UTAHST@WAKE,Wake Forest,Demon Deacons,Utah St.,Aggies,1-0,0-1,1,17,21,38,35,10,7,14,7,7,14,7,7,1,-4,3,0.6003961840559904,[3.9574682]
2019,1,NCAAF_20190830_PURDUE@NEVADA,Nevada,Wolf Pack,Purdue,Boilermakers,1-0,0-1,0,7,24,34,31,0,7,10,17,10,14,7,0,1,-17,3,0.07927697590235705,[-21.93568218]
2019,1,NCAAF_20190830_COLOST@COLO,Colorado,Buffaloes,Colorado St.,Rams,1-0,0-1,1,24,21,52,31,7,17,14,14,7,14,3,7,1,3,21,0.6770420904452075,[7.147907]
2019,1,NCAAF_20190830_OKLAST@OREGST,Oregon State,Beavers,Oklahoma State,Cowboys,0-1,1-0,1,16,31,36,52,10,6,7,13,7,24,14,7,-1,-15,-16,0.010688763239343646,[-35.8022766]
2019,1,NCAAF_20190829_ALBANY@CMICH,C. Michigan,,Albany,,1-0,0-1,,24,7,38,21,7,17,7,7,0,7,7,7,1,17,17,0.9321730863355889,[23.21485963]
2019,1,NCAAF_20190829_MRGNST@BGREEN,Bowling Green,,Morgan St.,,1-0,0-1,,30,3,46,3,13,17,7,9,0,3,0,0,1,27,43,0.9967824695259949,[42.39095849]
2019,1,NCAAF_20190829_ROB@BUFF,Buffalo,,Robert Morris,,1-0,0-1,,28,10,38,10,21,7,10,0,7,3,0,0,1,18,28,,
2019,1,NCAAF_20190829_UCLA@CINCY,Cincinnati,Bearcats,UCLA,Bruins,1-0,0-1,1,10,7,24,14,7,3,7,7,0,7,7,0,1,3,10,0.48556097510906004,[-0.56320897]
2019,1,NCAAF_20190829_WAG@UCONN,UConn,Huskies,Wagner,Seahawks,1-0,0-1,0,10,0,24,21,7,3,14,0,0,0,14,7,1,10,3,0.9034063460620518,[20.2438729]
2019,1,NCAAF_20190829_CAR@WKY,W. Kentucky,,Cent. Ark.,,0-1,1-0,,21,14,28,35,14,7,7,0,0,14,0,21,-1,7,-7,0.7745763188585935,[11.73059514]
2019,1,NCAAF_20190829_FAMU@UCF,UCF,Knights,Florida A&M,Rattlers,1-0,0-1,0,48,0,62,0,17,31,7,7,0,0,0,0,1,48,62,0.9999985504743044,[72.77676901]
2019,1,NCAAF_20190829_GRDWB@CHARLO,Charlotte,,Gardner-Webb,,1-0,0-1,,35,14,49,28,7,28,7,7,0,14,7,7,1,21,21,0.9558720962835611,[26.52085256]
2019,1,NCAAF_20190829_ALST@UAB,UAB,Blazers,Alabama St.,Hornets,1-0,0-1,0,24,13,24,19,14,10,0,0,13,0,6,0,1,11,5,0.9865759315876158,[34.44049201]
2019,1,NCAAF_20190829_FIU@TULANE,Tulane,Green Wave,FIU,Panthers,1-0,0-1,1,28,7,42,14,7,21,14,0,0,7,7,0,1,21,28,0.6197528994517569,[4.74249955]
2019,1,NCAAF_20190829_GATECH@CLEM,Clemson,Tigers,Georgia Tech,Yellow Jackets,1-0,0-1,1,28,0,52,14,14,14,14,10,0,0,7,7,1,28,38,0.9218533336580148,[22.05543172]
2019,1,NCAAF_20190829_TXSTSM@TXAM,Texas A&M,Aggies,Texas St.,Bobcats,1-0,0-1,1,28,0,41,7,14,14,3,10,0,0,0,7,1,28,34,0.9922084509222623,[37.62699149]
2019,1,NCAAF_20190829_SDST@MINN,Minnesota,Golden Gophers,S. Dakota St.,Jackrabbits,1-0,0-1,1,13,7,28,21,0,13,7,8,0,7,14,0,1,6,7,,
2019,1,NCAAF_20190829_KENTST@ARIZST,Arizona St.,Sun Devils,Kent St.,Golden Flashes,1-0,0-1,0,10,0,30,7,10,0,17,3,0,0,0,7,1,10,23,0.9662823229692369,[28.45142166]
2019,1,NCAAF_20190829_NCO@SJST,San Jose St.,Spartans,N. Colorado,Bears,1-0,0-1,1,21,6,35,18,14,7,7,7,3,3,9,3,1,15,17,0.39839119422210234,[-4.00633197]
2019,1,NCAAF_20190829_UTAH@BYU,BYU,Cougars,Utah,Utes,0-1,1-0,1,6,9,12,30,0,6,0,6,3,6,7,14,-1,-3,-18,0.15911090437763886,[-15.52848561]
2019,1,NCAAF_20190824_MIAMI@FLA,Florida,Gators,Miami (Fla.),Hurricanes,1-0,0-1,0,7,13,24,20,7,0,10,7,3,10,0,7,1,-6,4,0.4146321344337578,[-3.35495612]
2019,1,NCAAF_20190824_ARIZ@HAWAII,Hawaii,Rainbow Warriors,Arizona,Wildcats,1-0,0-1,1,28,21,45,38,14,14,7,10,0,21,14,3,1,7,7,0.08797498269484283,[-21.05478887]
2019,2,NCAAF_20190908_OREGST@HAWAII,Hawaii,,Oregon State,,2-0,0-2,,21,28,31,28,7,14,7,3,14,14,0,0,2,-7,3,0.49163741910762004,[-0.32551093]
2019,2,NCAAF_20190907_OHIO@PITT,Pittsburgh,Panthers,Ohio,Bobcats,1-1,1-1,1,17,3,20,10,3,14,3,0,0,3,7,0,0,14,10,0.5387010229037679,[1.50868567]
2019,2,NCAAF_20190907_BGREEN@KSTATE,Kansas State,Wildcats,Bowling Green,Falcons,2-0,1-1,1,38,0,52,0,17,21,7,7,0,0,0,0,1,38,52,0.9535443265265742,[26.08998714]
2019,2,NCAAF_20190907_CHARSO@SC,South Carolina,Gamecocks,Charleston So.,Buccaneers,1-1,0-2,1,44,3,72,10,21,23,7,21,3,0,0,7,1,41,62,0.9892433002839367,[35.69557069]
2019,2,NCAAF_20190907_CINCY@OHIOST,Ohio State,Buckeyes,Cincinnati,Bearcats,2-0,1-1,1,28,0,42,0,7,21,7,7,0,0,0,0,1,28,42,0.9674533638800057,[28.64241981]
2019,2,NCAAF_20190907_CUSE@MD,Maryland,Terrapins,Syracuse,Orange,2-0,1-1,0,42,13,63,20,21,21,7,14,7,6,7,0,1,29,43,0.36516164792841566,[-5.35228366]
2019,2,NCAAF_20190907_ODU@VATECH,Virginia Tech,Hokies,Old Dominion,Monarchs,1-1,1-1,1,17,3,31,17,10,7,7,7,3,0,7,7,0,14,14,0.9661766606118756,[28.37435518]
2019,2,NCAAF_20190907_RUT@IOWA,Iowa,Hawkeyes,Rutgers,Scarlet Knights,2-0,1-1,1,20,0,30,0,7,13,7,3,0,0,0,0,1,20,30,0.9642817480840519,[27.99143586]
2019,2,NCAAF_20190907_SO@MEMP,Memphis,Tigers,Southern U.,Jaguars,2-0,0-2,0,27,17,55,24,17,10,21,7,7,10,7,0,2,10,31,0.9999357251434959,[59.45849208]
2019,2,NCAAF_20190907_UAB@AKRON,Akron,Zips,UAB,Blazers,0-2,2-0,1,6,17,20,31,6,0,0,14,7,10,14,0,-2,-11,-11,0.3901318371276401,[-4.33181068]
2019,2,NCAAF_20190907_VANDY@PURDUE,Purdue,Boilermakers,Vanderbilt,Commodores,1-1,0-2,0,14,10,42,24,7,7,14,14,7,3,0,14,1,4,18,0.769679332907713,[11.45610478]
2019,2,NCAAF_20190907_WVU@MIZZOU,Missouri,Tigers,West Virginia,Mountaineers,1-1,1-1,1,31,0,38,7,10,21,0,7,0,0,0,7,0,31,31,0.4789529266747373,[-0.81957134]
2019,2,NCAAF_20190907_WCAR@NCST,NC State,Wolfpack,W. Carolina,Catamounts,2-0,0-2,0,24,0,41,0,3,21,10,7,0,0,0,0,2,24,41,0.9998798300071463,[57.02251092]
2019,2,NCAAF_20190907_NILL@UTAH,Utah,Utes,N. Illinois,Huskies,2-0,1-1,0,21,17,35,17,0,21,7,7,7,10,0,0,1,4,18,0.7775168173369555,[11.86048097]
2019,2,NCAAF_20190907_FORD@BALLST,Ball St.,Cardinals,Fordham,Rams,1-1,0-2,1,28,14,57,29,14,14,22,7,14,0,15,0,1,14,28,0.9793303665180402,[31.67796728]
2019,2,NCAAF_20190907_SFLA@GATECH,Georgia Tech,Yellow Jackets,South Florida,Bulls,1-1,0-2,1,14,3,14,10,0,14,0,0,3,0,0,7,1,11,4,0.7395785449901461,[9.96942399]
2019,2,NCAAF_20190907_TNTECH@MIAOH,Miami-OH,RedHawks,Tenn. Tech,Golden Eagles,1-1,1-1,1,41,3,48,17,10,31,0,7,3,0,0,14,0,38,31,0.9964385617793334,[41.78537696]
2019,2,NCAAF_20190907_CHARLO@APLST,App. St.,Mountaineers,Charlotte,49ers,2-0,1-1,1,28,13,56,41,14,14,14,14,6,7,15,13,1,15,15,0.927096749457567,[22.5849198]
2019,2,NCAAF_20190907_CMICH@WISC,Wisconsin,Badgers,C. Michigan,Chippewas,2-0,1-1,0,44,0,61,0,16,28,10,7,0,0,0,0,1,44,61,0.9806756291572938,[32.10957545]
2019,2,NCAAF_20190907_EIL@IND,Indiana,Hoosiers,E. Illinois,Panthers,2-0,0-2,1,35,0,52,0,21,14,7,10,0,0,0,0,2,35,52,0.9850247288097426,[33.70637695]
2019,2,NCAAF_20190907_GRAM@LATECH,Louisiana Tech,Bulldogs,Grambling,Tigers,1-1,0-2,0,20,0,20,14,7,13,0,0,0,0,7,7,1,20,6,0.9371112122167381,[23.77219575]
2019,2,NCAAF_20190907_ILL@UCONN,UConn,Huskies,Illinois,Fighting Illini,1-1,2-0,1,13,24,23,31,10,3,7,3,0,24,7,0,-1,-11,-8,0.16041973173076052,[-15.41475117]
2019,2,NCAAF_20190907_RICH@BC,Boston College,Eagles,Richmond,Spiders,2-0,1-1,1,35,10,45,13,21,14,10,0,0,10,0,3,1,25,32,,
2019,2,NCAAF_20190907_SIL@MA,UMass,Minutemen,S. Illinois,Salukis,0-2,1-1,1,13,17,20,45,6,7,0,7,0,17,14,14,-1,-4,-25,0.5894744558962177,[3.51223219]
2019,2,NCAAF_20190907_TXAM@CLEM,Clemson,Tigers,Texas A&M,Aggies,2-0,1-1,0,17,3,24,10,0,17,7,0,0,3,0,7,1,14,14,0.9272635632212964,[22.6036352]
2019,2,NCAAF_20190907_USM@MISSST,Miss. State,Bulldogs,So. Miss,Golden Eagles,2-0,1-1,0,21,0,38,15,7,14,7,10,0,0,7,8,1,21,23,0.9554385493500931,[26.39753162]
2019,2,NCAAF_20190907_MURYST@UGA,Georgia,Bulldogs,Murray St.,Racers,2-0,1-1,1,42,7,63,17,7,35,7,14,7,0,10,0,1,35,46,0.9999922480232472,[67.10090292]
2019,2,NCAAF_20190907_NMEXST@BAMA,Alabama,Crimson Tide,New Mexico St.,Aggies,2-0,0-2,1,38,0,62,10,21,17,24,0,0,0,7,3,2,38,52,0.9998887787842097,[57.32876552]
2019,2,NCAAF_20190907_TXSA@BAYLOR,Baylor,Bears,UTSA,Roadrunners,2-0,1-1,0,35,0,63,14,14,21,14,14,0,0,7,7,1,35,49,0.8673048926001447,[17.29369508]
2019,2,NCAAF_20190907_WIL@COLOST,Colorado St.,Rams,W. Illinois,Leathernecks,1-1,0-2,1,28,6,38,13,14,14,7,3,3,3,0,7,1,22,25,0.3632063339257444,[-5.43311911]
2019,2,NCAAF_20190907_SDGST@UCLA,UCLA,Bruins,San Diego St.,Aztecs,0-2,2-0,0,7,10,14,23,7,0,7,0,10,0,10,3,-2,-3,-9,0.47213577314761057,[-1.08541045]
2019,2,NCAAF_20190907_NCO@WASHST,Washington St.,Cougars,N. Colorado,Bears,2-0,0-2,0,24,10,59,17,14,10,21,14,7,3,0,7,2,14,42,0.9973050492550852,[43.20946785]
2019,2,NCAAF_20190907_GRDWB@ECU,East Carolina,Pirates,Gardner-Webb,Runnin' Bulldogs,1-1,0-2,1,31,7,48,9,17,14,7,10,0,7,2,0,1,24,39,0.9704369319389665,[29.30447276]
2019,2,NCAAF_20190907_ME@GAS,Ga. Southern,Eagles,Maine,Black Bears,1-1,1-1,0,10,3,26,18,0,10,6,10,3,0,0,15,0,7,8,0.7034926677933584,[8.29905936]
2019,2,NCAAF_20190907_NCAT@DUKE,Duke,Blue Devils,NC A&T,Aggies,1-1,1-1,0,28,10,45,13,7,21,10,7,3,7,3,0,0,18,32,0.9253313307372136,[22.38883175]
2019,2,NCAAF_20190907_CSTCAR@KANSAS,Kansas,Jayhawks,C. Carolina,Chanticleers,1-1,1-1,1,7,6,7,12,7,0,0,0,0,6,6,0,0,1,-5,0.7742274936687779,[11.68980312]
2019,2,NCAAF_20190907_EKY@LVILLE,Louisville,Cardinals,E. Kentucky,Colonels,1-1,1-1,0,14,0,42,0,14,0,14,14,0,0,0,0,0,14,42,0.888959614383137,[18.95937836]
2019,2,NCAAF_20190907_FUR@GAST,Georgia St.,,Furman,,2-0,1-1,,17,20,48,42,3,14,21,10,13,7,8,14,1,-3,6,0.5011062865531033,[0.04305877]
2019,2,NCAAF_20190907_JACKST@SALA,South Alabama,,Jackson St.,,1-1,0-2,,19,7,37,14,13,6,8,10,7,0,0,7,1,12,23,0.9613639053769669,[27.4331414]
2019,2,NCAAF_20190907_MCN@OKLAST,Oklahoma State,Cowboys,McNeese St.,Cowboys,2-0,1-1,1,28,0,56,14,14,14,28,0,0,0,7,7,1,28,42,0.9986690061397706,[46.64937125]
2019,2,NCAAF_20190907_NTEXAS@SMU,SMU,Mustangs,North Texas,Mean Green,2-0,1-1,1,28,14,49,27,21,7,14,7,0,14,6,7,1,14,22,0.6688673068824059,[6.78225022]
2019,2,NCAAF_20190907_SD@OKLA,Oklahoma,Sooners,South Dakota,Coyotes,2-0,0-2,1,28,0,70,14,14,14,28,14,0,0,14,0,2,28,56,0.9883875596797739,[35.24315882]
2019,2,NCAAF_20190907_TNST@MTSU,Middle Tenn.,,Tennessee St.,,1-1,1-1,,10,6,45,26,0,10,14,21,6,0,13,7,0,4,19,0.5731650724359398,[2.8638741]
2019,2,NCAAF_20190907_UCF@FAU,FAU,Owls,UCF,Knights,0-2,2-0,0,6,28,14,48,0,6,0,8,14,14,13,7,-2,-22,-34,0.11556131814563009,[-18.59383038]
2019,2,NCAAF_20190907_WKY@FIU,FIU,Panthers,W. Kentucky,Hilltoppers,0-2,1-1,0,7,14,14,20,7,0,7,0,7,7,3,3,-1,-7,-6,0.6897358680175564,[7.6877279]
2019,2,NCAAF_20190907_WYO@TXSTSM,Texas St.,Bobcats,Wyoming,Cowboys,0-2,2-0,0,14,10,14,23,7,7,0,0,0,10,10,3,-2,4,-9,0.06519607202357092,[-23.48633973]
2019,2,NCAAF_20190907_ARK@MISS,Ole Miss,Rebels,Arkansas,Razorbacks,1-1,1-1,1,10,3,31,17,7,3,7,14,0,3,0,14,0,7,14,0.7016588726013218,[8.21684227]
2019,2,NCAAF_20190907_BUFF@PSU,Penn State,Nittany Lions,Buffalo,Bulls,2-0,1-1,0,7,10,45,13,7,0,28,10,0,10,3,0,1,-3,32,0.9734532686319698,[30.03280451]
2019,2,NCAAF_20190907_EMICH@UK,Kentucky,Wildcats,E. Michigan,Eagles,2-0,1-1,1,17,3,38,17,14,3,7,14,0,3,7,7,1,14,21,0.7689524491514208,[11.41899598]
2019,2,NCAAF_20190907_LIB@LALAF,Louisiana,Ragin' Cajuns,Liberty,Flames,1-1,0-2,0,21,14,35,14,7,14,14,0,7,7,0,0,1,7,21,0.5127717368074267,[0.49718452]
2019,2,NCAAF_20190907_LSU@TEXAS,Texas,Longhorns,LSU,Tigers,1-1,2-0,1,7,20,38,45,0,7,14,17,3,17,3,22,-1,-13,-7,0.4839109593150702,[-0.62638502]
2019,2,NCAAF_20190907_NEVADA@OREG,Oregon,Ducks,Nevada,Wolf Pack,1-1,1-1,1,35,6,77,6,7,28,28,14,3,3,0,0,0,29,71,0.8310167134327779,[14.87837429]
2019,2,NCAAF_20190907_STONYBRK@UTAHST,Utah St.,Aggies,Stony Brook,Seawolves,1-1,1-1,0,34,0,62,7,17,17,14,14,0,0,7,0,0,34,55,0.8991246320766626,[19.82217801]
2019,2,NCAAF_20190907_TNMART@FLA,Florida,Gators,UT Martin,Skyhawks,2-0,1-1,0,17,0,45,0,3,14,14,14,0,0,0,0,1,17,45,0.9895011282339398,[35.83802071]
2019,2,NCAAF_20190907_TULANE@AUBURN,Auburn,Tigers,Tulane,Green Wave,2-0,1-1,1,14,6,24,6,0,14,7,3,3,3,0,0,1,8,18,0.9310991448746355,[23.04333608]
2019,2,NCAAF_20190907_WMICH@MICHST,Michigan St.,Spartans,W. Michigan,Broncos,2-0,1-1,1,31,7,51,17,21,10,6,14,0,7,0,10,1,24,34,0.8837588054221597,[18.53974322]
2019,2,NCAAF_20190907_MIAMI@UNC,North Carolina,Tar Heels,Miami (Fla.),Hurricanes,2-0,0-2,1,17,13,28,25,17,0,3,8,3,10,6,6,2,4,3,0.10647076197382921,[-19.33986297]
2019,2,NCAAF_20190907_PRARIE@HOU,Houston,Cougars,Prairie View,Panthers,1-1,1-1,1,34,10,37,17,24,10,3,0,3,7,0,7,0,24,20,0.9990189582133383,[48.07199593]
2019,2,NCAAF_20190907_UTEP@TXTECH,Texas Tech,Red Raiders,UTEP,Miners,2-0,1-1,0,21,0,38,3,7,14,10,7,0,0,0,3,1,21,35,0.9966948044498332,[42.17070297]
2019,2,NCAAF_20190907_TULSA@SJST,San Jose St.,Spartans,Tulsa,Golden Hurricane,1-1,1-1,0,10,17,16,34,3,7,0,6,7,10,3,14,0,-7,-18,0.1701503832300375,[-14.80664285]
2019,2,NCAAF_20190907_ARKST@UNLV,UNLV,Rebels,Arkansas St.,Red Wolves,1-1,1-1,1,3,23,17,43,0,3,7,7,10,13,10,10,0,-20,-26,0.28242293909198246,[-8.93858124]
2019,2,NCAAF_20190907_CAL@WASH,Washington,Huskies,California,Golden Bears,1-1,2-0,1,10,3,19,20,0,10,3,6,0,3,14,3,-1,7,-1,0.851192219751947,[16.17290133]
2019,2,NCAAF_20190907_STNFRD@USC,USC,Trojans,Stanford,Cardinal,2-0,1-1,1,24,20,45,20,3,21,7,14,7,13,0,0,1,4,25,0.39492330122771935,[-4.13824982]
2019,2,NCAAF_20190907_NAZ@ARIZ,Arizona,Wildcats,N. Arizona,Lumberjacks,1-1,1-1,1,51,13,65,41,21,30,7,7,7,6,14,14,0,38,24,0.9928026505419267,[38.]
2019,2,NCAAF_20190906_WAKE@RICE,Rice,Owls,Wake Forest,Demon Deacons,0-2,2-0,0,14,24,21,41,14,0,0,7,14,10,10,7,-2,-10,-20,0.011820667919515304,[-35.137469]
2019,2,NCAAF_20190906_WMMARY@UVA,Virginia,Cavaliers,William & Mary,Tribe,2-0,1-1,0,35,3,52,17,21,14,7,10,0,3,7,7,1,32,35,0.9695977028483751,[29.11285424]
2019,2,NCAAF_20190906_MRSHL@BOISE,Boise St.,Broncos,Marshall,Thundering Herd,2-0,1-1,0,7,7,14,7,0,7,7,0,7,0,0,0,1,0,7,0.8143312557453711,[13.88119503]
2019,2,NCAAF_20190906_SACST@ARIZST,Arizona St.,Sun Devils,Sacramento St.,Hornets,2-0,1-1,1,3,0,19,7,0,3,6,10,0,0,0,7,1,3,12,0.9836035909598253,[33.14531819]
2019,3,NCAAF_20190914_ARKST@UGA,Georgia,Bulldogs,Arkansas St.,Red Wolves,3-0,1-2,0,34,0,55,0,13,21,14,7,0,0,0,0,2,34,55,0.9835491246550524,[33.22350802]
2019,3,NCAAF_20190914_EMICH@ILL,Illinois,Fighting Illini,E. Michigan,Eagles,2-1,2-1,0,17,23,31,34,17,0,0,14,14,9,0,11,0,-6,-3,0.4281021201916262,[-2.82211813]
2019,3,NCAAF_20190914_FUR@VATECH,Virginia Tech,Hokies,Furman,Paladins,2-1,1-2,1,3,14,24,17,3,0,14,7,0,14,0,3,1,-11,7,0.9720303204763119,[29.76964533]
2019,3,NCAAF_20190914_KSTATE@MISSST,Miss. State,Bulldogs,Kansas State,Wildcats,2-1,3-0,1,14,17,24,31,0,14,7,3,3,14,0,14,-1,-3,-7,0.6897920578842238,[7.7131493]
2019,3,NCAAF_20190914_MD@TEMPLE,Temple,Owls,Maryland,Terrapins,2-0,2-1,0,7,2,20,17,7,0,6,7,2,0,13,2,0,5,3,0.4357772161582013,[-2.51805706]
2019,3,NCAAF_20190914_MIAOH@CINCY,Cincinnati,Bearcats,Miami-OH,RedHawks,2-1,1-2,0,14,10,35,13,0,14,21,0,10,0,3,0,1,4,22,0.664962917454319,[6.63520449]
2019,3,NCAAF_20190914_NCST@WVU,West Virginia,Mountaineers,NC State,Wolfpack,2-1,2-1,0,21,21,44,27,14,7,10,13,7,14,6,0,0,0,17,0.49313047580501146,[-0.26818572]
2019,3,NCAAF_20190914_OHIOST@IND,Indiana,Hoosiers,Ohio State,Buckeyes,2-1,3-0,1,10,30,10,51,3,7,0,0,7,23,21,0,-1,-20,-41,0.060827297878100706,[-24.10631981]
2019,3,NCAAF_20190914_PITT@PSU,Penn State,Nittany Lions,Pittsburgh,Panthers,3-0,1-2,0,10,10,17,10,7,3,7,0,0,10,0,0,2,0,7,0.9425143976854463,[24.54816864]
2019,3,NCAAF_20190914_TNCHAT@TENN,Tennessee,Volunteers,Chattanooga,Mocs,1-2,1-2,1,38,0,45,0,21,17,7,0,0,0,0,0,0,38,45,0.9121974716627834,[21.09348311]
2019,3,NCAAF_20190914_FAU@BALLST,Ball St.,Cardinals,FAU,Owls,1-2,1-2,0,17,21,31,41,14,3,7,7,7,14,13,7,0,-4,-10,0.04802582682895362,[-25.91971975]
2019,3,NCAAF_20190914_NRFST@CSTCAR,C. Carolina,Chanticleers,Norfolk St.,Spartans,2-1,1-2,1,19,7,46,7,12,7,14,13,0,7,0,0,1,12,39,0.878699302703581,[18.19825564]
2019,3,NCAAF_20190914_NMEX@ND,Notre Dame,Fighting Irish,New Mexico,Lobos,2-0,1-1,1,38,7,66,14,7,31,14,14,0,7,0,7,1,31,52,0.9904949690232465,[36.52600869]
2019,3,NCAAF_20190914_AKRON@CMICH,C. Michigan,Chippewas,Akron,Zips,2-1,0-3,0,27,10,45,24,3,24,3,15,0,10,0,14,2,17,21,0.5229940477724873,[0.89813915]
2019,3,NCAAF_20190914_ARMY@TXSA,UTSA,Roadrunners,Army,Black Knights,1-2,2-1,0,0,10,13,31,0,0,7,6,10,0,7,14,-1,-10,-18,0.08938385154472628,[-20.940037]
2019,3,NCAAF_20190914_BAMA@SC,South Carolina,Gamecocks,Alabama,Crimson Tide,1-2,3-0,0,10,24,23,47,10,0,3,10,14,10,10,13,-2,-14,-24,0.04927301698853015,[-25.72721805]
2019,3,NCAAF_20190914_ECU@NAVY,Navy,Midshipmen,East Carolina,Pirates,2-0,1-2,0,28,3,42,10,14,14,14,0,0,3,0,7,1,25,32,0.8434636530069406,[15.71088869]
2019,3,NCAAF_20190914_GAS@MINN,Minnesota,Golden Gophers,Ga. Southern,Eagles,3-0,1-2,0,21,20,35,32,14,7,0,14,10,10,0,12,2,1,3,0.8966807467469742,[19.66770783]
2019,3,NCAAF_20190914_MEMP@SALA,South Alabama,Jaguars,Memphis,Tigers,1-2,3-0,1,0,23,6,42,0,0,0,6,7,16,7,12,-2,-23,-36,0.02876409532051427,[-29.57914957]
2019,3,NCAAF_20190914_OKLAST@TULSA,Tulsa,Golden Hurricane,Oklahoma State,Cowboys,1-2,3-0,0,21,20,21,40,7,14,0,0,17,3,13,7,-2,1,-19,0.05938367216084339,[-24.29480396]
2019,3,NCAAF_20190914_STNFRD@UCF,UCF,Knights,Stanford,Cardinal,3-0,1-2,0,38,7,45,27,28,10,0,7,7,0,3,17,2,31,18,0.7025785071853707,[8.28268828]
2019,3,NCAAF_20190914_UNLV@NWEST,Northwestern,Wildcats,UNLV,Rebels,1-1,1-2,1,16,14,30,14,10,6,7,7,7,7,0,0,0,2,16,0.9553015853819946,[26.4536533]
2019,3,NCAAF_20190914_ARIZST@MICHST,Michigan St.,Spartans,Arizona St.,Sun Devils,2-1,3-0,1,0,3,7,10,0,0,0,7,0,3,0,7,-1,-3,-3,0.690491503152074,[7.74403216]
2019,3,NCAAF_20190914_BTHN@MIAMI,Miami (Fla.),Hurricanes,Bethune-Cook.,Wildcats,1-2,1-1,1,28,0,63,0,7,21,14,21,0,0,0,0,0,28,63,0.9958433280755854,[41.100656]
2019,3,NCAAF_20190914_COLOST@ARK,Arkansas,Razorbacks,Colorado St.,Rams,2-1,1-2,0,27,24,55,34,24,3,7,21,14,10,10,0,1,3,21,0.5121948858879739,[0.47613808]
2019,3,NCAAF_20190914_IOWA@IOWAST,Iowa St.,Cyclones,Iowa,Hawkeyes,1-1,3-0,0,7,6,17,18,7,0,7,3,3,3,3,9,-2,1,-1,0.3539276025805478,[-5.83613755]
2019,3,NCAAF_20190914_LVILLE@WKY,W. Kentucky,Hilltoppers,Louisville,Cardinals,1-2,2-1,1,7,31,21,38,0,7,7,7,7,24,7,0,-1,-24,-17,0.14916364268903126,[-16.19728675]
2019,3,NCAAF_20190914_SELOU@MISS,Ole Miss,Rebels,SE Louisiana,Lions,2-1,1-1,1,27,17,40,29,13,14,7,6,3,14,12,0,1,10,11,0.8735144486476782,[17.80350807]
2019,3,NCAAF_20190914_CPOLY@OREGST,Oregon State,Beavers,Cal-Poly,Mustangs,1-2,1-2,1,38,7,45,7,21,17,7,0,7,0,0,0,0,31,38,0.9635698686740596,[27.93499626]
2019,3,NCAAF_20190914_IDST@UTAH,Utah,Utes,Idaho State,Bengals,3-0,1-1,1,24,0,31,0,17,7,7,0,0,0,0,0,2,24,31,0.9812250633937307,[32.389596]
2019,3,NCAAF_20190914_NTEXAS@CAL,California,Golden Bears,North Texas,Mean Green,3-0,1-2,1,20,3,23,17,20,0,3,0,0,3,7,7,2,17,6,0.7820799375468661,[12.13576483]
2019,3,NCAAF_20190914_IDAHO@WYO,Wyoming,Cowboys,Idaho,Vandals,3-0,1-2,1,14,10,21,16,0,14,0,7,3,7,3,3,2,4,5,0.8734754388125066,[17.80058131]
2019,3,NCAAF_20190914_LATECH@BGREEN,Bowling Green,Falcons,Louisiana Tech,Bulldogs,1-2,2-1,1,7,21,7,35,7,0,0,0,14,7,0,14,-1,-14,-28,0.2917452341405097,[-8.5390705]
2019,3,NCAAF_20190914_BUFF@LIB,Liberty,Flames,Buffalo,Bulls,1-2,1-2,1,28,7,35,17,7,21,7,0,0,7,3,7,0,21,18,0.15846360546707716,[-15.58624747]
2019,3,NCAAF_20190914_MA@CHARLO,Charlotte,49ers,UMass,Minutemen,2-1,0-3,1,31,10,52,17,21,10,14,7,0,10,0,7,2,21,35,0.36330647917510817,[-5.44517658]
2019,3,NCAAF_20190914_SCST@SFLA,South Florida,Bulls,SC State,Bulldogs,1-2,2-1,1,24,3,55,16,7,17,17,14,3,0,6,7,-1,21,39,0.855896890792954,[16.54050074]
2019,3,NCAAF_20190914_USM@TROY,Troy,,So. Miss,,1-1,2-1,,14,17,42,47,7,7,7,21,14,3,9,21,-1,-3,-5,0.6254634485790599,[4.98149798]
2019,3,NCAAF_20190914_OHIO@MRSHL,Marshall,Thundering Herd,Ohio,Bobcats,2-1,1-2,1,27,17,33,31,10,17,0,6,3,14,7,7,1,10,2,0.35654576154342954,[-5.72663895]
2019,3,NCAAF_20190914_DUKE@MTSU,Middle Tenn.,Blue Raiders,Duke,Blue Devils,1-2,2-1,1,3,31,18,41,3,0,8,7,14,17,10,0,-1,-28,-23,0.2966758375863461,[-8.31623836]
2019,3,NCAAF_20190914_FLA@UK,Kentucky,Wildcats,Florida,Gators,2-1,3-0,0,14,7,21,29,0,14,7,0,7,0,3,19,-1,7,-8,0.4155050973129828,[-3.32356744]
2019,3,NCAAF_20190914_GAST@WMICH,W. Michigan,,Georgia St.,,2-1,2-1,,43,10,57,10,24,19,14,0,10,0,0,0,0,33,47,0.755130784902581,[10.75728594]
2019,3,NCAAF_20190914_KENTST@AUBURN,Auburn,Tigers,Kent St.,Golden Flashes,3-0,1-2,0,24,10,55,16,14,10,14,17,3,7,0,6,2,14,39,0.9985074487830714,[46.24310347]
2019,3,NCAAF_20190914_LAMAR@TXAM,Texas A&M,Aggies,Lamar,Cardinals,2-1,2-1,1,27,0,62,3,13,14,21,14,0,0,3,0,0,27,59,0.9999971035447521,[70.60913994]
2019,3,NCAAF_20190914_MURYST@TOLEDO,Toledo,,Murray St.,,1-1,1-2,,17,0,45,0,3,14,21,7,0,0,0,0,0,17,45,0.9770070738453044,[31.078093]
2019,3,NCAAF_20190914_NH@FIU,FIU,,New Hamp.,,1-2,0-2,,13,10,30,17,7,6,7,10,10,0,7,0,1,3,13,0.6871360201600281,[7.5961508]
2019,3,NCAAF_20190914_TXSTSM@SMU,SMU,Mustangs,Texas St.,Bobcats,3-0,0-3,1,13,3,47,17,7,6,21,13,3,0,7,7,3,10,30,0.9472423250126145,[25.20922928]
2019,3,NCAAF_20190914_WBRST@NEVADA,Nevada,Wolf Pack,Weber St.,Wildcats,2-1,1-2,1,9,10,19,13,3,6,7,3,0,10,3,0,1,-1,6,0.4416706663782526,[-2.28523454]
2019,3,NCAAF_20190914_CLEM@CUSE,Syracuse,Orange,Clemson,Tigers,1-2,3-0,0,6,17,6,41,0,6,0,0,14,3,10,14,-2,-11,-35,0.045410528195874655,[-26.33676176]
2019,3,NCAAF_20190914_FSU@UVA,Virginia,Cavaliers,Florida State,Seminoles,3-0,1-2,1,10,14,31,24,3,7,0,21,0,14,3,7,2,-4,7,0.44311352585905606,[-2.22831368]
2019,3,NCAAF_20190914_HAWAII@WASH,Washington,Huskies,Hawaii,Rainbow Warriors,2-1,2-1,1,38,7,52,20,21,17,0,14,0,7,13,0,0,31,32,0.9891424883358968,[35.74703865]
2019,3,NCAAF_20190914_NWST@LSU,LSU,Tigers,Northwestern St.,Demons,3-0,0-3,0,24,14,65,14,3,21,27,14,7,7,0,0,3,10,51,0.9998543605772939,[56.42325743]
2019,3,NCAAF_20190914_SEMOST@MIZZOU,Missouri,Tigers,SE Missouri St.,Redhawks,2-1,1-2,1,37,0,50,0,27,10,10,3,0,0,0,0,1,37,50,0.9984919503947844,[46.19364786]
2019,3,NCAAF_20190914_TCU@PURDUE,Purdue,Boilermakers,TCU,Horned Frogs,1-2,2-0,1,6,13,13,34,3,3,0,7,10,3,14,7,-1,-7,-21,0.4915090850132158,[-0.33149334]
2019,3,NCAAF_20190914_TXSO@LALAF,Louisiana,,Texas Southern,,2-1,0-3,,56,6,77,6,28,28,7,14,3,3,0,0,2,50,71,0.9795592844769507,[31.8444444]
2019,3,NCAAF_20190914_MOST@TULANE,Tulane,Green Wave,Missouri St.,Bears,2-1,0-2,1,38,6,58,6,10,28,13,7,0,6,0,0,2,32,52,0.7850048759876659,[12.29105774]
2019,3,NCAAF_20190914_NILL@NEB,Nebraska,Cornhuskers,N. Illinois,Huskies,2-1,1-2,1,30,5,44,8,10,20,7,7,0,5,3,0,1,25,36,0.6178388427677399,[4.66920858]
2019,3,NCAAF_20190914_OKLA@UCLA,UCLA,Bruins,Oklahoma,Sooners,0-3,3-0,0,7,34,14,48,0,7,7,0,17,17,7,7,-3,-27,-34,0.05401976017849419,[-25.02832362]
2019,3,NCAAF_20190914_SDGST@NMEXST,New Mexico St.,Aggies,San Diego St.,Aztecs,0-3,3-0,0,0,17,10,31,0,0,10,0,7,10,7,7,-3,-17,-21,0.06460839585738787,[-23.62869581]
2019,3,NCAAF_20190914_TEXAS@RICE,Rice,Owls,Texas,Longhorns,0-3,2-1,0,0,31,13,48,0,0,0,13,14,17,7,10,-2,-31,-35,0.00339693120158302,[-42.15519015]
2019,3,NCAAF_20190914_PORTST@BOISE,Boise St.,Broncos,Portland St.,Vikings,3-0,1-2,0,28,10,45,10,14,14,10,7,10,0,0,0,2,18,35,0.9797418116548761,[31.90229932]
2019,3,NCAAF_20190914_TXTECH@ARIZ,Arizona,Wildcats,Texas Tech,Red Raiders,2-1,2-1,1,13,7,28,14,0,13,0,15,7,0,7,0,0,6,14,0.2644451251208364,[-9.80690464]
2019,3,NCAAF_20190914_MT@OREG,Oregon,Ducks,Montana,Grizzlies,2-1,2-1,1,21,0,35,3,14,7,7,7,0,0,3,0,0,21,32,0.9990867407180928,[48.54511937]
2019,3,NCAAF_20190913_UNC@WAKE,Wake Forest,Demon Deacons,North Carolina,Tar Heels,3-0,2-1,0,21,0,24,18,7,14,0,3,0,0,3,15,1,21,6,0.7675399314647172,[11.38093203]
2019,3,NCAAF_20190913_KANSAS@BC,Boston College,Eagles,Kansas,Jayhawks,2-1,2-1,1,24,28,24,48,17,7,0,0,7,21,13,7,0,-4,-24,0.8849105870774032,[18.68710578]
2019,3,NCAAF_20190913_WASHST@HOU,Houston,Cougars,Washington St.,Cougars,1-2,3-0,1,14,7,24,31,0,14,0,10,0,7,14,10,-2,7,-7,0.284867789226103,[-8.8528471]
2019,4,NCAAF_20190922_CAR@HAWAII,Hawaii,,Cent. Ark.,,3-1,3-1,,28,9,35,16,14,14,0,7,0,9,0,7,0,19,19,0.49044775449482314,[-0.373104]
2019,4,NCAAF_20190921_BC@RUT,Rutgers,Scarlet Knights,Boston College,Eagles,1-2,3-1,0,13,17,16,30,7,6,0,3,7,10,7,6,-2,-4,-14,0.17045972026401568,[-14.83848772]
2019,4,NCAAF_20190921_CAL@MISS,Ole Miss,Rebels,California,Golden Bears,2-2,4-0,1,13,14,20,28,7,6,0,7,7,7,14,0,-2,-1,-8,0.4579686780887804,[-1.6446058]
2019,4,NCAAF_20190921_ELON@WAKE,Wake Forest,Demon Deacons,Elon,Phoenix,4-0,2-2,1,28,7,49,7,14,14,14,7,7,0,0,0,2,21,42,0.9950556284653799,[40.19402169]
2019,4,NCAAF_20190921_LAMON@IOWAST,Iowa St.,Cyclones,UL-Monroe,Warhawks,2-1,1-2,0,27,13,72,20,14,13,21,24,0,13,7,0,1,14,52,0.9808895966334807,[32.2911195]
2019,4,NCAAF_20190921_LSU@VANDY,Vanderbilt,Commodores,LSU,Tigers,0-3,4-0,1,17,38,38,66,7,10,14,7,28,10,21,7,-4,-21,-28,0.15685746759118102,[-15.69711217]
2019,4,NCAAF_20190921_MICH@WISC,Wisconsin,Badgers,Michigan,Wolverines,3-0,2-1,1,28,0,35,14,14,14,7,0,0,0,8,6,1,28,21,0.4538828423362482,[-1.80516197]
2019,4,NCAAF_20190921_MICHST@NWEST,Northwestern,Wildcats,Michigan St.,Spartans,1-2,3-1,0,3,14,10,31,0,3,0,7,7,7,10,7,-2,-11,-21,0.47141718821757495,[-1.11727464]
2019,4,NCAAF_20190921_MRGNST@ARMY,Army,Black Knights,Morgan St.,Bears,3-1,0-3,0,24,14,52,21,7,17,7,21,14,0,7,0,3,10,31,0.9999779181985026,[63.64092632]
2019,4,NCAAF_20190921_TENN@FLA,Florida,Gators,Tennessee,Volunteers,4-0,1-3,1,17,0,34,3,7,10,7,10,0,0,3,0,3,17,31,0.8165250944544967,[14.05712686]
2019,4,NCAAF_20190921_UCONN@IND,Indiana,Hoosiers,UConn,Huskies,3-1,1-2,1,17,3,38,3,7,10,14,7,3,0,0,0,2,14,35,0.9608845772956071,[27.43868937]
2019,4,NCAAF_20190921_USM@BAMA,Alabama,Crimson Tide,So. Miss,Golden Eagles,4-0,2-2,0,28,7,49,7,14,14,14,7,0,7,0,0,2,21,42,0.9972329056116134,[43.22418956]
2019,4,NCAAF_20190921_WMICH@CUSE,Syracuse,Orange,W. Michigan,Broncos,2-2,2-2,1,24,13,52,33,14,10,14,14,0,13,20,0,0,11,19,0.7761427698941656,[11.82951271]
2019,4,NCAAF_20190921_CSTCAR@MA,UMass,Minutemen,C. Carolina,Chanticleers,0-4,3-1,0,14,42,28,62,7,7,7,7,14,28,14,6,-3,-28,-34,0.5153261573680923,[0.59871905]
2019,4,NCAAF_20190921_LALAF@OHIO,Ohio,Bobcats,Louisiana,Ragin' Cajuns,1-3,3-1,1,6,10,25,45,0,6,6,13,7,3,14,21,-2,-4,-20,0.8244462702782349,[14.52832153]
2019,4,NCAAF_20190921_CCTST@EMICH,E. Michigan,Eagles,CCSU,Blue Devils,3-1,3-1,0,21,15,34,29,7,14,0,13,15,0,0,14,0,6,5,0.9824115114683347,[32.8183217]
2019,4,NCAAF_20190921_TROY@AKRON,Akron,Zips,Troy,Trojans,0-4,2-1,1,7,21,7,35,7,0,0,0,7,14,14,0,-2,-14,-28,0.23648337751777704,[-11.18180539]
2019,4,NCAAF_20190921_APLST@UNC,North Carolina,Tar Heels,App. St.,Mountaineers,2-2,3-0,1,17,27,31,34,7,10,7,7,13,14,7,0,-1,-10,-3,0.39254716953611646,[-4.24870298]
2019,4,NCAAF_20190921_AUBURN@TXAM,Texas A&M,Aggies,Auburn,Tigers,2-2,4-0,0,3,14,20,28,0,3,0,17,14,0,7,7,-2,-11,-8,0.26135808780335235,[-9.95876254]
2019,4,NCAAF_20190921_BGREEN@KENTST,Kent St.,Golden Flashes,Bowling Green,Falcons,2-2,1-3,1,24,7,62,20,21,3,17,21,7,0,0,13,1,17,42,0.38500022626207575,[-4.55545957]
2019,4,NCAAF_20190921_LVILLE@FSU,Florida State,Seminoles,Louisville,Cardinals,2-2,2-2,1,21,7,35,24,21,0,0,14,0,7,10,7,0,14,11,0.638230150003575,[5.51146949]
2019,4,NCAAF_20190921_MIAOH@OHIOST,Ohio State,Buckeyes,Miami-OH,RedHawks,4-0,1-3,0,49,5,76,5,7,42,14,13,5,0,0,0,3,44,71,0.9928878628286415,[38.19738275]
2019,4,NCAAF_20190921_SALA@UAB,UAB,Blazers,South Alabama,Jaguars,3-0,1-3,0,28,3,35,3,14,14,7,0,3,0,0,0,2,25,32,0.8177158676531475,[14.1271343]
2019,4,NCAAF_20190921_SMU@TCU,TCU,Horned Frogs,SMU,Mustangs,2-1,4-0,0,17,31,38,41,7,10,7,14,18,13,0,10,-2,-14,-3,0.8262937222240947,[14.64013931]
2019,4,NCAAF_20190921_TEMPLE@BUFF,Buffalo,Bulls,Temple,Owls,2-2,2-1,1,24,7,38,22,0,24,7,7,7,0,3,12,0,17,16,0.318243557703652,[-7.36379143]
2019,4,NCAAF_20190921_UCF@PITT,Pittsburgh,Panthers,UCF,Knights,2-2,3-1,0,21,10,35,34,7,14,7,7,0,10,21,3,-1,11,1,0.16102721502035888,[-15.42892295]
2019,4,NCAAF_20190921_WASH@BYU,BYU,Cougars,Washington,Huskies,2-2,3-1,0,12,24,19,45,3,9,7,0,21,3,21,0,-1,-12,-26,0.07281017361885023,[-22.67298651]
2019,4,NCAAF_20190921_WYO@TULSA,Tulsa,Golden Hurricane,Wyoming,Cowboys,2-2,3-1,1,14,7,24,21,0,14,3,7,7,0,0,14,-1,7,3,0.3893206023794522,[-4.37964314]
2019,4,NCAAF_20190921_CMICH@MIAMI,Miami (Fla.),Hurricanes,C. Michigan,Chippewas,2-2,2-2,0,7,2,17,12,7,0,7,3,0,2,3,7,0,5,5,0.9516466351436986,[25.8804231]
2019,4,NCAAF_20190921_SC@MIZZOU,Missouri,Tigers,South Carolina,Gamecocks,3-1,1-3,1,17,7,34,14,7,10,14,3,0,7,7,0,2,10,20,0.6128642483112965,[4.46848389]
2019,4,NCAAF_20190921_UK@MISSST,Miss. State,Bulldogs,Kentucky,Wildcats,3-1,2-2,0,21,3,28,13,7,14,0,7,3,0,7,3,1,18,15,0.7139418922655313,[8.80224529]
2019,4,NCAAF_20190921_NMEXST@NMEX,New Mexico,Lobos,New Mexico St.,Aggies,2-1,0-4,0,31,31,55,52,14,17,17,7,17,14,7,14,2,0,3,0.6182266384933197,[4.68715409]
2019,4,NCAAF_20190921_WVU@KANSAS,Kansas,Jayhawks,West Virginia,Mountaineers,2-2,3-1,1,7,10,24,29,0,7,10,7,7,3,10,9,-1,-3,-5,0.08534804665453133,[-21.34539656]
2019,4,NCAAF_20190921_HAMP@LIB,Liberty,Flames,Hampton,Pirates,2-2,2-2,1,41,12,62,27,27,14,7,14,12,0,8,7,0,29,35,0.9964896155811103,[42.00393053]
2019,4,NCAAF_20190921_WAG@FAU,FAU,Owls,Wagner,Seahawks,2-2,0-4,1,28,7,42,7,14,14,7,7,0,7,0,0,2,21,35,0.9927640889565588,[38.10053782]
2019,4,NCAAF_20190921_WMMARY@ECU,East Carolina,Pirates,William & Mary,Tribe,2-2,2-2,1,10,7,19,7,7,3,3,6,0,7,0,0,0,3,12,0.7582197325238988,[10.91579387]
2019,4,NCAAF_20190921_BALLST@NCST,NC State,Wolfpack,Ball St.,Cardinals,3-1,1-3,0,20,7,34,23,6,14,7,7,7,0,6,10,2,13,11,0.9916606486152565,[37.29627316]
2019,4,NCAAF_20190921_BAYLOR@RICE,Rice,Owls,Baylor,Bears,0-4,3-0,0,3,21,13,21,0,3,3,7,7,14,0,0,-3,-18,-8,0.042856106929040405,[-26.7752268]
2019,4,NCAAF_20190921_ODU@UVA,Virginia,Cavaliers,Old Dominion,Monarchs,4-0,1-2,0,7,17,28,17,0,7,7,14,10,7,0,0,3,-10,11,0.9352280275652964,[23.61915388]
2019,4,NCAAF_20190921_OREG@STNFRD,Stanford,Cardinal,Oregon,Ducks,1-3,3-1,1,3,14,6,21,3,0,0,3,7,7,0,7,-2,-11,-15,0.5310956895232539,[1.21569209]
2019,4,NCAAF_20190921_SIL@ARKST,Arkansas St.,Red Wolves,S. Illinois,Salukis,2-2,2-2,1,31,14,41,28,14,17,7,3,14,0,14,0,0,17,13,0.6386123488873097,[5.52736307]
2019,4,NCAAF_20190921_CHARLO@CLEM,Clemson,Tigers,Charlotte,49ers,4-0,2-2,0,38,3,52,10,17,21,7,7,0,3,7,0,2,35,42,0.999648956030835,[52.8000248]
2019,4,NCAAF_20190921_OKLAST@TEXAS,Texas,Longhorns,Oklahoma State,Cowboys,3-1,3-1,0,21,20,36,30,0,21,7,8,3,17,3,7,0,1,6,0.5075429773741473,[0.2946128]
2019,4,NCAAF_20190921_SJST@ARK,Arkansas,Razorbacks,San Jose St.,Spartans,2-2,2-1,0,7,24,24,31,7,0,3,14,7,17,0,7,0,-17,-7,0.8782913061042741,[18.17494457]
2019,4,NCAAF_20190921_TXSA@NTEXAS,North Texas,Mean Green,UTSA,Roadrunners,2-2,1-3,0,24,3,45,3,7,17,14,7,0,3,0,0,1,21,42,0.7585607828487716,[10.9328252]
2019,4,NCAAF_20190921_ND@UGA,Georgia,Bulldogs,Notre Dame,Fighting Irish,4-0,2-1,0,7,10,23,17,0,7,6,10,0,10,0,7,2,-3,6,0.6926762823097143,[7.84422318]
2019,4,NCAAF_20190921_NEB@ILL,Illinois,Fighting Illini,Nebraska,Cornhuskers,2-2,3-1,1,21,14,38,42,14,7,14,3,7,7,13,15,-1,7,-4,0.2311263812611679,[-11.45419251]
2019,4,NCAAF_20190921_NEVADA@UTEP,UTEP,Miners,Nevada,Wolf Pack,1-2,3-1,0,14,21,21,37,7,7,7,0,0,21,3,13,-2,-7,-16,0.09061253457967555,[-20.831569]
2019,4,NCAAF_20190921_COLO@ARIZST,Arizona St.,Sun Devils,Colorado,Buffaloes,3-1,3-1,0,21,24,31,34,0,21,3,7,14,10,7,3,0,-3,-3,0.6400137995609602,[5.58569117]
2019,4,NCAAF_20190921_SACST@FRESNO,Fresno St.,Bulldogs,Sacramento St.,Hornets,1-2,2-2,1,14,12,34,20,7,7,0,20,6,6,0,8,-1,2,14,0.9644913329145439,[28.12926589]
2019,4,NCAAF_20190921_TOLEDO@COLOST,Colorado St.,Rams,Toledo,Rockets,1-3,2-1,1,13,14,35,41,7,6,14,8,7,7,21,6,-1,-1,-6,0.2774980628058741,[-9.1972618]
2019,4,NCAAF_20190921_UCLA@WASHST,Washington St.,Cougars,UCLA,Bruins,3-1,1-3,1,35,17,63,67,7,28,14,14,10,7,21,29,2,18,-4,0.7800319223677383,[12.03315772]
2019,4,NCAAF_20190921_UTAHST@SDGST,San Diego St.,Aztecs,Utah St.,Aggies,3-1,2-1,1,3,20,17,23,3,0,0,14,7,13,3,0,1,-17,-6,0.3969528886021134,[-4.07039204]
2019,4,NCAAF_20190920_FIU@LATECH,Louisiana Tech,Bulldogs,FIU,Panthers,3-1,1-3,1,13,10,43,31,0,13,14,16,0,10,14,7,2,3,12,0.46986489903227446,[-1.1780649]
2019,4,NCAAF_20190920_AF@BOISE,Boise St.,Broncos,Air Force,Falcons,4-0,2-1,1,10,10,30,19,0,10,7,13,0,10,3,6,2,0,11,0.8007261714314616,[13.15368835]
2019,4,NCAAF_20190920_UTAH@USC,USC,Trojans,Utah,Utes,3-1,3-1,1,14,10,30,23,14,0,7,9,7,3,7,6,0,4,7,0.45655893191604,[-1.6999823]
2019,4,NCAAF_20190919_HOU@TULANE,Tulane,Green Wave,Houston,Cougars,3-1,1-3,0,14,28,38,31,7,7,7,17,14,14,0,3,2,-14,7,0.37821325626624047,[-4.83283875]
2019,5,NCAAF_20190928_BUFF@MIAOH,Miami-OH,RedHawks,Buffalo,Bulls,2-3,2-3,0,13,14,34,20,0,13,21,0,7,7,0,6,0,-1,14,0.3613426336463603,[-5.53668826]
2019,5,NCAAF_20190928_BYU@TOLEDO,Toledo,Rockets,BYU,Cougars,3-1,2-3,1,3,7,28,21,0,3,11,14,0,7,14,0,1,-4,7,0.6162790653295991,[4.61384101]
2019,5,NCAAF_20190928_CMICH@WMICH,W. Michigan,Broncos,C. Michigan,Chippewas,3-2,2-3,0,17,0,31,15,10,7,7,7,0,0,0,15,1,17,16,0.6217169502085187,[4.83648894]
2019,5,NCAAF_20190928_HOLY@CUSE,Syracuse,Orange,Holy Cross,Crusaders,3-2,1-3,0,24,3,41,3,17,7,10,7,0,3,0,0,2,21,38,0.996644351143355,[42.29430432]
2019,5,NCAAF_20190928_KANSAS@TCU,TCU,Horned Frogs,Kansas,Jayhawks,3-1,2-3,0,38,0,51,14,21,17,0,13,0,0,0,14,1,38,37,0.9124651963589794,[21.15764993]
2019,5,NCAAF_20190928_MTSU@IOWA,Iowa,Hawkeyes,Middle Tenn.,Blue Raiders,4-0,1-3,1,24,0,48,3,17,7,10,14,0,0,3,0,3,24,45,0.950817200213618,[25.78730732]
2019,5,NCAAF_20190928_NILL@VANDY,Vanderbilt,Commodores,N. Illinois,Huskies,1-3,1-3,1,14,0,24,18,14,0,7,3,0,0,10,8,0,14,6,0.5972854673994881,[3.84317448]
2019,5,NCAAF_20190928_NWEST@WISC,Wisconsin,Badgers,Northwestern,Wildcats,4-0,1-3,1,7,3,24,15,7,0,7,10,3,0,0,12,3,4,9,0.7947811448123934,[12.84230658]
2019,5,NCAAF_20190928_RUT@MICH,Michigan,Wolverines,Rutgers,Scarlet Knights,3-1,1-3,1,24,0,52,0,14,10,14,14,0,0,0,0,2,24,52,0.9747058183785227,[30.50104933]
2019,5,NCAAF_20190928_TXAM@ARK,Arkansas,Razorbacks,Texas A&M,Aggies,2-3,3-2,1,17,21,27,31,0,17,7,3,7,14,0,10,-1,-4,-4,0.12673200357823355,[-17.81701505]
2019,5,NCAAF_20190928_TXTECH@OKLA,Oklahoma,Sooners,Texas Tech,Red Raiders,4-0,2-2,0,34,10,55,16,17,17,14,7,0,10,6,0,2,24,39,0.8472555081894729,[15.9878066]
2019,5,NCAAF_20190928_DE@PITT,Pittsburgh,Panthers,Delaware,Fightin' Blue Hens,3-2,3-2,0,10,7,17,14,0,10,0,7,0,7,7,0,0,3,3,0.9526190046372646,[26.06762062]
2019,5,NCAAF_20190928_AKRON@MA,UMass,Minutemen,Akron,Zips,1-4,0-5,1,20,14,37,29,7,13,14,3,7,7,7,8,1,6,8,0.38220656205756964,[-4.67574898]
2019,5,NCAAF_20190928_CLEM@UNC,North Carolina,Tar Heels,Clemson,Tigers,2-3,5-0,1,14,14,20,21,7,7,0,6,0,14,0,7,-3,0,-1,0.011228322218358122,[-35.6122218]
2019,5,NCAAF_20190928_CSTCAR@APLST,App. St.,Mountaineers,C. Carolina,Chanticleers,4-0,3-2,0,35,21,56,37,14,21,7,14,14,7,9,7,1,14,19,0.8824944767585602,[18.5280454]
2019,5,NCAAF_20190928_FAU@CHARLO,Charlotte,49ers,FAU,Owls,2-3,3-2,1,14,24,27,45,7,7,7,6,14,10,14,7,-1,-10,-18,0.09328260928691812,[-20.6071457]
2019,5,NCAAF_20190928_GATECH@TEMPLE,Temple,Owls,Georgia Tech,Yellow Jackets,3-1,1-3,1,14,0,24,2,0,14,10,0,0,0,2,0,2,14,22,0.32940005236802716,[-6.88934506]
2019,5,NCAAF_20190928_IND@MICHST,Michigan St.,Spartans,Indiana,Hoosiers,4-1,3-2,1,21,14,40,31,7,14,0,19,7,7,3,14,1,7,9,0.6912868252752844,[7.7931764]
2019,5,NCAAF_20190928_IOWAST@BAYLOR,Baylor,Bears,Iowa St.,Cyclones,4-0,2-2,0,7,0,23,21,0,7,13,3,0,0,0,21,2,7,2,0.13851920544822738,[-16.95922793]
2019,5,NCAAF_20190928_MINN@PURDUE,Purdue,Boilermakers,Minnesota,Golden Gophers,1-3,4-0,0,10,28,31,38,3,7,7,14,14,14,10,0,-3,-18,-7,0.6618357621252442,[6.51346456]
2019,5,NCAAF_20190928_MISS@BAMA,Alabama,Crimson Tide,Ole Miss,Rebels,5-0,2-3,1,38,10,59,31,7,31,14,7,10,0,7,14,3,28,28,0.9854301551295788,[34.03701193]
2019,5,NCAAF_20190928_USC@WASH,Washington,Huskies,USC,Trojans,4-1,3-2,0,17,7,28,14,14,3,11,0,0,7,7,0,1,10,14,0.7025925066610867,[8.29821557]
2019,5,NCAAF_20190928_UVA@ND,Notre Dame,Fighting Irish,Virginia,Cavaliers,3-1,4-1,0,14,17,35,20,14,0,14,7,7,10,0,3,-1,-3,15,0.8814651159742535,[18.44681266]
2019,5,NCAAF_20190928_WAKE@BC,Boston College,Eagles,Wake Forest,Demon Deacons,3-2,5-0,1,17,17,24,27,0,17,0,7,10,7,3,7,-2,0,-3,0.50583889971369,[0.22835706]
2019,5,NCAAF_20190928_SMU@SFLA,South Florida,,SMU,,1-3,5-0,,0,34,21,48,0,0,7,14,14,20,7,7,-4,-34,-27,0.4524603045459029,[-1.86361443]
2019,5,NCAAF_20190928_TWST@FLA,Florida,Gators,Towson,Tigers,5-0,3-2,1,17,0,38,0,7,10,14,7,0,0,0,0,2,17,38,0.9980365290972593,[44.99548715]
2019,5,NCAAF_20190928_CINCY@MRSHL,Marshall,Thundering Herd,Cincinnati,Bearcats,2-2,3-1,0,0,28,14,52,0,0,0,14,14,14,17,7,-1,-28,-38,0.4020596647616401,[-3.8695796]
2019,5,NCAAF_20190928_ARKST@TROY,Troy,Trojans,Arkansas St.,Red Wolves,2-2,3-2,1,31,31,43,50,10,21,6,6,21,10,14,5,-1,0,-7,0.5395126333172346,[1.5478034]
2019,5,NCAAF_20190928_ECU@ODU,Old Dominion,Monarchs,East Carolina,Pirates,1-3,3-2,0,3,17,21,24,3,0,10,8,10,7,0,7,-2,-14,-3,0.4520490362855195,[-1.87981455]
2019,5,NCAAF_20190928_LALAF@GAS,Ga. Southern,Eagles,Louisiana,Ragin' Cajuns,1-3,4-1,1,13,17,24,37,3,10,8,3,7,10,7,13,-3,-4,-13,0.4868484685066554,[-0.51442602]
2019,5,NCAAF_20190928_NMEX@LIB,Liberty,Flames,New Mexico,Lobos,3-2,2-2,1,14,3,17,10,7,7,3,0,0,3,0,7,1,11,7,0.49956209541814733,[-0.01712567]
2019,5,NCAAF_20190928_KSTATE@OKLAST,Oklahoma State,Cowboys,Kansas State,Wildcats,4-1,3-1,1,16,3,26,13,10,6,7,3,0,3,0,10,1,13,13,0.6313833122583439,[5.23474474]
2019,5,NCAAF_20190928_MISSST@AUBURN,Auburn,Tigers,Miss. State,Bulldogs,5-0,3-2,0,42,9,56,23,21,21,7,7,6,3,7,7,2,33,33,0.5899139207349968,[3.54668337]
2019,5,NCAAF_20190928_NICHST@TXSTSM,Texas St.,Bobcats,Nicholls St.,Colonels,2-3,2-2,0,3,3,24,3,3,0,14,7,0,3,0,0,0,0,21,0.27589686380122125,[-9.28430206]
2019,5,NCAAF_20190928_SALA@LAMON,UL-Monroe,Warhawks,South Alabama,Jaguars,2-2,1-4,0,17,7,30,17,7,10,0,13,7,0,3,7,1,10,13,0.6491038681972232,[5.97400893]
2019,5,NCAAF_20190928_STNFRD@OREGST,Oregon State,Beavers,Stanford,Cardinal,1-3,2-3,0,0,14,28,31,0,0,7,21,7,7,7,10,-1,-14,-3,0.036169679773758956,[-28.03627844]
2019,5,NCAAF_20190928_UAB@WKY,W. Kentucky,Hilltoppers,UAB,Blazers,2-2,3-1,1,13,10,20,13,3,10,0,7,3,7,3,0,-1,3,7,0.26981853410491274,[-9.56962194]
2019,5,NCAAF_20190928_UCONN@UCF,UCF,Knights,UConn,Huskies,4-1,1-3,0,42,0,56,21,28,14,14,0,0,0,7,14,3,42,35,0.9971003779837159,[43.04446803]
2019,5,NCAAF_20190928_UTEP@USM,So. Miss,Golden Eagles,UTEP,Miners,3-2,1-3,0,24,6,31,13,14,10,7,0,0,6,7,0,2,18,18,0.9185691573452017,[21.7726536]
2019,5,NCAAF_20190928_COLOST@UTAHST,Utah St.,Aggies,Colorado St.,Rams,3-1,1-4,0,24,21,34,24,7,17,3,7,7,14,3,0,2,3,10,0.8236891659594355,[14.50223414]
2019,5,NCAAF_20190928_NCST@FSU,Florida State,Seminoles,NC State,Wolfpack,3-2,3-2,0,17,6,31,13,3,14,7,7,0,6,0,7,0,11,18,0.34654096592110717,[-6.15770424]
2019,5,NCAAF_20190928_OHIOST@NEB,Nebraska,Cornhuskers,Ohio State,Buckeyes,3-2,5-0,1,0,38,7,48,0,0,7,0,14,24,10,0,-2,-38,-41,0.03574782625542716,[-28.11959073]
2019,5,NCAAF_20190928_UK@SC,South Carolina,Gamecocks,Kentucky,Wildcats,2-3,2-3,1,10,0,24,7,7,3,7,7,0,0,0,7,0,10,17,0.5322122513327292,[1.26113542]
2019,5,NCAAF_20190928_FRESNO@NMEXST,New Mexico St.,Aggies,Fresno St.,Bulldogs,0-5,2-2,1,3,24,17,30,0,3,7,7,7,17,6,0,-2,-21,-13,0.03421546488672522,[-28.42916781]
2019,5,NCAAF_20190928_HOU@NTEXAS,North Texas,Mean Green,Houston,Cougars,2-3,2-3,1,6,17,25,46,0,6,12,7,14,3,14,15,0,-11,-21,0.26282515285718744,[-9.9019102]
2019,5,NCAAF_20190928_UNLV@WYO,Wyoming,Cowboys,UNLV,Rebels,4-1,1-3,1,33,10,53,17,7,26,0,20,10,0,0,7,3,23,36,0.7387487354130395,[9.97731079]
2019,5,NCAAF_20190928_WASHST@UTAH,Utah,Utes,Washington St.,Cougars,4-1,3-2,0,21,13,38,13,7,14,10,7,7,6,0,0,1,8,25,0.48082433706717453,[-0.75021481]
2019,5,NCAAF_20190928_HAWAII@NEVADA,Nevada,Wolf Pack,Hawaii,Rainbow Warriors,3-2,4-1,0,3,31,3,54,0,3,0,0,7,24,14,9,-1,-28,-51,0.6943575997291597,[7.92952399]
2019,5,NCAAF_20190928_UCLA@ARIZ,Arizona,Wildcats,UCLA,Bruins,3-1,1-4,1,6,7,20,17,0,6,7,7,7,0,10,0,2,-1,3,0.5292053715631214,[1.14319186]
2019,5,NCAAF_20190927_DUKE@VATECH,Virginia Tech,Hokies,Duke,Blue Devils,2-2,3-1,1,3,21,10,45,3,0,7,0,0,21,10,14,-1,-18,-35,0.5555923534392228,[2.1812018]
2019,5,NCAAF_20190927_PSU@MD,Maryland,Terrapins,Penn State,Nittany Lions,2-2,4-0,1,0,38,0,59,0,0,0,0,14,24,7,14,-2,-38,-59,0.06406830782239792,[-23.73818051]
2019,5,NCAAF_20190927_SJST@AF,Air Force,Falcons,San Jose St.,Spartans,3-1,2-2,0,21,10,41,24,7,14,13,7,7,3,0,14,1,11,17,0.8963606600683196,[19.67532456]
2019,5,NCAAF_20190927_ARIZST@CAL,California,Golden Bears,Arizona St.,Sun Devils,4-1,4-1,0,7,7,17,24,7,0,7,3,7,0,7,10,0,0,-7,0.45347737886337214,[-1.8235598]
2019,5,NCAAF_20190926_NAVY@MEMP,Memphis,Tigers,Navy,Midshipmen,4-0,2-1,0,14,20,35,23,7,7,14,7,13,7,0,3,2,-6,12,0.6992751942519951,[8.14914733]
2019,6,NCAAF_20191005_IOWA@MICH,Michigan,Wolverines,Iowa,Hawkeyes,4-1,4-1,1,10,3,10,3,10,0,0,0,0,3,0,0,0,7,7,0.5691874878325985,[2.7349844]
2019,6,NCAAF_20191005_KENTST@WISC,Wisconsin,Badgers,Kent St.,Golden Flashes,5-0,2-3,0,28,0,48,0,7,21,13,7,0,0,0,0,3,28,48,0.9987739588013788,[47.53018909]
2019,6,NCAAF_20191005_MD@RUT,Rutgers,Scarlet Knights,Maryland,Terrapins,1-4,3-2,1,7,27,7,48,0,7,0,0,7,20,21,0,-2,-20,-41,0.2341025027719772,[-11.38208495]
2019,6,NCAAF_20191005_OKLA@KANSAS,Kansas,Jayhawks,Oklahoma,Sooners,2-4,5-0,1,7,21,20,45,7,0,0,13,7,14,14,10,-3,-14,-25,0.012116743562780141,[-35.35756249]
2019,6,NCAAF_20191005_OKLAST@TXTECH,Texas Tech,Red Raiders,Oklahoma State,Cowboys,3-2,4-2,0,20,7,45,35,13,7,14,11,0,7,14,14,-1,13,10,0.36167614160017514,[-5.5542314]
2019,6,NCAAF_20191005_PURDUE@PSU,Penn State,Nittany Lions,Purdue,Boilermakers,5-0,1-4,0,28,7,35,7,21,7,0,7,0,7,0,0,4,21,28,0.8771613324382409,[18.21554916]
2019,6,NCAAF_20191005_SFLA@UCONN,UConn,Huskies,South Florida,Bulls,1-4,2-3,1,14,27,22,48,0,14,0,8,7,20,7,14,-1,-13,-26,0.08727303416361898,[-21.30391343]
2019,6,NCAAF_20191005_TULANE@ARMY,Army,Black Knights,Tulane,Green Wave,3-2,4-1,0,14,21,33,42,7,7,7,12,14,7,7,14,-1,-7,-9,0.5275558095360728,[1.08465476]
2019,6,NCAAF_20191005_UTAHST@LSU,LSU,Tigers,Utah St.,Aggies,5-0,3-2,1,21,6,42,6,7,14,14,7,6,0,0,0,2,15,36,0.7558308197036897,[10.87294293]
2019,6,NCAAF_20191005_BC@LVILLE,Louisville,Cardinals,Boston College,Eagles,3-2,3-3,0,28,22,41,39,14,14,3,10,7,15,7,10,0,6,2,0.3085302993551693,[-7.84567851]
2019,6,NCAAF_20191005_TCU@IOWAST,Iowa St.,Cyclones,TCU,Horned Frogs,3-2,3-2,0,21,3,49,24,7,14,14,14,0,3,7,14,0,18,25,0.5297484631968802,[1.17111674]
2019,6,NCAAF_20191005_EMICH@CMICH,C. Michigan,Chippewas,E. Michigan,Eagles,3-3,3-2,1,21,3,42,16,7,14,14,7,3,0,7,6,0,18,26,0.34016728670894525,[-6.46467705]
2019,6,NCAAF_20191005_AF@NAVY,Navy,Midshipmen,Air Force,Falcons,3-1,3-2,1,14,6,34,25,0,14,7,13,3,3,3,16,0,8,9,0.5989496616285577,[3.93255311]
2019,6,NCAAF_20191005_ARKST@GAST,Georgia St.,Panthers,Arkansas St.,Red Wolves,3-2,3-3,1,31,21,52,38,7,24,7,14,0,21,7,10,0,10,14,0.16343788537052106,[-15.38358524]
2019,6,NCAAF_20191005_AUBURN@FLA,Florida,Gators,Auburn,Tigers,6-0,5-1,0,17,13,24,13,7,10,0,7,6,7,0,0,1,4,11,0.27323355210247613,[-9.46248002]
2019,6,NCAAF_20191005_BALLST@NILL,N. Illinois,Huskies,Ball St.,Cardinals,1-4,2-3,0,17,3,20,27,14,3,0,3,0,3,14,10,-1,14,-7,0.9049705898519393,[20.56118908]
2019,6,NCAAF_20191005_BAYLOR@KSTATE,Kansas State,Wildcats,Baylor,Bears,3-2,5-0,0,3,10,12,31,3,0,3,6,0,10,7,14,-2,-7,-19,0.7190529577123038,[9.10109056]
2019,6,NCAAF_20191005_BGREEN@ND,Notre Dame,Fighting Irish,Bowling Green,Falcons,4-1,1-4,1,35,0,52,0,21,14,10,7,0,0,0,0,3,35,52,0.9975023905721119,[44.04919293]
2019,6,NCAAF_20191005_ILL@MINN,Minnesota,Golden Gophers,Illinois,Fighting Illini,5-0,2-3,0,16,10,40,17,3,13,14,10,7,3,7,0,3,6,23,0.8090537934814126,[13.72019019]
2019,6,NCAAF_20191005_MRSHL@MTSU,Middle Tenn.,Blue Raiders,Marshall,Thundering Herd,2-3,2-3,0,17,13,24,13,10,7,0,7,7,6,0,0,0,4,11,0.4913981612895205,[-0.33834326]
2019,6,NCAAF_20191005_TEXAS@WVU,West Virginia,Mountaineers,Texas,Longhorns,3-2,4-1,1,14,21,31,42,7,7,3,14,7,14,0,21,-1,-7,-11,0.4154418510092276,[-3.35103903]
2019,6,NCAAF_20191005_VATECH@MIAMI,Miami (Fla.),Hurricanes,Virginia Tech,Hokies,2-3,3-2,1,7,28,35,42,0,7,7,21,21,7,0,14,-1,-21,-7,0.6722550048985408,[7.0003873]
2019,6,NCAAF_20191005_WMICH@TOLEDO,Toledo,Rockets,W. Michigan,Broncos,4-1,3-3,1,24,7,31,24,14,10,0,7,7,0,10,7,1,17,7,0.6634290499302343,[6.61896783]
2019,6,NCAAF_20191005_MEMP@LAMON,UL-Monroe,Warhawks,Memphis,Tigers,2-3,5-0,1,17,29,33,52,3,14,9,7,7,22,10,13,-3,-12,-19,0.06137181134534464,[-24.21640588]
2019,6,NCAAF_20191005_NWEST@NEB,Nebraska,Cornhuskers,Northwestern,Wildcats,4-2,1-4,0,10,3,13,10,7,3,0,3,0,3,7,0,3,7,3,0.31574267339239914,[-7.52584999]
2019,6,NCAAF_20191005_TROY@MIZZOU,Missouri,Tigers,Troy,Trojans,4-1,2-3,0,42,7,42,10,21,21,0,0,7,0,3,0,2,35,32,0.8686588406727839,[17.57475495]
2019,6,NCAAF_20191005_UNC@GATECH,Georgia Tech,Yellow Jackets,North Carolina,Tar Heels,1-4,3-3,0,0,17,22,38,0,0,7,15,3,14,0,21,-2,-17,-16,0.7374227673572196,[9.97019354]
2019,6,NCAAF_20191005_ARIZ@COLO,Colorado,Buffaloes,Arizona,Wildcats,3-2,4-1,1,20,14,30,35,3,17,7,3,7,7,14,7,-1,6,-5,0.44101218747246773,[-2.3285558]
2019,6,NCAAF_20191005_WKY@ODU,Old Dominion,Monarchs,W. Kentucky,Hilltoppers,1-4,3-2,0,3,10,3,20,0,3,0,0,0,10,3,7,-2,-7,-17,0.40532168358879606,[-3.75943377]
2019,6,NCAAF_20191005_MA@FIU,FIU,Panthers,UMass,Minutemen,2-3,1-5,0,34,0,44,0,17,17,10,0,0,0,0,0,1,34,44,0.7312125983539063,[9.67308047]
2019,6,NCAAF_20191005_RICE@UAB,UAB,Blazers,Rice,Owls,4-1,0-6,0,21,20,35,20,0,21,14,0,7,13,0,0,4,1,15,0.8673155223657578,[17.47616998]
2019,6,NCAAF_20191005_UGA@TENN,Tennessee,Volunteers,Georgia,Bulldogs,1-4,5-0,1,14,26,14,43,7,7,0,0,10,16,3,14,-4,-12,-29,0.020325825195681935,[-32.11991519]
2019,6,NCAAF_20191005_MICHST@OHIOST,Ohio State,Buckeyes,Michigan St.,Spartans,6-0,4-2,1,27,10,34,10,3,24,0,7,0,10,0,0,2,17,24,0.8846613156846564,[18.80713511]
2019,6,NCAAF_20191005_VANDY@MISS,Ole Miss,Rebels,Vanderbilt,Commodores,3-3,1-4,1,10,6,31,6,10,0,14,7,0,6,0,0,2,4,25,0.5353218833147353,[1.39105734]
2019,6,NCAAF_20191005_CAL@OREG,Oregon,Ducks,California,Golden Bears,4-1,4-2,0,0,7,17,7,0,0,10,7,7,0,0,0,0,-7,10,0.6904352002650966,[7.79960659]
2019,6,NCAAF_20191005_LIB@NMEXST,New Mexico St.,Aggies,Liberty,Flames,0-6,4-2,0,0,10,13,20,0,0,6,7,3,7,3,7,-4,-10,-7,0.39132063388510385,[-4.32873247]
2019,6,NCAAF_20191005_PITT@DUKE,Duke,Blue Devils,Pittsburgh,Panthers,3-2,4-2,0,3,19,30,33,3,0,7,20,10,9,7,7,-1,-16,-3,0.512683056289013,[0.49891858]
2019,6,NCAAF_20191005_TXSA@UTEP,UTEP,Miners,UTSA,Roadrunners,1-4,2-3,1,3,10,16,26,0,3,7,6,7,3,6,10,-1,-7,-10,0.27016191820256874,[-9.60778934]
2019,6,NCAAF_20191005_OREGST@UCLA,UCLA,Bruins,Oregon State,Beavers,1-5,2-3,0,10,27,31,48,0,10,14,7,21,6,14,7,-1,-17,-17,0.8657451725117824,[17.36179099]
2019,6,NCAAF_20191005_SDGST@COLOST,Colorado St.,Rams,San Diego St.,Aztecs,1-5,4-1,0,3,10,10,24,3,0,0,7,3,7,7,7,-3,-7,-14,0.26395814842716414,[-9.9038204]
2019,6,NCAAF_20191005_BOISE@UNLV,UNLV,Rebels,Boise St.,Broncos,1-4,5-0,1,0,17,13,38,0,0,7,6,7,10,7,14,-4,-17,-25,0.06204137142995125,[-24.13012477]
2019,6,NCAAF_20191005_WASH@STNFRD,Stanford,Cardinal,Washington,Huskies,3-3,4-2,1,13,10,23,13,3,10,7,3,7,3,3,0,-1,3,10,0.2941523155285155,[-8.4932955]
2019,6,NCAAF_20191004_UCF@CINCY,Cincinnati,Bearcats,UCF,Knights,4-1,4-2,0,10,16,27,24,0,10,10,7,3,13,0,8,0,-6,3,0.12474434212143204,[-18.06930138]
2019,6,NCAAF_20191004_NMEX@SJST,San Jose St.,Spartans,New Mexico,Lobos,3-2,2-3,1,26,7,32,21,6,20,0,6,0,7,7,7,1,19,11,0.33011138973733023,[-6.89772484]
2019,6,NCAAF_20191003_TEMPLE@ECU,East Carolina,Pirates,Temple,Owls,3-3,4-1,1,10,17,17,27,7,3,0,7,0,17,7,3,-1,-7,-10,0.0998128831881433,[-20.1251971]
2019,7,NCAAF_20191012_MD@PURDUE,Purdue,Boilermakers,Maryland,Terrapins,2-4,3-3,0,30,14,40,14,13,17,3,7,0,14,0,0,-1,16,26,0.6555485355185362,[6.28639283]
2019,7,NCAAF_20191012_MEMP@TEMPLE,Temple,Owls,Memphis,Tigers,5-1,5-1,0,23,14,30,28,13,10,0,7,0,14,7,7,0,9,2,0.3579472752648182,[-5.71492902]
2019,7,NCAAF_20191012_MIAOH@WMICH,W. Michigan,Broncos,Miami-OH,RedHawks,4-3,2-4,1,21,6,38,16,0,21,0,17,6,0,3,7,2,15,22,0.5514419694920587,[2.03041233]
2019,7,NCAAF_20191012_MICH@ILL,Illinois,Fighting Illini,Michigan,Wolverines,2-4,5-1,1,7,28,25,42,0,7,10,8,14,14,0,14,-3,-21,-17,0.018332183430757598,[-32.81001702]
2019,7,NCAAF_20191012_MISSST@TENN,Tennessee,Volunteers,Miss. State,Bulldogs,2-4,3-3,0,10,3,20,10,7,3,3,7,0,3,0,7,-1,7,10,0.11493703873552685,[-18.85368786]
2019,7,NCAAF_20191012_OKLA@TEXAS,Texas,Longhorns,Oklahoma,Sooners,4-2,6-0,0,3,10,27,34,0,3,14,10,7,3,10,14,-2,-7,-7,0.2481825270581437,[-10.6811339]
2019,7,NCAAF_20191012_RUT@IND,Indiana,Hoosiers,Rutgers,Scarlet Knights,4-2,1-5,0,21,0,35,0,21,0,14,0,0,0,0,0,3,21,35,0.8163613190369783,[14.15710727]
2019,7,NCAAF_20191012_TOLEDO@BGREEN,Bowling Green,Falcons,Toledo,Rockets,2-4,4-2,1,17,7,20,7,10,7,3,0,0,7,0,0,-2,10,13,0.06903073135049287,[-23.28752146]
2019,7,NCAAF_20191012_GATECH@DUKE,Duke,Blue Devils,Georgia Tech,Yellow Jackets,4-2,1-5,0,38,14,41,23,10,28,3,0,7,7,3,6,3,24,18,0.48616577904061264,[-0.54462749]
2019,7,NCAAF_20191012_BALLST@EMICH,E. Michigan,Eagles,Ball St.,Cardinals,3-3,3-3,1,17,14,23,29,7,10,6,0,0,14,7,8,0,3,-6,0.8459138583366985,[16.00182713]
2019,7,NCAAF_20191012_ODU@MRSHL,Marshall,Thundering Herd,Old Dominion,Monarchs,3-3,1-5,0,17,10,31,17,7,10,7,7,0,10,7,0,2,7,14,0.8198798125874275,[14.36629791]
2019,7,NCAAF_20191012_NMEXST@CMICH,C. Michigan,Chippewas,New Mexico St.,Aggies,4-3,0-7,0,28,21,42,28,14,14,6,8,7,14,0,7,4,7,14,0.7154490257093185,[8.940585]
2019,7,NCAAF_20191012_BAMA@TXAM,Texas A&M,Aggies,Alabama,Crimson Tide,3-3,6-0,1,13,24,28,47,7,6,7,8,14,10,10,13,-3,-11,-19,0.052621731220063195,[-25.43717634]
2019,7,NCAAF_20191012_BYU@SFLA,South Florida,Bulls,BYU,Cougars,3-3,2-4,0,7,16,27,23,0,7,7,13,3,13,7,0,1,-9,4,0.5782391205409622,[3.0995216]
2019,7,NCAAF_20191012_CINCY@HOU,Houston,Cougars,Cincinnati,Bearcats,2-4,5-1,0,10,21,23,38,3,7,7,6,14,7,0,17,-3,-11,-15,0.5483886935393838,[1.90928499]
2019,7,NCAAF_20191012_FSU@CLEM,Clemson,Tigers,Florida State,Seminoles,6-0,3-3,1,28,0,45,14,14,14,14,3,0,0,7,7,3,28,31,0.9402741847961409,[24.44998572]
2019,7,NCAAF_20191012_KENTST@AKRON,Akron,Zips,Kent St.,Golden Flashes,0-6,3-3,0,3,17,3,26,0,3,0,0,7,10,0,9,-3,-14,-23,0.6997982728709067,[8.22527191]
2019,7,NCAAF_20191012_MICHST@WISC,Wisconsin,Badgers,Michigan St.,Spartans,6-0,4-3,1,17,0,38,0,7,10,0,21,0,0,0,0,2,17,38,0.7379269124234833,[10.00195623]
2019,7,NCAAF_20191012_NILL@OHIO,Ohio,Bobcats,N. Illinois,Huskies,2-4,2-4,1,21,10,36,39,7,14,0,15,10,0,12,17,0,11,-3,0.6001772096794726,[3.98537703]
2019,7,NCAAF_20191012_WASHST@ARIZST,Arizona St.,Sun Devils,Washington St.,Cougars,5-1,3-3,0,17,17,38,34,0,17,7,14,10,7,14,3,2,0,4,0.35963641447490924,[-5.64394987]
2019,7,NCAAF_20191012_UCONN@TULANE,Tulane,Green Wave,UConn,Huskies,5-1,1-5,1,28,0,49,7,14,14,14,7,0,0,0,7,4,28,42,0.9299122668256458,[23.16330221]
2019,7,NCAAF_20191012_IOWAST@WVU,West Virginia,Mountaineers,Iowa St.,Cyclones,3-3,4-2,0,14,14,14,38,7,7,0,0,0,14,7,17,-1,0,-24,0.39589411588232715,[-4.14528146]
2019,7,NCAAF_20191012_MTSU@FAU,FAU,Owls,Middle Tenn.,Blue Raiders,4-2,2-4,1,12,13,28,13,2,10,10,6,6,7,0,0,2,-1,15,0.627241417086528,[5.09632867]
2019,7,NCAAF_20191012_RI@VATECH,Virginia Tech,Hokies,Rhode Island,Rams,4-2,1-5,1,17,6,34,17,10,7,7,10,0,6,11,0,3,11,17,0.9775614252474077,[31.49607]
2019,7,NCAAF_20191012_SJST@NEVADA,Nevada,Wolf Pack,San Jose St.,Spartans,4-2,3-3,0,24,10,41,38,14,10,7,10,3,7,14,14,1,14,3,0.7745411100369779,[11.83786616]
2019,7,NCAAF_20191012_UNLV@VANDY,Vanderbilt,Commodores,UNLV,Rebels,1-5,2-4,1,10,24,10,34,7,3,0,0,7,17,0,10,-1,-14,-24,0.827079412534806,[14.80250539]
2019,7,NCAAF_20191012_GAST@CSTCAR,C. Carolina,Chanticleers,Georgia St.,Panthers,3-3,4-2,0,6,17,21,31,3,3,7,8,3,14,14,0,-1,-11,-10,0.5113997527906899,[0.44875813]
2019,7,NCAAF_20191012_UAB@TXSA,UTSA,Roadrunners,UAB,Blazers,2-4,5-1,1,7,16,14,33,0,7,7,0,3,13,7,10,-3,-9,-19,0.22171384558136742,[-12.0346504]
2019,7,NCAAF_20191012_ARMY@WKY,W. Kentucky,Hilltoppers,Army,Black Knights,4-2,3-3,0,7,0,17,8,7,0,3,7,0,0,0,8,1,7,9,0.1605463314140566,[-15.58022151]
2019,7,NCAAF_20191012_CHARLO@FIU,FIU,Panthers,Charlotte,49ers,3-3,2-4,0,28,17,48,23,7,21,13,7,10,7,6,0,1,11,25,0.7771479725876753,[11.97464562]
2019,7,NCAAF_20191012_FRESNO@AF,Air Force,Falcons,Fresno St.,Bulldogs,4-2,2-3,0,22,24,43,24,7,15,7,14,14,10,0,0,2,-2,19,0.23456039243176363,[-11.36717698]
2019,7,NCAAF_20191012_MA@LATECH,Louisiana Tech,,UMass,,5-1,1-6,,52,14,69,21,28,24,10,7,0,14,7,0,4,38,48,0.7644844414771053,[11.31837428]
2019,7,NCAAF_20191012_MISS@MIZZOU,Missouri,Tigers,Ole Miss,Rebels,5-1,3-4,0,12,7,38,27,3,9,23,3,7,0,7,13,2,5,11,0.7867408721640534,[12.48603126]
2019,7,NCAAF_20191012_NTEXAS@USM,So. Miss,Golden Eagles,North Texas,Mean Green,4-2,2-4,1,28,20,45,27,13,15,10,7,7,13,0,7,2,8,18,0.4715277919478472,[-1.12162612]
2019,7,NCAAF_20191012_ARK@UK,Kentucky,Wildcats,Arkansas,Razorbacks,3-3,2-4,0,7,13,24,20,0,7,10,7,7,6,0,7,1,-6,4,0.8000795851549701,[13.2199926]
2019,7,NCAAF_20191012_LVILLE@WAKE,Wake Forest,Demon Deacons,Louisville,Cardinals,5-1,4-2,1,21,31,59,62,7,14,10,28,21,10,14,17,1,-10,-3,0.6864382633821386,[7.62793661]
2019,7,NCAAF_20191012_NAVY@TULSA,Tulsa,Golden Hurricane,Navy,Midshipmen,2-4,4-1,0,3,28,17,45,3,0,7,7,7,21,0,17,-2,-25,-28,0.30477794864826724,[-8.01936665]
2019,7,NCAAF_20191012_NEB@MINN,Minnesota,Golden Gophers,Nebraska,Cornhuskers,6-0,4-3,0,14,0,34,7,7,7,20,0,0,0,0,7,2,14,27,0.5779527925008425,[3.08803078]
2019,7,NCAAF_20191012_PSU@IOWA,Iowa,Hawkeyes,Penn State,Nittany Lions,4-2,6-0,1,6,7,12,17,3,3,0,6,0,7,3,7,-2,-1,-5,0.29563027894727034,[-8.43238432]
2019,7,NCAAF_20191012_USC@ND,Notre Dame,Fighting Irish,USC,Trojans,5-1,3-3,0,17,3,30,27,0,17,3,10,3,0,10,14,2,14,3,0.761551549871293,[11.16920042]
2019,7,NCAAF_20191012_FLA@LSU,LSU,Tigers,Florida,Gators,6-0,6-1,1,21,21,42,28,7,14,14,7,7,14,7,0,0,0,14,0.6359771340998668,[5.46016043]
2019,7,NCAAF_20191012_UTAH@OREGST,Oregon State,Beavers,Utah,Utes,2-4,5-1,1,0,35,7,52,0,0,0,7,21,14,14,3,-3,-35,-45,0.044164365763728286,[-26.76140261]
2019,7,NCAAF_20191012_HAWAII@BOISE,Boise St.,Broncos,Hawaii,Rainbow Warriors,6-0,4-2,0,31,14,59,37,14,17,21,7,7,7,7,16,2,17,22,0.9336831180433943,[23.61331304]
2019,7,NCAAF_20191012_WYO@SDGST,San Diego St.,Aztecs,Wyoming,Cowboys,5-1,4-2,1,6,14,26,22,3,3,13,7,0,14,0,8,1,-8,4,0.6197025827260257,[4.78453739]
2019,7,NCAAF_20191012_WASH@ARIZ,Arizona,Wildcats,Washington,Huskies,4-2,5-2,1,17,13,27,51,0,17,0,10,6,7,14,24,-1,4,-24,0.16466404444694316,[-15.317255]
2019,7,NCAAF_20191011_COLOST@NMEX,New Mexico,Lobos,Colorado St.,Rams,2-4,2-5,0,14,21,21,35,6,8,0,7,7,14,7,7,0,-7,-14,0.28516396260919996,[-8.91222649]
2019,7,NCAAF_20191011_UVA@MIAMI,Miami (Fla.),Hurricanes,Virginia,Cavaliers,3-3,4-2,1,7,3,17,9,7,0,0,10,0,3,0,6,-1,4,8,0.7125770458100377,[8.80796893]
2019,7,NCAAF_20191011_COLO@OREG,Oregon,Ducks,Colorado,Buffaloes,5-1,3-3,1,24,3,45,3,7,17,14,7,3,0,0,0,2,21,42,0.7611726589543655,[11.15000273]
2019,7,NCAAF_20191010_CUSE@NCST,NC State,Wolfpack,Syracuse,Orange,4-2,3-3,0,13,0,16,10,6,7,3,0,0,0,3,7,1,13,6,0.6189427717117509,[4.75321954]
2019,7,NCAAF_20191010_LAMON@TXSTSM,Texas St.,Bobcats,UL-Monroe,Warhawks,2-4,3-3,0,7,17,14,24,0,7,7,0,7,10,0,7,-1,-10,-10,0.2859038392163207,[-8.87803646]
2019,7,NCAAF_20191009_APLST@LALAF,Louisiana,Ragin' Cajuns,App. St.,Mountaineers,4-2,5-0,1,7,7,7,17,0,7,0,0,7,0,3,7,-1,0,-10,0.20956856043720873,[-12.68632265]
2019,8,NCAAF_20191019_AUBURN@ARK,Arkansas,Razorbacks,Auburn,Tigers,2-5,6-1,1,0,17,10,51,0,0,10,0,17,0,14,20,-4,-17,-41,0.0421192464379907,[-27.17575422]
2019,8,NCAAF_20191019_CLEM@LVILLE,Louisville,Cardinals,Clemson,Tigers,4-3,7-0,1,3,17,10,45,0,3,0,7,3,14,7,21,-3,-14,-35,0.025930649745488754,[-30.60186999]
2019,8,NCAAF_20191019_FLA@SC,South Carolina,Gamecocks,Florida,Gators,3-4,7-1,1,10,10,27,38,7,3,10,7,3,7,7,21,-4,0,-11,0.4200288794292747,[-3.17652124]
2019,8,NCAAF_20191019_HOU@UCONN,UConn,Huskies,Houston,Cougars,1-6,3-4,0,7,10,17,24,0,7,3,7,3,7,7,7,-2,-3,-7,0.042313590900653786,[-27.14177656]
2019,8,NCAAF_20191019_IOWAST@TXTECH,Texas Tech,Red Raiders,Iowa St.,Cyclones,3-4,5-2,0,7,20,24,34,0,7,10,7,7,13,7,7,-2,-13,-10,0.3315811425389986,[-6.85532066]
2019,8,NCAAF_20191019_KENTST@OHIO,Ohio,Bobcats,Kent St.,Golden Flashes,3-4,3-4,0,24,24,45,38,10,14,7,14,14,10,0,14,0,0,7,0.9221729539078467,[22.34745206]
2019,8,NCAAF_20191019_NCST@BC,Boston College,Eagles,NC State,Wolfpack,4-3,4-3,1,24,3,45,24,7,17,7,14,0,3,7,14,0,21,21,0.39914963488826016,[-4.02218686]
2019,8,NCAAF_20191019_PURDUE@IOWA,Iowa,Hawkeyes,Purdue,Boilermakers,5-2,2-5,1,9,7,26,20,6,3,7,10,0,7,0,13,3,2,6,0.7411400247330918,[10.18125753]
2019,8,NCAAF_20191019_WISC@ILL,Illinois,Fighting Illini,Wisconsin,Badgers,3-4,6-1,0,7,13,24,23,0,7,7,10,7,6,7,3,-3,-6,1,0.021816734029016516,[-31.75575159]
2019,8,NCAAF_20191019_WVU@OKLA,Oklahoma,Sooners,West Virginia,Mountaineers,7-0,3-4,0,28,14,52,14,14,14,21,3,0,14,0,0,4,14,38,0.8335065061952074,[15.23755652]
2019,8,NCAAF_20191019_CMICH@BGREEN,Bowling Green,Falcons,C. Michigan,Chippewas,2-5,5-3,0,7,21,20,38,7,0,7,6,7,14,7,10,-3,-14,-18,0.24363535824629756,[-10.93347979]
2019,8,NCAAF_20191019_TOLEDO@BALLST,Ball St.,Cardinals,Toledo,Rockets,4-3,4-3,1,38,0,52,14,17,21,14,0,0,0,7,7,0,38,38,0.08862102124175686,[-21.23711524]
2019,8,NCAAF_20191019_NILL@MIAOH,Miami-OH,RedHawks,N. Illinois,Huskies,3-4,2-5,0,7,10,27,24,0,7,14,6,3,7,7,7,1,-3,3,0.38572640235633393,[-4.57190628]
2019,8,NCAAF_20191019_OREGST@CAL,California,Golden Bears,Oregon State,Beavers,4-3,3-4,0,3,14,17,21,0,3,14,0,7,7,0,7,1,-11,-4,0.8817009315017917,[18.62810367]
2019,8,NCAAF_20191019_TCU@KSTATE,Kansas State,Wildcats,TCU,Horned Frogs,4-2,3-3,0,14,10,24,17,7,7,3,7,0,10,7,0,1,4,7,0.35924933671499093,[-5.67352194]
2019,8,NCAAF_20191019_NMEX@WYO,Wyoming,Cowboys,New Mexico,Lobos,5-2,2-5,1,7,0,23,10,7,0,6,10,0,0,0,10,3,7,13,0.8208030699052584,[14.45554341]
2019,8,NCAAF_20191019_BUFF@AKRON,Akron,Zips,Buffalo,Bulls,0-7,3-4,0,0,7,0,21,0,0,0,0,7,0,7,7,-3,-7,-21,0.21461622269251768,[-12.44209394]
2019,8,NCAAF_20191019_DUKE@UVA,Virginia,Cavaliers,Duke,Blue Devils,5-2,4-3,1,17,0,48,14,0,17,24,7,0,0,7,7,1,17,34,0.42893707319816565,[-2.8186282]
2019,8,NCAAF_20191019_IND@MD,Maryland,Terrapins,Indiana,Hoosiers,3-4,5-2,0,21,24,28,34,7,14,7,0,14,10,7,3,-2,-3,-6,0.44966690180206803,[-1.99108189]
2019,8,NCAAF_20191019_LAMON@APLST,App. St.,Mountaineers,UL-Monroe,Warhawks,6-0,3-4,0,31,7,52,7,21,10,7,14,7,0,0,0,3,24,45,0.8523124642538435,[16.46976274]
2019,8,NCAAF_20191019_LSU@MISSST,Miss. State,Bulldogs,LSU,Tigers,3-4,7-0,1,7,22,13,36,0,7,0,6,3,19,14,0,-4,-15,-23,0.41098563170990776,[-3.54152912]
2019,8,NCAAF_20191019_MINN@RUT,Rutgers,Scarlet Knights,Minnesota,Golden Gophers,1-6,7-0,1,0,14,7,42,0,0,0,7,7,7,7,21,-6,-14,-35,0.1427582635703487,[-16.80982795]
2019,8,NCAAF_20191019_OREG@WASH,Washington,Huskies,Oregon,Ducks,5-3,6-1,0,21,14,31,35,7,14,10,0,7,7,14,7,-1,7,-4,0.6466638692228867,[5.92319737]
2019,8,NCAAF_20191019_SFLA@NAVY,Navy,Midshipmen,South Florida,Bulls,5-1,3-4,0,21,3,35,3,7,14,0,14,0,3,0,0,2,18,32,0.5568830647574939,[2.25185773]
2019,8,NCAAF_20191019_TEMPLE@SMU,SMU,Mustangs,Temple,Owls,7-0,5-2,1,24,7,45,21,10,14,7,14,0,7,7,7,2,17,24,0.49277304094142216,[-0.28513971]
2019,8,NCAAF_20191019_TULSA@CINCY,Cincinnati,Bearcats,Tulsa,Golden Hurricane,6-1,2-5,0,10,7,24,13,10,0,7,7,0,7,3,3,4,3,11,0.7714057358542274,[11.70200343]
2019,8,NCAAF_20191019_USM@LATECH,Louisiana Tech,Bulldogs,So. Miss,Golden Eagles,6-1,4-3,0,24,27,45,30,7,17,0,21,14,13,0,3,2,-3,15,0.47360744446703906,[-1.04202219]
2019,8,NCAAF_20191019_BAYLOR@OKLAST,Oklahoma State,Cowboys,Baylor,Bears,4-3,7-0,1,13,10,27,45,6,7,7,7,7,3,14,21,-3,3,-18,0.8066439571143049,[13.62395992]
2019,8,NCAAF_20191019_CHARLO@WKY,W. Kentucky,Hilltoppers,Charlotte,49ers,5-2,2-5,0,17,14,30,14,7,10,13,0,7,7,0,0,3,3,16,0.6687469901455823,[6.86955729]
2019,8,NCAAF_20191019_MIZZOU@VANDY,Vanderbilt,Commodores,Missouri,Tigers,2-5,5-2,1,14,7,21,14,0,14,0,7,0,7,7,0,-3,7,7,0.1456259559336771,[-16.61104567]
2019,8,NCAAF_20191019_MTSU@NTEXAS,North Texas,Mean Green,Middle Tenn.,Blue Raiders,3-4,2-5,1,17,16,33,30,7,10,3,13,3,13,0,14,1,1,3,0.4567416353653059,[-1.7100239]
2019,8,NCAAF_20191019_ODU@UAB,UAB,Blazers,Old Dominion,Monarchs,6-1,1-6,0,28,3,38,14,14,14,7,3,0,3,11,0,5,25,24,0.7900154247597291,[12.69343632]
2019,8,NCAAF_20191019_ARIZST@UTAH,Utah,Utes,Arizona St.,Sun Devils,6-1,5-2,0,14,0,21,3,0,14,0,7,0,0,3,0,1,14,18,0.6660522581326801,[6.75280648]
2019,8,NCAAF_20191019_ME@LIB,Liberty,Flames,Maine,Black Bears,5-2,2-5,1,45,17,59,44,17,28,7,7,3,14,7,20,3,28,15,0.6693989462223947,[6.8978603]
2019,8,NCAAF_20191019_RICE@TXSA,UTSA,,Rice,,3-4,0-7,,7,10,31,27,7,0,17,7,3,7,14,3,3,-3,4,0.6270277289260158,[5.09943325]
2019,8,NCAAF_20191019_UK@UGA,Georgia,Bulldogs,Kentucky,Wildcats,6-1,3-4,1,0,0,21,0,0,0,14,7,0,0,0,0,3,0,21,0.9213885151265161,[22.26297456]
2019,8,NCAAF_20191019_ARMY@GAST,Georgia St.,Panthers,Army,Black Knights,5-2,3-4,1,14,14,28,21,7,7,6,8,7,7,7,0,2,0,7,0.13283320464561732,[-17.51950234]
2019,8,NCAAF_20191019_COLO@WASHST,Washington St.,Cougars,Colorado,Buffaloes,4-3,3-4,0,24,3,41,10,21,3,7,10,3,0,7,0,1,21,31,0.7768514428787182,[11.98717775]
2019,8,NCAAF_20191019_ECU@UCF,UCF,Knights,East Carolina,Pirates,5-2,3-4,0,35,6,41,28,21,14,6,0,0,6,16,6,2,29,13,0.9888574893530675,[35.97201779]
2019,8,NCAAF_20191019_KANSAS@TEXAS,Texas,Longhorns,Kansas,Jayhawks,5-2,2-5,1,21,17,50,48,14,7,3,26,3,14,7,24,3,4,2,0.9377047953872715,[24.17239399]
2019,8,NCAAF_20191019_SDGST@SJST,San Jose St.,Spartans,San Diego St.,Aztecs,3-4,6-1,0,7,13,17,27,7,0,3,7,7,6,14,0,-3,-6,-10,0.06069785792877902,[-24.37942837]
2019,8,NCAAF_20191019_TULANE@MEMP,Memphis,Tigers,Tulane,Green Wave,6-1,5-2,0,34,10,47,17,13,21,6,7,3,7,0,7,1,24,30,0.6715150423591414,[6.98987966]
2019,8,NCAAF_20191019_UTEP@FIU,FIU,Panthers,UTEP,Miners,4-3,1-5,0,18,7,32,17,3,15,0,14,7,0,0,10,3,11,15,0.9071369983666311,[20.82841595]
2019,8,NCAAF_20191019_WMICH@EMICH,E. Michigan,Eagles,W. Michigan,Broncos,4-3,4-4,0,10,14,34,27,3,7,10,14,7,7,7,6,0,-4,7,0.4388575233880794,[-2.42176683]
2019,8,NCAAF_20191019_FSU@WAKE,Wake Forest,Demon Deacons,Florida State,Seminoles,6-1,3-4,1,12,14,22,20,6,6,0,10,0,14,0,6,3,-2,2,0.5272880830603792,[1.07743348]
2019,8,NCAAF_20191019_MICH@PSU,Penn State,Nittany Lions,Michigan,Wolverines,7-0,5-2,0,21,7,28,21,7,14,0,7,0,7,7,7,2,14,7,0.6431358901033273,[5.77405897]
2019,8,NCAAF_20191019_TXAM@MISS,Ole Miss,Rebels,Texas A&M,Aggies,3-5,4-3,0,7,10,17,24,7,0,7,3,3,7,7,7,-1,-3,-7,0.3123139211185295,[-7.70132575]
2019,8,NCAAF_20191019_TENN@BAMA,Alabama,Crimson Tide,Tennessee,Volunteers,7-0,2-5,0,21,10,35,13,14,7,7,7,7,3,3,0,5,11,22,0.9910007450793125,[37.23391396]
2019,8,NCAAF_20191019_ARIZ@USC,USC,Trojans,Arizona,Wildcats,4-3,4-3,1,17,0,41,14,10,7,10,14,0,0,0,14,0,17,27,0.6911061408341018,[7.85377894]
2019,8,NCAAF_20191019_BOISE@BYU,BYU,Cougars,Boise St.,Broncos,3-4,6-1,0,7,10,28,25,7,0,21,0,7,3,0,15,-3,-3,3,0.19836333984452226,[-13.33886127]
2019,8,NCAAF_20191019_NEVADA@UTAHST,Utah St.,Aggies,Nevada,Wolf Pack,4-2,4-3,0,22,3,36,10,9,13,0,14,3,0,0,7,0,19,26,0.8552605765963313,[16.67221428]
2019,8,NCAAF_20191019_AF@HAWAII,Hawaii,Rainbow Warriors,Air Force,Falcons,4-3,5-2,1,20,28,26,56,3,17,0,6,7,21,7,21,-1,-8,-30,0.23138998508446407,[-11.55708513]
2019,8,NCAAF_20191018_MRSHL@FAU,FAU,Owls,Marshall,Thundering Herd,4-3,4-3,0,17,17,31,36,14,3,0,14,10,7,5,14,0,0,-5,0.6431989497147796,[5.77672011]
2019,8,NCAAF_20191018_PITT@CUSE,Syracuse,Orange,Pittsburgh,Panthers,3-4,5-2,0,6,24,20,27,3,3,7,7,10,14,0,3,-2,-18,-7,0.5060816657529251,[0.23994833]
2019,8,NCAAF_20191018_OHIOST@NWEST,Northwestern,Wildcats,Ohio State,Buckeyes,1-5,7-0,0,3,31,3,52,3,0,0,0,7,24,7,14,-6,-28,-49,0.08220127358723239,[-21.8843285]
2019,8,NCAAF_20191018_UNLV@FRESNO,Fresno St.,Bulldogs,UNLV,Rebels,3-3,2-5,0,28,17,56,27,7,21,7,21,3,14,3,7,1,11,29,0.8967832833187745,[19.88569663]
2019,8,NCAAF_20191017_LALAF@ARKST,Arkansas St.,Red Wolves,Louisiana,Ragin' Cajuns,3-4,5-2,1,10,24,20,37,7,3,3,7,7,17,0,13,-2,-14,-17,0.6613796380966317,[6.55123545]
2019,8,NCAAF_20191017_UCLA@STNFRD,Stanford,Cardinal,UCLA,Bruins,3-4,2-5,1,10,21,16,34,10,0,0,6,14,7,6,7,1,-11,-18,0.7541095793308803,[10.82051544]
2019,8,NCAAF_20191016_SALA@TROY,Troy,Trojans,South Alabama,Jaguars,3-3,1-6,1,16,10,37,13,3,13,7,14,3,7,3,0,2,6,24,0.8824678928561802,[18.68920055]
2019,9,NCAAF_20191026_APLST@SALA,South Alabama,Jaguars,App. St.,Mountaineers,1-7,7-0,0,0,13,3,30,0,0,0,3,7,6,10,7,-6,-13,-27,0.05931635626812304,[-24.69455941]
2019,9,NCAAF_20191026_BGREEN@WMICH,W. Michigan,Broncos,Bowling Green,Falcons,5-4,2-6,0,21,3,49,10,0,21,28,0,3,0,7,0,3,18,39,0.8494933689035284,[16.36657453]
2019,9,NCAAF_20191026_ILL@PURDUE,Purdue,Boilermakers,Illinois,Fighting Illini,2-6,4-4,1,0,17,6,24,0,0,0,6,3,14,7,0,-2,-17,-18,0.8781058613525039,[18.44443071]
2019,9,NCAAF_20191026_IOWA@NWEST,Northwestern,Wildcats,Iowa,Hawkeyes,1-6,6-2,0,0,10,0,20,0,0,0,0,7,3,7,3,-5,-10,-20,0.21129858553024206,[-12.68994711]
2019,9,NCAAF_20191026_LIB@RUT,Rutgers,Scarlet Knights,Liberty,Flames,2-6,5-3,0,21,21,44,34,7,14,17,6,14,7,3,10,-3,0,10,0.6290887309999033,[5.21319787]
2019,9,NCAAF_20191026_MIAMI@PITT,Pittsburgh,Panthers,Miami (Fla.),Hurricanes,5-3,4-4,1,6,10,12,16,3,3,3,3,3,7,0,6,1,-4,-4,0.3410957010784694,[-6.47968364]
2019,9,NCAAF_20191026_MISSST@TXAM,Texas A&M,Aggies,Miss. State,Bulldogs,5-3,3-5,0,28,10,49,30,14,14,14,7,0,10,7,13,2,18,19,0.3893137836698565,[-4.44836111]
2019,9,NCAAF_20191026_OKLA@KSTATE,Kansas State,Wildcats,Oklahoma,Sooners,5-2,7-1,0,24,23,48,41,7,17,17,7,17,6,0,18,-2,1,7,0.11385408310910461,[-19.08869551]
2019,9,NCAAF_20191026_SJST@ARMY,Army,Black Knights,San Jose St.,Spartans,3-5,4-4,0,10,23,29,34,7,3,7,12,7,16,0,11,-1,-13,-5,0.9067611359632629,[20.90513405]
2019,9,NCAAF_20191026_WISC@OHIOST,Ohio State,Buckeyes,Wisconsin,Badgers,8-0,6-2,0,10,0,38,7,0,10,14,14,0,0,7,0,2,10,31,0.7326666822292648,[9.82533129]
2019,9,NCAAF_20191026_USM@RICE,Rice,Owls,So. Miss,Golden Eagles,0-8,5-3,0,0,10,6,20,0,0,6,0,0,10,3,7,-5,-10,-14,0.13988799843616917,[-17.10335397]
2019,9,NCAAF_20191026_NEVADA@WYO,Wyoming,Cowboys,Nevada,Wolf Pack,6-2,4-4,0,24,3,31,3,14,10,7,0,3,0,0,0,2,21,28,0.7104050094611747,[8.77570205]
2019,9,NCAAF_20191026_OHIO@BALLST,Ball St.,Cardinals,Ohio,Bobcats,4-4,4-4,1,7,13,21,34,7,0,7,7,7,6,14,7,0,-6,-13,0.11130193393533427,[-19.29994864]
2019,9,NCAAF_20191026_WKY@MRSHL,Marshall,Thundering Herd,W. Kentucky,Hilltoppers,5-3,5-3,0,20,7,26,23,14,6,3,3,0,7,6,10,0,13,3,0.7062865214665933,[8.58581213]
2019,9,NCAAF_20191026_NMEXST@GAS,Ga. Southern,Eagles,New Mexico St.,Aggies,4-3,0-8,1,28,7,41,7,7,21,13,0,7,0,0,0,4,21,34,0.6796989688834617,[7.38772765]
2019,9,NCAAF_20191026_AKRON@NILL,N. Illinois,Huskies,Akron,Zips,3-5,0-8,0,21,0,49,0,7,14,14,14,0,0,0,0,3,21,49,0.793113150842857,[12.93280735]
2019,9,NCAAF_20191026_ARIZ@STNFRD,Stanford,Cardinal,Arizona,Wildcats,4-4,4-4,0,31,24,41,31,7,24,7,3,10,14,7,0,0,7,10,0.7023602316588017,[8.40592817]
2019,9,NCAAF_20191026_AUBURN@LSU,LSU,Tigers,Auburn,Tigers,8-0,6-2,1,10,10,23,20,0,10,6,7,3,7,3,7,2,0,3,0.4490476638426546,[-2.02659395]
2019,9,NCAAF_20191026_CMICH@BUFF,Buffalo,Bulls,C. Michigan,Chippewas,4-4,5-4,0,30,14,43,20,3,27,3,10,7,7,0,6,-1,16,23,0.6618112230346946,[6.60527781]
2019,9,NCAAF_20191026_CUSE@FSU,Florida State,Seminoles,Syracuse,Orange,4-4,3-5,0,21,3,35,17,13,8,14,0,0,3,0,14,1,18,18,0.5009091199627588,[0.03606105]
2019,9,NCAAF_20191026_FAU@ODU,Old Dominion,Monarchs,FAU,Owls,1-7,5-3,1,3,24,3,41,0,3,0,0,14,10,7,10,-4,-21,-38,0.09964819443836614,[-20.3115276]
2019,9,NCAAF_20191026_FIU@MTSU,Middle Tenn.,Blue Raiders,FIU,Panthers,3-5,4-4,0,14,17,50,17,14,0,23,13,7,10,0,0,-1,-3,33,0.5728328275442356,[2.9052142]
2019,9,NCAAF_20191026_IND@NEB,Nebraska,Cornhuskers,Indiana,Hoosiers,4-4,6-2,1,21,16,31,38,14,7,3,7,9,7,15,7,-2,5,-7,0.4043220264078182,[-3.83228085]
2019,9,NCAAF_20191026_MD@MINN,Minnesota,Golden Gophers,Maryland,Terrapins,8-0,3-5,0,28,3,52,10,14,14,10,14,0,3,0,7,5,25,42,0.6007917712684825,[4.04150101]
2019,9,NCAAF_20191026_MIAOH@KENTST,Kent St.,Golden Flashes,Miami-OH,RedHawks,3-5,4-4,1,6,9,16,23,0,6,0,10,6,3,7,7,-1,-3,-7,0.18605447947294818,[-14.12373698]
2019,9,NCAAF_20191026_NTEXAS@CHARLO,Charlotte,49ers,North Texas,Mean Green,3-5,3-5,1,7,21,39,38,0,7,14,18,14,7,14,3,0,-14,1,0.1851704489765138,[-14.17603759]
2019,9,NCAAF_20191026_OKLAST@IOWAST,Iowa St.,Cyclones,Oklahoma State,Cowboys,5-3,5-3,1,13,21,27,34,0,13,7,7,7,14,3,10,0,-8,-7,0.5869925677269949,[3.4784447]
2019,9,NCAAF_20191026_PSU@MICHST,Michigan St.,Spartans,Penn State,Nittany Lions,4-4,8-0,0,0,21,7,28,0,0,7,0,7,14,7,0,-4,-21,-21,0.13073398810757653,[-17.76964838]
2019,9,NCAAF_20191026_TEXAS@TCU,TCU,Horned Frogs,Texas,Longhorns,4-3,5-3,1,13,17,37,27,3,10,14,10,3,14,3,7,-1,-4,10,0.4413666326484291,[-2.33417924]
2019,9,NCAAF_20191026_TULANE@NAVY,Navy,Midshipmen,Tulane,Green Wave,6-1,5-3,1,31,14,41,38,21,10,0,10,0,14,14,10,1,17,3,0.5419058626517816,[1.66530035]
2019,9,NCAAF_20191026_UCONN@MA,UMass,Minutemen,UConn,Huskies,1-7,2-6,1,21,35,35,56,7,14,7,7,14,21,7,14,-1,-14,-21,0.505988187218026,[0.23753546]
2019,9,NCAAF_20191026_UVA@LVILLE,Louisville,Cardinals,Virginia,Cavaliers,5-3,5-3,1,7,14,28,21,7,0,7,14,7,7,0,7,0,-7,7,0.3790363445119628,[-4.87411105]
2019,9,NCAAF_20191026_SFLA@ECU,East Carolina,Pirates,South Florida,Bulls,3-5,4-4,1,10,35,20,45,7,3,0,10,14,21,3,7,-1,-25,-25,0.1898536826201105,[-13.90070311]
2019,9,NCAAF_20191026_DUKE@UNC,North Carolina,Tar Heels,Duke,Blue Devils,4-4,4-4,0,7,3,20,17,7,0,10,3,3,0,14,0,0,4,3,0.3339142157583279,[-6.79072235]
2019,9,NCAAF_20191026_HAWAII@NMEX,New Mexico,Lobos,Hawaii,Rainbow Warriors,2-6,5-3,1,3,35,31,45,3,0,7,21,21,14,3,7,-3,-32,-14,0.4542337850999205,[-1.81935608]
2019,9,NCAAF_20191026_SC@TENN,Tennessee,Volunteers,South Carolina,Gamecocks,3-5,3-5,0,17,21,41,21,3,14,14,10,7,14,0,0,0,-4,20,0.25542506578623336,[-10.4047629]
2019,9,NCAAF_20191026_ARK@BAMA,Alabama,Crimson Tide,Arkansas,Razorbacks,8-0,2-6,0,41,0,48,7,17,24,7,0,0,0,0,7,6,41,41,0.9955407919292943,[41.3833892]
2019,9,NCAAF_20191026_MEMP@TULSA,Tulsa,Golden Hurricane,Memphis,Tigers,2-6,7-1,0,17,28,41,42,0,17,14,10,14,14,7,7,-5,-11,-1,0.1361671279377118,[-17.37047257]
2019,9,NCAAF_20191026_TROY@GAST,Georgia St.,Panthers,Troy,Trojans,6-2,3-4,1,28,14,52,33,7,21,7,17,0,14,0,19,3,14,19,0.19690396579706881,[-13.49395952]
2019,9,NCAAF_20191026_TXSTSM@ARKST,Arkansas St.,Red Wolves,Texas St.,Bobcats,4-4,2-5,0,17,14,38,14,7,10,14,7,0,14,0,0,2,3,24,0.8822011875753758,[18.76870908]
2019,9,NCAAF_20191026_TXTECH@KANSAS,Kansas,Jayhawks,Texas Tech,Red Raiders,3-5,3-5,1,14,17,37,34,0,14,6,17,7,10,10,7,0,-3,3,0.1398161036175145,[-17.1084691]
2019,9,NCAAF_20191026_UCF@TEMPLE,Temple,,UCF,,5-3,6-2,,21,28,21,63,7,14,0,0,14,14,28,7,-1,-7,-42,0.1463995469047623,[-16.64726848]
2019,9,NCAAF_20191026_ARIZST@UCLA,UCLA,Bruins,Arizona St.,Sun Devils,3-5,5-3,0,28,7,42,32,14,14,14,0,7,0,3,22,-2,21,10,0.38790931697860076,[-4.50634564]
2019,9,NCAAF_20191026_BC@CLEM,Clemson,Tigers,Boston College,Eagles,8-0,4-4,0,38,7,59,7,17,21,14,7,0,7,0,0,4,31,52,0.928249390983347,[23.14911811]
2019,9,NCAAF_20191026_COLOST@FRESNO,Fresno St.,Bulldogs,Colorado St.,Rams,3-4,3-5,0,14,21,31,41,7,7,14,3,14,7,3,17,0,-7,-10,0.8209153351389974,[14.54037828]
2019,9,NCAAF_20191026_MIZZOU@UK,Kentucky,Wildcats,Missouri,Tigers,4-4,5-3,0,22,0,29,7,0,22,0,7,0,0,7,0,-1,22,22,0.30779407902582534,[-7.94562656]
2019,9,NCAAF_20191026_ND@MICH,Michigan,Wolverines,Notre Dame,Fighting Irish,6-2,5-2,0,17,0,45,14,3,14,7,21,0,0,7,7,1,17,31,0.5699171598157764,[2.78767527]
2019,9,NCAAF_20191026_LATECH@UTEP,UTEP,,Louisiana Tech,,1-6,7-1,,7,28,21,42,7,0,0,14,7,21,14,0,-6,-21,-21,0.08991474093849572,[-21.22493463]
2019,9,NCAAF_20191026_CAL@UTAH,Utah,Utes,California,Golden Bears,7-1,4-4,1,28,0,35,0,7,21,7,0,0,0,0,0,3,28,35,0.7457335347939793,[10.46187721]
2019,9,NCAAF_20191026_UTAHST@AF,Air Force,Falcons,Utah St.,Aggies,6-2,4-3,1,17,0,31,7,0,17,7,7,0,0,7,0,2,17,24,0.29984435612100313,[-8.30540006]
2019,9,NCAAF_20191026_SDGST@UNLV,UNLV,Rebels,San Diego St.,Aztecs,2-6,7-1,0,7,17,17,20,0,7,3,7,14,3,3,0,-5,-10,-3,0.1643135530953055,[-15.45857158]
2019,9,NCAAF_20191026_WASHST@OREG,Oregon,Ducks,Washington St.,Cougars,7-1,4-4,1,17,17,37,35,9,8,7,13,3,14,3,15,3,0,2,0.5296261422031968,[1.17622833]
2019,9,NCAAF_20191025_USC@COLO,Colorado,Buffaloes,USC,Trojans,3-5,5-3,0,17,14,31,35,3,14,14,0,7,7,7,14,-2,3,-4,0.21575283298540393,[-12.44774191]
2019,9,NCAAF_20191024_SMU@HOU,Houston,Cougars,SMU,Mustangs,3-5,8-0,0,13,21,31,34,0,13,7,11,7,14,10,3,-5,-8,-3,0.4987754453953416,[-0.04857308]
2019,10,NCAAF_20191103_FRESNO@HAWAII,Hawaii,,Fresno St.,,5-4,4-4,,24,14,38,41,0,24,0,14,7,7,17,10,1,10,-3,0.09776493674760034,[-20.5992068]
2019,10,NCAAF_20191102_BC@CUSE,Syracuse,,Boston College,,3-6,5-4,,20,44,27,58,17,3,7,0,10,34,7,7,-2,-24,-31,0.46243054603048817,[-1.50090349]
2019,10,NCAAF_20191102_BUFF@EMICH,E. Michigan,Eagles,Buffalo,Bulls,4-5,5-4,1,7,29,14,43,7,0,0,7,2,27,7,7,-1,-22,-29,0.40749302761140416,[-3.72389809]
2019,10,NCAAF_20191102_HOU@UCF,UCF,Knights,Houston,Cougars,7-2,3-6,0,21,23,44,29,14,7,21,2,17,6,0,6,4,-2,15,0.8475408631171004,[16.32705653]
2019,10,NCAAF_20191102_LIB@MA,UMass,Minutemen,Liberty,Flames,1-8,6-3,0,14,49,21,63,7,7,7,0,28,21,14,0,-5,-35,-42,0.3207172232638057,[-7.41114444]
2019,10,NCAAF_20191102_MICH@MD,Maryland,Terrapins,Michigan,Wolverines,3-6,7-2,0,0,21,7,38,0,0,7,0,14,7,14,3,-4,-21,-31,0.07986981991397601,[-22.37451785]
2019,10,NCAAF_20191102_NCST@WAKE,Wake Forest,Demon Deacons,NC State,Wolfpack,7-1,4-4,0,34,10,44,10,21,13,10,0,0,10,0,0,3,24,34,0.41811482324651994,[-3.28975848]
2019,10,NCAAF_20191102_NEB@PURDUE,Purdue,Boilermakers,Nebraska,Cornhuskers,3-6,4-5,0,14,10,31,27,0,14,3,14,10,0,3,14,-1,4,4,0.6923095178093398,[7.9954064]
2019,10,NCAAF_20191102_NILL@CMICH,C. Michigan,Chippewas,N. Illinois,Huskies,6-4,3-6,0,38,10,48,10,21,17,0,10,3,7,0,0,3,28,38,0.2988768637377921,[-8.3968593]
2019,10,NCAAF_20191102_ODU@FIU,FIU,Panthers,Old Dominion,Monarchs,5-4,1-8,0,9,7,24,17,3,6,7,8,7,0,0,10,4,2,7,0.7620765415361431,[11.34678672]
2019,10,NCAAF_20191102_TXSA@TXAM,Texas A&M,Aggies,UTSA,Roadrunners,6-3,3-5,0,21,7,45,14,14,7,14,10,7,0,0,7,3,14,31,0.9721981278653622,[30.46180146]
2019,10,NCAAF_20191102_AKRON@BGREEN,Bowling Green,Falcons,Akron,Zips,3-6,0-9,0,21,6,35,6,7,14,7,7,6,0,0,0,3,15,29,0.3818103930549197,[-4.78586571]
2019,10,NCAAF_20191102_VATECH@ND,Notre Dame,Fighting Irish,Virginia Tech,Hokies,6-2,5-3,1,14,14,21,20,7,7,0,7,7,7,3,3,1,0,1,0.8312624703544919,[15.26435082]
2019,10,NCAAF_20191102_TROY@CSTCAR,C. Carolina,Chanticleers,Troy,Trojans,4-4,3-5,0,17,21,36,35,14,3,11,8,21,0,7,7,1,-4,1,0.19940083204858505,[-13.42780904]
2019,10,NCAAF_20191102_ARKST@LAMON,UL-Monroe,Warhawks,Arkansas St.,Red Wolves,3-5,5-4,1,28,31,41,48,14,14,6,7,3,28,3,14,-2,-3,-7,0.24742058942271217,[-10.86348988]
2019,10,NCAAF_20191102_ARMY@AF,Air Force,Falcons,Army,Black Knights,7-2,3-6,0,3,6,17,13,0,3,7,7,0,6,7,0,4,-3,4,0.5144512545518236,[0.57660048]
2019,10,NCAAF_20191102_KSTATE@KANSAS,Kansas,Jayhawks,Kansas State,Wildcats,3-6,6-2,1,3,17,10,38,3,0,0,7,7,10,7,14,-3,-14,-28,0.15909625698124585,[-15.88521073]
2019,10,NCAAF_20191102_MIAMI@FSU,Florida State,Seminoles,Miami (Fla.),Hurricanes,4-5,5-4,0,3,17,10,27,0,3,7,0,7,10,0,10,-1,-14,-17,0.36061110851521927,[-5.67859319]
2019,10,NCAAF_20191102_MRSHL@RICE,Rice,Owls,Marshall,Thundering Herd,0-9,6-3,0,7,17,7,20,0,7,0,0,3,14,3,0,-6,-10,-13,0.10788871101613806,[-19.69913229]
2019,10,NCAAF_20191102_MTSU@CHARLO,Charlotte,49ers,Middle Tenn.,Blue Raiders,4-5,3-6,0,24,7,34,20,14,10,10,0,7,0,6,7,1,17,14,0.15635206818680358,[-16.06639493]
2019,10,NCAAF_20191102_RUT@ILL,Illinois,Fighting Illini,Rutgers,Scarlet Knights,5-4,2-7,1,10,10,38,10,10,0,21,7,0,10,0,0,3,0,28,0.6146758346374983,[4.63941499]
2019,10,NCAAF_20191102_TCU@OKLAST,Oklahoma State,Cowboys,TCU,Horned Frogs,6-3,4-4,1,17,17,34,27,10,7,7,10,3,14,0,10,2,0,7,0.5058368668650128,[0.2328465]
2019,10,NCAAF_20191102_UGA@FLA,Florida,Gators,Georgia,Bulldogs,7-2,7-1,1,3,13,17,24,0,3,0,14,3,10,3,8,0,-10,-7,0.16229372296442235,[-15.67666251]
2019,10,NCAAF_20191102_UNLV@COLOST,Colorado St.,Rams,UNLV,Rebels,4-5,2-7,1,24,0,37,17,21,3,3,10,0,0,3,14,2,24,20,0.6556686800561254,[6.37634795]
2019,10,NCAAF_20191102_UTEP@NTEXAS,North Texas,Mean Green,UTEP,Miners,4-5,1-7,1,38,14,52,26,21,17,7,7,7,7,6,6,3,24,26,0.9105315045120466,[21.38923046]
2019,10,NCAAF_20191102_FAU@WKY,W. Kentucky,Hilltoppers,FAU,Owls,5-4,6-3,1,14,21,24,35,14,0,7,3,0,21,7,7,-1,-7,-11,0.18382338730552406,[-14.33693448]
2019,10,NCAAF_20191102_MISSST@ARK,Arkansas,Razorbacks,Miss. State,Bulldogs,2-7,4-5,0,10,38,24,54,0,10,7,7,14,24,7,9,-2,-28,-30,0.09688841670340409,[-20.6802822]
2019,10,NCAAF_20191102_PITT@GATECH,Georgia Tech,Yellow Jackets,Pittsburgh,Panthers,2-6,6-3,0,7,17,10,20,0,7,3,0,10,7,0,3,-4,-10,-10,0.4968804451400569,[-0.12444329]
2019,10,NCAAF_20191102_TULSA@TULANE,Tulane,Green Wave,Tulsa,Golden Hurricane,6-3,2-7,0,24,16,38,26,10,14,7,7,0,16,0,10,4,8,12,0.6966419479531463,[8.19209334]
2019,10,NCAAF_20191102_UTAH@WASH,Washington,Huskies,Utah,Utes,5-4,8-1,0,14,13,28,33,7,7,7,7,0,13,6,14,-3,1,-5,0.6011141368442431,[4.07772387]
2019,10,NCAAF_20191102_WOFF@CLEM,Clemson,Tigers,Wofford,Terriers,9-0,5-3,1,42,0,59,14,21,21,14,3,0,0,14,0,4,42,45,0.9941652586894895,[40.13533838]
2019,10,NCAAF_20191102_OREGST@ARIZ,Arizona,Wildcats,Oregon State,Beavers,4-5,4-4,0,19,35,38,56,6,13,12,7,7,28,7,14,0,-16,-18,0.8477301956927378,[16.33984561]
2019,10,NCAAF_20191102_TXSTSM@LALAF,Louisiana,Ragin' Cajuns,Texas St.,Bobcats,6-2,2-6,0,10,3,31,3,0,10,21,0,0,3,0,0,4,7,28,0.8078832809420495,[13.84729438]
2019,10,NCAAF_20191102_CINCY@ECU,East Carolina,Pirates,Cincinnati,Bearcats,3-6,7-1,1,31,21,43,46,14,17,9,3,21,0,7,18,-4,10,-3,0.10446847235606538,[-19.99608153]
2019,10,NCAAF_20191102_MISS@AUBURN,Auburn,Tigers,Ole Miss,Rebels,7-2,3-6,0,10,7,20,14,0,10,10,0,0,7,0,7,4,3,6,0.8818206672667759,[18.84458651]
2019,10,NCAAF_20191102_NWEST@IND,Indiana,Hoosiers,Northwestern,Wildcats,7-2,1-7,1,24,3,34,3,10,14,7,3,0,3,0,0,6,21,31,0.4453140822926912,[-2.18835051]
2019,10,NCAAF_20191102_UAB@TENN,Tennessee,Volunteers,UAB,Blazers,4-5,6-2,0,23,0,30,7,6,17,7,0,0,0,0,7,-2,23,23,0.6500263398705016,[6.13319432]
2019,10,NCAAF_20191102_SMU@MEMP,Memphis,Tigers,SMU,Mustangs,8-1,8-1,0,23,17,54,48,7,16,17,14,7,10,7,24,0,6,6,0.6219361912336241,[4.94246789]
2019,10,NCAAF_20191102_UVA@UNC,North Carolina,Tar Heels,Virginia,Cavaliers,4-5,6-3,1,17,17,31,38,3,14,14,0,7,10,21,0,-2,0,-7,0.3565301128109184,[-5.85243071]
2019,10,NCAAF_20191102_VANDY@SC,South Carolina,Gamecocks,Vanderbilt,Commodores,4-5,2-6,1,14,7,24,7,0,14,0,10,7,0,0,0,2,7,17,0.7141709890052838,[9.00124549]
2019,10,NCAAF_20191102_OREG@USC,USC,Trojans,Oregon,Ducks,5-4,8-1,1,17,28,24,56,10,7,0,7,0,28,14,14,-3,-11,-32,0.44145476503674974,[-2.34387171]
2019,10,NCAAF_20191102_COLO@UCLA,UCLA,Bruins,Colorado,Buffaloes,4-5,3-6,0,17,7,31,14,17,0,7,7,0,7,0,7,1,10,17,0.5685647725314165,[2.74872028]
2019,10,NCAAF_20191102_BYU@UTAHST,Utah St.,Aggies,BYU,Cougars,4-4,4-4,1,14,21,14,42,7,7,0,0,7,14,14,7,0,-7,-28,0.7137093274794823,[8.97964316]
2019,10,NCAAF_20191102_BOISE@SJST,San Jose St.,Spartans,Boise St.,Broncos,4-5,7-1,1,24,17,42,52,14,10,10,8,7,10,14,21,-3,7,-10,0.030844460536002538,[-29.73606033]
2019,10,NCAAF_20191102_NMEX@NEVADA,Nevada,Wolf Pack,New Mexico,Lobos,5-4,2-7,1,14,7,21,10,0,14,0,7,7,0,3,0,3,7,11,0.6342381697050721,[5.46014906]
2019,10,NCAAF_20191101_NAVY@UCONN,UConn,Huskies,Navy,Midshipmen,2-7,7-1,1,10,28,10,56,7,3,0,0,14,14,14,14,-5,-18,-46,0.06562008162168842,[-24.01816185]
2019,10,NCAAF_20191031_GAS@APLST,App. St.,Mountaineers,Ga. Southern,Eagles,7-1,5-3,1,7,10,21,24,0,7,0,14,7,3,14,0,2,-3,-3,0.8166722943380725,[14.36662924]
2019,10,NCAAF_20191031_WVU@BAYLOR,Baylor,Bears,West Virginia,Mountaineers,8-0,3-5,0,7,0,17,14,7,0,7,3,0,0,14,0,5,7,3,0.2909155397710619,[-8.76413556]
2019,11,NCAAF_20191109_ECU@SMU,SMU,Mustangs,East Carolina,Pirates,9-1,3-7,1,28,20,59,51,14,14,17,14,7,13,17,14,6,8,8,0.8885211347170803,[19.48511305]
2019,11,NCAAF_20191109_FSU@BC,Boston College,Eagles,Florida State,Seminoles,5-5,5-5,1,14,10,31,38,7,7,0,17,3,7,14,14,0,4,-7,0.5395830059550386,[1.5889819]
2019,11,NCAAF_20191109_MA@ARMY,Army,Black Knights,UMass,Minutemen,4-6,1-9,0,35,7,63,7,14,21,14,14,7,0,0,0,3,28,56,0.9183276334745389,[22.28643377]
2019,11,NCAAF_20191109_MD@OHIOST,Ohio State,Buckeyes,Maryland,Terrapins,9-0,3-7,0,42,0,73,14,21,21,10,21,0,0,7,7,6,42,59,0.9745015329931319,[31.20150827]
2019,11,NCAAF_20191109_PSU@MINN,Minnesota,Golden Gophers,Penn State,Nittany Lions,9-0,8-1,0,24,13,31,26,14,10,0,7,10,3,6,7,1,11,5,0.09502225264251818,[-20.95199625]
2019,11,NCAAF_20191109_PURDUE@NWEST,Northwestern,Wildcats,Purdue,Boilermakers,1-8,4-6,0,16,7,22,24,14,2,0,6,0,7,14,3,-3,9,-2,0.42250756880515505,[-3.12546009]
2019,11,NCAAF_20191109_TXTECH@WVU,West Virginia,Mountaineers,Texas Tech,Red Raiders,3-6,4-5,0,10,35,17,38,3,7,0,7,21,14,0,3,-1,-25,-21,0.5286147921364507,[1.1477815]
2019,11,NCAAF_20191109_VANDY@FLA,Florida,Gators,Vanderbilt,Commodores,8-2,2-7,1,14,0,56,0,0,14,28,14,0,0,0,0,6,14,56,0.81681118702451,[14.44201857]
2019,11,NCAAF_20191109_WKY@ARK,Arkansas,Razorbacks,W. Kentucky,Hilltoppers,2-8,6-4,1,7,35,19,45,7,0,0,12,14,21,3,7,-4,-28,-26,0.6556217572928742,[6.40405621]
2019,11,NCAAF_20191109_GATECH@UVA,Virginia,Cavaliers,Georgia Tech,Yellow Jackets,7-3,2-7,0,24,21,33,28,14,10,0,9,14,7,0,7,5,3,5,0.4804218505810829,[-0.78494965]
2019,11,NCAAF_20191109_TXSA@ODU,Old Dominion,Monarchs,UTSA,Roadrunners,1-9,4-5,0,20,10,23,24,10,10,3,0,10,0,0,14,-3,10,-1,0.48034711929219187,[-0.78794829]
2019,11,NCAAF_20191109_CHARLO@UTEP,UTEP,Miners,Charlotte,49ers,1-8,5-5,1,21,7,21,28,14,7,0,0,0,7,14,7,-4,14,-7,0.27846084235003565,[-9.39192249]
2019,11,NCAAF_20191109_SALA@TXSTSM,Texas St.,Bobcats,South Alabama,Jaguars,3-6,1-8,0,13,14,30,28,3,10,14,3,7,7,7,7,2,-1,2,0.4402277059565747,[-2.40453061]
2019,11,NCAAF_20191109_STNFRD@COLO,Colorado,Buffaloes,Stanford,Cardinal,4-6,4-5,1,10,6,16,13,7,3,0,6,3,3,0,7,0,4,3,0.22607487335905674,[-12.02067499]
2019,11,NCAAF_20191109_GAS@TROY,Troy,Trojans,Ga. Southern,Eagles,4-5,5-4,1,27,14,49,28,14,13,0,22,0,14,0,14,-1,13,21,0.6546022484215441,[6.35980914]
2019,11,NCAAF_20191109_ILL@MICHST,Michigan St.,Spartans,Illinois,Fighting Illini,4-5,6-4,0,28,10,34,37,14,14,3,3,3,7,0,27,-2,18,-3,0.8537939989496912,[16.83333874]
2019,11,NCAAF_20191109_KSTATE@TEXAS,Texas,Longhorns,Kansas State,Wildcats,6-3,6-3,0,7,14,27,24,0,7,10,10,14,0,0,10,0,-7,3,0.6325159728550063,[5.41247309]
2019,11,NCAAF_20191109_LSU@BAMA,Alabama,Crimson Tide,LSU,Tigers,8-1,9-0,1,13,33,41,46,7,6,7,21,10,23,0,13,-1,-20,-5,0.831444725414066,[15.34713407]
2019,11,NCAAF_20191109_LVILLE@MIAMI,Miami (Fla.),Hurricanes,Louisville,Cardinals,6-4,5-4,0,35,14,52,27,21,14,17,0,7,7,7,6,1,21,25,0.7738398229995958,[12.01614016]
2019,11,NCAAF_20191109_UAB@USM,So. Miss,Golden Eagles,UAB,Blazers,6-3,6-3,0,20,2,37,2,7,13,10,7,0,2,0,0,0,18,35,0.487237221535887,[-0.51158177]
2019,11,NCAAF_20191109_UCONN@CINCY,Cincinnati,Bearcats,UConn,Huskies,8-1,2-8,0,38,0,48,3,14,24,3,7,0,0,0,3,6,38,45,0.9445311794758918,[25.48544117]
2019,11,NCAAF_20191109_USC@ARIZST,Arizona St.,Sun Devils,USC,Trojans,5-4,6-4,0,13,28,26,31,7,6,7,6,28,0,3,0,-1,-15,-5,0.39391238101707593,[-4.30306735]
2019,11,NCAAF_20191109_WAKE@VATECH,Virginia Tech,Hokies,Wake Forest,Demon Deacons,6-3,7-2,1,6,10,36,17,3,3,17,13,3,7,7,0,-1,-4,19,0.46070754993765894,[-1.57728006]
2019,11,NCAAF_20191109_IOWA@WISC,Wisconsin,Badgers,Iowa,Hawkeyes,7-2,6-3,1,14,6,24,22,0,14,7,3,3,3,0,16,1,8,2,0.5177651743411824,[0.71221122]
2019,11,NCAAF_20191109_NMEXST@MISS,Ole Miss,Rebels,New Mexico St.,Aggies,4-6,0-9,1,24,3,41,3,10,14,7,10,0,3,0,0,4,21,38,0.9330404215574335,[23.96384971]
2019,11,NCAAF_20191109_NTEXAS@LATECH,Louisiana Tech,Bulldogs,North Texas,Mean Green,8-1,4-6,0,17,3,52,17,7,10,14,21,3,0,0,14,4,14,35,0.49100585283097253,[-0.36048941]
2019,11,NCAAF_20191109_GAST@LAMON,UL-Monroe,Warhawks,Georgia St.,Panthers,4-5,6-3,1,24,24,45,31,14,10,7,14,10,14,7,0,-2,0,14,0.48960069143788243,[-0.4168208]
2019,11,NCAAF_20191109_FIU@FAU,FAU,Owls,FIU,Panthers,7-3,5-5,0,13,7,37,7,7,6,15,9,0,7,0,0,2,6,30,0.7424820627810762,[10.40873013]
2019,11,NCAAF_20191109_APLST@SC,South Carolina,Gamecocks,App. St.,Mountaineers,4-6,8-1,1,6,13,15,20,6,0,3,6,3,10,7,0,-4,-7,-5,0.6531454314984658,[6.29666706]
2019,11,NCAAF_20191109_MIZZOU@UGA,Georgia,Bulldogs,Missouri,Tigers,8-1,5-4,0,16,0,27,0,7,9,3,8,0,0,0,0,3,16,27,0.8276109414587531,[15.10533151]
2019,11,NCAAF_20191109_UTAHST@FRESNO,Fresno St.,Bulldogs,Utah St.,Aggies,4-5,5-4,1,14,21,35,37,7,7,14,7,7,14,10,6,-1,-7,-2,0.5269091831715871,[1.0792597]
2019,11,NCAAF_20191109_WASHST@CAL,California,Golden Bears,Washington St.,Cougars,5-4,4-5,0,13,11,33,20,6,7,7,13,5,6,3,6,1,2,13,0.27468487320282975,[-9.57234941]
2019,11,NCAAF_20191109_CLEM@NCST,NC State,Wolfpack,Clemson,Tigers,4-5,10-0,0,0,42,10,55,0,0,7,3,28,14,7,6,-6,-42,-45,0.07632021830197899,[-22.86772046]
2019,11,NCAAF_20191109_LIB@BYU,BYU,Cougars,Liberty,Flames,5-4,6-4,0,17,7,31,24,7,10,7,7,7,0,10,7,-1,10,7,0.754166762024262,[10.99461422]
2019,11,NCAAF_20191109_ND@DUKE,Duke,Blue Devils,Notre Dame,Fighting Irish,4-5,7-2,0,7,21,7,38,0,7,0,0,14,7,7,10,-3,-14,-31,0.1683943155036589,[-15.3573628]
2019,11,NCAAF_20191109_TENN@UK,Kentucky,Wildcats,Tennessee,Volunteers,4-5,5-5,1,13,3,13,17,13,0,0,0,0,3,14,0,-1,10,-4,0.6691695469705767,[6.99687536]
2019,11,NCAAF_20191109_IOWAST@OKLA,Oklahoma,Sooners,Iowa St.,Cyclones,8-1,5-4,1,35,14,42,41,14,21,7,0,7,7,7,20,3,21,1,0.735944717931812,[10.0869861]
2019,11,NCAAF_20191109_NEVADA@SDGST,San Diego St.,Aztecs,Nevada,Wolf Pack,7-2,6-4,1,3,3,13,17,0,3,7,3,3,0,7,7,1,0,-4,0.788814852375161,[12.82776947]
2019,11,NCAAF_20191109_SJST@HAWAII,Hawaii,Rainbow Warriors,San Jose St.,Spartans,6-4,4-6,0,21,23,42,40,7,14,7,14,3,20,3,14,2,-2,2,0.6504224286228528,[6.17890724]
2019,11,NCAAF_20191108_UCF@TULSA,Tulsa,Golden Hurricane,UCF,Knights,3-7,7-3,1,17,28,34,31,7,10,7,10,14,14,3,0,-4,-11,3,0.043859454434271195,[-27.30112492]
2019,11,NCAAF_20191108_WASH@OREGST,Oregon State,Beavers,Washington,Huskies,4-5,6-4,1,0,10,7,19,0,0,7,0,3,7,9,0,-2,-10,-12,0.024936814477305114,[-31.35404858]
2019,11,NCAAF_20191107_LALAF@CSTCAR,C. Carolina,Chanticleers,Louisiana,Ragin' Cajuns,4-5,7-2,0,0,24,7,48,0,0,0,7,14,10,21,3,-3,-24,-41,0.3192747223590817,[-7.51021089]
2019,11,NCAAF_20191107_TEMPLE@SFLA,South Florida,Bulls,Temple,Owls,4-5,6-3,1,0,7,7,17,0,0,7,0,0,7,7,3,-2,-7,-10,0.4329559739803388,[-2.69970072]
2019,11,NCAAF_20191106_MIAOH@OHIO,Ohio,Bobcats,Miami-OH,RedHawks,4-5,5-4,1,7,7,21,24,0,7,0,14,0,7,7,10,-1,0,-3,0.6747493145161512,[7.24381015]
2019,11,NCAAF_20191105_KENTST@TOLEDO,Toledo,Rockets,Kent St.,Golden Flashes,6-3,3-6,0,28,17,35,33,14,14,0,7,10,7,10,6,3,11,2,0.888022965497856,[19.44322466]
2019,11,NCAAF_20191105_BALLST@WMICH,W. Michigan,Broncos,Ball St.,Cardinals,6-4,4-5,1,21,10,35,31,7,14,0,14,7,3,7,14,2,11,4,0.8225401307041402,[14.79071597]
2019,12,NCAAF_20191116_ALST@FSU,Florida State,Seminoles,Alabama St.,Hornets,6-5,5-5,0,21,6,49,12,14,7,14,14,3,3,6,0,1,15,37,0.9938726931126902,[40.20228081]
2019,12,NCAAF_20191116_BAMA@MISSST,Miss. State,Bulldogs,Alabama,Crimson Tide,4-6,9-1,0,7,35,7,38,7,0,0,0,21,14,3,0,-5,-28,-31,0.10981899440837684,[-19.70193209]
2019,12,NCAAF_20191116_FLA@MIZZOU,Missouri,Tigers,Florida,Gators,5-5,9-2,0,3,6,6,23,0,3,3,0,3,3,14,3,-4,-3,-17,0.45393631606584894,[-1.8574086]
2019,12,NCAAF_20191116_IND@PSU,Penn State,Nittany Lions,Indiana,Hoosiers,9-1,7-3,1,20,14,34,27,17,3,7,7,14,0,3,10,2,6,7,0.9118140244969335,[21.70053615]
2019,12,NCAAF_20191116_KANSAS@OKLAST,Oklahoma State,Cowboys,Kansas,Jayhawks,7-3,3-7,0,24,0,31,13,14,10,7,0,0,0,0,13,4,24,18,0.9075777221425738,[21.28281718]
2019,12,NCAAF_20191116_MA@NWEST,Northwestern,Wildcats,UMass,Minutemen,2-8,1-10,1,21,6,45,6,0,21,3,21,3,3,0,0,1,15,39,0.9820240033404986,[33.66558339]
2019,12,NCAAF_20191116_MICHST@MICH,Michigan,Wolverines,Michigan St.,Spartans,8-2,4-6,1,17,7,44,10,0,17,10,17,7,0,3,0,4,10,34,0.8031079739370749,[13.68752386]
2019,12,NCAAF_20191116_TCU@TXTECH,Texas Tech,Red Raiders,TCU,Horned Frogs,4-6,5-5,0,16,27,31,33,0,16,12,3,17,10,0,6,-1,-11,-2,0.41070684732159257,[-3.62304775]
2019,12,NCAAF_20191116_TULANE@TEMPLE,Temple,Owls,Tulane,Green Wave,7-3,6-4,1,13,7,29,21,3,10,9,7,0,7,0,14,1,6,8,0.5138805251450091,[0.5585652]
2019,12,NCAAF_20191116_VMI@ARMY,Army,Black Knights,VMI,Keydets,5-6,4-7,1,14,6,47,6,7,7,19,14,3,3,0,0,1,8,41,0.999955853888471,[62.92945592]
2019,12,NCAAF_20191116_WISC@NEB,Nebraska,Cornhuskers,Wisconsin,Badgers,4-6,8-2,1,14,27,21,37,7,7,7,0,7,20,7,3,-4,-13,-16,0.10967066829168615,[-19.71461421]
2019,12,NCAAF_20191116_UTEP@UAB,UAB,Blazers,UTEP,Miners,7-3,1-9,0,23,7,37,10,17,6,7,7,0,7,0,3,6,16,27,0.9008160923510576,[20.64449099]
2019,12,NCAAF_20191116_NAVY@ND,Notre Dame,Fighting Irish,Navy,Midshipmen,8-2,7-2,1,38,3,52,20,14,24,7,7,0,3,7,10,1,35,32,0.8626444550926147,[17.53167591]
2019,12,NCAAF_20191116_CSTCAR@ARKST,Arkansas St.,Red Wolves,C. Carolina,Chanticleers,6-4,4-6,0,7,13,28,27,7,0,14,7,3,10,0,14,2,-6,1,0.7978535420211796,[13.38583349]
2019,12,NCAAF_20191116_IDST@BYU,BYU,Cougars,Idaho State,Bengals,6-4,3-8,1,28,3,42,10,7,21,14,0,0,3,7,0,3,25,32,0.8526412462961337,[16.81824638]
2019,12,NCAAF_20191116_LAMON@GAS,Ga. Southern,Eagles,UL-Monroe,Warhawks,6-4,4-6,1,24,7,51,29,7,17,7,20,7,0,7,15,2,17,22,0.592030147179823,[3.7360969]
2019,12,NCAAF_20191116_TROY@TXSTSM,Texas St.,Bobcats,Troy,Trojans,3-7,5-5,0,10,35,27,63,3,7,10,7,14,21,7,21,-2,-25,-36,0.10557038010899866,[-20.07018819]
2019,12,NCAAF_20191116_CMICH@BALLST,Ball St.,Cardinals,C. Michigan,Chippewas,4-6,7-4,1,27,11,44,45,3,24,14,3,3,8,20,14,-3,16,-1,0.2771067837937269,[-9.49323709]
2019,12,NCAAF_20191116_MEMP@HOU,Houston,Cougars,Memphis,Tigers,3-7,9-1,1,20,28,27,45,17,3,0,7,7,21,14,3,-6,-8,-18,0.3666024430787944,[-5.47108372]
2019,12,NCAAF_20191116_OHIOST@RUT,Rutgers,Scarlet Knights,Ohio State,Buckeyes,2-8,10-0,1,7,35,21,56,7,0,7,7,21,14,14,7,-8,-28,-35,0.0024934586352477472,[-45.06802962]
2019,12,NCAAF_20191116_TEXAS@IOWAST,Iowa St.,Cyclones,Texas,Longhorns,6-4,6-4,0,10,7,23,21,7,3,10,3,0,7,0,14,0,3,2,0.5447645572801065,[1.80479982]
2019,12,NCAAF_20191116_UGA@AUBURN,Auburn,Tigers,Georgia,Bulldogs,7-3,9-1,1,0,14,14,21,0,0,0,14,7,7,7,0,-2,-14,-7,0.3220511442757541,[-7.41489291]
2019,12,NCAAF_20191116_UK@VANDY,Vanderbilt,Commodores,Kentucky,Wildcats,2-8,5-5,1,14,24,14,38,14,0,0,0,3,21,14,0,-3,-10,-24,0.28237221970151793,[-9.2420577]
2019,12,NCAAF_20191116_VATECH@GATECH,Georgia Tech,Yellow Jackets,Virginia Tech,Hokies,2-8,7-3,1,0,31,0,45,0,0,0,0,14,17,14,0,-5,-31,-45,0.4591750767584515,[-1.64537851]
2019,12,NCAAF_20191116_WAKE@CLEM,Clemson,Tigers,Wake Forest,Demon Deacons,11-0,7-3,0,31,3,52,3,14,17,14,7,3,0,0,0,4,28,49,0.9411729589745337,[25.11426741]
2019,12,NCAAF_20191116_WVU@KSTATE,Kansas State,Wildcats,West Virginia,Mountaineers,6-4,4-6,0,13,14,20,24,10,3,7,0,14,0,0,10,2,-1,-4,0.504566983535482,[0.18374658]
2019,12,NCAAF_20191116_CUSE@DUKE,Duke,Blue Devils,Syracuse,Orange,4-6,4-6,1,6,14,6,49,0,6,0,0,14,0,21,14,0,-8,-43,0.5133367372115324,[0.53667435]
2019,12,NCAAF_20191116_HAWAII@UNLV,UNLV,Rebels,Hawaii,Rainbow Warriors,2-8,7-4,1,7,7,7,21,7,0,0,0,0,7,7,7,-5,0,-14,0.5080041102201156,[0.32204943]
2019,12,NCAAF_20191116_MINN@IOWA,Iowa,Hawkeyes,Minnesota,Golden Gophers,7-3,9-1,1,20,6,23,19,13,7,0,3,0,6,7,6,-2,14,4,0.7722939205195385,[11.9805067]
2019,12,NCAAF_20191116_UIW@NMEXST,New Mexico St.,,Incarnate Word,,1-9,5-6,,24,7,41,28,14,10,3,14,0,7,7,14,-4,17,13,0.9746906623437399,[31.37401926]
2019,12,NCAAF_20191116_WYO@UTAHST,Utah St.,Aggies,Wyoming,Cowboys,6-4,6-4,1,20,14,26,21,0,20,3,3,0,14,0,7,0,6,5,0.6526716270685045,[6.30054447]
2019,12,NCAAF_20191116_RICE@MTSU,Middle Tenn.,Blue Raiders,Rice,Owls,3-7,1-9,1,14,31,28,31,0,14,7,7,10,21,0,0,2,-17,-3,0.8811928800951665,[18.955255]
2019,12,NCAAF_20191116_STNFRD@WASHST,Washington St.,Cougars,Stanford,Cardinal,5-5,4-6,1,22,14,49,22,13,9,10,17,0,14,8,0,1,8,27,0.5313607484636123,[1.26303322]
2019,12,NCAAF_20191116_LALAF@SALA,South Alabama,Jaguars,Louisiana,Ragin' Cajuns,1-9,8-2,0,14,17,27,37,7,7,7,6,3,14,6,14,-7,-3,-10,0.19986527615315797,[-13.51622393]
2019,12,NCAAF_20191116_USM@TXSA,UTSA,Roadrunners,So. Miss,Golden Eagles,4-6,7-3,1,10,16,17,36,7,3,7,0,7,9,13,7,-3,-6,-19,0.20616692915589896,[-13.15815037]
2019,12,NCAAF_20191116_AF@COLOST,Colorado St.,Rams,Air Force,Falcons,4-6,8-2,1,14,10,21,38,14,0,0,7,0,10,0,28,-4,4,-17,0.3597006034890068,[-5.76631377]
2019,12,NCAAF_20191116_CINCY@SFLA,South Florida,Bulls,Cincinnati,Bearcats,4-6,9-1,0,10,0,17,20,7,3,7,0,0,0,10,10,-5,10,-3,0.3651905996995428,[-5.53132245]
2019,12,NCAAF_20191116_LSU@MISS,Ole Miss,Rebels,LSU,Tigers,4-7,10-0,0,7,31,37,58,0,7,16,14,14,17,13,14,-6,-24,-21,0.14413182305614614,[-17.04471422]
2019,12,NCAAF_20191116_APLST@GAST,Georgia St.,Panthers,App. St.,Mountaineers,6-4,9-1,1,21,35,27,56,21,0,0,6,14,21,7,14,-3,-14,-29,0.12196266794209254,[-18.70262543]
2019,12,NCAAF_20191116_ARIZST@OREGST,Oregon State,Beavers,Arizona St.,Sun Devils,5-5,5-5,1,28,21,35,34,14,14,7,0,14,7,7,6,0,7,1,0.1323937017575435,[-17.8987434]
2019,12,NCAAF_20191116_LVILLE@NCST,NC State,Wolfpack,Louisville,Cardinals,4-6,6-4,1,10,7,20,34,0,10,0,10,0,7,20,7,-2,3,-14,0.6902432391030344,[7.96974772]
2019,12,NCAAF_20191116_OKLA@BAYLOR,Baylor,Bears,Oklahoma,Sooners,9-1,9-1,1,31,10,31,34,14,17,0,0,3,7,7,17,0,21,-3,0.06632172933442715,[-24.13618375]
2019,12,NCAAF_20191116_SC@TXAM,Texas A&M,Aggies,South Carolina,Gamecocks,7-3,4-7,0,13,3,30,6,3,10,0,17,3,0,0,3,3,10,24,0.5758258526480382,[3.06929075]
2019,12,NCAAF_20191116_UCLA@UTAH,Utah,Utes,UCLA,Bruins,9-1,4-6,0,28,3,49,3,7,21,7,14,3,0,0,0,5,25,46,0.7785330295652086,[12.3147696]
2019,12,NCAAF_20191116_NMEX@BOISE,Boise St.,Broncos,New Mexico,Lobos,9-1,2-8,0,28,0,42,9,28,0,14,0,0,0,3,6,7,28,33,0.9444124102325708,[25.56748181]
2019,12,NCAAF_20191116_ARIZ@OREG,Oregon,Ducks,Arizona,Wildcats,9-1,4-6,1,21,6,34,6,14,7,7,6,0,6,0,0,5,15,28,0.7928405346483185,[13.10234901]
2019,12,NCAAF_20191116_USC@CAL,California,Golden Bears,USC,Trojans,5-5,7-4,1,10,17,17,41,7,3,0,7,10,7,17,7,-2,-7,-24,0.33625569479053175,[-6.78463575]
2019,12,NCAAF_20191115_LATECH@MRSHL,Marshall,Thundering Herd,Louisiana Tech,Bulldogs,7-3,8-2,0,17,7,31,10,0,17,7,7,7,0,3,0,-1,10,21,0.5297662818686459,[1.1986944]
2019,12,NCAAF_20191115_FRESNO@SDGST,San Diego St.,Aztecs,Fresno St.,Bulldogs,8-2,4-6,1,10,7,17,7,7,3,0,7,7,0,0,0,4,3,10,0.3892658335846607,[-4.51394986]
2019,12,NCAAF_20191114_BUFF@KENTST,Kent St.,Golden Flashes,Buffalo,Bulls,4-6,5-5,0,6,17,30,27,0,6,0,24,7,10,7,3,-1,-11,3,0.12112353081453753,[-18.7693523]
2019,12,NCAAF_20191113_BGREEN@MIAOH,Miami-OH,RedHawks,Bowling Green,Falcons,6-4,3-7,0,37,3,44,3,10,27,7,0,3,0,0,0,3,34,41,0.812266956350365,[14.2253142]
2019,12,NCAAF_20191113_NILL@TOLEDO,Toledo,Rockets,N. Illinois,Huskies,6-4,4-6,0,7,14,28,31,7,0,0,21,7,7,14,3,2,-7,-3,0.527756514479403,[1.11762496]
2019,12,NCAAF_20191112_EMICH@AKRON,Akron,Zips,E. Michigan,Eagles,0-10,5-5,1,0,21,14,42,0,0,7,7,7,14,14,7,-5,-21,-28,0.24392573659654226,[-11.13476217]
2019,13,NCAAF_20191123_BALLST@KENTST,Kent St.,Golden Flashes,Ball St.,Cardinals,5-6,4-7,0,21,24,41,38,7,14,10,10,7,17,0,14,1,-3,3,0.4565442452246511,[-1.75265781]
2019,13,NCAAF_20191123_BYU@MA,UMass,Minutemen,BYU,Cougars,1-11,7-4,0,0,49,24,56,0,0,10,14,7,42,7,0,-6,-49,-32,0.07707272953556477,[-22.88366512]
2019,13,NCAAF_20191123_ECU@UCONN,UConn,Huskies,East Carolina,Pirates,2-9,4-7,0,7,17,24,31,7,0,7,10,10,7,7,7,-2,-10,-7,0.32128036601585563,[-7.45298047]
2019,13,NCAAF_20191123_ILL@IOWA,Iowa,Hawkeyes,Illinois,Fighting Illini,8-3,6-5,1,13,7,19,10,7,6,0,6,7,0,0,3,2,6,9,0.9456234397991717,[25.75459463]
2019,13,NCAAF_20191123_KANSAS@IOWAST,Iowa St.,Cyclones,Kansas,Jayhawks,7-4,3-8,1,14,9,41,31,7,7,7,20,6,3,15,7,4,5,10,0.9302449856223943,[23.72796754]
2019,13,NCAAF_20191123_LIB@UVA,Virginia,Cavaliers,Liberty,Flames,8-3,6-5,0,24,14,55,27,10,14,14,17,7,7,7,6,2,10,28,0.8720646467128679,[18.24547192]
2019,13,NCAAF_20191123_MICHST@RUT,Rutgers,Scarlet Knights,Michigan St.,Spartans,2-9,5-6,0,0,17,0,27,0,0,0,0,10,7,3,7,-3,-17,-27,0.09426633077067126,[-21.11551739]
2019,13,NCAAF_20191123_MINN@NWEST,Northwestern,Wildcats,Minnesota,Golden Gophers,2-9,10-1,1,9,21,22,38,0,9,7,6,14,7,7,10,-8,-12,-16,0.4369238189188934,[-2.54961897]
2019,13,NCAAF_20191123_OKLAST@WVU,West Virginia,Mountaineers,Oklahoma State,Cowboys,4-7,8-3,1,10,7,13,20,0,10,3,0,7,0,3,10,-4,3,-7,0.38924909035895905,[-4.51681284]
2019,13,NCAAF_20191123_PSU@OHIOST,Ohio State,Buckeyes,Penn State,Nittany Lions,11-0,9-2,0,14,0,28,17,7,7,7,7,0,0,17,0,2,14,11,0.6308267013787802,[5.36415848]
2019,13,NCAAF_20191123_SAMF@AUBURN,Auburn,Tigers,Samford,Bulldogs,8-3,5-7,0,31,0,52,0,7,24,7,14,0,0,0,0,3,31,52,0.9254554555361373,[23.16815052]
2019,13,NCAAF_20191123_UCF@TULANE,Tulane,Green Wave,UCF,Knights,6-5,8-3,1,7,17,31,34,0,7,10,14,10,7,14,3,-2,-10,-3,0.12923136881273012,[-18.14634168]
2019,13,NCAAF_20191123_WCAR@BAMA,Alabama,Crimson Tide,W. Carolina,Catamounts,10-1,3-9,1,38,0,66,3,17,21,21,7,0,0,0,3,7,38,63,0.9999970733644088,[72.76992855]
2019,13,NCAAF_20191123_AF@NMEX,New Mexico,Lobos,Air Force,Falcons,2-9,9-2,1,10,14,22,44,7,3,6,6,7,7,16,14,-7,-4,-22,0.1418717774206294,[-17.21360797]
2019,13,NCAAF_20191123_SALA@GAST,Georgia St.,Panthers,South Alabama,Jaguars,7-4,1-10,1,14,3,28,15,0,14,7,7,3,0,0,12,6,11,13,0.6436761152078214,[5.91429357]
2019,13,NCAAF_20191123_BC@ND,Notre Dame,Fighting Irish,Boston College,Eagles,9-2,5-6,1,16,7,40,7,3,13,17,7,0,7,0,0,4,9,33,0.8028559766369794,[13.67949334]
2019,13,NCAAF_20191123_TXSTSM@APLST,App. St.,Mountaineers,Texas St.,Bobcats,10-1,3-8,0,14,10,35,13,7,7,14,7,0,10,3,0,7,4,22,0.9593219767645963,[27.98747583]
2019,13,NCAAF_20191123_GAS@ARKST,Arkansas St.,Red Wolves,Ga. Southern,Eagles,7-4,6-5,1,35,19,38,33,14,21,3,0,3,16,8,6,1,16,5,0.628788792995212,[5.27749942]
2019,13,NCAAF_20191123_ETNST@VANDY,Vanderbilt,Commodores,ETSU,Buccaneers,3-8,3-9,0,14,0,38,0,7,7,17,7,0,0,0,0,0,14,38,0.9946669769288885,[41.00400946]
2019,13,NCAAF_20191123_LATECH@UAB,UAB,Blazers,Louisiana Tech,Bulldogs,8-3,8-3,1,13,7,20,14,3,10,7,0,0,7,0,7,0,6,6,0.4772320124549263,[-0.91695681]
2019,13,NCAAF_20191123_MERCER@UNC,North Carolina,Tar Heels,Mercer,Bears,5-6,4-8,0,42,0,56,7,21,21,14,0,0,0,0,7,1,42,49,0.6246532621472667,[5.10211043]
2019,13,NCAAF_20191123_MICH@IND,Indiana,Hoosiers,Michigan,Wolverines,7-4,9-2,1,14,21,14,39,7,7,0,0,7,14,18,0,-2,-7,-25,0.13422268944919646,[-17.77086381]
2019,13,NCAAF_20191123_MRSHL@CHARLO,Charlotte,49ers,Marshall,Thundering Herd,6-5,7-4,0,7,10,24,13,0,7,3,14,7,3,3,0,-1,-3,11,0.1702679146491235,[-15.30523583]
2019,13,NCAAF_20191123_NEB@MD,Maryland,Terrapins,Nebraska,Cornhuskers,3-8,5-6,0,0,34,7,54,0,0,0,7,17,17,10,10,-2,-34,-47,0.45772649382735453,[-1.70479327]
2019,13,NCAAF_20191123_NTEXAS@RICE,Rice,Owls,North Texas,Mean Green,2-9,4-7,0,20,0,20,14,10,10,0,0,0,0,7,7,-2,20,6,0.163124730593471,[-15.76433002]
2019,13,NCAAF_20191123_PITT@VATECH,Virginia Tech,Hokies,Pittsburgh,Panthers,8-3,7-4,1,21,0,28,0,14,7,0,7,0,0,0,0,1,21,28,0.5579799266911968,[2.34208946]
2019,13,NCAAF_20191123_SMU@NAVY,Navy,Midshipmen,SMU,Mustangs,8-2,9-2,0,10,21,35,28,7,3,10,15,7,14,0,7,-1,-11,7,0.49062109296725687,[-0.37755525]
2019,13,NCAAF_20191123_TEXAS@BAYLOR,Baylor,Bears,Texas,Longhorns,10-1,6-5,1,7,3,24,10,0,7,14,3,0,3,0,7,4,4,14,0.22401414203241354,[-12.18349848]
2019,13,NCAAF_20191123_TNMART@UK,Kentucky,Wildcats,UT Martin,Skyhawks,6-5,7-5,0,29,0,50,7,16,13,7,14,0,0,0,7,-1,29,43,0.9816072245194251,[33.53182264]
2019,13,NCAAF_20191123_TXAM@UGA,Georgia,Bulldogs,Texas A&M,Aggies,10-1,7-4,1,13,3,19,13,3,10,3,3,0,3,3,7,3,10,6,0.8514751287813549,[16.74524246]
2019,13,NCAAF_20191123_UCLA@USC,USC,Trojans,UCLA,Bruins,8-4,4-7,0,24,14,52,35,10,14,14,14,7,7,14,7,4,10,17,0.7166369381453329,[9.19944871]
2019,13,NCAAF_20191123_WKY@USM,So. Miss,Golden Eagles,W. Kentucky,Hilltoppers,7-4,7-4,0,7,21,10,28,7,0,0,3,7,14,0,7,0,-14,-18,0.6425822700743948,[5.86719958]
2019,13,NCAAF_20191123_CAL@STNFRD,Stanford,Cardinal,California,Golden Bears,4-7,6-5,1,10,10,20,24,7,3,7,3,7,3,0,14,-2,0,-4,0.665378182194212,[6.85986644]
2019,13,NCAAF_20191123_CUSE@LVILLE,Louisville,Cardinals,Syracuse,Orange,7-4,4-7,1,28,10,56,34,21,7,21,7,3,7,17,7,3,18,22,0.3863756550050096,[-4.63726978]
2019,13,NCAAF_20191123_MEMP@SFLA,South Florida,Bulls,Memphis,Tigers,4-7,10-1,0,10,28,10,49,10,0,0,0,7,21,14,7,-6,-18,-39,0.2524400659696022,[-10.70814089]
2019,13,NCAAF_20191123_PURDUE@WISC,Wisconsin,Badgers,Purdue,Boilermakers,9-2,4-7,1,24,17,45,24,14,10,14,7,3,14,7,0,5,7,21,0.7731204473335522,[12.0302465]
2019,13,NCAAF_20191123_SJST@UNLV,UNLV,Rebels,San Jose St.,Spartans,3-8,4-7,0,21,6,38,35,7,14,3,14,6,0,22,7,-1,15,3,0.6395900913559722,[5.73863151]
2019,13,NCAAF_20191123_UTEP@NMEXST,New Mexico St.,Aggies,UTEP,Miners,2-9,1-10,1,14,13,44,35,7,7,7,23,0,13,3,19,1,1,9,0.6692254343219851,[7.02990825]
2019,13,NCAAF_20191123_ODU@MTSU,Middle Tenn.,Blue Raiders,Old Dominion,Monarchs,4-7,1-10,1,28,10,38,17,14,14,7,3,7,3,7,0,3,18,21,0.8065564145610293,[13.89482668]
2019,13,NCAAF_20191123_CSTCAR@LAMON,UL-Monroe,Warhawks,C. Carolina,Chanticleers,5-6,4-7,0,21,14,45,42,14,7,10,14,14,0,14,14,1,7,3,0.5569983317227358,[2.30216293]
2019,13,NCAAF_20191123_TROY@LALAF,Louisiana,Ragin' Cajuns,Troy,Trojans,9-2,5-6,1,31,3,53,3,14,17,19,3,3,0,0,0,4,28,50,0.37644111042013884,[-5.0558003]
2019,13,NCAAF_20191123_FAU@TXSA,UTSA,Roadrunners,FAU,Owls,4-7,8-3,1,3,17,26,40,3,0,8,15,7,10,16,7,-4,-14,-14,0.09433619772299684,[-21.1088432]
2019,13,NCAAF_20191123_ARK@LSU,LSU,Tigers,Arkansas,Razorbacks,11-0,2-9,1,28,6,56,20,7,21,21,7,3,3,0,14,9,22,36,0.9616990207778079,[28.43518574]
2019,13,NCAAF_20191123_KSTATE@TXTECH,Texas Tech,Red Raiders,Kansas State,Wildcats,4-7,7-4,1,3,6,27,30,0,3,14,10,3,3,17,7,-3,-3,-3,0.5055235216011821,[0.22234031]
2019,13,NCAAF_20191123_MIAMI@FIU,FIU,Panthers,Miami (Fla.),Hurricanes,6-5,6-5,1,13,0,30,24,10,3,3,14,0,0,3,21,0,13,6,0.08077154138940024,[-22.47996044]
2019,13,NCAAF_20191123_TEMPLE@CINCY,Cincinnati,Bearcats,Temple,Owls,10-1,7-4,0,6,0,15,13,0,6,7,2,0,0,0,13,3,6,2,0.5584281458873659,[2.36032564]
2019,13,NCAAF_20191123_ABIL@MISSST,Miss. State,Bulldogs,Abil Christian,Wildcats,5-6,5-7,1,21,7,45,7,7,14,7,17,0,7,0,0,0,14,38,0.9989645987054641,[49.45758386]
2019,13,NCAAF_20191123_DUKE@WAKE,Wake Forest,Demon Deacons,Duke,Blue Devils,8-3,4-7,0,13,10,39,27,3,10,10,16,7,3,3,14,4,3,12,0.583869207575298,[3.40116886]
2019,13,NCAAF_20191123_HOU@TULSA,Tulsa,Golden Hurricane,Houston,Cougars,3-8,4-7,0,7,14,14,24,7,0,0,7,0,14,3,7,-1,-7,-10,0.2695865348712807,[-9.86079524]
2019,13,NCAAF_20191123_OREG@ARIZST,Arizona St.,Sun Devils,Oregon,Ducks,6-5,9-2,0,10,7,31,28,7,3,3,18,7,0,0,21,-3,3,3,0.2711770630407401,[-9.78360349]
2019,13,NCAAF_20191123_TENN@MIZZOU,Missouri,Tigers,Tennessee,Volunteers,5-6,6-5,0,10,17,20,24,3,7,7,3,0,17,7,0,-1,-7,-4,0.7672027389657933,[11.71715837]
2019,13,NCAAF_20191123_TCU@OKLA,Oklahoma,Sooners,TCU,Horned Frogs,10-1,5-6,0,21,10,28,24,14,7,7,0,0,10,7,7,5,11,4,0.7806610549185274,[12.43595766]
2019,13,NCAAF_20191123_OREGST@WASHST,Washington St.,Cougars,Oregon State,Beavers,6-5,5-6,1,21,24,54,53,7,14,14,19,7,17,0,29,1,-3,1,0.9328752203687143,[24.0480791]
2019,13,NCAAF_20191123_UTAH@ARIZ,Arizona,Wildcats,Utah,Utes,4-7,10-1,1,0,14,7,35,0,0,0,7,14,0,14,7,-6,-14,-28,0.1796636653327579,[-14.7197606]
2019,13,NCAAF_20191123_WASH@COLO,Colorado,Buffaloes,Washington,Huskies,5-6,6-5,1,13,0,20,14,3,10,7,0,0,0,7,7,-1,13,6,0.1195773953124557,[-18.90220386]
2019,13,NCAAF_20191123_BOISE@UTAHST,Utah St.,Aggies,Boise St.,Broncos,6-5,10-1,0,7,42,21,56,7,0,7,7,21,21,14,0,-4,-35,-35,0.3962412456274428,[-4.22473954]
2019,13,NCAAF_20191123_NEVADA@FRESNO,Fresno St.,Bulldogs,Nevada,Wolf Pack,4-7,7-4,0,21,14,28,35,7,14,7,0,14,0,14,7,-3,7,-7,0.8421318169615918,[16.11057335]
2019,13,NCAAF_20191123_SDGST@HAWAII,Hawaii,Rainbow Warriors,San Diego St.,Aztecs,8-4,8-3,0,7,3,14,11,7,0,7,0,0,3,0,8,0,4,3,0.1781618198835888,[-14.81202102]
2019,13,NCAAF_20191122_COLOST@WYO,Wyoming,Cowboys,Colorado St.,Rams,7-4,4-7,0,7,7,17,7,0,7,7,3,0,7,0,0,3,0,10,0.6211079236698264,[4.95223548]
2019,13,NCAAF_20191121_NCST@GATECH,Georgia Tech,Yellow Jackets,NC State,Wolfpack,3-8,4-7,1,21,3,28,26,7,14,7,0,0,3,10,13,-1,18,2,0.40062798176319137,[-4.0422157]
2019,13,NCAAF_20191120_AKRON@MIAOH,Miami-OH,RedHawks,Akron,Zips,7-4,0-11,0,17,3,20,17,3,14,3,0,0,3,7,7,7,14,3,0.7872124501893635,[12.79499874]
2019,13,NCAAF_20191120_TOLEDO@BUFF,Buffalo,Bulls,Toledo,Rockets,6-5,6-5,1,28,20,49,30,14,14,7,14,7,13,3,7,0,8,19,0.4968773075211148,[-0.12569614]
2019,13,NCAAF_20191119_EMICH@NILL,N. Illinois,Huskies,E. Michigan,Eagles,4-7,6-5,1,7,14,17,45,0,7,3,7,7,7,24,7,-2,-7,-28,0.585859623709258,[3.48314927]
2019,13,NCAAF_20191119_OHIO@BGREEN,Bowling Green,Falcons,Ohio,Bobcats,3-8,5-6,1,24,38,24,66,14,10,0,0,24,14,28,0,-2,-14,-42,0.08901684059197001,[-21.6278043]
2019,14,NCAAF_20191201_ARMY@HAWAII,Hawaii,,Army,,9-4,5-7,,24,17,52,31,10,14,14,14,10,7,14,0,4,7,21,0.2163240135544715,[-12.63451601]
2019,14,NCAAF_20191130_CLEM@SC,South Carolina,Gamecocks,Clemson,Tigers,4-8,12-0,0,3,24,3,38,0,3,0,0,14,10,7,7,-8,-21,-35,0.059749298627375214,[-25.06848258]
2019,14,NCAAF_20191130_LVILLE@UK,Kentucky,Wildcats,Louisville,Cardinals,7-5,7-5,0,17,13,45,13,7,10,14,14,6,7,0,0,0,4,32,0.6493146751927252,[6.17454359]
2019,14,NCAAF_20191130_NWEST@ILL,Illinois,Fighting Illini,Northwestern,Wildcats,6-6,3-9,0,7,10,10,29,0,7,3,0,3,7,7,12,3,-3,-19,0.2505981323334031,[-10.83016167]
2019,14,NCAAF_20191130_OHIOST@MICH,Michigan,Wolverines,Ohio State,Buckeyes,9-3,12-0,1,16,28,27,56,13,3,3,8,14,14,14,14,-3,-12,-29,0.3002418444708115,[-8.43255605]
2019,14,NCAAF_20191130_TULSA@ECU,East Carolina,Pirates,Tulsa,Golden Hurricane,4-8,4-8,1,3,21,24,49,3,0,7,14,7,14,14,14,0,-18,-25,0.29712395759071397,[-8.57723533]
2019,14,NCAAF_20191130_TXSTSM@CSTCAR,C. Carolina,Chanticleers,Texas St.,Bobcats,5-7,3-9,1,7,7,24,21,0,7,7,10,0,7,0,14,2,0,3,0.6570887327866406,[6.51364229]
2019,14,NCAAF_20191130_UGA@GATECH,Georgia Tech,Yellow Jackets,Georgia,Bulldogs,3-9,11-1,1,7,17,7,52,0,7,0,0,17,0,21,14,-8,-10,-45,0.06446260061792886,[-24.44812031]
2019,14,NCAAF_20191130_CHARLO@ODU,Old Dominion,Monarchs,Charlotte,49ers,1-11,7-5,1,7,24,22,38,7,0,7,8,14,10,14,0,-6,-17,-16,0.47059381747784046,[-1.18794103]
2019,14,NCAAF_20191130_MTSU@WKY,W. Kentucky,Hilltoppers,Middle Tenn.,Blue Raiders,8-4,4-8,0,10,13,31,26,3,7,7,14,3,10,0,13,4,-3,5,0.3707791944656543,[-5.31019398]
2019,14,NCAAF_20191130_NMEXST@LIB,Liberty,Flames,New Mexico St.,Aggies,7-5,2-10,0,20,14,49,28,10,10,15,14,7,7,7,7,5,6,21,0.681770738173085,[7.61058011]
2019,14,NCAAF_20191130_WYO@AF,Air Force,Falcons,Wyoming,Cowboys,10-2,7-5,1,7,0,20,6,0,7,3,10,0,0,0,6,3,7,14,0.5413170890081517,[1.67059322]
2019,14,NCAAF_20191130_RICE@UTEP,UTEP,Miners,Rice,Owls,1-11,3-9,1,16,14,16,30,6,10,0,0,14,0,10,6,-2,2,-14,0.3565537577645812,[-5.92037668]
2019,14,NCAAF_20191130_BAMA@AUBURN,Auburn,Tigers,Alabama,Crimson Tide,9-3,10-2,1,27,31,48,45,7,20,13,8,3,28,7,7,-1,-4,3,0.2168079745363004,[-12.60795832]
2019,14,NCAAF_20191130_BAYLOR@KANSAS,Kansas,Jayhawks,Baylor,Bears,3-9,11-1,1,0,34,6,61,0,0,6,0,21,13,14,13,-8,-34,-55,0.26290600465025293,[-10.2151281]
2019,14,NCAAF_20191130_BC@PITT,Pittsburgh,Panthers,Boston College,Eagles,7-5,6-6,0,9,13,19,26,0,9,7,3,6,7,10,3,1,-4,-7,0.4550920655481172,[-1.81637609]
2019,14,NCAAF_20191130_MD@MICHST,Michigan St.,Spartans,Maryland,Terrapins,6-6,3-9,1,13,7,19,16,3,10,0,6,7,0,9,0,3,6,3,0.7484993999112569,[10.78453501]
2019,14,NCAAF_20191130_MIAMI@DUKE,Duke,Blue Devils,Miami (Fla.),Hurricanes,5-7,6-6,1,13,14,27,17,3,10,0,14,0,14,3,0,-1,-1,10,0.28208074448296383,[-9.28540466]
2019,14,NCAAF_20191130_RUT@PSU,Penn State,Nittany Lions,Rutgers,Scarlet Knights,10-2,2-10,1,7,3,27,6,7,0,6,14,3,0,0,3,8,4,21,0.9922654482519822,[38.98559983]
2019,14,NCAAF_20191130_TXSA@LATECH,Louisiana Tech,Bulldogs,UTSA,Roadrunners,9-3,4-8,0,24,17,41,27,14,10,10,7,10,7,3,7,5,7,14,0.7710526815804934,[11.95260315]
2019,14,NCAAF_20191130_UCONN@TEMPLE,Temple,Owls,UConn,Huskies,8-4,2-10,0,14,17,49,17,7,7,28,7,14,3,0,0,6,-3,32,0.9348805576223753,[24.3644979]
2019,14,NCAAF_20191130_USM@FAU,FAU,Owls,So. Miss,Golden Eagles,9-3,7-5,0,17,10,34,17,10,7,7,10,0,10,7,0,2,7,17,0.7000992408293719,[8.4483501]
2019,14,NCAAF_20191130_WISC@MINN,Minnesota,Golden Gophers,Wisconsin,Badgers,10-2,10-2,0,7,10,17,38,7,0,3,7,0,10,14,14,0,-3,-21,0.21971684120210766,[-12.44904833]
2019,14,NCAAF_20191130_ND@STNFRD,Stanford,Cardinal,Notre Dame,Fighting Irish,4-8,10-2,1,17,21,24,45,10,7,0,7,7,14,7,17,-6,-4,-21,0.22277771979101957,[-12.28313274]
2019,14,NCAAF_20191130_OREGST@OREG,Oregon,Ducks,Oregon State,Beavers,10-2,5-7,1,17,3,24,10,10,7,0,7,3,0,0,7,5,14,14,0.9439756973258964,[25.58648489]
2019,14,NCAAF_20191130_TULANE@SMU,SMU,Mustangs,Tulane,Green Wave,10-2,6-6,1,21,10,37,20,14,7,0,16,7,3,7,3,4,11,17,0.5497986580226574,[2.01517417]
2019,14,NCAAF_20191130_UAB@NTEXAS,North Texas,,UAB,,4-8,9-3,,14,17,21,26,7,7,7,0,3,14,9,0,-5,-3,-5,0.47664012980531634,[-0.94336817]
2019,14,NCAAF_20191130_UTAHST@NMEX,New Mexico,Lobos,Utah St.,Aggies,2-10,7-5,0,6,31,25,38,0,6,12,7,7,24,7,0,-5,-25,-13,0.09421592981811577,[-21.17751061]
2019,14,NCAAF_20191130_VANDY@TENN,Tennessee,Volunteers,Vanderbilt,Commodores,7-5,3-9,1,21,3,28,10,7,14,0,7,3,0,0,7,4,18,18,0.5952874878602488,[3.88321895]
2019,14,NCAAF_20191130_GAST@GAS,Ga. Southern,Eagles,Georgia St.,Panthers,7-5,7-5,0,17,7,38,10,7,10,14,7,7,0,3,0,0,10,28,0.6254822001212921,[5.15112381]
2019,14,NCAAF_20191130_IOWAST@KSTATE,Kansas State,Wildcats,Iowa St.,Cyclones,8-4,7-5,1,14,14,27,17,7,7,3,10,0,14,3,0,1,0,10,0.3396186167880024,[-6.65813201]
2019,14,NCAAF_20191130_NAVY@HOU,Houston,Cougars,Navy,Midshipmen,4-8,9-2,1,27,28,41,56,14,13,7,7,21,7,14,14,-5,-1,-15,0.49478424815951516,[-0.21051919]
2019,14,NCAAF_20191130_TXAM@LSU,LSU,Tigers,Texas A&M,Aggies,12-0,7-5,1,31,0,50,7,21,10,10,9,0,0,7,0,5,31,43,0.7019790307910104,[8.53554082]
2019,14,NCAAF_20191130_UNC@NCST,NC State,Wolfpack,North Carolina,Tar Heels,4-8,6-6,0,10,6,10,41,3,7,0,0,0,6,28,7,-2,4,-31,0.6863705929789126,[7.81881658]
2019,14,NCAAF_20191130_COLO@UTAH,Utah,Utes,Colorado,Buffaloes,11-1,5-7,0,17,7,45,15,0,17,14,14,7,0,0,8,6,10,30,0.8389461612621156,[15.94289862]
2019,14,NCAAF_20191130_FSU@FLA,Florida,Gators,Florida State,Seminoles,10-2,6-6,1,30,7,40,17,7,23,7,3,7,0,10,0,4,23,23,0.7192074947466055,[9.34687282]
2019,14,NCAAF_20191130_LAMON@LALAF,Louisiana,,UL-Monroe,,10-2,5-7,,21,14,31,30,7,14,7,3,7,7,10,6,5,7,1,0.7003909370921905,[8.46186362]
2019,14,NCAAF_20191130_OKLA@OKLAST,Oklahoma State,Cowboys,Oklahoma,Sooners,8-4,11-1,0,13,20,16,34,7,6,3,0,10,10,7,7,-3,-7,-18,0.24372308704109402,[-11.18065962]
2019,14,NCAAF_20191130_BYU@SDGST,San Diego St.,Aztecs,BYU,Cougars,9-3,7-5,1,7,3,13,3,0,7,3,3,3,0,0,0,2,4,10,0.564616077216239,[2.61948108]
2019,14,NCAAF_20191130_ARIZ@ARIZST,Arizona St.,Sun Devils,Arizona,Wildcats,7-5,4-8,0,6,7,24,14,0,6,15,3,0,7,0,7,3,-1,10,0.6201750755827762,[4.92617252]
2019,14,NCAAF_20191130_CAL@UCLA,UCLA,Bruins,California,Golden Bears,4-8,7-5,1,10,14,18,28,7,3,8,0,7,7,7,7,-3,-4,-10,0.4521333050169586,[-1.93660874]
2019,14,NCAAF_20191130_FRESNO@SJST,San Jose St.,Spartans,Fresno St.,Bulldogs,5-7,4-8,1,3,16,17,16,3,0,7,7,14,2,0,0,1,-13,1,0.06500816589970027,[-24.37861828]
2019,14,NCAAF_20191129_BGREEN@BUFF,Buffalo,Bulls,Bowling Green,Falcons,7-5,3-9,1,35,7,49,7,21,14,0,14,0,7,0,0,4,28,42,0.9012313433921475,[20.74867939]
2019,14,NCAAF_20191129_KENTST@EMICH,E. Michigan,Eagles,Kent St.,Golden Flashes,6-6,6-6,1,14,24,26,34,7,7,6,6,14,10,7,3,0,-10,-8,0.812449722179193,[14.2815842]
2019,14,NCAAF_20191129_MIAOH@BALLST,Ball St.,Cardinals,Miami-OH,RedHawks,5-7,7-5,1,14,27,41,27,7,7,6,21,7,20,0,0,-2,-13,14,0.23134040987474547,[-11.82574697]
2019,14,NCAAF_20191129_TOLEDO@CMICH,C. Michigan,Chippewas,Toledo,Rockets,8-4,6-6,0,35,7,49,7,14,21,7,7,0,7,0,0,2,28,42,0.34649278915362525,[-6.35706908]
2019,14,NCAAF_20191129_TXTECH@TEXAS,Texas,Longhorns,Texas Tech,Red Raiders,7-5,4-8,1,28,21,49,24,6,22,14,7,14,7,3,0,3,7,25,0.6125563884427756,[4.60490258]
2019,14,NCAAF_20191129_VATECH@UVA,Virginia,Cavaliers,Virginia Tech,Hokies,9-3,8-4,1,13,6,39,30,13,0,7,19,3,3,21,3,1,7,9,0.4053848502610923,[-3.85528777]
2019,14,NCAAF_20191129_IOWA@NEB,Nebraska,Cornhuskers,Iowa,Hawkeyes,5-7,9-3,0,10,24,24,27,3,7,14,0,14,10,0,3,-4,-14,-3,0.15127751002261158,[-16.60039295]
2019,14,NCAAF_20191129_MIZZOU@ARK,Arkansas,Razorbacks,Missouri,Tigers,2-10,6-6,1,7,10,14,24,7,0,7,0,0,10,7,7,-4,-3,-10,0.10928379985209036,[-19.81069392]
2019,14,NCAAF_20191129_BOISE@COLOST,Colorado St.,Rams,Boise St.,Broncos,4-8,11-1,1,14,24,24,31,7,7,7,3,7,17,0,7,-7,-10,-7,0.15490812391905417,[-16.35303753]
2019,14,NCAAF_20191129_CINCY@MEMP,Memphis,Tigers,Cincinnati,Bearcats,11-1,10-2,1,20,17,34,24,17,3,0,14,3,14,0,7,1,3,10,0.6472133268814799,[6.08335876]
2019,14,NCAAF_20191129_WASHST@WASH,Washington,Huskies,Washington St.,Cougars,7-5,6-6,0,21,10,31,13,7,14,7,3,7,3,3,0,1,11,18,0.6371395446957593,[5.64886111]
2019,14,NCAAF_20191129_WVU@TCU,TCU,Horned Frogs,West Virginia,Mountaineers,5-7,5-7,1,10,10,17,20,7,3,7,0,7,3,3,7,0,0,-3,0.5958288827160722,[3.90571879]
2019,14,NCAAF_20191129_ARKST@SALA,South Alabama,Jaguars,Arkansas St.,Red Wolves,2-10,7-5,0,14,7,34,30,14,0,6,14,7,0,10,13,-5,7,4,0.14953447602638736,[-16.72054946]
2019,14,NCAAF_20191129_APLST@TROY,Troy,Trojans,App. St.,Mountaineers,5-7,11-1,1,13,34,13,48,10,3,0,0,20,14,7,7,-6,-21,-35,0.2984103687691295,[-8.51745873]
2019,14,NCAAF_20191129_SFLA@UCF,UCF,Knights,South Florida,Bulls,9-3,4-8,1,24,0,34,7,7,17,7,3,0,0,7,0,5,24,27,0.899257172022193,[20.56722398]
2019,14,NCAAF_20191128_MISS@MISSST,Miss. State,Bulldogs,Ole Miss,Rebels,6-6,4-8,1,14,14,21,20,7,7,7,0,0,14,0,6,2,0,1,0.752980230148013,[11.01193983]
2019,14,NCAAF_20191126_OHIO@AKRON,Akron,Zips,Ohio,Bobcats,0-12,6-6,1,3,31,3,52,3,0,0,0,14,17,7,14,-6,-28,-49,0.12018686450735117,[-18.90428362]
2019,14,NCAAF_20191126_WMICH@NILL,N. Illinois,Huskies,W. Michigan,Broncos,5-7,7-5,1,10,0,17,14,3,7,0,7,0,0,7,7,-2,10,3,0.5152148759285475,[0.61423722]
2019,15,NCAAF_20191207_LALAF@APLST,App. St.,Mountaineers,Louisiana,Ragin' Cajuns,12-1,10-3,1,35,17,45,38,21,14,7,3,7,10,7,14,2,18,7,0.7596246232858581,[11.38792853]
2019,15,NCAAF_20191207_MIAOH@CMICH,C. Michigan,Chippewas,Miami-OH,RedHawks,8-5,8-5,0,14,10,21,26,0,14,0,7,7,3,7,9,0,4,-5,0.4744453375006399,[-1.03527123]
2019,15,NCAAF_20191207_UAB@FAU,FAU,Owls,UAB,Blazers,10-3,9-4,0,35,6,49,6,14,21,7,7,3,3,0,0,1,29,43,0.7201739516930574,[9.42176241]
2019,15,NCAAF_20191207_CINCY@MEMP,Memphis,Tigers,Cincinnati,Bearcats,12-1,10-3,0,10,14,29,24,10,0,10,9,7,7,7,3,2,-4,5,0.6562006997092116,[6.4945367]
2019,15,NCAAF_20191207_HAWAII@BOISE,Boise St.,Broncos,Hawaii,Rainbow Warriors,12-1,9-5,1,17,3,31,10,3,14,14,0,3,0,0,7,3,14,21,0.9048397540643269,[21.15172951]
2019,15,NCAAF_20191207_UGA@LSU,LSU,Tigers,Georgia,Bulldogs,13-0,11-2,0,17,3,37,10,14,3,17,3,0,3,0,7,2,14,27,0.3362193330878922,[-6.82865648]
2019,15,NCAAF_20191207_UVA@CLEM,Clemson,Tigers,Virginia,Cavaliers,13-0,9-4,0,31,7,62,17,14,17,14,17,7,0,7,3,4,24,45,0.9551597242185654,[27.40945413]
2019,15,NCAAF_20191207_OHIOST@WISC,Wisconsin,Badgers,Ohio State,Buckeyes,10-3,13-0,1,21,7,21,34,7,14,0,0,0,7,17,10,-3,14,-13,0.2398992920343228,[-11.41265501]
2019,15,NCAAF_20191206_UTAH@OREG,Oregon,Ducks,Utah,Utes,11-2,11-2,0,20,0,37,15,10,10,3,14,0,0,15,0,0,20,22,0.4518395169246565,[-1.95450366]
2020,1,NCAAF_20200907_BYU@NAVY,Navy,Midshipmen,BYU,Cougars,0-1,1-0,1,0,31,3,55,0,0,3,0,14,17,17,7,-1,-31,-52,0.6368406478254531,[5.65665763]
2020,1,NCAAF_20200905_EKY@MRSHL,Marshall,Thundering Herd,E. Kentucky,Colonels,1-0,0-1,1,38,0,59,0,21,17,14,7,0,0,0,0,1,38,59,0.8877263496088149,[19.62751239]
2020,1,NCAAF_20200905_MTSU@ARMY,Army,Black Knights,Middle Tenn.,Blue Raiders,1-0,0-1,0,21,0,42,0,7,14,14,7,0,0,0,0,1,21,42,0.5986296434540984,[4.03695739]
2020,1,NCAAF_20200905_SMU@TXSTSM,Texas St.,Bobcats,SMU,Mustangs,0-1,1-0,1,14,14,24,31,0,14,7,3,0,14,14,3,-1,0,-7,0.04213907896877778,[-27.89950307]
2020,1,NCAAF_20200905_HOUBP@NTEXAS,North Texas,Mean Green,Houston Christian,Huskies,1-0,0-1,1,23,10,57,31,14,9,20,14,0,10,7,14,1,13,26,0.933043016247192,[24.22230024]
2020,1,NCAAF_20200905_ARKST@MEMP,Memphis,Tigers,Arkansas St.,Red Wolves,1-0,0-1,0,21,14,37,24,7,14,13,3,14,0,3,7,1,7,13,0.8360986437144762,[15.81399188]
2020,1,NCAAF_20200905_SFA@UTEP,UTEP,Miners,S.F. Austin,Lumberjacks,1-0,0-1,0,17,14,24,14,3,14,0,7,7,7,0,0,1,3,10,0.6884299615681012,[7.94142254]
2020,1,NCAAF_20200903_CAR@UAB,UAB,Blazers,Cent. Ark.,Bears,1-0,1-1,0,28,21,45,35,14,14,3,14,7,14,0,14,0,7,10,0.7648364293061385,[11.6671299]
2020,1,NCAAF_20200903_SALA@USM,So. Miss,Golden Eagles,South Alabama,Jaguars,0-1,1-0,0,10,13,21,32,0,10,3,8,13,0,10,9,-1,-3,-11,0.8251454587127605,[15.11269097]
2020,2,NCAAF_20200912_ARKST@KSTATE,Kansas State,Wildcats,Arkansas St.,Red Wolves,0-1,1-1,0,21,14,31,35,7,14,0,10,7,7,7,14,-1,7,-4,0.8524338324707681,[16.98637629]
2020,2,NCAAF_20200912_CHARLO@APLST,App. St.,Mountaineers,Charlotte,49ers,1-0,0-1,0,14,10,35,20,0,14,7,14,7,3,10,0,1,4,15,0.9111784786613396,[21.87201412]
2020,2,NCAAF_20200912_CUSE@UNC,North Carolina,Tar Heels,Syracuse,Orange,1-0,0-1,1,7,3,31,6,7,0,3,21,0,3,3,0,1,4,25,0.4134868791788131,[-3.54652319]
2020,2,NCAAF_20200912_EKY@WVU,West Virginia,Mountaineers,E. Kentucky,Colonels,1-0,0-2,1,42,7,56,10,14,28,7,7,0,7,3,0,1,35,46,0.9944359641984747,[41.18950271]
2020,2,NCAAF_20200912_LALAF@IOWAST,Iowa St.,Cyclones,Louisiana,Ragin' Cajuns,0-1,1-0,0,14,10,14,31,0,14,0,0,0,10,7,14,-1,4,-17,0.9290646385990272,[23.83219098]
2020,2,NCAAF_20200912_LAMON@ARMY,Army,Black Knights,UL-Monroe,Warhawks,2-0,0-1,0,17,7,37,7,14,3,13,7,0,7,0,0,2,10,30,0.8226650211760201,[15.01731764]
2020,2,NCAAF_20200912_DUKE@ND,Notre Dame,Fighting Irish,Duke,Blue Devils,1-0,0-1,0,10,6,27,13,0,10,7,10,3,3,7,0,1,4,14,0.8697347265856863,[18.25531472]
2020,2,NCAAF_20200912_AP@PITT,Pittsburgh,Panthers,Austin Peay,Governors,1-0,0-2,0,42,0,55,0,21,21,0,13,0,0,0,0,1,42,55,0.9348362324735445,[24.5453003]
2020,2,NCAAF_20200912_GATECH@FSU,Florida State,Seminoles,Georgia Tech,Yellow Jackets,0-1,1-0,0,10,0,13,16,10,0,3,0,0,0,7,9,-1,10,-3,0.5529000273671332,[2.15778443]
2020,2,NCAAF_20200912_CAMP@GAS,Ga. Southern,Eagles,Campbell,Fighting Camels,1-0,0-1,0,6,13,27,26,3,3,7,14,13,0,7,6,1,-7,1,0.9845992746149013,[35.03987451]
2020,2,NCAAF_20200912_CIT@SFLA,South Florida,Bulls,The Citadel,Bulldogs,1-0,0-1,0,20,6,27,6,7,13,0,7,3,3,0,0,1,14,21,0.7030149904794101,[8.64939121]
2020,2,NCAAF_20200912_MOST@OKLA,Oklahoma,Sooners,Missouri St.,Bears,1-0,0-1,0,41,0,48,0,31,10,0,7,0,0,0,0,1,41,48,0.9999212968095246,[61.31546893]
2020,2,NCAAF_20200912_CLEM@WAKE,Wake Forest,Demon Deacons,Clemson,Tigers,0-1,1-0,0,0,27,13,37,0,0,3,10,14,13,10,0,-1,-27,-24,0.04964282488281846,[-26.74402756]
2020,2,NCAAF_20200912_TULANE@SALA,South Alabama,Jaguars,Tulane,Green Wave,1-1,1-0,0,14,6,24,27,0,14,10,0,0,6,7,14,0,8,-3,0.10030345033261434,[-20.76509416]
2020,2,NCAAF_20200912_HOUBP@TXTECH,Texas Tech,Red Raiders,Houston Christian,Huskies,1-0,0-2,1,21,10,35,33,14,7,7,7,3,7,10,13,1,11,2,0.9959850729661159,[43.00930609]
2020,2,NCAAF_20200912_UTEP@TEXAS,Texas,Longhorns,UTEP,Miners,1-0,1-1,1,45,3,59,3,21,24,7,7,0,3,0,0,0,42,56,0.9972335516248862,[45.01209989]
2020,2,NCAAF_20200912_WKY@LVILLE,Louisville,Cardinals,W. Kentucky,Hilltoppers,1-0,0-1,1,28,7,35,21,7,21,7,0,7,0,7,7,1,21,14,0.7483741092688923,[10.86069454]
2020,2,NCAAF_20200912_CSTCAR@KANSAS,Kansas,Jayhawks,C. Carolina,Chanticleers,0-1,1-0,1,3,28,23,38,0,3,14,6,14,14,0,10,-1,-25,-15,0.7595176183767436,[11.43456531]
2020,2,NCAAF_20200910_UAB@MIAMI,Miami (Fla.),Hurricanes,UAB,Blazers,1-0,1-1,0,14,7,31,14,7,7,17,0,7,0,7,0,0,7,17,0.8868417637669725,[19.63060748]
2020,3,NCAAF_20200919_AP@CINCY,Cincinnati,Bearcats,Austin Peay,Governors,1-0,0-3,1,28,3,55,20,14,14,14,13,3,0,3,14,1,25,35,0.9691711516061878,[30.37206685]
2020,3,NCAAF_20200919_BC@DUKE,Duke,Blue Devils,Boston College,Eagles,0-2,1-0,1,6,7,6,26,6,0,0,0,7,0,16,3,-1,-1,-20,0.4321756344405101,[-2.77656206]
2020,3,NCAAF_20200919_CUSE@PITT,Pittsburgh,Panthers,Syracuse,Orange,2-0,0-2,0,14,10,21,10,7,7,7,0,3,7,0,0,2,4,11,0.5506817279584861,[2.07032201]
2020,3,NCAAF_20200919_LIB@WKY,W. Kentucky,Hilltoppers,Liberty,Flames,0-2,1-0,1,10,17,24,30,0,10,7,7,10,7,7,6,-1,-7,-6,0.5572028426639828,[2.33844533]
2020,3,NCAAF_20200919_NAVY@TULANE,Tulane,Green Wave,Navy,Midshipmen,1-1,1-1,0,24,0,24,27,10,14,0,0,0,0,16,11,0,24,-3,0.45339205485161505,[-1.90311375]
2020,3,NCAAF_20200919_TULSA@OKLAST,Oklahoma State,Cowboys,Tulsa,Golden Hurricane,1-0,0-1,0,3,7,16,7,3,0,0,13,0,7,0,0,1,-4,9,0.9043657896179541,[21.23950451]
2020,3,NCAAF_20200919_SFLA@ND,Notre Dame,Fighting Irish,South Florida,Bulls,2-0,1-1,1,35,0,52,0,14,21,10,7,0,0,0,0,1,35,52,0.9344809920281951,[24.54179587]
2020,3,NCAAF_20200919_APLST@MRSHL,Marshall,Thundering Herd,App. St.,Mountaineers,2-0,1-1,1,10,7,17,7,7,3,7,0,7,0,0,0,1,3,10,0.30314762147740404,[-8.37609366]
2020,3,NCAAF_20200919_SFA@TXSA,UTSA,Roadrunners,S.F. Austin,Lumberjacks,2-0,0-2,1,17,7,24,10,3,14,0,7,0,7,3,0,2,10,14,0.8842836681675855,[19.44912487]
2020,3,NCAAF_20200919_TROY@MTSU,Middle Tenn.,Blue Raiders,Troy,Trojans,0-2,1-0,0,7,26,14,47,7,0,0,7,7,19,14,7,-1,-19,-33,0.45712237887469964,[-1.75017965]
2020,3,NCAAF_20200919_UCF@GATECH,Georgia Tech,Yellow Jackets,UCF,Knights,1-1,1-0,1,14,28,21,49,7,7,0,7,7,21,0,21,0,-14,-28,0.19180370736902086,[-14.16039756]
2020,3,NCAAF_20200919_CIT@CLEM,Clemson,Tigers,The Citadel,Bulldogs,2-0,0-2,1,49,0,49,0,28,21,0,0,0,0,0,0,2,49,49,0.998694697877264,[48.92391624]
2020,3,NCAAF_20200919_SMU@NTEXAS,North Texas,Mean Green,SMU,Mustangs,1-1,2-0,1,7,34,35,65,0,7,14,14,21,13,21,10,-1,-27,-30,0.2586872689112889,[-10.52190791]
2020,3,NCAAF_20200919_LATECH@USM,So. Miss,Golden Eagles,Louisiana Tech,Bulldogs,0-2,1-0,1,13,10,30,31,0,13,14,3,7,3,14,7,-1,3,-1,0.48425604667516065,[-0.64156373]
2020,3,NCAAF_20200919_MIAMI@LVILLE,Louisville,Cardinals,Miami (Fla.),Hurricanes,1-1,2-0,0,6,20,34,47,3,3,14,14,14,6,17,10,-1,-14,-13,0.24541914397758968,[-11.19766506]
2020,3,NCAAF_20200919_TXSTSM@LAMON,UL-Monroe,Warhawks,Texas St.,Bobcats,0-2,1-2,0,14,31,17,38,7,7,3,0,14,17,0,7,-1,-17,-21,0.6840794500788691,[7.78723165]
2020,3,NCAAF_20200919_WAKE@NCST,NC State,Wolfpack,Wake Forest,Demon Deacons,1-0,0-2,1,21,21,45,42,14,7,14,10,7,14,14,7,1,0,3,0.4898137535962598,[-0.41502533]
2020,3,NCAAF_20200919_ABIL@UTEP,UTEP,Miners,Abil Christian,Wildcats,2-1,0-1,0,10,7,17,13,0,10,0,7,7,0,3,3,2,3,4,0.5626676037934732,[2.56362358]
2020,3,NCAAF_20200918_CAMP@CSTCAR,C. Carolina,Chanticleers,Campbell,Fighting Camels,2-0,0-2,0,21,9,43,21,14,7,7,15,0,9,0,12,2,12,22,0.8408243460581205,[16.21770025]
2020,4,NCAAF_20200926_CAMP@APLST,App. St.,Mountaineers,Campbell,Fighting Camels,2-1,0-3,0,17,13,52,21,7,10,21,14,7,6,0,8,2,4,31,0.9906296709437625,[38.16724838]
2020,4,NCAAF_20200926_FLA@MISS,Ole Miss,Rebels,Florida,Gators,0-1,1-0,1,14,28,35,51,7,7,7,14,14,14,13,10,-1,-14,-16,0.242873131277489,[-11.31858049]
2020,4,NCAAF_20200926_GAS@LALAF,Louisiana,Ragin' Cajuns,Ga. Southern,Eagles,3-0,1-1,0,7,7,20,18,0,7,3,10,0,7,3,8,2,0,2,0.6119298032854303,[4.61699794]
2020,4,NCAAF_20200926_GATECH@CUSE,Syracuse,Orange,Georgia Tech,Yellow Jackets,1-2,1-2,1,23,13,37,20,17,6,7,7,0,13,7,0,0,10,17,0.5073510024299,[0.29920165]
2020,4,NCAAF_20200926_KSTATE@OKLA,Oklahoma,Sooners,Kansas State,Wildcats,1-1,1-1,1,21,7,35,38,7,14,14,0,0,7,14,17,0,14,-3,0.833021086669326,[15.68764]
2020,4,NCAAF_20200926_LVILLE@PITT,Pittsburgh,Panthers,Louisville,Cardinals,3-0,1-2,1,20,17,23,20,13,7,3,0,7,10,3,0,2,3,3,0.625558272903989,[5.19762344]
2020,4,NCAAF_20200926_UCF@ECU,East Carolina,Pirates,UCF,Knights,0-1,2-0,1,7,27,28,51,7,0,7,14,10,17,14,10,-2,-20,-23,0.017094838572150883,[-34.38693687]
2020,4,NCAAF_20200926_UK@AUBURN,Auburn,Tigers,Kentucky,Wildcats,1-0,0-1,1,8,7,29,13,8,0,7,14,7,0,6,0,1,1,16,0.8117600856750777,[14.35992217]
2020,4,NCAAF_20200926_FIU@LIB,Liberty,Flames,FIU,Panthers,2-0,0-1,0,14,14,36,34,14,0,13,9,14,0,14,6,2,0,2,0.4063611249432958,[-3.84677338]
2020,4,NCAAF_20200926_IOWAST@TCU,TCU,Horned Frogs,Iowa St.,Cyclones,0-1,1-1,1,7,16,34,37,0,7,14,13,0,16,7,14,-1,-9,-3,0.4674378746868534,[-1.32674864]
2020,4,NCAAF_20200926_TULANE@USM,So. Miss,Golden Eagles,Tulane,Green Wave,0-3,2-1,1,21,31,24,66,14,7,3,0,7,24,21,14,-2,-10,-42,0.3301654629775057,[-7.1354048]
2020,4,NCAAF_20200926_ARMY@CINCY,Cincinnati,Bearcats,Army,Black Knights,2-0,2-1,1,10,7,24,10,3,7,7,7,7,0,0,3,0,3,14,0.5687246401607637,[2.81106264]
2020,4,NCAAF_20200926_MISSST@LSU,LSU,Tigers,Miss. State,Bulldogs,0-1,1-0,0,14,17,34,44,0,14,10,10,3,14,10,17,-1,-3,-10,0.7027067623838094,[8.64129756]
2020,4,NCAAF_20200926_UTEP@LAMON,UL-Monroe,Warhawks,UTEP,Miners,0-3,3-1,0,0,24,6,31,0,0,6,0,7,17,0,7,-3,-24,-25,0.7934346116165991,[13.28821682]
2020,4,NCAAF_20200926_WVU@OKLAST,Oklahoma State,Cowboys,West Virginia,Mountaineers,2-0,1-1,0,20,7,27,13,0,20,0,7,0,7,3,3,1,13,14,0.6035824305393489,[4.26430835]
2020,4,NCAAF_20200926_DUKE@UVA,Virginia,Cavaliers,Duke,Blue Devils,1-0,0-3,1,17,10,38,20,0,17,0,21,10,0,10,0,1,7,18,0.5444203382665636,[1.81165318]
2020,4,NCAAF_20200926_UGA@ARK,Arkansas,Razorbacks,Georgia,Bulldogs,0-1,1-0,1,7,5,10,37,7,0,3,0,0,5,22,10,-1,2,-27,0.015085272987004683,[-35.19905147]
2020,4,NCAAF_20200926_TXSTSM@BC,Boston College,Eagles,Texas St.,Bobcats,2-0,1-3,0,7,14,24,21,0,7,7,10,7,7,7,0,1,-7,3,0.9634212297219306,[29.09401989]
2020,4,NCAAF_20200926_BAMA@MIZZOU,Missouri,Tigers,Alabama,Crimson Tide,0-1,1-0,0,3,28,19,38,0,3,3,13,14,14,7,3,-1,-25,-19,0.08488216017268213,[-22.29262738]
2020,4,NCAAF_20200926_HOUBP@LATECH,Louisiana Tech,Bulldogs,Houston Christian,Huskies,2-0,0-3,1,38,17,66,38,17,21,14,14,14,3,7,14,2,21,28,0.8666035958831501,[18.03072249]
2020,4,NCAAF_20200926_SFA@SMU,SMU,Mustangs,S.F. Austin,Lumberjacks,3-0,0-3,1,29,0,50,7,22,7,7,14,0,0,7,0,3,29,43,0.993108189981402,[39.98908728]
2020,4,NCAAF_20200926_FSU@MIAMI,Miami (Fla.),Hurricanes,Florida State,Seminoles,3-0,0-2,1,38,3,52,10,14,24,0,14,3,0,7,0,3,35,42,0.6612141374559127,[6.75095877]
2020,4,NCAAF_20200926_KANSAS@BAYLOR,Baylor,Bears,Kansas,Jayhawks,1-0,0-2,0,17,7,47,14,7,10,14,16,7,0,0,7,1,10,33,0.7934272724978364,[13.2877993]
2020,4,NCAAF_20200926_TENN@SC,South Carolina,Gamecocks,Tennessee,Volunteers,0-1,1-0,1,7,14,27,31,7,0,14,6,7,7,10,7,-1,-7,-4,0.6416033674484356,[5.88989738]
2020,4,NCAAF_20200926_VANDY@TXAM,Texas A&M,Aggies,Vanderbilt,Commodores,1-0,0-1,0,7,5,17,12,7,0,7,3,3,2,7,0,1,2,5,0.8172287293838663,[14.69202276]
2020,4,NCAAF_20200926_NCST@VATECH,Virginia Tech,Hokies,NC State,Wolfpack,1-0,1-1,1,31,10,45,24,17,14,6,8,0,10,7,7,0,21,21,0.5557401642154458,[2.27604852]
2020,4,NCAAF_20200926_TROY@BYU,BYU,Cougars,Troy,Trojans,2-0,1-1,0,24,7,48,7,7,17,14,10,0,7,0,0,1,17,41,0.5893070878231852,[3.66568802]
2020,4,NCAAF_20200925_MTSU@TXSA,UTSA,Roadrunners,Middle Tenn.,Blue Raiders,3-0,0-3,0,17,10,37,35,0,17,17,3,3,7,13,12,3,7,2,0.24069107925492372,[-11.43209169]
2020,4,NCAAF_20200924_UAB@SALA,South Alabama,Jaguars,UAB,Blazers,1-2,2-1,0,10,28,10,42,0,10,0,0,14,14,0,14,-1,-18,-32,0.2381161860914498,[-11.56676172]
2020,5,NCAAF_20201003_ARKST@CSTCAR,C. Carolina,Chanticleers,Arkansas St.,Red Wolves,3-0,1-2,0,24,14,52,23,7,17,7,21,14,0,0,9,2,10,29,0.2320967791903138,[-11.89719567]
2020,5,NCAAF_20201003_ECU@GAST,Georgia St.,Panthers,East Carolina,Pirates,1-1,0-2,1,35,13,49,29,21,14,0,14,7,6,3,13,1,22,20,0.49041214098826835,[-0.39067103]
2020,5,NCAAF_20201003_MIZZOU@TENN,Tennessee,Volunteers,Missouri,Tigers,2-0,0-2,1,21,6,35,12,7,14,7,7,0,6,6,0,2,15,23,0.26828826177304754,[-10.04488635]
2020,5,NCAAF_20201003_NCST@PITT,Pittsburgh,Panthers,NC State,Wolfpack,3-1,2-1,1,13,17,29,30,7,6,7,9,10,7,0,13,1,-4,-1,0.5019164452714657,[0.07808109]
2020,5,NCAAF_20201003_SC@FLA,Florida,Gators,South Carolina,Gamecocks,2-0,0-2,0,24,14,38,24,14,10,14,0,7,7,3,7,2,10,14,0.6970993102550602,[8.38825101]
2020,5,NCAAF_20201003_TCU@TEXAS,Texas,Longhorns,TCU,Horned Frogs,2-1,1-1,1,14,20,31,33,7,7,7,10,7,13,3,10,1,-6,-2,0.548641007809463,[1.98669235]
2020,5,NCAAF_20201003_TXSA@UAB,UAB,Blazers,UTSA,Roadrunners,3-1,3-1,0,14,6,21,13,7,7,7,0,3,3,0,7,0,8,8,0.7487892164044939,[10.9012439]
2020,5,NCAAF_20201003_NAL@LIB,Liberty,Flames,North Alabama,Lions,3-0,0-1,0,7,0,28,7,0,7,14,7,0,0,0,7,3,7,21,,
2020,5,NCAAF_20201003_ABIL@ARMY,Army,Black Knights,Abil Christian,Wildcats,3-1,0-2,0,23,3,55,23,7,16,15,17,0,3,7,13,3,20,32,0.9741301884125901,[31.61862842]
2020,5,NCAAF_20201003_MEMP@SMU,SMU,Mustangs,Memphis,Tigers,4-0,1-1,1,24,20,30,27,17,7,3,3,3,17,7,0,3,4,3,0.3518250532013273,[-6.182952]
2020,5,NCAAF_20201003_OKLAST@KANSAS,Kansas,Jayhawks,Oklahoma State,Cowboys,0-3,3-0,1,0,31,7,47,0,0,0,7,10,21,13,3,-3,-31,-40,0.07778100811056654,[-23.08310011]
2020,5,NCAAF_20201003_SFLA@CINCY,Cincinnati,Bearcats,South Florida,Bulls,3-0,1-2,0,14,0,28,7,7,7,14,0,0,0,7,0,2,14,21,0.6653345740494168,[6.94150079]
2020,5,NCAAF_20201003_TXAM@BAMA,Alabama,Crimson Tide,Texas A&M,Aggies,2-0,1-1,0,35,14,52,24,14,21,7,10,7,7,3,7,1,21,28,0.9179859840534431,[22.61977231]
2020,5,NCAAF_20201003_TXTECH@KSTATE,Kansas State,Wildcats,Texas Tech,Red Raiders,2-1,1-2,1,14,0,31,21,7,7,3,14,0,0,14,7,1,14,10,0.5532430303783635,[2.17573468]
2020,5,NCAAF_20201003_UNC@BC,Boston College,Eagles,North Carolina,Tar Heels,2-1,2-0,1,16,21,22,26,3,13,0,6,14,7,3,2,0,-5,-4,0.6082057811941403,[4.46406644]
2020,5,NCAAF_20201003_CHARLO@FAU,FAU,Owls,Charlotte,49ers,1-0,0-2,1,0,10,21,17,0,0,21,0,10,0,0,7,1,-10,4,0.8995326907860597,[20.78701555]
2020,5,NCAAF_20201003_JAXST@FSU,Florida State,Seminoles,Jacksonville St.,Gamecocks,1-2,0-1,0,14,21,41,24,0,14,20,7,14,7,3,0,1,-7,17,0.959861914057184,[28.42948252]
2020,5,NCAAF_20201003_VATECH@DUKE,Duke,Blue Devils,Virginia Tech,Hokies,0-4,2-0,1,7,10,31,38,7,0,7,17,7,3,14,14,-2,-3,-7,0.35014407764709354,[-6.25664171]
2020,5,NCAAF_20201003_WKY@MTSU,Middle Tenn.,Blue Raiders,W. Kentucky,Hilltoppers,0-4,1-2,1,10,10,17,20,0,10,0,7,0,10,3,7,-1,0,-3,0.5725169810056404,[2.9709848]
2020,5,NCAAF_20201003_NAVY@AF,Air Force,Falcons,Navy,Midshipmen,1-0,1-2,0,16,7,40,7,3,13,3,21,0,7,0,0,0,9,33,0.4659411565468764,[-1.38933263]
2020,5,NCAAF_20201003_GAS@LAMON,UL-Monroe,Warhawks,Ga. Southern,Eagles,0-4,2-1,1,17,21,30,35,3,14,6,7,7,14,14,0,-2,-4,-5,0.33121533240688694,[-7.09580216]
2020,5,NCAAF_20201003_ARK@MISSST,Miss. State,Bulldogs,Arkansas,Razorbacks,1-1,1-1,1,7,14,14,21,7,0,7,0,7,7,7,0,0,-7,-7,0.9124470132914444,[22.03995253]
2020,5,NCAAF_20201003_AUBURN@UGA,Georgia,Bulldogs,Auburn,Tigers,2-0,1-1,1,24,3,27,6,10,14,3,0,0,3,3,0,1,21,21,0.6305595660718009,[5.41800859]
2020,5,NCAAF_20201003_LSU@VANDY,Vanderbilt,Commodores,LSU,Tigers,0-2,1-1,1,7,21,7,41,0,7,0,0,7,14,13,7,-1,-14,-34,0.0582569274088347,[-25.51174014]
2020,5,NCAAF_20201003_OKLA@IOWAST,Iowa St.,Cyclones,Oklahoma,Sooners,2-1,1-2,0,13,17,37,30,3,10,10,14,10,7,3,10,1,-4,7,0.26236771114899704,[-10.33850837]
2020,5,NCAAF_20201003_TULSA@UCF,UCF,Knights,Tulsa,Golden Hurricane,2-1,1-1,0,23,12,26,34,16,7,3,0,2,10,13,9,1,11,-8,0.9313162074307364,[24.14787354]
2020,5,NCAAF_20201003_USM@NTEXAS,North Texas,Mean Green,So. Miss,Golden Eagles,1-2,1-3,1,10,20,31,41,3,7,7,14,17,3,7,14,0,-10,-10,0.4952710693706718,[-0.192673]
2020,5,NCAAF_20201003_UVA@CLEM,Clemson,Tigers,Virginia,Cavaliers,3-0,1-1,1,24,10,41,23,10,14,10,7,0,10,7,6,2,14,18,0.95310139106449,[27.23665421]
2020,5,NCAAF_20201002_CAMP@WAKE,Wake Forest,Demon Deacons,Campbell,Fighting Camels,1-2,0-4,0,24,7,66,14,14,10,28,14,0,7,7,0,1,17,52,0.9918666293361603,[39.05611279]
2020,5,NCAAF_20201002_LATECH@BYU,BYU,Cougars,Louisiana Tech,Bulldogs,3-0,2-1,0,28,7,45,14,7,21,10,7,7,0,0,7,1,21,31,0.6738829974544753,[7.32500025]
2020,6,NCAAF_20201010_FLA@TXAM,Texas A&M,Aggies,Florida,Gators,2-1,2-1,0,17,21,41,38,7,10,7,17,14,7,7,10,0,-4,3,0.388905722856847,[-4.58942961]
2020,6,NCAAF_20201010_LAMON@LIB,Liberty,Flames,UL-Monroe,Warhawks,4-0,0-5,0,24,0,40,7,14,10,7,9,0,0,0,7,4,24,33,0.6247116376356707,[5.17018718]
2020,6,NCAAF_20201010_LSU@MIZZOU,Missouri,Tigers,LSU,Tigers,1-2,1-2,1,24,24,45,41,14,10,14,7,14,10,17,0,0,0,4,0.23374346145733615,[-11.81746492]
2020,6,NCAAF_20201010_NCST@UVA,Virginia,Cavaliers,NC State,Wolfpack,1-2,3-1,0,7,24,21,38,0,7,7,7,14,10,0,14,-2,-17,-17,0.5047975902395547,[0.19559961]
2020,6,NCAAF_20201010_SC@VANDY,Vanderbilt,Commodores,South Carolina,Gamecocks,0-3,1-2,0,0,10,7,41,0,0,7,0,3,7,17,14,-1,-10,-34,0.2697968723341001,[-9.97717601]
2020,6,NCAAF_20201010_VATECH@UNC,North Carolina,Tar Heels,Virginia Tech,Hokies,3-0,2-1,1,35,14,56,45,21,14,7,14,0,14,23,8,1,21,11,0.33190314019321754,[-7.06965429]
2020,6,NCAAF_20201010_DUKE@CUSE,Syracuse,Orange,Duke,Blue Devils,1-3,1-4,0,14,24,24,38,7,7,7,3,10,14,6,8,0,-10,-14,0.5112724256837906,[0.45963125]
2020,6,NCAAF_20201010_CIT@ARMY,Army,Black Knights,The Citadel,Bulldogs,4-1,0-4,1,7,3,14,9,0,7,7,0,3,0,0,6,4,4,5,0.8460878759031588,[16.58664729]
2020,6,NCAAF_20201010_CAR@ARKST,Arkansas St.,Red Wolves,Cent. Ark.,Bears,2-2,2-3,0,23,13,50,27,2,21,20,7,3,10,0,14,0,10,23,0.7966501237013981,[13.49502042]
2020,6,NCAAF_20201010_TENN@UGA,Georgia,Bulldogs,Tennessee,Volunteers,3-0,2-1,1,17,21,44,21,7,10,13,14,7,14,0,0,1,-4,23,0.9401225217497565,[25.30457357]
2020,6,NCAAF_20201010_TXSA@BYU,BYU,Cougars,UTSA,Roadrunners,4-0,3-2,1,14,3,27,20,0,14,7,6,3,0,3,14,1,11,7,0.8925107071668668,[20.1680122]
2020,6,NCAAF_20201010_TXSTSM@TROY,Troy,Trojans,Texas St.,Bobcats,2-1,1-4,1,23,3,37,17,6,17,7,7,3,0,7,7,1,20,20,0.8483198367768587,[16.74044513]
2020,6,NCAAF_20201010_TXTECH@IOWAST,Iowa St.,Cyclones,Texas Tech,Red Raiders,3-1,1-3,0,21,7,31,15,7,14,7,3,7,0,0,8,2,14,16,0.6732231823332772,[7.30007288]
2020,6,NCAAF_20201010_ARK@AUBURN,Auburn,Tigers,Arkansas,Razorbacks,2-1,1-2,0,20,12,30,28,10,10,0,10,0,12,6,10,1,8,2,0.9585348935499951,[28.20177246]
2020,6,NCAAF_20201010_KSTATE@TCU,TCU,Horned Frogs,Kansas State,Wildcats,1-2,3-1,1,7,14,14,21,7,0,0,7,6,8,7,0,-2,-7,-7,0.5736535387524533,[3.02007608]
2020,6,NCAAF_20201010_MTSU@FIU,FIU,Panthers,Middle Tenn.,Blue Raiders,0-2,1-4,0,14,17,28,31,7,7,14,0,0,17,7,7,-1,-3,-3,0.4826070903187858,[-0.70932335]
2020,6,NCAAF_20201010_TEMPLE@NAVY,Navy,Midshipmen,Temple,Owls,2-2,0-1,1,21,10,31,29,7,14,7,3,0,10,7,12,2,11,2,0.5036529263803546,[0.14892971]
2020,6,NCAAF_20201010_ECU@SFLA,South Florida,Bulls,East Carolina,Pirates,1-3,1-2,0,17,31,24,44,7,10,0,7,17,14,7,6,0,-14,-20,0.7827280926548033,[12.70983791]
2020,6,NCAAF_20201010_BAMA@MISS,Ole Miss,Rebels,Alabama,Crimson Tide,1-2,3-0,1,21,21,48,63,7,14,14,13,7,14,21,21,-2,0,-15,0.03187853296557519,[-30.15260556]
2020,6,NCAAF_20201010_FSU@ND,Notre Dame,Fighting Irish,Florida State,Seminoles,3-0,1-3,1,35,20,42,26,14,21,7,0,17,3,6,0,2,15,16,0.8743390247817608,[18.65788955]
2020,6,NCAAF_20201010_MIAMI@CLEM,Clemson,Tigers,Miami (Fla.),Hurricanes,4-0,3-1,1,21,10,42,17,7,14,14,7,0,10,0,7,1,11,25,0.8898668766131319,[19.93752741]
2020,6,NCAAF_20201010_MISSST@UK,Kentucky,Wildcats,Miss. State,Bulldogs,1-2,1-2,1,14,0,24,2,0,14,0,10,0,0,2,0,0,14,22,0.34709825692808405,[-6.39471118]
2020,6,NCAAF_20201010_MRSHL@WKY,W. Kentucky,Hilltoppers,Marshall,Thundering Herd,1-3,3-0,0,0,28,14,38,0,0,7,7,14,14,10,0,-2,-28,-24,0.3277563349447139,[-7.25593346]
2020,6,NCAAF_20201010_UTEP@LATECH,Louisiana Tech,Bulldogs,UTEP,Miners,3-1,3-2,1,14,7,21,17,7,7,0,7,0,7,3,7,0,7,4,0.9030234143205201,[21.12732824]
2020,6,NCAAF_20201010_CHARLO@NTEXAS,North Texas,Mean Green,Charlotte,49ers,1-3,1-2,1,7,21,21,49,0,7,7,7,7,14,14,14,0,-14,-28,0.69760847132878,[8.4175127]
2020,6,NCAAF_20201009_LVILLE@GATECH,Georgia Tech,Yellow Jackets,Louisville,Cardinals,2-2,1-3,0,14,21,46,27,7,7,12,20,7,14,6,0,1,-7,19,0.5529040264704316,[2.16322649]
2020,6,NCAAF_20201008_TULANE@HOU,Houston,Cougars,Tulane,Green Wave,1-0,2-2,1,21,24,49,31,7,14,21,7,17,7,7,0,-1,-3,18,0.531878068216377,[1.30103601]
2020,7,NCAAF_20201017_AUBURN@SC,South Carolina,Gamecocks,Auburn,Tigers,1-2,2-1,1,14,16,30,22,0,14,13,3,9,7,3,3,-1,-2,8,0.2051970339734035,[-13.39757234]
2020,7,NCAAF_20201017_CLEM@GATECH,Georgia Tech,Yellow Jackets,Clemson,Tigers,2-2,4-0,1,7,52,7,73,7,0,0,0,17,35,7,14,-2,-45,-66,0.03343243988430966,[-29.82522878]
2020,7,NCAAF_20201017_KANSAS@WVU,West Virginia,Mountaineers,Kansas,Jayhawks,2-1,0-3,1,17,10,38,17,7,10,7,14,10,0,0,7,2,7,21,0.8747385864003734,[18.70126489]
2020,7,NCAAF_20201017_LIB@CUSE,Syracuse,Orange,Liberty,Flames,1-3,4-0,1,14,21,21,38,7,7,0,7,14,7,14,3,-3,-7,-17,0.8055314737230488,[14.02165732]
2020,7,NCAAF_20201017_NAVY@ECU,East Carolina,Pirates,Navy,Midshipmen,1-2,3-2,0,13,13,23,27,6,7,0,10,7,6,14,0,-2,0,-4,0.14836990102765257,[-16.98213613]
2020,7,NCAAF_20201017_PITT@MIAMI,Miami (Fla.),Hurricanes,Pittsburgh,Panthers,3-1,3-2,0,14,6,31,19,7,7,14,3,0,6,13,0,0,8,12,0.6630608280643526,[6.849021]
2020,7,NCAAF_20201017_SFLA@TEMPLE,Temple,Owls,South Florida,Bulls,1-1,1-4,0,17,21,39,37,10,7,9,13,7,14,10,6,0,-4,2,0.6376381213167894,[5.73127924]
2020,7,NCAAF_20201017_TXSTSM@SALA,South Alabama,Jaguars,Texas St.,Bobcats,1-2,1-4,0,17,10,30,20,3,14,0,13,7,3,7,3,0,7,10,0.5313353850057034,[1.2796548]
2020,7,NCAAF_20201017_UK@TENN,Tennessee,Volunteers,Kentucky,Wildcats,2-1,1-2,0,7,17,7,34,0,7,0,0,0,17,10,7,1,-10,-27,0.36083456370103384,[-5.79762005]
2020,7,NCAAF_20201017_ARMY@TXSA,UTSA,Roadrunners,Army,Black Knights,3-2,4-1,1,10,14,16,28,0,10,0,6,7,7,7,7,-1,-4,-12,0.13513747693591283,[-17.9420236]
2020,7,NCAAF_20201017_WKY@UAB,UAB,Blazers,W. Kentucky,Hilltoppers,3-1,1-3,0,24,14,37,14,10,14,10,3,7,7,0,0,2,10,23,0.5795002191978751,[3.26500724]
2020,7,NCAAF_20201017_LVILLE@ND,Notre Dame,Fighting Irish,Louisville,Cardinals,3-0,1-3,1,6,0,12,7,6,0,6,0,0,0,7,0,2,6,5,0.913558889643056,[22.18281777]
2020,7,NCAAF_20201017_DUKE@NCST,NC State,Wolfpack,Duke,Blue Devils,3-1,1-4,0,14,20,31,20,0,14,7,10,7,13,0,0,2,-6,11,0.5697264848176444,[2.8591543]
2020,7,NCAAF_20201017_EKY@TROY,Troy,Trojans,E. Kentucky,Colonels,2-1,1-3,1,21,17,31,29,14,7,7,3,7,10,0,12,1,4,2,0.9454564796015422,[26.0775717]
2020,7,NCAAF_20201017_MISS@ARK,Arkansas,Razorbacks,Ole Miss,Rebels,1-2,1-2,1,20,0,33,21,7,13,0,13,0,0,7,14,0,20,12,0.27106280509348535,[-9.92125958]
2020,7,NCAAF_20201017_UCF@MEMP,Memphis,Tigers,UCF,Knights,2-1,2-2,1,14,27,50,49,7,7,15,21,7,20,8,14,0,-13,1,0.3215823754526804,[-7.53985013]
2020,7,NCAAF_20201017_TXAM@MISSST,Miss. State,Bulldogs,Texas A&M,Aggies,1-2,2-1,1,0,14,14,28,0,0,7,7,0,14,14,0,-1,-14,-14,0.5576301302715218,[2.35927758]
2020,7,NCAAF_20201017_UMASS@GAS,Ga. Southern,Eagles,UMass,Minutemen,2-1,0-0,1,28,0,41,0,14,14,10,3,0,0,0,0,2,28,41,0.8093346146960796,[14.24788463]
2020,7,NCAAF_20201017_UVA@WAKE,Wake Forest,Demon Deacons,Virginia,Cavaliers,1-2,1-2,1,20,20,40,23,14,6,3,17,3,17,0,3,0,0,17,0.526650591367994,[1.0880297]
2020,7,NCAAF_20201017_NTEXAS@MTSU,Middle Tenn.,Blue Raiders,North Texas,Mean Green,1-4,1-3,1,28,21,35,52,21,7,0,7,7,14,21,10,0,7,-17,0.5458808204484876,[1.87586865]
2020,7,NCAAF_20201017_MRSHL@LATECH,Louisiana Tech,Bulldogs,Marshall,Thundering Herd,3-1,3-0,0,3,14,17,35,0,3,7,7,7,7,14,7,0,-11,-18,0.3820287102337083,[-4.88504991]
2020,7,NCAAF_20201017_UNC@FSU,Florida State,Seminoles,North Carolina,Tar Heels,1-3,3-0,0,31,7,31,28,7,24,0,0,0,7,14,7,-2,24,3,0.5251735929151178,[1.0276476]
2020,7,NCAAF_20201017_BC@VATECH,Virginia Tech,Hokies,Boston College,Eagles,2-1,3-1,0,17,7,40,14,3,14,10,13,0,7,7,0,-1,10,26,0.5691344556823033,[2.83462992]
2020,7,NCAAF_20201017_UGA@BAMA,Alabama,Crimson Tide,Georgia,Bulldogs,3-0,3-0,1,20,24,41,24,7,13,14,7,7,17,0,0,0,-4,17,0.6366826082954201,[5.6898238]
2020,7,NCAAF_20201016_BYU@HOU,Houston,Cougars,BYU,Cougars,1-1,4-0,1,20,14,26,43,3,17,6,0,14,0,7,22,-3,6,-17,0.5225128663800185,[0.91890791]
2020,7,NCAAF_20201015_GAST@ARKST,Arkansas St.,Red Wolves,Georgia St.,Panthers,2-2,1-1,0,28,28,59,52,14,14,17,14,7,21,14,10,1,0,7,0.7304529198292583,[9.99582437]
2020,7,NCAAF_20201014_CSTCAR@LALAF,Louisiana,Ragin' Cajuns,C. Carolina,Chanticleers,3-0,3-0,1,13,13,27,30,7,6,7,7,7,6,7,10,0,0,-3,0.731238309516037,[10.03454353]
2020,8,NCAAF_20201024_AUBURN@MISS,Ole Miss,Rebels,Auburn,Tigers,1-4,3-2,1,14,14,28,35,0,14,7,7,7,7,7,14,-2,0,-7,0.14708727906208208,[-17.08210429]
2020,8,NCAAF_20201024_CUSE@CLEM,Clemson,Tigers,Syracuse,Orange,6-0,1-5,1,27,14,47,21,17,10,7,13,0,14,7,0,5,13,26,0.9732637348176588,[31.44590436]
2020,8,NCAAF_20201024_FSU@LVILLE,Louisville,Cardinals,Florida State,Seminoles,2-4,2-4,0,31,14,48,16,21,10,7,10,7,7,2,0,0,17,32,0.4201610415604081,[-3.28093694]
2020,8,NCAAF_20201024_GAS@CSTCAR,C. Carolina,Chanticleers,Ga. Southern,Eagles,5-0,3-2,0,14,14,28,14,7,7,0,14,7,7,0,0,2,0,14,0.3616567537662817,[-5.76510842]
2020,8,NCAAF_20201024_KANSAS@KSTATE,Kansas State,Wildcats,Kansas,Jayhawks,4-1,0-5,0,34,7,55,14,7,27,21,0,0,7,0,7,4,27,41,0.8876458877432134,[19.77053264]
2020,8,NCAAF_20201024_MERCER@ARMY,Army,Black Knights,Mercer,Bears,6-1,0-2,0,21,3,49,3,7,14,21,7,3,0,0,0,6,18,46,0.8917111547472975,[20.12187971]
2020,8,NCAAF_20201024_NCST@UNC,North Carolina,Tar Heels,NC State,Wolfpack,4-1,4-2,0,17,7,48,21,7,10,21,10,0,7,7,7,0,10,27,0.40664620738911694,[-3.8459814]
2020,8,NCAAF_20201024_NEB@OHIOST,Ohio State,Buckeyes,Nebraska,Cornhuskers,1-0,0-1,0,24,14,52,17,14,10,14,14,7,7,3,0,1,10,35,0.9658356350826872,[29.68311638]
2020,8,NCAAF_20201024_OKLA@TCU,TCU,Horned Frogs,Oklahoma,Sooners,1-3,3-2,0,7,17,14,33,0,7,0,7,10,7,10,6,-2,-10,-19,0.24177131846999833,[-11.40887397]
2020,8,NCAAF_20201024_RUT@MICHST,Michigan St.,Spartans,Rutgers,Scarlet Knights,0-1,1-0,0,13,28,27,38,7,6,7,7,14,14,0,10,-1,-15,-11,0.8995933524068285,[20.83118588]
2020,8,NCAAF_20201024_TEMPLE@MEMP,Memphis,Tigers,Temple,Owls,3-1,1-2,0,10,15,41,29,7,3,17,14,3,12,7,7,2,-5,12,0.7005775884678904,[8.56643206]
2020,8,NCAAF_20201024_UTEP@CHARLO,Charlotte,49ers,UTEP,Miners,2-2,3-3,0,14,14,38,28,7,7,7,17,7,7,0,14,-1,0,10,0.7644605873516955,[11.73632614]
2020,8,NCAAF_20201024_USM@LIB,Liberty,Flames,So. Miss,Golden Eagles,6-0,1-4,0,35,7,56,35,14,21,7,14,7,0,21,7,5,28,21,0.45509341079061794,[-1.83688908]
2020,8,NCAAF_20201024_TULANE@UCF,UCF,Knights,Tulane,Green Wave,3-2,2-4,1,37,14,51,34,10,27,14,0,14,0,14,6,1,23,17,0.8423220417956265,[16.34996247]
2020,8,NCAAF_20201024_FAU@MRSHL,Marshall,Thundering Herd,FAU,Owls,5-0,1-1,1,7,6,20,9,7,0,10,3,0,6,3,0,4,1,11,0.38061331823558986,[-4.9482435]
2020,8,NCAAF_20201024_BAMA@TENN,Tennessee,Volunteers,Alabama,Crimson Tide,2-3,5-0,0,10,28,17,48,0,10,7,0,14,14,14,6,-3,-18,-31,0.026586076609482534,[-31.48555701]
2020,8,NCAAF_20201024_BAYLOR@TEXAS,Texas,Longhorns,Baylor,Bears,3-2,1-2,0,13,3,27,16,0,13,14,0,3,0,0,13,2,10,11,0.7190220257349965,[9.44375645]
2020,8,NCAAF_20201024_HOU@NAVY,Navy,Midshipmen,Houston,Cougars,3-3,2-1,0,13,16,21,37,7,6,0,8,3,13,7,14,1,-3,-16,0.47390708679025395,[-1.06582322]
2020,8,NCAAF_20201024_IOWA@PURDUE,Purdue,Boilermakers,Iowa,Hawkeyes,1-0,0-1,0,14,17,24,20,7,7,0,10,0,17,0,3,1,-3,4,0.26935315583845787,[-10.01095891]
2020,8,NCAAF_20201024_IOWAST@OKLAST,Oklahoma State,Cowboys,Iowa St.,Cyclones,4-0,3-2,1,14,7,24,21,7,7,7,3,7,0,7,7,1,7,3,0.48637030353983546,[-0.55644636]
2020,8,NCAAF_20201024_ND@PITT,Pittsburgh,Panthers,Notre Dame,Fighting Irish,3-4,5-0,0,3,28,3,45,3,0,0,0,7,21,17,0,-2,-25,-42,0.15802478301704936,[-16.32654404]
2020,8,NCAAF_20201024_VATECH@WAKE,Wake Forest,Demon Deacons,Virginia Tech,Hokies,3-2,3-2,0,17,10,23,16,10,7,3,3,0,10,3,3,0,7,7,0.4455341985161002,[-2.23014149]
2020,8,NCAAF_20201024_GAST@TROY,Troy,Trojans,Georgia St.,Panthers,3-2,2-2,0,21,13,34,36,7,14,0,13,7,6,20,3,1,8,-2,0.7313723520603342,[10.04675682]
2020,8,NCAAF_20201024_GATECH@BC,Boston College,Eagles,Georgia Tech,Yellow Jackets,4-2,2-4,0,34,14,48,27,14,20,14,0,0,14,7,6,2,20,21,0.5824740889156605,[3.39077887]
2020,8,NCAAF_20201024_TNCHAT@WKY,W. Kentucky,Hilltoppers,Chattanooga,Mocs,2-4,0-1,0,3,7,13,10,3,0,3,7,7,0,3,0,2,-4,3,0.8592243034297822,[17.53533961]
2020,8,NCAAF_20201024_UK@MIZZOU,Missouri,Tigers,Kentucky,Wildcats,2-2,2-3,0,10,3,20,10,0,10,7,3,0,3,0,7,0,7,10,0.557204117415594,[2.3430219]
2020,8,NCAAF_20201024_WVU@TXTECH,Texas Tech,Red Raiders,West Virginia,Mountaineers,2-3,3-2,0,20,13,34,27,13,7,7,7,7,6,14,0,-1,7,7,0.4482938531562233,[-2.11648974]
2020,8,NCAAF_20201024_LAMON@SALA,South Alabama,Jaguars,UL-Monroe,Warhawks,3-2,0-6,1,17,6,38,14,17,0,14,7,0,6,0,8,3,11,24,0.43654955829459996,[-2.60094224]
2020,8,NCAAF_20201024_SC@LSU,LSU,Tigers,South Carolina,Gamecocks,2-2,2-3,1,31,10,52,24,10,21,14,7,7,3,7,7,0,21,28,0.8016053664974373,[13.7986133]
2020,8,NCAAF_20201024_UTAHST@BOISE,Boise St.,Broncos,Utah St.,Aggies,1-0,0-1,1,28,0,42,13,7,21,0,14,0,0,7,6,1,28,29,0.6351808611852727,[5.62788074]
2020,8,NCAAF_20201024_HAWAII@FRESNO,Fresno St.,Bulldogs,Hawaii,Rainbow Warriors,0-1,1-0,0,13,17,19,34,7,6,3,3,7,10,7,10,-1,-4,-15,0.833755850925594,[15.78111045]
2020,8,NCAAF_20201024_MD@NWEST,Northwestern,Wildcats,Maryland,Terrapins,1-0,0-1,0,30,3,43,3,14,16,7,6,3,0,0,0,1,27,40,0.6762760513284781,[7.44687104]
2020,8,NCAAF_20201024_MICH@MINN,Minnesota,Golden Gophers,Michigan,Wolverines,0-1,1-0,0,17,35,24,49,10,7,7,0,21,14,7,7,-1,-18,-25,0.1805424923659058,[-14.87222519]
2020,8,NCAAF_20201024_LATECH@TXSA,UTSA,Roadrunners,Louisiana Tech,Bulldogs,4-3,3-3,0,6,19,27,26,3,3,7,14,3,16,7,0,1,-13,1,0.26995922734012345,[-9.98109126]
2020,8,NCAAF_20201024_UVA@MIAMI,Miami (Fla.),Hurricanes,Virginia,Cavaliers,5-1,1-4,1,10,7,19,14,7,3,3,6,7,0,0,7,4,3,5,0.6765998956593432,[7.46154986]
2020,8,NCAAF_20201024_CINCY@SMU,SMU,Mustangs,Cincinnati,Bearcats,5-1,4-0,1,10,14,13,42,0,10,0,3,14,0,14,14,1,-4,-29,0.49264681420595213,[-0.30015995]
2020,8,NCAAF_20201024_TXSTSM@BYU,BYU,Cougars,Texas St.,Bobcats,6-0,1-6,0,35,7,52,14,14,21,14,3,7,0,0,7,5,28,38,0.9289497452955444,[23.90522184]
2020,8,NCAAF_20201024_AF@SJST,San Jose St.,Spartans,Air Force,Falcons,1-0,1-1,1,0,0,17,6,0,0,14,3,0,0,0,6,0,0,11,0.10924582075576605,[-20.03833078]
2020,8,NCAAF_20201024_UNLV@SDGST,San Diego St.,Aztecs,UNLV,Rebels,1-0,0-1,1,27,0,34,6,7,20,0,7,0,0,6,0,1,27,28,0.8254116988397713,[15.24493463]
2020,8,NCAAF_20201023_JAXST@FIU,FIU,Panthers,Jacksonville St.,Gamecocks,0-3,3-1,1,3,13,10,19,3,0,7,0,3,10,3,3,-3,-10,-9,0.741273464208114,[10.54028738]
2020,8,NCAAF_20201023_TULSA@SFLA,South Florida,Bulls,Tulsa,Golden Hurricane,1-5,2-1,1,6,21,13,42,6,0,7,0,7,14,21,0,-1,-15,-29,0.5236447126403232,[0.9656976]
2020,8,NCAAF_20201023_ILL@WISC,Wisconsin,Badgers,Illinois,Fighting Illini,1-0,0-1,0,28,7,45,7,7,21,0,17,0,7,0,0,1,21,38,0.9536471616561847,[27.37830364]
2020,8,NCAAF_20201023_LALAF@UAB,UAB,Blazers,Louisiana,Ragin' Cajuns,4-2,4-1,1,13,10,20,24,3,10,7,0,0,10,7,7,0,3,-4,0.4694075219816526,[-1.2499527]
2020,8,NCAAF_20201022_ARKST@APLST,App. St.,Mountaineers,Arkansas St.,Red Wolves,3-1,3-3,0,31,7,45,17,14,17,7,7,7,0,10,0,0,24,28,0.7251989488102101,[9.74367236]
2020,9,NCAAF_20201031_BC@CLEM,Clemson,Tigers,Boston College,Eagles,7-0,4-3,0,13,28,34,28,7,6,13,8,14,14,0,0,3,-15,6,0.9549997121689016,[27.66504213]
2020,9,NCAAF_20201031_CSTCAR@GAST,Georgia St.,Panthers,C. Carolina,Chanticleers,2-3,6-0,1,0,34,0,51,0,0,0,0,7,27,14,3,-4,-34,-51,0.492687553399063,[-0.29911451]
2020,9,NCAAF_20201031_IOWAST@KANSAS,Kansas,Jayhawks,Iowa St.,Cyclones,0-6,4-2,1,7,20,22,52,0,7,7,8,13,7,15,17,-4,-13,-30,0.06387412797195191,[-24.85262892]
2020,9,NCAAF_20201031_KSTATE@WVU,West Virginia,Mountaineers,Kansas State,Wildcats,4-2,4-2,0,24,10,37,10,3,21,10,3,3,7,0,0,0,14,27,0.4609293679978175,[-1.600652]
2020,9,NCAAF_20201031_MEMP@CINCY,Cincinnati,Bearcats,Memphis,Tigers,5-0,3-2,1,21,10,49,10,7,14,14,14,7,3,0,0,2,11,39,0.3801467702243314,[-4.97847231]
2020,9,NCAAF_20201031_MICHST@MICH,Michigan,Wolverines,Michigan St.,Spartans,1-1,1-1,0,10,14,24,27,7,3,7,7,7,7,6,7,0,-4,-3,0.8297945152217955,[15.55659366]
2020,9,NCAAF_20201031_PURDUE@ILL,Illinois,Fighting Illini,Purdue,Boilermakers,0-2,2-0,1,10,17,24,31,0,10,0,14,7,10,14,0,-2,-7,-7,0.1788931093603241,[-15.00567432]
2020,9,NCAAF_20201031_TEMPLE@TULANE,Tulane,,Temple,,3-4,1-3,,10,3,38,3,0,10,14,14,3,0,0,0,2,7,35,0.48663102314841533,[-0.54692772]
2020,9,NCAAF_20201031_TXSA@FAU,FAU,,UTSA,,2-1,4-4,,17,3,24,3,10,7,0,7,0,3,0,0,-2,14,21,0.8876092910371769,[19.80832002]
2020,9,NCAAF_20201031_UGA@UK,Kentucky,Wildcats,Georgia,Bulldogs,2-4,4-1,1,3,7,3,14,0,3,0,0,7,0,7,0,-2,-4,-11,0.12985605661414312,[-18.39128676]
2020,9,NCAAF_20201031_WAKE@CUSE,Syracuse,Orange,Wake Forest,Demon Deacons,1-6,4-2,0,7,17,14,38,0,7,0,7,10,7,21,0,-3,-10,-24,0.38330405709038595,[-4.84334799]
2020,9,NCAAF_20201031_UCF@HOU,Houston,,UCF,,2-2,4-2,,7,23,21,44,7,0,6,8,10,13,0,21,-2,-16,-23,0.193985397660826,[-14.08717349]
2020,9,NCAAF_20201031_RICE@USM,So. Miss,,Rice,,1-5,1-1,,6,23,6,30,0,6,0,0,3,20,0,7,0,-17,-24,0.8001612218798727,[13.74277188]
2020,9,NCAAF_20201031_TROY@ARKST,Arkansas St.,,Troy,,3-4,4-2,,3,24,10,38,0,3,7,0,14,10,0,14,-1,-21,-28,0.48912317837441066,[-0.44494494]
2020,9,NCAAF_20201031_IND@RUT,Rutgers,Scarlet Knights,Indiana,Hoosiers,1-1,2-0,1,7,20,21,37,7,0,8,6,3,17,10,7,-1,-13,-16,0.14971830329380664,[-16.93199761]
2020,9,NCAAF_20201031_LSU@AUBURN,Auburn,Tigers,LSU,Tigers,4-2,2-3,1,21,3,48,11,0,21,21,6,0,3,0,8,2,18,37,0.4426532777067935,[-2.35376453]
2020,9,NCAAF_20201031_ND@GATECH,Georgia Tech,Yellow Jackets,Notre Dame,Fighting Irish,2-5,6-0,0,7,17,13,31,0,7,0,6,7,10,7,7,-4,-10,-18,0.10199456210451396,[-20.7279301]
2020,9,NCAAF_20201031_NWEST@IOWA,Iowa,Hawkeyes,Northwestern,Wildcats,0-2,2-0,0,20,14,20,21,17,3,0,0,0,14,7,0,-2,6,-1,0.7620700711478977,[11.63419052]
2020,9,NCAAF_20201031_TCU@BAYLOR,Baylor,Bears,TCU,Horned Frogs,1-3,2-3,0,7,30,23,33,0,7,7,9,20,10,3,0,-1,-23,-10,0.3268990963530035,[-7.31838371]
2020,9,NCAAF_20201031_APLST@LAMON,UL-Monroe,,App. St.,,0-7,4-1,,7,21,13,31,0,7,0,6,14,7,7,3,-4,-14,-18,0.07872625236078767,[-23.06827742]
2020,9,NCAAF_20201031_MISS@VANDY,Vanderbilt,Commodores,Ole Miss,Rebels,0-4,2-4,0,14,33,21,54,0,14,0,7,21,12,21,0,-2,-19,-33,0.3277736548947028,[-7.2788487]
2020,9,NCAAF_20201031_VATECH@LVILLE,Louisville,Cardinals,Virginia Tech,Hokies,2-5,4-2,1,14,21,35,42,0,14,0,21,14,7,7,14,-2,-7,-7,0.31750924674365666,[-7.74563572]
2020,9,NCAAF_20201031_BOISE@AF,Air Force,Falcons,Boise St.,Broncos,1-2,2-0,0,17,28,30,49,14,3,0,13,7,21,7,14,-1,-11,-19,0.27128060799092135,[-9.93661002]
2020,9,NCAAF_20201031_CHARLO@DUKE,Duke,Blue Devils,Charlotte,49ers,2-5,2-3,1,24,7,53,19,17,7,13,16,0,7,6,6,0,17,34,0.8804389561334929,[19.20900453]
2020,9,NCAAF_20201031_MISSST@BAMA,Alabama,Crimson Tide,Miss. State,Bulldogs,6-0,1-4,1,27,0,41,0,17,10,0,14,0,0,0,0,5,27,41,0.8958604862792721,[20.53282848]
2020,9,NCAAF_20201031_NMEX@SJST,San Jose St.,Spartans,New Mexico,Lobos,2-0,0-1,0,21,14,38,21,7,14,10,7,0,14,7,0,2,7,17,0.4713080190668635,[-1.17458893]
2020,9,NCAAF_20201031_ARK@TXAM,Texas A&M,Aggies,Arkansas,Razorbacks,4-1,2-3,1,28,14,42,31,14,14,14,0,7,7,3,14,2,14,11,0.8484652539437704,[16.80522436]
2020,9,NCAAF_20201031_MIZZOU@FLA,Florida,Gators,Missouri,Tigers,3-1,2-3,0,20,7,41,17,6,14,14,7,0,7,0,10,1,13,24,0.5904167010712345,[3.73051743]
2020,9,NCAAF_20201031_NAVY@SMU,SMU,Mustangs,Navy,Midshipmen,6-1,3-4,1,31,17,51,37,0,31,14,6,7,10,0,20,3,14,14,0.5503805093695529,[2.06619973]
2020,9,NCAAF_20201031_OHIOST@PSU,Penn State,Nittany Lions,Ohio State,Buckeyes,0-2,2-0,0,6,21,25,38,3,3,7,12,14,7,10,7,-2,-15,-13,0.3324040891408857,[-7.07023034]
2020,9,NCAAF_20201031_LALAF@TXSTSM,Texas St.,,Louisiana,,1-7,5-1,,21,34,34,44,14,7,6,7,14,20,3,7,-4,-13,-10,0.15258428665280244,[-16.73243498]
2020,9,NCAAF_20201031_OKLA@TXTECH,Texas Tech,Red Raiders,Oklahoma,Sooners,2-4,4-2,1,14,48,28,62,7,7,0,14,21,27,7,7,-2,-34,-34,0.1496925443007584,[-16.93380274]
2020,9,NCAAF_20201031_UNC@UVA,Virginia,Cavaliers,North Carolina,Tar Heels,2-4,4-2,0,27,20,44,41,13,14,14,3,10,10,7,14,-2,7,3,0.549834233589949,[2.04367777]
2020,9,NCAAF_20201031_SDGST@UTAHST,Utah St.,Aggies,San Diego St.,Aztecs,0-2,2-0,0,7,10,7,38,0,7,0,0,7,3,14,14,-2,-3,-31,0.5430030578723678,[1.76235519]
2020,9,NCAAF_20201031_WKY@BYU,BYU,Cougars,W. Kentucky,Hilltoppers,7-0,2-5,1,35,3,41,10,14,21,3,3,3,0,7,0,5,32,31,0.8028631807697033,[13.9009803]
2020,9,NCAAF_20201031_NEVADA@UNLV,UNLV,Rebels,Nevada,Wolf Pack,0-2,2-0,0,12,24,19,37,3,9,7,0,10,14,3,10,-2,-12,-18,0.39778458269305417,[-4.22769708]
2020,9,NCAAF_20201030_ECU@TULSA,Tulsa,Golden Hurricane,East Carolina,Pirates,3-1,1-4,0,3,17,34,30,3,0,17,14,7,10,3,10,2,-14,4,0.7420260982909397,[10.60008788]
2020,9,NCAAF_20201030_HAWAII@WYO,Wyoming,Cowboys,Hawaii,Rainbow Warriors,1-1,1-1,1,10,7,31,7,10,0,7,14,0,7,0,0,0,3,24,0.7076637657436903,[8.91883842]
2020,9,NCAAF_20201029_SALA@GAS,Ga. Southern,Eagles,South Alabama,Jaguars,4-2,3-3,0,10,10,24,17,0,10,0,14,3,7,7,0,1,0,7,0.7253463566969902,[9.77104918]
2020,9,NCAAF_20201029_COLOST@FRESNO,Fresno St.,Bulldogs,Colorado St.,Rams,1-1,0-1,0,24,10,38,17,7,17,7,7,3,7,0,7,1,14,21,0.7247906086629383,[9.74386776]
2020,10,NCAAF_20201107_ARIZST@USC,USC,Trojans,Arizona St.,Sun Devils,1-0,0-1,0,14,17,28,27,7,7,0,14,3,14,7,3,1,-3,1,0.6215805899035032,[5.07292609]
2020,10,NCAAF_20201107_ARKST@LALAF,Louisiana,Ragin' Cajuns,Arkansas St.,Red Wolves,6-1,3-5,0,0,6,27,20,0,0,14,13,3,3,0,14,3,-6,7,0.5206769697862585,[0.84953332]
2020,10,NCAAF_20201107_LAMON@GAST,Georgia St.,,UL-Monroe,,3-3,0-8,,42,14,52,34,21,21,3,7,7,7,6,14,3,28,18,0.5473290331920282,[1.94827014]
2020,10,NCAAF_20201107_LIB@VATECH,Virginia Tech,Hokies,Liberty,Flames,4-3,7-0,0,20,14,35,38,3,17,0,15,7,7,7,17,-3,6,-3,0.8662684169838748,[18.16814617]
2020,10,NCAAF_20201107_MICH@IND,Indiana,Hoosiers,Michigan,Wolverines,3-0,1-2,0,24,7,38,21,14,10,7,7,7,0,7,7,2,17,17,0.14331867234617235,[-17.45716121]
2020,10,NCAAF_20201107_MICHST@IOWA,Iowa,Hawkeyes,Michigan St.,Spartans,1-2,1-2,1,35,0,49,7,14,21,7,7,0,0,7,0,0,35,42,0.716300730897204,[9.36956068]
2020,10,NCAAF_20201107_NEB@NWEST,Northwestern,Wildcats,Nebraska,Cornhuskers,3-0,0-2,0,7,13,21,13,7,0,7,7,0,13,0,0,3,-6,8,0.5955400115085294,[3.96187208]
2020,10,NCAAF_20201107_SFLA@MEMP,Memphis,,South Florida,,4-2,1-6,,13,27,34,33,6,7,7,14,3,24,3,3,3,-14,1,0.7972895453373126,[13.6307977]
2020,10,NCAAF_20201107_SMU@TEMPLE,Temple,Owls,SMU,Mustangs,1-4,7-1,1,13,10,23,47,13,0,3,7,7,3,10,27,-6,3,-24,0.4265132725221883,[-3.03519349]
2020,10,NCAAF_20201107_TULANE@ECU,East Carolina,,Tulane,,1-5,4-4,,7,21,21,38,7,0,0,14,7,14,10,7,-3,-14,-17,0.16069798367779997,[-16.24585554]
2020,10,NCAAF_20201107_UNC@DUKE,Duke,Blue Devils,North Carolina,Tar Heels,2-6,5-2,0,10,42,24,56,0,10,7,7,21,21,7,7,-3,-32,-32,0.5046711791068337,[0.19183833]
2020,10,NCAAF_20201107_WVU@TEXAS,Texas,Longhorns,West Virginia,Mountaineers,5-2,4-3,1,10,7,17,13,7,3,7,0,7,0,6,0,1,3,4,0.6214150470440651,[5.0657943]
2020,10,NCAAF_20201107_TROY@GAS,Ga. Southern,,Troy,,5-2,4-3,,6,10,20,13,0,6,14,0,0,10,3,0,1,-4,7,0.3779821584444094,[-5.09176807]
2020,10,NCAAF_20201107_BC@CUSE,Syracuse,,Boston College,,1-7,5-3,,3,10,13,16,0,3,3,7,3,7,0,6,-4,-7,-3,0.39338366352497967,[-4.43193705]
2020,10,NCAAF_20201107_UMASS@MRSHL,Marshall,Thundering Herd,UMass,Minutemen,6-0,0-2,1,31,10,51,10,14,17,13,7,7,3,0,0,6,21,41,0.919418173143969,[22.95616911]
2020,10,NCAAF_20201107_APLST@TXSTSM,Texas St.,,App. St.,,1-8,5-1,,10,24,17,38,7,3,0,7,14,10,0,14,-4,-14,-21,0.05151168159876962,[-26.71130666]
2020,10,NCAAF_20201107_NAL@USM,So. Miss,,North Alabama,,2-5,0-3,,7,10,24,13,0,7,0,17,7,3,3,0,2,-3,11,0.8923530449396894,[20.30154764]
2020,10,NCAAF_20201107_FLA@UGA,Georgia,Bulldogs,Florida,Gators,4-2,4-1,1,21,38,28,44,14,7,7,0,14,24,3,3,0,-17,-16,0.7576604788546089,[11.44879832]
2020,10,NCAAF_20201107_FRESNO@UNLV,UNLV,Rebels,Fresno St.,Bulldogs,0-3,2-1,0,17,20,27,40,7,10,10,0,6,14,7,13,-2,-3,-13,0.1299452380755467,[-18.45856965]
2020,10,NCAAF_20201107_HOU@CINCY,Cincinnati,Bearcats,Houston,Cougars,6-0,2-3,0,28,10,38,10,7,21,3,7,0,10,0,0,4,18,28,0.5861758587804335,[3.56701364]
2020,10,NCAAF_20201107_KANSAS@OKLA,Oklahoma,Sooners,Kansas,Jayhawks,5-2,0-7,0,31,3,62,9,14,17,10,21,0,3,0,6,5,28,53,0.9834144614486673,[34.89714827]
2020,10,NCAAF_20201107_MD@PSU,Penn State,,Maryland,,0-3,2-1,,7,28,19,35,0,7,0,12,14,14,7,0,-2,-21,-16,0.9590967578864772,[28.51234557]
2020,10,NCAAF_20201107_MINN@ILL,Illinois,Fighting Illini,Minnesota,Golden Gophers,0-3,1-2,0,7,28,14,41,0,7,0,7,7,21,7,6,-1,-21,-27,0.1969552097296181,[-13.96778285]
2020,10,NCAAF_20201107_TXTECH@TCU,TCU,Horned Frogs,Texas Tech,Red Raiders,3-3,2-5,0,10,3,34,18,3,7,17,7,0,3,7,8,1,7,16,0.6335731671881688,[5.59224265]
2020,10,NCAAF_20201107_VANDY@MISSST,Miss. State,Bulldogs,Vanderbilt,Commodores,2-4,0-5,0,17,0,24,17,14,3,0,7,0,0,7,10,2,17,7,0.8478293167495474,[16.82869693]
2020,10,NCAAF_20201107_OKLAST@KSTATE,Kansas State,Wildcats,Oklahoma State,Cowboys,4-3,5-1,0,12,0,18,20,3,9,0,6,0,0,13,7,-1,12,-2,0.38871832287742514,[-4.63100277]
2020,10,NCAAF_20201107_PITT@FSU,Florida State,,Pittsburgh,,2-5,4-4,,17,24,17,41,14,3,0,0,10,14,7,10,-2,-7,-24,0.46088024369965297,[-1.60913644]
2020,10,NCAAF_20201107_WKY@FAU,FAU,,W. Kentucky,,3-1,2-6,,0,0,10,6,0,0,3,7,0,0,3,3,1,0,4,0.8043330699224689,[14.04402629]
2020,10,NCAAF_20201107_BAYLOR@IOWAST,Iowa St.,Cyclones,Baylor,Bears,5-2,1-4,1,10,21,38,31,0,10,21,7,14,7,3,7,4,-11,7,0.7227334864621143,[9.6823921]
2020,10,NCAAF_20201107_TXAM@SC,South Carolina,Gamecocks,Texas A&M,Aggies,2-4,5-1,1,0,21,3,48,0,0,0,3,7,14,13,14,-3,-21,-45,0.41635917625435304,[-3.46048371]
2020,10,NCAAF_20201107_UCLA@COLO,Colorado,Buffaloes,UCLA,Bruins,1-0,0-1,1,35,14,48,42,14,21,10,3,7,7,21,7,1,21,6,0.4690677307323513,[-1.27158845]
2020,10,NCAAF_20201107_RUT@OHIOST,Ohio State,Buckeyes,Rutgers,Scarlet Knights,3-0,1-2,0,35,3,49,27,7,28,7,7,3,0,6,18,2,32,22,0.996632067742166,[44.39343317]
2020,10,NCAAF_20201107_STNFRD@OREG,Oregon,Ducks,Stanford,Cardinal,1-0,0-1,0,14,7,35,14,7,7,14,7,7,0,0,7,1,7,21,0.6404429507554958,[5.89224317]
2020,10,NCAAF_20201107_TENN@ARK,Arkansas,Razorbacks,Tennessee,Volunteers,3-3,2-4,0,0,13,24,13,0,0,24,0,3,10,0,0,1,-13,11,0.32824331721742994,[-7.2869134]
2020,10,NCAAF_20201107_SALA@CSTCAR,C. Carolina,Chanticleers,South Alabama,Jaguars,7-0,3-4,0,17,6,23,6,14,3,0,6,3,3,0,0,4,11,17,0.6449427077818219,[6.08981565]
2020,10,NCAAF_20201107_WASHST@OREGST,Oregon State,Beavers,Washington St.,Cougars,0-1,1-0,0,7,14,28,38,0,7,7,14,7,7,14,10,-1,-7,-10,0.0899104242464337,[-21.97541835]
2020,10,NCAAF_20201107_NMEX@HAWAII,Hawaii,,New Mexico,,2-1,0-2,,14,20,39,33,7,7,14,11,17,3,7,6,2,-6,6,0.6514135084532967,[6.37550051]
2020,10,NCAAF_20201106_MIAMI@NCST,NC State,Wolfpack,Miami (Fla.),Hurricanes,4-3,6-1,1,24,21,41,44,14,10,14,3,14,7,10,13,-2,3,-3,0.3405298141891715,[-6.73394293]
2020,10,NCAAF_20201106_SJST@SDGST,San Diego St.,Aztecs,San Jose St.,Spartans,2-1,3-0,0,10,7,17,28,3,7,0,7,0,7,7,14,-1,3,-11,0.8908927973858698,[20.1729484]
2020,10,NCAAF_20201106_BYU@BOISE,Boise St.,Broncos,BYU,Cougars,2-1,8-0,1,3,16,17,51,3,0,0,14,7,9,22,13,-6,-13,-34,0.6994128612221006,[8.56390753]
2020,10,NCAAF_20201105_UTAHST@NEVADA,Nevada,Wolf Pack,Utah St.,Aggies,3-0,0-3,1,21,9,34,9,7,14,10,3,9,0,0,0,3,12,25,0.22826588413662074,[-12.19872632]
2020,10,NCAAF_20201105_WYO@COLOST,Colorado St.,Rams,Wyoming,Cowboys,1-1,1-2,1,24,14,34,24,14,10,7,3,0,14,3,7,0,10,10,0.37777491227836624,[-5.10070104]
2020,10,NCAAF_20201104_EMICH@KENTST,Kent St.,,E. Michigan,,1-0,0-1,,20,9,27,23,13,7,0,7,9,0,6,8,1,11,4,0.2110077516060347,[-13.15486536]
2020,10,NCAAF_20201104_WMICH@AKRON,Akron,,W. Michigan,,0-1,1-0,,13,30,13,58,7,6,0,0,16,14,21,7,-1,-17,-45,0.18550832177439924,[-14.65627683]
2020,10,NCAAF_20201104_BALLST@MIAOH,Miami-OH,RedHawks,Ball St.,Cardinals,1-0,0-1,1,10,14,38,31,0,10,14,14,7,7,7,10,1,-4,7,0.7412281418767475,[10.60241478]
2020,10,NCAAF_20201104_BUFF@NILL,N. Illinois,Huskies,Buffalo,Bulls,0-1,1-0,1,16,21,30,49,3,13,0,14,14,7,21,7,-1,-5,-19,0.4390306476120396,[-2.51369009]
2020,10,NCAAF_20201104_OHIO@CMICH,C. Michigan,Chippewas,Ohio,Bobcats,1-0,0-1,1,20,20,30,27,14,6,7,3,7,13,7,0,1,0,3,0.28068993177296275,[-9.51547574]
2020,10,NCAAF_20201104_BGREEN@TOLEDO,Toledo,,Bowling Green,,1-0,0-1,,21,0,38,3,21,0,7,10,0,0,3,0,1,21,35,0.8855585540688766,[19.71341215]
2020,11,NCAAF_20201115_CAL@UCLA,UCLA,Bruins,California,Golden Bears,1-1,0-1,1,27,10,34,10,7,20,0,7,3,7,0,0,1,17,24,0.42833379891669754,[-2.97158462]
2020,11,NCAAF_20201114_ARMY@TULANE,Tulane,Green Wave,Army,Black Knights,5-4,6-2,0,14,12,38,12,14,0,10,14,0,12,0,0,-1,2,26,0.5087903721708612,[0.36254335]
2020,11,NCAAF_20201114_IND@MICHST,Michigan St.,Spartans,Indiana,Hoosiers,1-3,4-0,0,0,24,0,24,0,0,0,0,14,10,0,0,-3,-24,-24,0.5273622122587118,[1.12930088]
2020,11,NCAAF_20201114_MIAMI@VATECH,Virginia Tech,Hokies,Miami (Fla.),Hurricanes,4-4,7-1,1,14,13,24,25,7,7,10,0,3,10,6,6,-3,1,-1,0.40963833109378656,[-3.75895463]
2020,11,NCAAF_20201114_MTSU@MRSHL,Marshall,Thundering Herd,Middle Tenn.,Blue Raiders,7-0,2-6,1,21,7,42,14,7,14,21,0,0,7,7,0,5,14,28,0.6583394608373254,[6.71149124]
2020,11,NCAAF_20201114_PSU@NEB,Nebraska,Cornhuskers,Penn State,Nittany Lions,1-2,0-4,1,27,6,30,23,10,17,0,3,0,6,10,7,1,21,7,0.09271504276994236,[-21.78650906]
2020,11,NCAAF_20201114_TCU@WVU,West Virginia,Mountaineers,TCU,Horned Frogs,5-3,3-4,0,14,3,24,6,7,7,3,7,0,3,3,0,2,11,18,0.4231406479273544,[-3.1895385]
2020,11,NCAAF_20201114_VANDY@UK,Kentucky,Wildcats,Vanderbilt,Commodores,3-4,0-6,1,24,14,38,35,14,10,7,7,0,14,7,14,3,10,3,0.7855332517367273,[13.01409451]
2020,11,NCAAF_20201114_WAKE@UNC,North Carolina,Tar Heels,Wake Forest,Demon Deacons,6-2,4-3,1,24,35,59,53,17,7,7,28,14,21,10,8,2,-11,6,0.41244919857239193,[-3.64006652]
2020,11,NCAAF_20201114_WCAR@LIB,Liberty,Flames,W. Carolina,Catamounts,8-0,0-1,0,28,7,58,14,7,21,14,16,0,7,7,0,8,21,44,0.9385576609617271,[25.38230169]
2020,11,NCAAF_20201114_ILL@RUT,Rutgers,Scarlet Knights,Illinois,Fighting Illini,1-3,1-3,1,13,7,20,23,10,3,7,0,0,7,10,6,0,6,-3,0.38867972945627083,[-4.65209201]
2020,11,NCAAF_20201114_SALA@LALAF,Louisiana,Ragin' Cajuns,South Alabama,Jaguars,7-1,3-5,0,28,10,38,10,14,14,3,7,3,7,0,0,4,18,28,0.8088940007966643,[14.37651071]
2020,11,NCAAF_20201114_FRESNO@UTAHST,Utah St.,Aggies,Fresno St.,Bulldogs,0-4,3-1,0,16,28,16,35,13,3,0,0,7,21,0,7,-3,-12,-19,0.4485087990041221,[-2.12942209]
2020,11,NCAAF_20201114_GAST@APLST,App. St.,Mountaineers,Georgia St.,Panthers,6-1,3-4,0,3,10,17,13,3,0,7,7,7,3,0,3,3,-7,4,0.8925591342156973,[20.4050648]
2020,11,NCAAF_20201114_UTEP@TXSA,UTSA,Roadrunners,UTEP,Miners,5-4,3-4,1,24,21,52,21,3,21,14,14,7,14,0,0,2,3,31,0.733288455585524,[10.24633702]
2020,11,NCAAF_20201114_COLO@STNFRD,Stanford,Cardinal,Colorado,Buffaloes,0-2,2-0,1,9,14,32,35,3,6,7,16,7,7,14,7,-2,-5,-3,0.7067433557062185,[8.94835441]
2020,11,NCAAF_20201114_LVILLE@UVA,Virginia,Cavaliers,Louisville,Cardinals,3-4,2-6,1,14,10,31,17,7,7,7,10,3,7,7,0,1,4,14,0.5987352985098097,[4.11431704]
2020,11,NCAAF_20201114_ND@BC,Boston College,Eagles,Notre Dame,Fighting Irish,5-4,8-0,0,16,31,31,45,10,6,7,8,10,21,7,7,-3,-15,-14,0.1662669719771721,[-15.94268542]
2020,11,NCAAF_20201114_SFLA@HOU,Houston,Cougars,South Florida,Bulls,3-3,1-7,1,28,0,56,21,14,14,14,14,0,0,7,14,2,28,35,0.6516294045483425,[6.41185852]
2020,11,NCAAF_20201114_TXSTSM@GAS,Ga. Southern,Eagles,Texas St.,Bobcats,6-2,1-9,0,27,21,40,38,17,10,3,10,7,14,7,10,5,6,2,0.7726782987520191,[12.30135048]
2020,11,NCAAF_20201114_USC@ARIZ,Arizona,Wildcats,USC,Trojans,0-1,2-0,1,13,17,30,34,7,6,7,10,10,7,3,14,-2,-4,-4,0.26631580678867384,[-10.2661574]
2020,11,NCAAF_20201114_USM@WKY,W. Kentucky,Hilltoppers,So. Miss,Golden Eagles,3-6,2-6,0,10,0,10,7,7,3,0,0,0,0,0,7,1,10,3,0.4529423605880307,[-1.94517432]
2020,11,NCAAF_20201114_BAYLOR@TXTECH,Texas Tech,Red Raiders,Baylor,Bears,3-5,1-5,0,6,13,24,23,3,3,6,12,7,6,10,0,2,-7,1,0.5366018357603145,[1.51157971]
2020,11,NCAAF_20201114_HAWAII@SDGST,San Diego St.,Aztecs,Hawaii,Rainbow Warriors,3-1,2-2,1,28,0,34,10,14,14,0,6,0,0,3,7,1,28,24,0.7833872049136174,[12.89343228]
2020,11,NCAAF_20201114_NWEST@PURDUE,Purdue,Boilermakers,Northwestern,Wildcats,2-1,4-0,0,10,17,20,27,3,7,3,7,7,10,7,3,-2,-7,-7,0.5431644483461863,[1.7835847]
2020,11,NCAAF_20201114_NEVADA@NMEX,New Mexico,Lobos,Nevada,Wolf Pack,0-3,4-0,1,13,10,20,27,7,6,0,7,0,10,10,7,-4,3,-7,0.2947794032368357,[-8.87563255]
2020,11,NCAAF_20201114_ARK@FLA,Florida,Gators,Arkansas,Razorbacks,5-1,3-4,1,35,14,63,35,7,28,7,21,7,7,7,14,2,21,28,0.8971595697172714,[20.82095094]
2020,11,NCAAF_20201114_OREG@WASHST,Washington St.,Cougars,Oregon,Ducks,1-1,2-0,1,19,14,29,43,13,6,0,10,7,7,7,22,-1,5,-14,0.3962586980378968,[-4.32767296]
2020,11,NCAAF_20201114_SMU@TULSA,Tulsa,Golden Hurricane,SMU,Mustangs,4-1,7-2,0,7,24,28,24,0,7,7,14,14,10,0,0,-3,-17,4,0.30619721202113004,[-8.33571711]
2020,11,NCAAF_20201114_FSU@NCST,NC State,Wolfpack,Florida State,Seminoles,5-3,2-6,1,21,3,38,22,7,14,14,3,0,3,6,13,3,18,16,0.5780592144562293,[3.23997441]
2020,11,NCAAF_20201114_SC@MISS,Ole Miss,Rebels,South Carolina,Gamecocks,3-4,2-5,0,24,21,59,42,14,10,14,21,7,14,14,7,1,3,17,0.442608975299282,[-2.37502293]
2020,11,NCAAF_20201114_TEMPLE@UCF,UCF,Knights,Temple,Owls,5-2,1-5,0,21,3,38,13,21,0,17,0,0,3,0,10,4,18,25,0.8538989470369098,[17.32929736]
2020,11,NCAAF_20201114_WISC@MICH,Michigan,Wolverines,Wisconsin,Badgers,1-3,2-0,0,0,28,11,49,0,0,11,0,14,14,7,14,-1,-28,-38,0.5087593263371458,[0.36126271]
2020,11,NCAAF_20201114_UNLV@SJST,San Jose St.,Spartans,UNLV,Rebels,4-0,0-4,1,24,10,34,17,10,14,7,3,3,7,7,0,4,14,17,0.44670342866929047,[-2.20452406]
2020,11,NCAAF_20201114_OREGST@WASH,Washington,Huskies,Oregon State,Beavers,1-0,0-2,1,24,21,27,21,10,14,0,3,7,14,0,0,1,3,6,0.9569827862667964,[28.24368857]
2020,11,NCAAF_20201113_FAU@FIU,FIU,Panthers,FAU,Owls,0-4,4-1,0,10,24,19,38,0,10,0,9,7,17,0,14,-4,-14,-19,0.25386536253103253,[-10.8976218]
2020,11,NCAAF_20201113_IOWA@MINN,Minnesota,Golden Gophers,Iowa,Hawkeyes,1-3,2-2,0,0,14,7,35,0,0,0,7,7,7,0,21,-1,-14,-28,0.27007993994531587,[-10.0782285]
2020,11,NCAAF_20201113_ECU@CINCY,Cincinnati,Bearcats,East Carolina,Pirates,7-0,1-6,0,35,10,55,17,7,28,7,13,0,10,0,7,6,25,38,0.9045368357102821,[21.51708537]
2020,11,NCAAF_20201112_COLOST@BOISE,Boise St.,Broncos,Colorado St.,Rams,3-1,1-2,0,42,7,52,21,21,21,10,0,0,7,14,0,2,35,31,0.8270247574209888,[15.50588485]
2020,11,NCAAF_20201111_EMICH@BALLST,Ball St.,Cardinals,E. Michigan,Eagles,1-1,0-2,1,13,21,38,31,7,6,8,17,14,7,3,7,1,-8,7,0.25006917103923176,[-11.09335176]
2020,11,NCAAF_20201111_CMICH@NILL,N. Illinois,Huskies,C. Michigan,Chippewas,0-2,2-0,1,0,9,10,40,0,0,0,10,7,2,17,14,-2,-9,-30,0.5939772967176655,[3.91217087]
2020,11,NCAAF_20201111_TOLEDO@WMICH,W. Michigan,Broncos,Toledo,Rockets,2-0,1-1,1,14,24,41,38,14,0,7,20,14,10,7,7,1,-10,3,0.481979891702219,[-0.74340023]
2020,11,NCAAF_20201110_AKRON@OHIO,Ohio,Bobcats,Akron,Zips,1-1,0-2,1,14,7,24,10,7,7,3,7,0,7,3,0,1,7,14,0.9023275748512576,[21.30460232]
2020,11,NCAAF_20201110_KENTST@BGREEN,Bowling Green,Falcons,Kent St.,Golden Flashes,0-2,2-0,0,10,38,24,62,10,0,0,14,10,28,7,17,-2,-28,-38,0.3717391961929368,[-5.38403631]
2020,11,NCAAF_20201110_MIAOH@BUFF,Buffalo,Bulls,Miami-OH,RedHawks,2-0,1-1,0,14,7,42,10,0,14,21,7,0,7,0,3,1,7,32,0.6458325665073714,[6.15470986]
2020,12,NCAAF_20201121_APLST@CSTCAR,C. Carolina,Chanticleers,App. St.,Mountaineers,8-0,6-2,0,9,17,34,23,6,3,12,13,7,10,3,3,2,-8,11,0.14491897351321847,[-17.43242294]
2020,12,NCAAF_20201121_ARKST@TXSTSM,Texas St.,Bobcats,Arkansas St.,Red Wolves,2-9,3-6,1,27,24,47,45,10,17,0,20,3,21,7,14,-1,3,2,0.18070635183244788,[-15.03118168]
2020,12,NCAAF_20201121_ECU@TEMPLE,Temple,Owls,East Carolina,Pirates,1-6,2-6,1,3,21,3,28,0,3,0,0,7,14,7,0,-1,-18,-25,0.8135846203039752,[14.67720525]
2020,12,NCAAF_20201121_FLA@VANDY,Vanderbilt,Commodores,Florida,Gators,0-7,6-1,1,10,17,17,38,10,0,7,0,7,10,14,7,-6,-7,-21,0.10915174230150071,[-20.27461362]
2020,12,NCAAF_20201121_GAS@ARMY,Army,Black Knights,Ga. Southern,Eagles,7-2,6-3,0,7,21,28,27,0,7,14,7,14,7,6,0,1,-14,1,0.7247508077388092,[9.83241919]
2020,12,NCAAF_20201121_ILL@NEB,Nebraska,Cornhuskers,Illinois,Fighting Illini,1-3,2-3,1,10,28,23,41,7,3,7,6,14,14,10,3,-1,-18,-18,0.7221010720984418,[9.70199955]
2020,12,NCAAF_20201121_IND@OHIOST,Ohio State,Buckeyes,Indiana,Hoosiers,4-0,4-1,0,28,7,42,35,7,21,14,0,0,7,14,14,0,21,7,0.9393274953664219,[25.51352642]
2020,12,NCAAF_20201121_LSU@ARK,Arkansas,Razorbacks,LSU,Tigers,3-5,3-3,1,14,20,24,27,7,7,7,3,3,17,0,7,0,-6,-3,0.05431263361408778,[-26.42346072]
2020,12,NCAAF_20201121_SFA@MEMP,Memphis,Tigers,S.F. Austin,Lumberjacks,5-2,6-4,0,20,14,56,14,14,6,15,21,0,14,0,0,-1,6,42,0.9967891529033429,[44.88611121]
2020,12,NCAAF_20201121_FIU@WKY,W. Kentucky,Hilltoppers,FIU,Panthers,4-6,0-5,1,10,13,38,21,0,10,14,14,7,6,0,8,4,-3,17,0.4425883085840192,[-2.37833986]
2020,12,NCAAF_20201121_RICE@NTEXAS,North Texas,Mean Green,Rice,Owls,3-3,1-2,0,14,10,27,17,0,14,3,10,10,0,0,7,2,4,10,0.7731788141878231,[12.34140835]
2020,12,NCAAF_20201121_NAL@BYU,BYU,Cougars,North Alabama,Lions,9-0,0-4,0,42,7,66,14,14,28,14,10,0,7,0,7,9,35,52,0.9575542981849304,[28.37641441]
2020,12,NCAAF_20201121_TXSA@USM,So. Miss,Golden Eagles,UTSA,Roadrunners,2-7,6-4,1,10,9,20,23,3,7,3,7,0,9,14,0,-4,1,-3,0.6723653415191253,[7.35280407]
2020,12,NCAAF_20201121_CAL@OREGST,Oregon State,Beavers,California,Golden Bears,1-2,0-2,1,14,20,31,27,14,0,3,14,7,13,0,7,1,-6,4,0.22260765615477496,[-12.57296011]
2020,12,NCAAF_20201121_CINCY@UCF,UCF,Knights,Cincinnati,Bearcats,5-3,8-0,1,17,19,33,36,14,3,8,8,3,16,3,14,-3,-2,-3,0.7314831568260111,[10.16660435]
2020,12,NCAAF_20201121_GAST@SALA,South Alabama,Jaguars,Georgia St.,Panthers,3-6,4-4,0,7,7,14,31,7,0,7,0,0,7,14,10,-1,0,-17,0.3906296346291356,[-4.57318002]
2020,12,NCAAF_20201121_IOWA@PSU,Penn State,Nittany Lions,Iowa,Hawkeyes,0-5,3-2,1,7,24,21,41,7,0,14,0,3,21,7,10,-3,-17,-20,0.6147711552784699,[4.80536324]
2020,12,NCAAF_20201121_MTSU@TROY,Troy,Trojans,Middle Tenn.,Blue Raiders,4-4,3-6,1,10,17,17,20,3,7,0,7,7,10,0,3,1,-7,-3,0.58737360613337,[3.63633295]
2020,12,NCAAF_20201121_SDGST@NEVADA,Nevada,Wolf Pack,San Diego St.,Aztecs,5-0,3-2,1,16,21,26,21,6,10,10,0,7,14,0,0,2,-5,5,0.25605077443921054,[-10.79678834]
2020,12,NCAAF_20201121_UCLA@OREG,Oregon,Ducks,UCLA,Bruins,3-0,1-2,0,24,21,38,35,14,10,14,0,7,14,7,7,2,3,3,0.8095966517382562,[14.43391095]
2020,12,NCAAF_20201121_WISC@NWEST,Northwestern,Wildcats,Wisconsin,Badgers,5-0,2-1,0,14,7,17,7,7,7,0,3,7,0,0,0,3,7,10,0.17215990756198674,[-15.57446964]
2020,12,NCAAF_20201121_ABIL@UVA,Virginia,Cavaliers,Abil Christian,Wildcats,4-4,1-5,1,28,7,55,15,14,14,14,13,0,7,0,8,3,21,40,0.9890893027291958,[37.77181793]
2020,12,NCAAF_20201121_KSTATE@IOWAST,Iowa St.,Cyclones,Kansas State,Wildcats,6-2,4-4,1,35,0,45,0,7,28,3,7,0,0,0,0,2,35,45,0.6173576856010092,[4.91689603]
2020,12,NCAAF_20201121_UK@BAMA,Alabama,Crimson Tide,Kentucky,Wildcats,7-0,3-5,0,28,3,63,3,7,21,21,14,3,0,0,0,4,25,60,0.9387873762747851,[25.43975713]
2020,12,NCAAF_20201121_VATECH@PITT,Pittsburgh,Panthers,Virginia Tech,Hokies,5-4,4-5,1,23,14,47,14,6,17,17,7,0,14,0,0,1,9,33,0.4143949443001883,[-3.56155848]
2020,12,NCAAF_20201121_TENN@AUBURN,Auburn,Tigers,Tennessee,Volunteers,5-2,2-5,0,10,10,30,17,0,10,10,10,7,3,0,7,3,0,13,0.8850973866986379,[19.77738639]
2020,12,NCAAF_20201121_LIB@NCST,NC State,Wolfpack,Liberty,Flames,6-3,8-1,1,7,7,15,14,0,7,2,6,0,7,7,0,-2,0,1,0.792731359977734,[13.43791365]
2020,12,NCAAF_20201121_MISSST@UGA,Georgia,Bulldogs,Miss. State,Bulldogs,5-2,2-5,1,17,17,31,24,0,17,7,7,3,14,7,0,3,0,7,0.8009651369602074,[13.9178069]
2020,12,NCAAF_20201121_MIZZOU@SC,South Carolina,Gamecocks,Missouri,Tigers,2-6,3-3,1,0,17,10,17,0,0,3,7,7,10,0,0,-1,-17,-7,0.39008007137155987,[-4.59676381]
2020,12,NCAAF_20201121_OKLAST@OKLA,Oklahoma,Sooners,Oklahoma State,Cowboys,6-2,5-2,1,27,13,41,13,21,6,0,14,7,6,0,0,1,14,28,0.7419481845497846,[10.69458508]
2020,12,NCAAF_20201121_ARIZ@WASH,Washington,Huskies,Arizona,Wildcats,2-0,0-2,1,24,0,44,27,17,7,13,7,0,0,0,27,2,24,17,0.8477292653591423,[16.90978272]
2020,12,NCAAF_20201121_USC@UTAH,Utah,Utes,USC,Trojans,0-1,3-0,1,17,24,17,33,3,14,0,0,3,21,6,3,-3,-7,-16,0.6349212835773549,[5.68054157]
2020,12,NCAAF_20201121_BOISE@HAWAII,Hawaii,Rainbow Warriors,Boise St.,Broncos,2-3,4-1,0,3,19,32,40,3,0,14,15,3,16,21,0,-2,-16,-8,0.10072538422994481,[-21.03841826]
2020,12,NCAAF_20201120_CUSE@LVILLE,Louisville,Cardinals,Syracuse,Orange,3-6,1-8,0,20,0,30,0,3,17,7,3,0,0,0,0,2,20,30,0.47565099253156273,[-1.00581325]
2020,12,NCAAF_20201120_PURDUE@MINN,Minnesota,Golden Gophers,Purdue,Boilermakers,2-3,2-2,1,21,10,34,31,14,7,7,6,7,3,14,7,0,11,3,0.4890711515321754,[-0.45122684]
2020,12,NCAAF_20201120_UMASS@FAU,FAU,Owls,UMass,Minutemen,5-1,0-3,0,7,0,24,2,7,0,14,3,0,0,2,0,5,7,22,0.9533834477744586,[27.64517786]
2020,12,NCAAF_20201120_NMEX@AF,Air Force,Falcons,New Mexico,Lobos,2-2,0-4,0,21,0,28,0,7,14,0,7,0,0,0,0,2,21,28,0.8507012271182235,[17.11898526]
2020,12,NCAAF_20201118_NILL@BALLST,Ball St.,Cardinals,N. Illinois,Huskies,2-1,0-3,0,14,14,31,25,0,14,6,11,7,7,0,11,2,0,6,0.23319060797720015,[-11.99593372]
2020,12,NCAAF_20201118_TOLEDO@EMICH,E. Michigan,Eagles,Toledo,Rockets,0-3,2-1,0,7,24,28,45,0,7,6,15,7,17,14,7,-2,-17,-17,0.4208235424741995,[-3.29036223]
2020,12,NCAAF_20201118_WMICH@CMICH,C. Michigan,Chippewas,W. Michigan,Broncos,2-1,3-0,1,14,31,44,52,14,0,16,14,14,17,14,7,-1,-17,-8,0.425601175258701,[-3.08939389]
2020,12,NCAAF_20201117_BUFF@BGREEN,Bowling Green,Falcons,Buffalo,Bulls,0-3,3-0,0,3,21,17,42,3,0,0,14,7,14,14,7,-3,-18,-25,0.06833061019696796,[-24.51198266]
2020,12,NCAAF_20201117_AKRON@KENTST,Kent St.,Golden Flashes,Akron,Zips,3-0,0-3,0,35,28,69,35,14,21,20,14,7,21,0,7,3,7,34,0.5652654880030142,[2.706456]
2020,13,NCAAF_20201128_BALLST@TOLEDO,Toledo,Rockets,Ball St.,Cardinals,2-2,3-1,0,3,17,24,27,0,3,6,15,14,3,7,3,-1,-14,-3,0.7892696549471951,[13.2731203]
2020,13,NCAAF_20201128_BGREEN@OHIO,Ohio,Bobcats,Bowling Green,Falcons,2-1,0-4,1,45,10,52,10,21,24,7,0,3,7,0,0,2,35,42,0.9383410548092765,[25.4435635]
2020,13,NCAAF_20201128_GAS@GAST,Georgia St.,Panthers,Ga. Southern,Eagles,5-4,6-4,1,13,14,30,24,3,10,0,17,0,14,3,7,-1,-1,6,0.3665564694166622,[-5.63008725]
2020,13,NCAAF_20201128_KENTST@BUFF,Buffalo,Bulls,Kent St.,Golden Flashes,4-0,3-1,1,35,24,70,41,21,14,14,21,10,14,7,10,1,11,29,0.8414519560623607,[16.51843883]
2020,13,NCAAF_20201128_MD@IND,Indiana,Hoosiers,Maryland,Terrapins,5-1,2-2,0,7,3,27,11,7,0,10,10,0,3,0,8,3,4,16,0.7164092400010968,[9.44778487]
2020,13,NCAAF_20201128_NCST@CUSE,Syracuse,Orange,NC State,Wolfpack,1-9,7-3,1,22,14,29,36,7,15,7,0,7,7,13,9,-6,8,-7,0.39177876342525264,[-4.53537312]
2020,13,NCAAF_20201128_NILL@WMICH,W. Michigan,Broncos,N. Illinois,Huskies,4-0,0-4,0,20,17,30,27,7,13,0,10,3,14,7,3,4,3,3,0.5348381816739398,[1.44369382]
2020,13,NCAAF_20201128_PSU@MICH,Michigan,Wolverines,Penn State,Nittany Lions,2-4,1-5,0,7,17,17,27,7,0,3,7,7,10,3,7,1,-10,-10,0.44575193480188835,[-2.25214214]
2020,13,NCAAF_20201128_SMU@ECU,East Carolina,Pirates,SMU,Mustangs,3-6,7-3,0,45,7,52,38,21,24,0,7,7,0,17,14,-4,38,14,0.14132729894227225,[-17.73913795]
2020,13,NCAAF_20201128_TXTECH@OKLAST,Oklahoma State,Cowboys,Texas Tech,Red Raiders,6-2,3-6,0,21,17,50,44,7,14,20,9,7,10,14,13,3,4,6,0.6698464854339534,[7.25646138]
2020,13,NCAAF_20201128_UK@FLA,Florida,Gators,Kentucky,Wildcats,7-1,3-6,0,14,10,34,10,7,7,17,3,0,10,0,0,4,4,24,0.6958606690491602,[8.46247981]
2020,13,NCAAF_20201128_VANDY@MIZZOU,Missouri,Tigers,Vanderbilt,Commodores,4-3,0-8,0,21,0,41,0,7,14,6,14,0,0,0,0,4,21,41,0.8203702503909382,[15.13701681]
2020,13,NCAAF_20201128_MIAOH@AKRON,Akron,Zips,Miami-OH,RedHawks,0-4,2-1,1,0,24,7,38,0,0,0,7,7,17,7,7,-2,-24,-31,0.2048968180900531,[-13.60940495]
2020,13,NCAAF_20201128_CSTCAR@TXSTSM,Texas St.,Bobcats,C. Carolina,Chanticleers,2-10,9-0,1,7,35,14,49,7,0,0,7,14,21,7,7,-7,-28,-35,0.29900445164645406,[-8.70575254]
2020,13,NCAAF_20201128_LALAF@LAMON,UL-Monroe,Warhawks,Louisiana,Ragin' Cajuns,0-9,8-1,0,14,49,20,70,14,0,0,6,21,28,7,14,-8,-35,-50,0.20916186275330007,[-13.36299284]
2020,13,NCAAF_20201128_NTEXAS@TXSA,UTSA,Roadrunners,North Texas,Mean Green,7-4,3-4,1,28,7,49,17,7,21,7,14,0,7,3,7,4,21,32,0.32072770615145396,[-7.68864906]
2020,13,NCAAF_20201128_SALA@ARKST,Arkansas St.,Red Wolves,South Alabama,Jaguars,3-7,4-6,0,17,14,31,38,7,10,7,7,7,7,14,10,-1,3,-7,0.7925491646104709,[13.46148682]
2020,13,NCAAF_20201128_AUBURN@BAMA,Alabama,Crimson Tide,Auburn,Tigers,8-0,5-3,0,21,3,42,13,7,14,14,7,0,3,3,7,3,18,29,0.7966193823146074,[13.69773573]
2020,13,NCAAF_20201128_NWEST@MICHST,Michigan St.,Spartans,Northwestern,Wildcats,2-3,5-1,1,17,6,29,20,10,7,0,12,0,6,7,7,-3,11,9,0.4765238618515846,[-0.9721741]
2020,13,NCAAF_20201128_PITT@CLEM,Clemson,Tigers,Pittsburgh,Panthers,8-1,5-5,0,38,10,52,17,31,7,7,7,0,10,7,0,3,28,35,0.9492284159574186,[27.03560709]
2020,13,NCAAF_20201128_TROY@APLST,App. St.,Mountaineers,Troy,Trojans,7-2,4-5,0,34,10,47,10,21,13,13,0,0,10,0,0,3,24,37,0.7024604179761103,[8.77549854]
2020,13,NCAAF_20201128_LVILLE@BC,Boston College,Eagles,Louisville,Cardinals,6-4,3-7,0,13,10,34,27,7,6,7,14,3,7,3,14,3,3,7,0.6073660106251239,[4.49862803]
2020,13,NCAAF_20201128_MISSST@MISS,Ole Miss,Rebels,Miss. State,Bulldogs,4-4,2-6,0,21,14,31,24,14,7,0,10,0,14,0,10,2,7,7,0.32335377582078706,[-7.56772218]
2020,13,NCAAF_20201128_RUT@PURDUE,Purdue,Boilermakers,Rutgers,Scarlet Knights,2-3,2-4,1,23,13,30,37,7,16,7,0,13,0,21,3,0,10,-7,0.8810893366144442,[19.49055181]
2020,13,NCAAF_20201128_SDGST@COLO,Colorado,Buffaloes,San Diego St.,Aztecs,3-0,3-3,0,14,10,20,10,7,7,3,3,0,10,0,0,0,4,10,0.469438122876379,[-1.26611161]
2020,13,NCAAF_20201128_DUKE@GATECH,Georgia Tech,Yellow Jackets,Duke,Blue Devils,3-5,2-7,1,28,26,56,33,14,14,14,14,7,19,7,0,1,2,23,0.47159818018100397,[-1.17646779]
2020,13,NCAAF_20201128_KSTATE@BAYLOR,Baylor,Bears,Kansas State,Wildcats,2-5,4-5,0,6,17,32,31,6,0,9,17,14,3,0,14,-2,-11,1,0.4118032988890028,[-3.68047196]
2020,13,NCAAF_20201128_LSU@TXAM,Texas A&M,Aggies,LSU,Tigers,6-1,3-4,1,13,0,20,7,10,3,7,0,0,0,0,7,3,13,13,0.3001478958683469,[-8.6514182]
2020,13,NCAAF_20201128_MEMP@NAVY,Navy,Midshipmen,Memphis,Tigers,3-5,6-2,1,7,7,7,10,7,0,0,0,7,0,0,3,-3,0,-3,0.3148913708093366,[-7.95889997]
2020,13,NCAAF_20201128_UGA@SC,South Carolina,Gamecocks,Georgia,Bulldogs,2-7,6-2,1,10,28,16,45,0,10,0,6,21,7,10,7,-4,-18,-29,0.11409709424646652,[-19.89629135]
2020,13,NCAAF_20201128_UTAH@WASH,Washington,Huskies,Utah,Utes,3-0,0-2,0,0,21,24,21,0,0,17,7,7,14,0,0,3,-21,3,0.5465984289612924,[1.93298703]
2020,13,NCAAF_20201128_ARIZ@UCLA,UCLA,Bruins,Arizona,Wildcats,2-2,0-3,0,20,7,27,10,3,17,0,7,7,0,3,0,2,13,17,0.5241972794279928,[1.00207354]
2020,13,NCAAF_20201128_TCU@KANSAS,Kansas,Jayhawks,TCU,Horned Frogs,0-8,4-4,0,12,38,23,59,6,6,8,3,24,14,7,14,-4,-26,-36,0.08301030792575093,[-22.86962348]
2020,13,NCAAF_20201128_NEVADA@HAWAII,Hawaii,Rainbow Warriors,Nevada,Wolf Pack,3-3,5-1,0,10,7,24,21,0,10,7,7,0,7,0,14,-2,3,3,0.43262150135955224,[-2.80200182]
2020,13,NCAAF_20201127_IOWAST@TEXAS,Texas,Longhorns,Iowa St.,Cyclones,5-3,7-2,1,13,10,20,23,13,0,7,0,7,3,3,10,-2,3,-3,0.47793370031504145,[-0.91372951]
2020,13,NCAAF_20201127_UMASS@LIB,Liberty,Flames,UMass,Minutemen,9-1,0-4,0,31,0,45,0,14,17,14,0,0,0,0,0,9,31,45,0.8611018459789166,[17.91924054]
2020,13,NCAAF_20201127_NEB@IOWA,Iowa,Hawkeyes,Nebraska,Cornhuskers,4-2,1-4,1,13,13,26,20,10,3,7,6,0,13,7,0,3,0,6,0.8469674724503089,[16.89935816]
2020,13,NCAAF_20201127_ND@UNC,North Carolina,Tar Heels,Notre Dame,Fighting Irish,6-3,9-0,0,17,17,17,31,14,3,0,0,14,3,7,7,-3,0,-14,0.13685828353176344,[-18.07214511]
2020,13,NCAAF_20201127_UCF@SFLA,South Florida,Bulls,UCF,Knights,1-8,6-3,1,14,31,46,58,7,7,14,18,14,17,14,13,-5,-17,-12,0.09194649242096964,[-21.94102802]
2020,13,NCAAF_20201127_CMICH@EMICH,E. Michigan,Eagles,C. Michigan,Chippewas,0-4,3-1,0,17,6,23,31,7,10,3,3,6,0,0,25,-3,11,-8,0.5060221207312634,[0.24924845]
2020,13,NCAAF_20201127_WYO@UNLV,UNLV,Rebels,Wyoming,Cowboys,0-5,2-2,0,7,17,14,45,0,7,0,7,10,7,21,7,-2,-10,-31,0.21726433736738682,[-12.90287432]
2020,13,NCAAF_20201127_STNFRD@CAL,California,Golden Bears,Stanford,Cardinal,0-3,1-2,1,10,10,23,24,7,3,7,6,0,10,14,0,-1,0,-1,0.3609785166491688,[-5.87539155]
2020,13,NCAAF_20201127_OREG@OREGST,Oregon State,Beavers,Oregon,Ducks,2-2,3-1,0,13,24,41,38,7,6,6,22,14,10,7,7,-1,-11,3,0.06748682621286406,[-24.68038151]
2020,13,NCAAF_20201126_NMEX@UTAHST,Utah St.,Aggies,New Mexico,Lobos,1-4,0-5,0,6,13,41,27,3,3,28,7,3,10,7,7,1,-7,14,0.8730339494966113,[18.83672296]
2020,14,NCAAF_20201206_WKY@CHARLO,Charlotte,49ers,W. Kentucky,Hilltoppers,2-4,5-6,1,0,17,19,37,0,0,7,12,3,14,10,10,-3,-17,-18,0.36078503846394017,[-5.88660028]
2020,14,NCAAF_20201206_WASHST@USC,USC,Trojans,Washington St.,Cougars,4-0,1-2,0,35,6,38,13,28,7,3,0,0,6,0,7,3,29,25,0.5001500375224543,[0.00621246]
2020,14,NCAAF_20201205_ARK@MIZZOU,Missouri,Tigers,Arkansas,Razorbacks,5-3,3-6,1,20,27,50,48,10,10,3,27,6,21,6,15,2,-7,2,0.8288776793070523,[15.68839876]
2020,14,NCAAF_20201205_KANSAS@TXTECH,Texas Tech,Red Raiders,Kansas,Jayhawks,4-6,0-9,0,10,3,16,13,10,0,3,3,0,3,3,7,4,7,3,0.8554507923755171,[17.51142884]
2020,14,NCAAF_20201205_MEMP@TULANE,Tulane,Green Wave,Memphis,Tigers,6-5,6-3,1,21,14,35,21,14,7,7,7,7,7,7,0,0,7,14,0.3462258375824504,[-6.53361771]
2020,14,NCAAF_20201205_NEB@PURDUE,Purdue,Boilermakers,Nebraska,Cornhuskers,2-4,2-4,1,13,27,27,37,3,10,7,7,17,10,7,3,0,-14,-10,0.6167437312849805,[4.90503835]
2020,14,NCAAF_20201205_OHIOST@MICHST,Michigan St.,Spartans,Ohio State,Buckeyes,2-4,5-0,1,0,28,12,52,0,0,7,5,14,14,10,14,-3,-28,-40,0.06574961595276063,[-24.91366919]
2020,14,NCAAF_20201205_OKLAST@TCU,TCU,Horned Frogs,Oklahoma State,Cowboys,5-4,6-3,0,7,16,29,22,0,7,14,8,13,3,6,0,-1,-9,7,0.46497797868518675,[-1.45199205]
2020,14,NCAAF_20201205_PSU@RUT,Rutgers,Scarlet Knights,Penn State,Nittany Lions,2-5,2-5,0,0,17,7,23,0,0,7,0,7,10,3,3,0,-17,-16,0.020655015745570493,[-33.70469848]
2020,14,NCAAF_20201205_RICE@MRSHL,Marshall,Thundering Herd,Rice,Owls,7-1,2-2,1,0,10,0,20,0,0,0,0,7,3,10,0,5,-10,-20,0.893560087038787,[20.57702499]
2020,14,NCAAF_20201205_TEXAS@KSTATE,Kansas State,Wildcats,Texas,Longhorns,4-6,6-3,1,17,31,31,69,7,10,14,0,17,14,35,3,-2,-14,-38,0.36064978316815144,[-5.8925682]
2020,14,NCAAF_20201205_TOLEDO@NILL,N. Illinois,Huskies,Toledo,Rockets,0-5,3-2,1,24,24,24,41,7,17,0,0,7,17,0,17,-3,0,-17,0.45584260446094205,[-1.83213389]
2020,14,NCAAF_20201205_TXAM@AUBURN,Auburn,Tigers,Texas A&M,Aggies,5-4,7-1,1,10,14,20,31,0,10,10,0,7,7,0,17,-2,-4,-11,0.6780530671527337,[7.63592704]
2020,14,NCAAF_20201205_WCAR@UNC,North Carolina,Tar Heels,W. Carolina,Catamounts,7-3,0-3,0,42,3,49,9,21,21,7,0,3,0,0,6,7,39,40,0.9924119970656691,[40.10974406]
2020,14,NCAAF_20201205_BALLST@CMICH,C. Michigan,Chippewas,Ball St.,Cardinals,3-2,4-1,1,7,24,20,45,0,7,7,6,10,14,14,7,-1,-17,-25,0.7022536266568625,[8.76963139]
2020,14,NCAAF_20201205_BGREEN@AKRON,Akron,Zips,Bowling Green,Falcons,1-4,0-5,1,17,3,31,3,3,14,7,7,3,0,0,0,1,14,28,0.5871424006475918,[3.63740736]
2020,14,NCAAF_20201205_EMICH@WMICH,W. Michigan,Broncos,E. Michigan,Eagles,4-1,1-4,0,21,30,42,53,7,14,7,14,9,21,13,10,3,-9,-11,0.5827167037545727,[3.44989011]
2020,14,NCAAF_20201205_TROY@SALA,South Alabama,Jaguars,Troy,Trojans,4-7,5-5,0,0,27,0,29,0,0,0,0,3,24,0,2,-1,-27,-29,0.1948487020080405,[-14.20877135]
2020,14,NCAAF_20201205_CUSE@ND,Notre Dame,Fighting Irish,Syracuse,Orange,10-0,1-10,1,24,7,45,21,3,21,14,7,0,7,7,7,9,17,24,0.8950439313316649,[20.71117991]
2020,14,NCAAF_20201205_LAMON@ARKST,Arkansas St.,Red Wolves,UL-Monroe,Warhawks,4-7,0-10,0,28,7,48,15,14,14,7,13,7,0,8,0,4,21,33,0.7630523282733003,[11.82991028]
2020,14,NCAAF_20201205_BC@UVA,Virginia,Cavaliers,Boston College,Eagles,5-4,6-5,0,20,17,43,32,6,14,10,13,7,10,0,15,-1,3,11,0.4913397680752406,[-0.35861438]
2020,14,NCAAF_20201205_FLA@TENN,Tennessee,Volunteers,Florida,Gators,2-6,8-1,1,7,17,19,31,0,7,0,12,3,14,7,7,-6,-10,-12,0.18198294657548608,[-14.99617861]
2020,14,NCAAF_20201205_IND@WISC,Wisconsin,Badgers,Indiana,Hoosiers,2-2,6-1,1,3,7,6,14,0,3,3,0,0,7,7,0,-4,-4,-8,0.8093936303965075,[14.46477241]
2020,14,NCAAF_20201205_IOWA@ILL,Illinois,Fighting Illini,Iowa,Hawkeyes,2-4,5-2,0,14,13,21,35,7,7,0,7,0,13,8,14,-3,1,-14,0.06608766378261433,[-24.87010527]
2020,14,NCAAF_20201205_TULSA@NAVY,Navy,Midshipmen,Tulsa,Golden Hurricane,3-6,6-1,0,3,6,6,19,0,3,3,0,0,6,7,6,-3,-3,-13,0.6190396704255221,[5.00447849]
2020,14,NCAAF_20201205_WVU@IOWAST,Iowa St.,Cyclones,West Virginia,Mountaineers,8-2,5-4,0,21,0,42,6,7,14,14,7,0,0,0,6,3,21,36,0.632036708371068,[5.57095012]
2020,14,NCAAF_20201205_GATECH@NCST,NC State,Wolfpack,Georgia Tech,Yellow Jackets,8-3,3-6,1,20,7,23,13,3,17,0,3,0,7,3,3,5,13,10,0.59261755438683,[3.87004341]
2020,14,NCAAF_20201205_STNFRD@WASH,Washington,Huskies,Stanford,Cardinal,3-1,2-2,0,3,24,26,31,0,3,13,10,14,10,7,0,1,-21,-5,0.7126237746860654,[9.26804608]
2020,14,NCAAF_20201205_BYU@CSTCAR,C. Carolina,Chanticleers,BYU,Cougars,10-0,9-1,1,13,14,22,17,6,7,3,6,0,14,3,0,1,-1,5,0.16257482468248086,[-16.25318885]
2020,14,NCAAF_20201205_FAU@GAS,Ga. Southern,Eagles,FAU,Owls,7-4,5-2,1,10,0,20,3,0,10,0,10,0,0,3,0,2,10,17,0.23368395397082597,[-12.00521933]
2020,14,NCAAF_20201205_SJST@HAWAII,Hawaii,Rainbow Warriors,San Jose St.,Spartans,3-4,5-0,0,10,21,24,35,0,10,7,7,21,0,7,7,-2,-11,-11,0.6274622820983605,[5.37086162]
2020,14,NCAAF_20201205_COLO@ARIZ,Arizona,Wildcats,Colorado,Buffaloes,0-4,4-0,1,13,14,13,24,10,3,0,0,0,14,7,3,-4,-1,-11,0.494820027539146,[-0.21448835]
2020,14,NCAAF_20201205_COLOST@SDGST,San Diego St.,Aztecs,Colorado St.,Rams,4-3,1-3,0,23,17,29,17,7,16,0,6,0,17,0,0,3,6,12,0.6850014556191417,[7.95753711]
2020,14,NCAAF_20201205_OREG@CAL,California,Golden Bears,Oregon,Ducks,1-3,3-2,0,14,17,21,17,7,7,7,0,3,14,0,0,-2,-3,4,0.23217443373951618,[-12.08676089]
2020,14,NCAAF_20201205_CLEM@VATECH,Virginia Tech,Hokies,Clemson,Tigers,4-6,9-1,1,10,17,10,45,7,3,0,0,10,7,14,14,-5,-7,-35,0.06384630809238212,[-25.16224374]
2020,14,NCAAF_20201205_SC@UK,Kentucky,Wildcats,South Carolina,Gamecocks,4-6,2-8,0,27,3,41,18,10,17,7,7,3,0,7,8,2,24,23,0.5281500593246606,[1.16655238]
2020,14,NCAAF_20201205_BAMA@LSU,LSU,Tigers,Alabama,Crimson Tide,3-5,9-0,0,14,45,17,55,0,14,3,0,21,24,7,3,-6,-31,-38,0.19149657392795538,[-14.41076685]
2020,14,NCAAF_20201205_BAYLOR@OKLA,Oklahoma,Sooners,Baylor,Bears,7-2,2-6,1,10,0,27,14,3,7,7,10,0,0,7,7,5,10,13,0.8876692280895444,[20.05734992]
2020,14,NCAAF_20201205_MIAMI@DUKE,Duke,Blue Devils,Miami (Fla.),Hurricanes,2-8,8-1,0,0,21,0,48,0,0,0,0,14,7,21,6,-6,-21,-48,0.26907656820508685,[-10.16900646]
2020,14,NCAAF_20201205_FRESNO@NEVADA,Nevada,Wolf Pack,Fresno St.,Bulldogs,6-1,3-2,1,24,20,37,26,17,7,0,13,7,13,0,6,3,4,11,0.22223675704882995,[-12.63115285]
2020,14,NCAAF_20201205_OREGST@UTAH,Utah,Utes,Oregon State,Beavers,1-2,2-3,1,16,10,30,24,6,10,7,7,0,10,0,14,-1,6,6,0.9275088296026077,[24.07567345]
2020,14,NCAAF_20201205_UCLA@ARIZST,Arizona St.,Sun Devils,UCLA,Bruins,0-2,3-2,1,3,17,18,25,0,3,9,6,0,17,0,8,-3,-14,-7,0.5902093373529691,[3.76762785]
2020,14,NCAAF_20201205_WYO@NMEX,New Mexico,Lobos,Wyoming,Cowboys,1-5,2-3,1,10,13,17,16,0,10,0,7,3,10,0,3,-1,-3,1,0.16627760640989364,[-16.0062243]
2020,14,NCAAF_20201204_LALAF@APLST,App. St.,Mountaineers,Louisiana,Ragin' Cajuns,7-3,9-1,0,10,9,21,24,7,3,0,11,0,9,15,0,-2,1,-3,0.6978415157468786,[8.55999786]
2020,14,NCAAF_20201203_LATECH@NTEXAS,North Texas,Mean Green,Louisiana Tech,Bulldogs,3-5,5-3,1,17,28,31,42,14,3,7,7,7,21,14,0,-2,-11,-11,0.4564139869568421,[-1.80833111]
2020,14,NCAAF_20201203_AF@UTAHST,Utah St.,Aggies,Air Force,Falcons,1-5,3-2,1,7,21,7,35,7,0,0,0,7,14,7,7,-2,-14,-28,0.5267467257538563,[1.1083079]
2020,15,NCAAF_20201212_BAMA@ARK,Arkansas,Razorbacks,Alabama,Crimson Tide,3-7,10-0,1,3,38,3,52,3,0,0,0,10,28,7,7,-7,-35,-49,0.008649310718554681,[-39.43249359]
2020,15,NCAAF_20201212_ILL@NWEST,Northwestern,Wildcats,Illinois,Fighting Illini,6-1,2-5,0,14,3,28,10,0,14,14,0,3,0,0,7,4,11,18,0.7761286476882152,[12.57678611]
2020,15,NCAAF_20201212_MICHST@PSU,Penn State,Nittany Lions,Michigan St.,Spartans,3-5,2-5,0,10,21,39,24,3,7,15,14,0,21,3,0,1,-11,15,0.8377787506507068,[16.32382911]
2020,15,NCAAF_20201212_MINN@NEB,Nebraska,Cornhuskers,Minnesota,Golden Gophers,2-5,3-3,1,14,17,17,24,0,14,0,3,10,7,0,7,-1,-3,-7,0.385129919592086,[-4.83790995]
2020,15,NCAAF_20201212_NILL@EMICH,E. Michigan,Eagles,N. Illinois,Huskies,2-4,0-6,1,20,10,41,33,10,10,14,7,10,0,14,9,2,10,8,0.47414463537674334,[-1.07440445]
2020,15,NCAAF_20201212_UGA@MIZZOU,Missouri,Tigers,Georgia,Bulldogs,5-4,7-2,1,14,21,14,49,0,14,0,0,14,7,21,7,-2,-7,-35,0.18141772545286394,[-15.07483299]
2020,15,NCAAF_20201212_UTAH@COLO,Colorado,Buffaloes,Utah,Utes,4-1,2-2,0,14,10,21,38,0,14,7,0,7,3,14,14,2,4,-17,0.19475846783281114,[-14.25510895]
2020,15,NCAAF_20201212_WAKE@LVILLE,Louisville,Cardinals,Wake Forest,Demon Deacons,4-7,4-4,0,21,10,45,21,0,21,7,17,7,3,3,8,0,11,24,0.3672760055964407,[-5.61721016]
2020,15,NCAAF_20201212_WMICH@BALLST,Ball St.,Cardinals,W. Michigan,Broncos,5-1,4-2,0,13,20,30,27,6,7,0,17,3,17,7,0,1,-7,3,0.25913560225863885,[-10.70197193]
2020,15,NCAAF_20201212_UAB@RICE,Rice,Owls,UAB,Blazers,2-3,5-3,0,13,7,16,21,3,10,0,3,0,7,14,0,-3,6,-5,0.2045963916058322,[-13.67233094]
2020,15,NCAAF_20201212_AKRON@BUFF,Buffalo,Bulls,Akron,Zips,5-0,1-5,0,35,0,56,7,14,21,14,7,0,0,0,7,4,35,49,0.8966377746736814,[20.91687308]
2020,15,NCAAF_20201212_CMICH@TOLEDO,Toledo,Rockets,C. Michigan,Chippewas,4-2,3-3,0,17,10,24,23,10,7,0,7,7,3,13,0,1,7,1,0.6129334485299194,[4.75404897]
2020,15,NCAAF_20201212_CSTCAR@TROY,Troy,Trojans,C. Carolina,Chanticleers,5-6,11-0,0,16,21,38,42,3,13,7,15,14,7,7,14,-6,-5,-4,0.6426552205805697,[6.05602494]
2020,15,NCAAF_20201212_NAVY@ARMY,Army,Black Knights,Navy,Midshipmen,8-2,3-7,1,3,0,15,0,0,3,0,12,0,0,0,0,5,3,15,0.5005401615435912,[0.02243038]
2020,15,NCAAF_20201212_OKLAST@BAYLOR,Baylor,Bears,Oklahoma State,Cowboys,2-7,7-3,0,0,28,3,42,0,0,0,3,14,14,7,7,-5,-28,-39,0.3104304983597447,[-8.19414577]
2020,15,NCAAF_20201212_UNC@MIAMI,Miami (Fla.),Hurricanes,North Carolina,Tar Heels,8-2,8-3,1,10,34,26,62,3,7,8,8,21,13,7,21,0,-24,-36,0.706194299421597,[8.9838597]
2020,15,NCAAF_20201212_WISC@IOWA,Iowa,Hawkeyes,Wisconsin,Badgers,6-2,2-3,1,6,0,28,7,3,3,15,7,0,0,7,0,4,6,21,0.44107712606224914,[-2.45575446]
2020,15,NCAAF_20201212_HOU@MEMP,Memphis,Tigers,Houston,Cougars,7-3,3-4,0,17,6,30,27,3,14,10,3,3,3,0,21,4,11,3,0.6278319481463047,[5.40251268]
2020,15,NCAAF_20201212_DUKE@FSU,Florida State,Seminoles,Duke,Blue Devils,3-6,2-9,1,28,21,56,35,28,0,14,14,7,14,0,14,1,7,21,0.5243941003677373,[1.01360437]
2020,15,NCAAF_20201212_TENN@VANDY,Vanderbilt,Commodores,Tennessee,Volunteers,0-9,3-6,1,10,28,17,42,7,3,0,7,7,21,7,7,-3,-18,-25,0.3512545512905221,[-6.32722118]
2020,15,NCAAF_20201212_APLST@GAS,Ga. Southern,Eagles,App. St.,Mountaineers,7-5,8-3,1,17,7,26,34,7,10,0,9,0,7,10,17,-1,10,-8,0.21148253149172325,[-13.27429144]
2020,15,NCAAF_20201212_BOISE@WYO,Wyoming,Cowboys,Boise St.,Broncos,2-4,5-1,0,3,10,9,17,3,0,3,3,7,3,7,0,-3,-7,-8,0.24882382543310466,[-11.2351229]
2020,15,NCAAF_20201212_LATECH@TCU,TCU,Horned Frogs,Louisiana Tech,Bulldogs,6-4,5-4,0,31,0,52,10,10,21,14,7,0,0,3,7,1,31,42,0.9069561359443348,[21.90451439]
2020,15,NCAAF_20201212_LSU@FLA,Florida,Gators,LSU,Tigers,8-2,4-5,1,17,24,34,37,7,10,14,3,7,17,3,10,4,-7,-3,0.4079899602799044,[-3.85526233]
2020,15,NCAAF_20201212_AUBURN@MISSST,Miss. State,Bulldogs,Auburn,Tigers,2-7,6-4,0,3,6,10,24,0,3,0,7,3,3,3,15,-4,-3,-14,0.31343469862197293,[-8.05345634]
2020,15,NCAAF_20201212_USC@UCLA,UCLA,Bruins,USC,Trojans,3-3,5-0,0,21,10,38,43,7,14,14,3,0,10,13,20,-2,11,-5,0.2868065223464944,[-9.32243503]
2020,15,NCAAF_20201212_UVA@VATECH,Virginia Tech,Hokies,Virginia,Cavaliers,5-6,5-5,1,27,7,33,15,3,24,3,3,7,0,8,0,0,20,18,0.5380830402184785,[1.5838191]
2020,15,NCAAF_20201212_SDGST@BYU,BYU,Cougars,San Diego St.,Aztecs,10-1,4-4,1,17,14,28,14,7,10,3,8,14,0,0,0,6,3,14,0.5217536171254329,[0.90377356]
2020,15,NCAAF_20201212_STNFRD@OREGST,Oregon State,Beavers,Stanford,Cardinal,2-4,3-2,1,14,9,24,27,7,7,7,3,6,3,7,11,-1,5,-3,0.15374625398630215,[-16.9057652]
2020,15,NCAAF_20201212_FRESNO@NMEX,New Mexico,Lobos,Fresno St.,Bulldogs,2-5,3-3,1,21,24,49,39,7,14,7,21,7,17,7,8,-1,-3,10,0.10576635628539033,[-20.69717679]
2020,15,NCAAF_20201212_UNLV@HAWAII,Hawaii,Rainbow Warriors,UNLV,Rebels,4-4,0-6,0,21,7,38,21,7,14,14,3,0,7,14,0,4,14,17,0.5973360816961124,[4.0828692]
2020,15,NCAAF_20201211_UTEP@NTEXAS,North Texas,Mean Green,UTEP,Miners,4-5,3-5,0,17,21,45,43,7,10,14,14,7,14,0,22,1,-4,2,0.8605669235856159,[17.93903715]
2020,15,NCAAF_20201211_ARIZST@ARIZ,Arizona,Wildcats,Arizona St.,Sun Devils,0-5,1-2,1,7,42,7,70,0,7,0,0,21,21,21,7,-1,-35,-63,0.3682823246420498,[-5.57296983]
2020,15,NCAAF_20201211_NEVADA@SJST,San Jose St.,Spartans,Nevada,Wolf Pack,6-0,6-2,0,7,20,30,20,7,0,20,3,10,10,0,0,0,-13,10,0.3152566457473511,[-7.96841564]
2020,15,NCAAF_20201210_FAU@USM,So. Miss,Golden Eagles,FAU,Owls,3-7,5-3,0,24,17,45,31,10,14,14,7,7,10,14,0,-2,7,14,0.24574109762730756,[-11.39676994]
2020,15,NCAAF_20201210_PITT@GATECH,Georgia Tech,Yellow Jackets,Pittsburgh,Panthers,3-7,6-5,0,7,16,20,34,7,0,6,7,3,13,7,11,-3,-9,-14,0.40855626228270603,[-3.83110507]
2021,1,NCAAF_20210906_LVILLE@MISS,Ole Miss,Rebels,Louisville,Cardinals,1-0,0-1,1,26,0,43,24,9,17,3,14,0,0,10,14,1,26,19,0.5853188394298132,[3.57900239]
2021,1,NCAAF_20210904_ARMY@GAST,Georgia St.,Panthers,Army,Black Knights,0-1,1-0,1,7,27,10,43,0,7,3,0,14,13,6,10,-1,-20,-33,0.18008703224968192,[-15.19540993]
2021,1,NCAAF_20210904_COLG@BC,Boston College,Eagles,Colgate,Raiders,1-0,0-1,1,27,0,51,0,7,20,3,21,0,0,0,0,1,27,51,0.9699927506480326,[31.23143832]
2021,1,NCAAF_20210904_FORD@NEB,Nebraska,,Fordham,,1-1,0-1,,24,7,52,7,7,17,14,14,0,7,0,0,1,17,45,0.9996810202241456,[56.7098608]
2021,1,NCAAF_20210904_HOLY@UCONN,UConn,Huskies,Holy Cross,Crusaders,0-2,1-0,0,21,24,28,38,14,7,7,0,7,17,7,7,-1,-3,-10,0.7879115103415801,[13.27176098]
2021,1,NCAAF_20210904_LAMON@UK,Kentucky,Wildcats,UL-Monroe,Warhawks,1-0,0-1,1,28,7,45,10,14,14,3,14,7,0,0,3,1,21,35,0.9528583863611746,[27.78622219]
2021,1,NCAAF_20210904_PSU@WISC,Wisconsin,Badgers,Penn State,Nittany Lions,0-1,1-0,0,0,0,10,16,0,0,7,3,0,0,7,9,-1,0,-6,0.44896325147433924,[-2.13028741]
2021,1,NCAAF_20210904_STNFRD@KSTATE,Kansas State,Wildcats,Stanford,Cardinal,1-0,0-1,0,14,0,24,7,7,7,0,10,0,0,0,7,1,14,17,0.4878545868172445,[-0.50564391]
2021,1,NCAAF_20210904_TEMPLE@RUT,Rutgers,Scarlet Knights,Temple,Owls,1-0,0-1,1,26,7,61,14,12,14,14,21,0,7,7,0,1,19,47,0.3871767066281375,[-4.76080764]
2021,1,NCAAF_20210904_TULANE@OKLA,Oklahoma,Sooners,Tulane,Green Wave,1-0,0-1,1,37,14,40,35,14,23,3,0,14,0,8,13,1,23,5,0.9316387571367764,[24.71210937]
2021,1,NCAAF_20210904_WMICH@MICH,Michigan,Wolverines,W. Michigan,Broncos,1-0,0-1,1,27,7,47,14,10,17,6,14,7,0,0,7,1,20,33,0.959730712943374,[29.02083738]
2021,1,NCAAF_20210904_FRESNO@OREG,Oregon,Ducks,Fresno St.,Bulldogs,1-0,1-1,0,21,13,31,24,14,7,0,10,0,13,8,3,0,8,7,0.7645857138945706,[11.97539785]
2021,1,NCAAF_20210904_LAF@AF,Air Force,Falcons,Lafayette,Leopards,1-0,0-1,0,28,7,35,14,14,14,0,7,0,7,7,0,1,21,21,0.8767018462668077,[19.24110791]
2021,1,NCAAF_20210904_RICE@ARK,Arkansas,Razorbacks,Rice,Owls,1-0,0-1,1,7,10,38,17,7,0,10,21,0,10,7,0,1,-3,21,0.8433286156456536,[16.74311341]
2021,1,NCAAF_20210904_BAMA@MIAMI,Miami (Fla.),Hurricanes,Alabama,Crimson Tide,0-1,1-0,0,3,27,13,44,0,3,10,0,10,17,14,3,-1,-24,-31,0.07286496607252635,[-24.15867051]
2021,1,NCAAF_20210904_IND@IOWA,Iowa,Hawkeyes,Indiana,Hoosiers,1-0,0-1,1,31,3,34,6,14,17,0,3,3,0,3,0,1,28,28,0.7521872280596072,[11.31541274]
2021,1,NCAAF_20210904_MIAOH@CINCY,Cincinnati,Bearcats,Miami-OH,RedHawks,1-0,0-1,1,35,0,49,14,21,14,0,14,0,0,0,14,1,35,35,0.805202300423851,[14.2873369]
2021,1,NCAAF_20210904_MRSHL@NAVY,Navy,Midshipmen,Marshall,Thundering Herd,0-1,1-0,0,0,21,7,49,0,0,0,7,14,7,7,21,-1,-21,-42,0.5388981330355677,[1.62175041]
2021,1,NCAAF_20210904_WVU@MD,Maryland,Terrapins,West Virginia,Mountaineers,1-0,0-1,1,20,21,30,24,17,3,0,10,14,7,0,3,1,-1,6,0.279417728140821,[-9.70763741]
2021,1,NCAAF_20210904_CMICH@MIZZOU,Missouri,Tigers,C. Michigan,Chippewas,1-0,0-1,1,17,14,34,24,7,10,7,10,7,7,0,10,1,3,10,0.8799394635994714,[19.5072739]
2021,1,NCAAF_20210904_LATECH@MISSST,Miss. State,Bulldogs,Louisiana Tech,Bulldogs,1-0,0-1,1,14,21,35,34,14,0,0,21,7,14,10,3,1,-7,1,0.9013437993136679,[21.40974076]
2021,1,NCAAF_20210904_MTST@WYO,Wyoming,Cowboys,Montana St.,Bobcats,1-0,0-1,0,3,7,19,16,0,3,0,16,7,0,0,9,1,-4,3,0.9117646389618891,[22.44689858]
2021,1,NCAAF_20210904_UMASS@PITT,Pittsburgh,Panthers,UMass,Minutemen,1-0,0-1,0,23,0,51,7,13,10,14,14,0,0,0,7,1,23,44,0.9720923241855014,[31.75931405]
2021,1,NCAAF_20210904_LALAF@TEXAS,Texas,Longhorns,Louisiana,Ragin' Cajuns,1-0,0-1,0,14,6,38,18,7,7,14,10,3,3,6,6,1,8,20,0.8920228876560173,[20.54805863]
2021,1,NCAAF_20210904_NOIOWA@IOWAST,Iowa St.,Cyclones,Northern Iowa,Panthers,1-0,0-1,0,13,10,16,10,3,10,0,3,7,3,0,0,1,3,6,0.8668126408047302,[18.45718049]
2021,1,NCAAF_20210904_SJST@USC,USC,Trojans,San Jose St.,Spartans,1-0,1-1,0,13,0,30,7,10,3,0,17,0,0,7,0,0,13,23,0.950628522624602,[27.41680709]
2021,1,NCAAF_20210904_CAMP@LIB,Liberty,Flames,Campbell,Fighting Camels,1-0,0-1,0,20,7,48,7,14,6,14,14,0,7,0,0,1,13,41,0.9463160184330179,[26.73857513]
2021,1,NCAAF_20210904_GRDWB@GAS,Ga. Southern,Eagles,Gardner-Webb,Runnin' Bulldogs,1-0,0-1,0,20,6,30,25,3,17,0,10,6,0,6,13,1,14,5,0.9851826337552121,[36.11789301]
2021,1,NCAAF_20210904_ABIL@SMU,SMU,Mustangs,Abil Christian,Wildcats,1-0,0-1,0,35,3,56,9,7,28,14,7,0,3,6,0,1,32,47,0.9810788949929062,[34.4841781]
2021,1,NCAAF_20210904_AKRON@AUBURN,Auburn,Tigers,Akron,Zips,1-0,0-1,0,37,0,60,10,13,24,16,7,0,0,0,10,1,37,50,0.9952405083650239,[43.05756586]
2021,1,NCAAF_20210904_BAYLOR@TXSTSM,Texas St.,Bobcats,Baylor,Bears,0-1,1-0,1,10,14,20,29,3,7,3,7,7,7,10,5,-1,-4,-9,0.04737793776964361,[-27.74641651]
2021,1,NCAAF_20210904_CAR@ARKST,Arkansas St.,,Cent. Ark.,,1-0,0-1,,6,7,40,21,3,3,14,20,7,0,7,7,1,-1,19,0.8091962686616481,[14.52957421]
2021,1,NCAAF_20210904_CUSE@OHIO,Ohio,Bobcats,Syracuse,Orange,0-1,1-0,1,6,12,9,29,0,6,0,3,9,3,10,7,-1,-6,-20,0.487804838239854,[-0.50771571]
2021,1,NCAAF_20210904_EIL@SC,South Carolina,Gamecocks,E. Illinois,Panthers,1-0,0-2,1,29,0,46,0,15,14,3,14,0,0,0,0,1,29,46,0.9957392015665607,[43.68600426]
2021,1,NCAAF_20210904_MONNJ@MTSU,Middle Tenn.,Blue Raiders,Monmouth,Hawks,1-0,0-1,0,21,7,50,15,0,21,7,22,0,7,8,0,1,14,35,0.969412305807825,[31.09092492]
2021,1,NCAAF_20210904_MOST@OKLAST,Oklahoma State,Cowboys,Missouri St.,Bears,1-0,0-1,0,20,3,23,16,6,14,0,3,0,3,6,7,1,17,7,0.9968904142663656,[45.43504472]
2021,1,NCAAF_20210904_NICHST@MEMP,Memphis,,Nicholls St.,,1-0,0-1,,29,7,42,17,10,19,6,7,7,0,7,3,1,22,25,0.9611740257409052,[29.30158342]
2021,1,NCAAF_20210904_NRFST@TOLEDO,Toledo,Rockets,Norfolk St.,Spartans,1-0,0-1,0,28,7,49,10,14,14,14,7,7,0,0,3,1,21,39,0.9805208265885935,[34.28601085]
2021,1,NCAAF_20210904_OREGST@PURDUE,Purdue,Boilermakers,Oregon State,Beavers,1-0,0-1,0,13,7,30,21,7,6,3,14,7,0,0,14,1,6,9,0.8483286860806847,[17.09282755]
2021,1,NCAAF_20210904_SO@TROY,Troy,,Southern U.,,1-0,0-1,,34,3,55,3,14,20,14,7,0,3,0,0,1,31,52,0.9889094941444864,[37.98304767]
2021,1,NCAAF_20210904_TXTECH@HOU,Houston,Cougars,Texas Tech,Red Raiders,0-1,1-0,1,21,7,21,38,14,7,0,0,0,7,17,14,-1,14,-17,0.36989029545065866,[-5.51571409]
2021,1,NCAAF_20210904_FAU@FLA,Florida,Gators,FAU,Owls,1-0,0-1,1,14,0,35,14,14,0,7,14,0,0,0,14,1,14,21,0.8370583782912431,[16.31478588]
2021,1,NCAAF_20210904_NILL@GATECH,Georgia Tech,Yellow Jackets,N. Illinois,Huskies,0-1,1-0,0,7,14,21,22,0,7,0,14,7,7,0,8,-1,-7,-1,0.6876780462674311,[8.1251684]
2021,1,NCAAF_20210904_NWST@NTEXAS,North Texas,Mean Green,Northwestern St.,Demons,1-0,0-1,0,24,14,44,14,7,17,17,3,0,14,0,0,1,10,30,0.9151529782655521,[22.80369944]
2021,1,NCAAF_20210904_TXSA@ILL,Illinois,,UTSA,,1-1,1-0,,14,20,30,37,0,14,3,13,7,13,3,14,0,-6,-7,0.798488734556251,[13.88685667]
2021,1,NCAAF_20210904_UGA@CLEM,Clemson,Tigers,Georgia,Bulldogs,0-1,1-0,0,0,7,3,10,0,0,0,3,0,7,3,0,-1,-7,-7,0.6450911700513042,[6.17925716]
2021,1,NCAAF_20210904_WMMARY@UVA,Virginia,Cavaliers,William & Mary,Tribe,1-0,0-1,0,17,0,43,0,3,14,12,14,0,0,0,0,1,17,43,0.9726657106795377,[31.90921029]
2021,1,NCAAF_20210904_DUQ@TCU,TCU,Horned Frogs,Duquesne,Dukes,1-0,0-1,1,35,0,45,3,21,14,3,7,0,0,3,0,1,35,42,0.9969164250261497,[45.48092789]
2021,1,NCAAF_20210904_ETNST@VANDY,Vanderbilt,Commodores,ETSU,Buccaneers,0-1,1-0,1,3,10,3,23,3,0,0,0,0,10,3,10,-1,-7,-20,0.9883083769983543,[37.64860215]
2021,1,NCAAF_20210904_KENTST@TXAM,Texas A&M,Aggies,Kent St.,Golden Flashes,1-0,0-1,1,10,3,41,10,10,0,17,14,3,0,0,7,1,7,31,0.9714094551639115,[31.5841073]
2021,1,NCAAF_20210904_MT@WASH,Washington,Huskies,Montana,Grizzlies,0-1,1-0,1,7,3,7,13,7,0,0,0,3,0,0,10,-1,4,-6,0.9968550809632799,[45.37326692]
2021,1,NCAAF_20210904_USM@SALA,South Alabama,,So. Miss,,1-0,0-1,,14,7,31,7,0,14,10,7,7,0,0,0,1,7,24,0.26406725324728,[-10.47625039]
2021,1,NCAAF_20210904_LSU@UCLA,UCLA,Bruins,LSU,Tigers,2-0,0-1,1,14,10,38,27,0,14,10,14,0,10,10,7,2,4,11,0.15335273142076078,[-16.97438594]
2021,1,NCAAF_20210904_BTHN@UTEP,UTEP,Miners,Bethune-Cook.,Wildcats,2-0,0-1,0,10,0,38,28,10,0,7,21,0,0,14,14,2,10,10,0.6020646310263897,[4.29598871]
2021,1,NCAAF_20210904_BYU@ARIZ,Arizona,Wildcats,BYU,Cougars,0-1,1-0,0,3,14,16,24,0,3,10,3,0,14,7,3,-1,-11,-8,0.4106097329767605,[-3.75266067]
2021,1,NCAAF_20210904_NEVADA@CAL,California,Golden Bears,Nevada,Wolf Pack,0-1,1-0,1,14,13,17,22,14,0,0,3,0,13,9,0,-1,1,-5,0.7655480303506891,[12.02740914]
2021,1,NCAAF_20210904_NMEXST@SDGST,San Diego St.,Aztecs,New Mexico St.,Aggies,1-0,0-2,0,0,10,28,10,0,0,21,7,3,7,0,0,1,-10,18,0.9067200763723459,[21.93413954]
2021,1,NCAAF_20210904_UTAHST@WASHST,Washington St.,Cougars,Utah St.,Aggies,0-1,1-0,1,6,5,23,26,0,6,14,3,3,2,6,15,-1,1,-3,0.7345929145254622,[10.40828678]
2021,1,NCAAF_20210904_PORTST@HAWAII,Hawaii,,Portland St.,,1-1,0-1,,35,7,49,35,28,7,7,7,0,7,21,7,1,28,14,0.6706473286867946,[7.33506824]
2021,1,NCAAF_20210903_UNC@VATECH,Virginia Tech,Hokies,North Carolina,Tar Heels,1-0,0-1,1,14,0,17,10,7,7,0,3,0,0,7,3,1,14,7,0.5679754737183408,[2.84338401]
2021,1,NCAAF_20210903_DUKE@CHARLO,Charlotte,49ers,Duke,Blue Devils,1-0,0-1,0,10,14,31,28,7,3,7,14,0,14,0,14,1,-4,3,0.13463246784603755,[-18.34603309]
2021,1,NCAAF_20210903_ODU@WAKE,Wake Forest,Demon Deacons,Old Dominion,Monarchs,1-0,0-1,0,28,3,42,10,14,14,7,7,3,0,0,7,1,25,32,0.9434950153583267,[26.31795221]
2021,1,NCAAF_20210903_STFRPA@EMICH,E. Michigan,Eagles,St. Fran.-Pa.,Red Flash,1-0,0-1,1,28,7,35,15,14,14,7,0,0,7,0,8,1,21,20,,
2021,1,NCAAF_20210903_SD@KANSAS,Kansas,Jayhawks,South Dakota,Coyotes,1-0,0-1,1,7,0,17,14,0,7,3,7,0,0,7,7,1,7,3,0.8097351784264442,[14.56249636]
2021,1,NCAAF_20210903_MICHST@NWEST,Northwestern,Wildcats,Michigan St.,Spartans,0-1,1-0,0,7,21,21,38,0,7,0,14,14,7,7,10,-1,-14,-17,0.512404176205661,[0.51642029]
2021,1,NCAAF_20210903_NCO@COLO,Colorado,Buffaloes,N. Colorado,Bears,1-0,0-1,0,14,0,35,7,0,14,7,14,0,0,7,0,1,14,28,0.9576117025042964,[28.62310802]
2021,1,NCAAF_20210903_SDST@COLOST,Colorado St.,Rams,S. Dakota St.,Jackrabbits,0-1,1-0,1,10,21,23,42,0,10,0,13,7,14,14,7,-1,-11,-19,0.2760435573709953,[-9.87475459]
2021,1,NCAAF_20210902_CIT@CSTCAR,C. Carolina,Chanticleers,The Citadel,Bulldogs,1-0,0-1,0,31,0,52,14,7,24,14,7,0,0,7,7,1,31,38,0.5583548460203074,[2.43781034]
2021,1,NCAAF_20210902_WAG@BUFF,Buffalo,Bulls,Wagner,Seahawks,1-0,0-1,1,38,0,69,7,14,24,21,10,0,0,0,7,1,38,62,0.9894888990930596,[38.32068347]
2021,1,NCAAF_20210902_WIL@BALLST,Ball St.,Cardinals,W. Illinois,Leathernecks,1-0,0-1,0,7,7,31,21,7,0,14,10,0,7,7,7,1,0,10,0.3190555933752769,[-7.81067507]
2021,1,NCAAF_20210902_DAVIS@TULSA,Tulsa,Golden Hurricane,UC-Davis,Aggies,0-1,1-0,0,10,10,17,19,3,7,7,0,7,3,3,6,-1,0,-2,0.6956107097600398,[8.49944899]
2021,1,NCAAF_20210902_ECU@APLST,App. St.,Mountaineers,East Carolina,Pirates,1-0,0-1,0,20,6,33,19,14,6,7,6,6,0,3,10,1,14,14,0.8627933502177247,[18.15005562]
2021,1,NCAAF_20210902_SFLA@NCST,NC State,Wolfpack,South Florida,Bulls,1-0,0-1,0,24,0,45,0,10,14,14,7,0,0,0,0,1,24,45,0.7543387514322002,[11.42863782]
2021,1,NCAAF_20210902_WBRST@UTAH,Utah,Utes,Weber St.,Wildcats,1-0,0-1,0,19,7,40,17,13,6,7,14,7,0,3,7,1,12,23,0.9338449686973909,[24.9935344]
2021,1,NCAAF_20210902_BGREEN@TENN,Tennessee,Volunteers,Bowling Green,Falcons,1-0,0-1,0,14,6,38,6,14,0,14,10,0,6,0,0,1,8,32,0.957850086888892,[28.6670367]
2021,1,NCAAF_20210902_HOUBP@NMEX,New Mexico,Lobos,Houston Christian,Huskies,1-0,0-1,0,21,10,27,17,14,7,3,3,0,10,0,7,1,11,10,0.7574709438893668,[11.59442819]
2021,1,NCAAF_20210902_LIUPOST@FIU,FIU,,LIU,,1-0,0-1,,28,10,48,10,21,7,10,10,0,10,0,0,1,18,38,,
2021,1,NCAAF_20210902_OHIOST@MINN,Minnesota,Golden Gophers,Ohio State,Buckeyes,0-1,1-0,1,14,10,31,45,0,14,7,10,7,3,21,14,-1,4,-14,0.07264302688244173,[-24.18531909]
2021,1,NCAAF_20210902_TNMART@WKY,W. Kentucky,Hilltoppers,UT Martin,Skyhawks,1-0,0-1,0,28,14,59,21,7,21,17,14,7,7,0,7,1,14,38,0.8475674039374003,[17.0390943]
2021,1,NCAAF_20210902_BOISE@UCF,UCF,Knights,Boise St.,Broncos,1-0,0-1,0,14,24,36,31,0,14,14,8,14,10,0,7,1,-10,5,0.6394868335328668,[5.9299365]
2021,1,NCAAF_20210902_SUT@ARIZST,Arizona St.,Sun Devils,So. Utah,Thunderbirds,1-0,0-2,0,28,7,41,14,13,15,6,7,7,0,7,0,1,21,27,0.9968794955281085,[45.41588689]
2021,1,NCAAF_20210901_UAB@JAXST,Jacksonville St.,Gamecocks,UAB,Blazers,0-1,1-0,1,0,10,0,31,0,0,0,0,0,10,14,7,-1,-10,-31,0.34981940012322443,[-6.40688281]
2021,1,NCAAF_20210828_NEB@ILL,Illinois,Fighting Illini,Nebraska,Cornhuskers,1-1,1-1,0,16,9,30,22,2,14,14,0,0,9,7,6,0,7,8,0.30240546336161067,[-8.59372161]
2021,1,NCAAF_20210828_UCONN@FRESNO,Fresno St.,,UConn,,1-1,0-2,,31,0,45,0,7,24,7,7,0,0,0,0,1,31,45,0.9515297735556163,[27.56447482]
2021,1,NCAAF_20210828_HAWAII@UCLA,UCLA,,Hawaii,,2-0,1-1,,31,3,44,10,24,7,13,0,3,0,7,0,1,28,34,0.797910427927927,[13.85273742]
2021,1,NCAAF_20210828_UTEP@NMEXST,New Mexico St.,,UTEP,,0-2,2-0,,3,20,3,30,0,3,0,0,17,3,10,0,-2,-17,-27,0.6903358519463404,[8.25010095]
2021,1,NCAAF_20210828_SUT@SJST,San Jose St.,,So. Utah,,1-1,0-2,,38,14,45,14,21,17,7,0,0,14,0,0,1,24,31,0.9127861252995935,[22.55336942]
2021,2,NCAAF_20210911_ILL@UVA,Virginia,Cavaliers,Illinois,Fighting Illini,2-0,1-2,1,21,7,42,14,14,7,14,7,0,7,7,0,1,14,28,0.6856009827270502,[8.04286768]
2021,2,NCAAF_20210911_VMI@KENTST,Kent St.,,VMI,,1-1,1-1,,39,0,60,10,22,17,14,7,0,0,3,7,0,39,50,0.9894054584508023,[38.34265253]
2021,2,NCAAF_20210911_WKY@ARMY,Army,Black Knights,W. Kentucky,Hilltoppers,2-0,1-1,0,21,14,38,35,0,21,7,10,0,14,0,21,1,7,3,0.7428701203925636,[10.85126874]
2021,2,NCAAF_20210911_ALST@AUBURN,Auburn,Tigers,Alabama St.,Hornets,2-0,1-1,0,20,0,62,0,6,14,35,7,0,0,0,0,1,20,62,0.9994981403245665,[54.72861433]
2021,2,NCAAF_20210911_INST@NWEST,Northwestern,,Indiana St.,,1-1,1-1,,14,0,24,6,14,0,3,7,0,0,0,6,0,14,18,0.9789130445657573,[33.80398273]
2021,2,NCAAF_20210911_KENSAW@GATECH,Georgia Tech,,Kennesaw St.,,1-1,1-1,,24,3,45,17,14,10,7,14,0,3,0,14,0,21,28,,
2021,2,NCAAF_20210911_MIAOH@MINN,Minnesota,Golden Gophers,Miami-OH,RedHawks,1-1,0-2,0,21,3,31,26,7,14,0,10,0,3,10,13,1,18,5,0.8798726516500123,[19.53820352]
2021,2,NCAAF_20210911_NRFST@WAKE,Wake Forest,,Norfolk St.,,2-0,0-2,,24,9,41,16,7,17,17,0,3,6,0,7,2,15,25,0.9969416576149346,[45.61091687]
2021,2,NCAAF_20210911_OREG@OHIOST,Ohio State,Buckeyes,Oregon,Ducks,1-1,2-0,1,7,14,28,35,0,7,7,14,0,14,14,7,-1,-7,-7,0.8783955511951443,[19.41597192]
2021,2,NCAAF_20210911_PITT@TENN,Tennessee,Volunteers,Pittsburgh,Panthers,1-1,2-0,0,20,27,34,41,10,10,7,7,0,27,7,7,-1,-7,-7,0.42336906611133873,[-3.21572058]
2021,2,NCAAF_20210911_SC@ECU,East Carolina,Pirates,South Carolina,Gamecocks,0-2,2-0,1,14,7,17,20,7,7,0,3,0,7,7,6,-2,7,-3,0.1070794422381669,[-20.66722367]
2021,2,NCAAF_20210911_TULSA@OKLAST,Oklahoma State,Cowboys,Tulsa,Golden Hurricane,2-0,0-2,1,7,7,28,23,0,7,0,21,0,7,7,9,2,0,5,0.8827899101290546,[19.78275925]
2021,2,NCAAF_20210911_YST@MICHST,Michigan St.,Spartans,Youngstown St.,Penguins,2-0,1-1,1,35,7,42,14,14,21,7,0,0,7,7,0,1,28,28,0.9838258487534481,[35.60548699]
2021,2,NCAAF_20210911_FLA@SFLA,South Florida,Bulls,Florida,Gators,0-2,2-0,0,3,35,20,42,3,0,10,7,14,21,0,7,-2,-32,-22,0.07803061922412846,[-23.59929631]
2021,2,NCAAF_20210911_MRGNST@TULANE,Tulane,,Morgan St.,,1-1,0-2,,52,7,69,20,17,35,7,10,0,7,7,6,1,45,49,0.9997834567152217,[58.54812662]
2021,2,NCAAF_20210911_WYO@NILL,N. Illinois,,Wyoming,,1-1,2-0,,10,28,43,50,3,7,12,21,14,14,14,8,-1,-18,-7,0.3768842092750081,[-5.21874247]
2021,2,NCAAF_20210911_DUQ@OHIO,Ohio,,Duquesne,,0-2,1-1,,13,11,26,28,13,0,0,13,8,3,7,10,-1,2,-2,0.9633443640221404,[29.79582027]
2021,2,NCAAF_20210911_MTSU@VATECH,Virginia Tech,Hokies,Middle Tenn.,Blue Raiders,2-0,1-1,1,14,7,35,14,7,7,14,7,0,7,0,7,1,7,21,0.84039979158321,[16.57260918]
2021,2,NCAAF_20210911_RUT@CUSE,Syracuse,,Rutgers,,1-1,2-0,,0,0,7,17,0,0,7,0,0,0,14,3,-1,0,-10,0.6610133912915772,[6.90837822]
2021,2,NCAAF_20210911_TOLEDO@ND,Notre Dame,Fighting Irish,Toledo,Rockets,2-0,1-1,1,14,16,32,29,7,7,0,18,6,10,0,13,1,-2,3,0.9365956739360786,[25.40220842]
2021,2,NCAAF_20210911_PURDUE@UCONN,UConn,Huskies,Purdue,Boilermakers,0-3,2-0,1,0,35,0,49,0,0,0,0,7,28,14,0,-2,-35,-49,0.015656368481762217,[-35.82170092]
2021,2,NCAAF_20210911_ROB@CMICH,C. Michigan,,Robert Morris,,1-1,0-1,,28,0,45,0,7,21,14,3,0,0,0,0,1,28,45,0.8782836253313617,[19.4067526]
2021,2,NCAAF_20210911_AF@NAVY,Navy,Midshipmen,Air Force,Falcons,0-2,2-0,0,3,7,3,23,0,3,0,0,0,7,7,9,-2,-4,-20,0.42164495651656797,[-3.28900982]
2021,2,NCAAF_20210911_BALLST@PSU,Penn State,Nittany Lions,Ball St.,Cardinals,2-0,1-1,0,24,6,44,13,14,10,10,10,0,6,0,7,1,18,31,0.9933834474415661,[41.2181918]
2021,2,NCAAF_20210911_BC@UMASS,UMass,,Boston College,,0-2,2-0,,0,14,28,45,0,0,21,7,14,0,21,10,-2,-14,-17,0.025449668245024593,[-32.48176282]
2021,2,NCAAF_20210911_BUFF@NEB,Nebraska,Cornhuskers,Buffalo,Bulls,2-1,1-1,0,14,0,28,3,0,14,0,14,0,0,3,0,1,14,25,0.6247751097557848,[5.29148215]
2021,2,NCAAF_20210911_CAL@TCU,TCU,Horned Frogs,California,Golden Bears,2-0,0-2,0,14,19,34,32,0,14,7,13,6,13,0,13,2,-5,2,0.720726997241789,[9.73295417]
2021,2,NCAAF_20210911_GAS@FAU,FAU,,Ga. Southern,,1-1,1-1,,10,6,38,6,0,10,21,7,6,0,0,0,0,4,32,0.7275225747528496,[10.07127406]
2021,2,NCAAF_20210911_MURYST@CINCY,Cincinnati,Bearcats,Murray St.,Racers,2-0,1-1,0,7,7,42,7,0,7,14,21,0,7,0,0,1,0,35,0.994051437244843,[41.8462151]
2021,2,NCAAF_20210911_TEMPLE@AKRON,Akron,,Temple,,0-2,1-1,,17,24,24,45,14,3,0,7,7,17,14,7,-1,-7,-21,0.13561030416997655,[-18.30546049]
2021,2,NCAAF_20210911_TXAM@COLO,Colorado,Buffaloes,Texas A&M,Aggies,1-1,2-0,0,7,3,7,10,7,0,0,0,0,3,0,7,-1,4,-3,0.23348902869045074,[-12.10216428]
2021,2,NCAAF_20210911_UAB@UGA,Georgia,Bulldogs,UAB,Blazers,2-0,1-1,1,35,0,56,7,21,14,14,7,0,0,0,7,1,35,49,0.9781096107036509,[33.54416649]
2021,2,NCAAF_20210911_MERCER@BAMA,Alabama,Crimson Tide,Mercer,Bears,2-0,1-1,1,31,0,48,14,14,17,14,3,0,0,7,7,1,31,34,0.999897074594182,[61.75367726]
2021,2,NCAAF_20210911_SALA@BGREEN,Bowling Green,,South Alabama,,0-2,2-0,,8,6,19,22,8,0,11,0,0,6,6,10,-2,2,-3,0.338686591270567,[-6.92201893]
2021,2,NCAAF_20210911_IOWA@IOWAST,Iowa St.,Cyclones,Iowa,Hawkeyes,1-1,2-0,0,10,14,17,27,3,7,0,7,0,14,10,3,-1,-4,-10,0.3570888072142704,[-6.09348884]
2021,2,NCAAF_20210911_ILST@WMICH,W. Michigan,,Illinois St.,,1-1,1-1,,14,0,28,0,7,7,14,0,0,0,0,0,0,14,28,0.49190155075398356,[-0.33776026]
2021,2,NCAAF_20210911_LIUPOST@WVU,West Virginia,,LIU,,1-1,0-2,,38,0,66,0,21,17,21,7,0,0,0,0,1,38,66,0.9997295601551798,[57.55976045]
2021,2,NCAAF_20210911_SCST@CLEM,Clemson,Tigers,SC State,Bulldogs,1-1,0-2,1,35,3,49,3,28,7,14,0,0,3,0,0,1,32,46,0.999971877575544,[67.01626409]
2021,2,NCAAF_20210911_GRDWB@CHARLO,Charlotte,,Gardner-Webb,,2-0,0-2,,28,10,38,10,14,14,7,3,3,7,0,0,2,18,28,0.9092284542856992,[22.22795604]
2021,2,NCAAF_20210911_LAMAR@TXSA,UTSA,,Lamar,,2-0,1-1,,34,0,54,0,13,21,10,10,0,0,0,0,1,34,54,0.9932732077921193,[41.11999041]
2021,2,NCAAF_20210911_PORTST@WASHST,Washington St.,Cougars,Portland St.,Vikings,1-1,0-2,1,30,10,44,24,7,23,7,7,0,10,0,14,1,20,20,0.9641041608068114,[29.95468994]
2021,2,NCAAF_20210911_BTHN@UCF,UCF,,Bethune-Cook.,,2-0,0-2,,35,7,63,14,14,21,21,7,7,0,7,0,2,28,49,0.998243224860571,[48.56179893]
2021,2,NCAAF_20210911_HOU@RICE,Rice,Owls,Houston,Cougars,0-2,1-1,1,7,17,7,44,0,7,0,0,17,0,14,13,-1,-10,-37,0.09940567712444315,[-21.37822319]
2021,2,NCAAF_20210911_NCCEN@MRSHL,Marshall,,NC Central,,2-0,1-1,,30,7,44,10,6,24,7,7,0,7,0,3,1,23,34,0.9973567468760349,[46.40247687]
2021,2,NCAAF_20210911_APLST@MIAMI,Miami (Fla.),Hurricanes,App. St.,Mountaineers,1-1,1-1,0,12,14,25,23,9,3,7,6,7,7,3,6,0,-2,2,0.6695244997939218,[7.29719736]
2021,2,NCAAF_20210911_EKY@LVILLE,Louisville,,E. Kentucky,,1-1,1-1,,20,3,30,3,7,13,7,3,0,3,0,0,0,17,27,0.9617876233695017,[29.47854625]
2021,2,NCAAF_20210911_EMICH@WISC,Wisconsin,Badgers,E. Michigan,Eagles,1-1,1-1,1,24,0,34,7,7,17,3,7,0,0,0,7,0,24,27,0.968139889134912,[30.84804627]
2021,2,NCAAF_20210911_GRAM@USM,So. Miss,,Grambling,,1-1,1-1,,10,0,37,0,7,3,10,17,0,0,0,0,0,10,37,0.853031457598928,[17.46140697]
2021,2,NCAAF_20210911_HAMP@ODU,Old Dominion,,Hampton,,1-1,1-1,,34,0,47,7,10,24,7,6,0,0,7,0,0,34,40,0.9660367023851297,[30.37156754]
2021,2,NCAAF_20210911_LIB@TROY,Troy,Trojans,Liberty,Flames,1-1,2-0,1,7,14,13,21,7,0,0,6,7,7,0,7,-1,-7,-8,0.5181322329762792,[0.75644569]
2021,2,NCAAF_20210911_MEMP@ARKST,Arkansas St.,,Memphis,,1-1,2-0,,23,34,50,55,10,13,7,20,20,14,7,14,-1,-11,-5,0.20995843933733227,[-13.41919748]
2021,2,NCAAF_20210911_NCST@MISSST,Miss. State,Bulldogs,NC State,Wolfpack,2-0,1-1,0,14,3,24,10,7,7,7,3,0,3,0,7,1,11,14,0.6273266827680871,[5.40353383]
2021,2,NCAAF_20210911_NICHST@LALAF,Louisiana,,Nicholls St.,,1-1,0-2,,17,10,27,24,10,7,7,3,7,3,0,14,1,7,3,0.8511200475867478,[17.32373794]
2021,2,NCAAF_20210911_NMEXST@NMEX,New Mexico,,New Mexico St.,,2-0,0-3,,24,20,34,25,14,10,3,7,3,17,2,3,2,4,9,0.6149980574828895,[4.86428996]
2021,2,NCAAF_20210911_NTEXAS@SMU,SMU,,North Texas,,2-0,1-1,,7,6,35,12,0,7,14,14,3,3,6,0,1,1,23,0.7671049706619172,[12.13446158]
2021,2,NCAAF_20210911_SELOU@LATECH,Louisiana Tech,,SE Louisiana,,1-1,1-1,,24,21,45,42,14,10,14,7,7,14,14,7,0,3,3,0.49054885956512095,[-0.39418646]
2021,2,NCAAF_20210911_SFA@TXTECH,Texas Tech,,S.F. Austin,,2-0,1-1,,7,13,28,22,7,0,14,7,7,6,0,9,1,-6,6,0.9958954924295704,[43.97861812]
2021,2,NCAAF_20210911_SIL@KSTATE,Kansas State,,S. Illinois,,2-0,1-1,,21,23,31,23,14,7,3,7,0,23,0,0,1,-2,8,0.9193603732254972,[23.30545012]
2021,2,NCAAF_20210911_TEXAS@ARK,Arkansas,Razorbacks,Texas,Longhorns,2-0,1-1,1,16,0,40,21,3,13,17,7,0,0,7,14,1,16,19,0.11496190915796012,[-19.97418315]
2021,2,NCAAF_20210911_TXSO@BAYLOR,Baylor,Bears,Texas Southern,Tigers,2-0,0-2,1,42,0,66,7,21,21,10,14,0,0,0,7,2,42,59,0.9998718332973249,[60.82400744]
2021,2,NCAAF_20210911_WCAR@OKLA,Oklahoma,Sooners,W. Carolina,Catamounts,2-0,0-2,0,45,0,76,0,17,28,17,14,0,0,0,0,2,45,76,0.9998893104135569,[61.44680041]
2021,2,NCAAF_20210911_AP@MISS,Ole Miss,Rebels,Austin Peay,Governors,2-0,1-1,0,37,7,54,17,14,23,14,3,0,7,3,7,1,30,37,0.9764198395232252,[33.0229806]
2021,2,NCAAF_20210911_GAST@UNC,North Carolina,Tar Heels,Georgia St.,Panthers,1-1,0-2,0,24,10,59,17,14,10,21,14,3,7,0,7,1,14,42,0.8848941547570837,[19.96184828]
2021,2,NCAAF_20210911_HOW@MD,Maryland,,Howard,,2-0,0-2,,38,0,62,0,14,24,14,10,0,0,0,0,2,38,62,0.9960643173889031,[44.21467638]
2021,2,NCAAF_20210911_IDAHO@IND,Indiana,,Idaho,,1-1,1-1,,35,7,56,14,21,14,7,14,0,7,7,0,0,28,42,0.9581208808888011,[28.77089043]
2021,2,NCAAF_20210911_MIZZOU@UK,Kentucky,Wildcats,Missouri,Tigers,2-0,1-1,1,21,14,35,28,14,7,7,7,7,7,7,7,1,7,7,0.43225897538164104,[-2.83878051]
2021,2,NCAAF_20210911_JAXST@FSU,Florida State,,Jacksonville St.,,0-2,1-1,,14,7,17,20,0,14,3,0,0,7,0,13,-1,7,-3,0.9081154909197834,[22.11516127]
2021,2,NCAAF_20210911_MCN@LSU,LSU,Tigers,McNeese St.,Cowboys,1-1,0-2,0,17,0,34,7,7,10,7,10,0,0,0,7,1,17,27,0.9967630764044088,[45.29985074]
2021,2,NCAAF_20210911_WASH@MICH,Michigan,Wolverines,Washington,Huskies,2-0,0-2,0,10,0,31,10,3,7,7,14,0,0,3,7,2,10,21,0.6440782412269246,[6.14556554]
2021,2,NCAAF_20210911_CPOLY@FRESNO,Fresno St.,,Cal-Poly,,2-1,1-1,,35,10,63,10,7,28,21,7,0,10,0,0,1,25,53,0.9960626455277105,[44.21229462]
2021,2,NCAAF_20210911_SDGST@ARIZ,Arizona,Wildcats,San Diego St.,Aztecs,0-2,2-0,0,7,35,14,38,7,0,0,7,21,14,3,0,-2,-28,-24,0.44082478677984593,[-2.4769581]
2021,2,NCAAF_20210911_VANDY@COLOST,Colorado St.,Rams,Vanderbilt,Commodores,0-2,1-1,1,14,7,21,24,7,7,0,7,0,7,14,3,-1,7,-3,0.49139111085283704,[-0.35905228]
2021,2,NCAAF_20210911_UTAH@BYU,BYU,Cougars,Utah,Utes,2-0,1-1,1,16,7,26,17,3,13,7,3,0,7,0,10,1,9,9,0.22421410582325774,[-12.61182458]
2021,2,NCAAF_20210911_IDST@NEVADA,Nevada,,Idaho State,,2-0,0-2,,21,7,49,10,14,7,7,21,7,0,3,0,2,14,39,0.7688838548760839,[12.23145907]
2021,2,NCAAF_20210911_STNFRD@USC,USC,Trojans,Stanford,Cardinal,1-1,1-1,0,10,21,28,42,0,10,3,15,7,14,14,7,0,-11,-14,0.578524015994885,[3.29619599]
2021,2,NCAAF_20210911_UNLV@ARIZST,Arizona St.,Sun Devils,UNLV,Rebels,2-0,0-2,1,14,10,37,10,0,14,7,16,3,7,0,0,2,4,27,0.911830483122813,[22.49572774]
2021,2,NCAAF_20210911_HAWAII@OREGST,Oregon State,Beavers,Hawaii,Rainbow Warriors,1-1,1-2,1,24,7,45,27,21,3,7,14,0,7,13,7,0,17,18,0.5909338970800628,[3.82574914]
2021,2,NCAAF_20210910_KANSAS@CSTCAR,C. Carolina,Chanticleers,Kansas,Jayhawks,2-0,1-1,0,28,15,49,22,7,21,7,14,9,6,7,0,1,13,27,0.4804522174653164,[-0.8155456]
2021,2,NCAAF_20210910_NCAT@DUKE,Duke,Blue Devils,NC A&T,Aggies,1-1,0-2,1,21,14,45,17,0,21,21,3,7,7,3,0,1,7,28,0.9110185971592872,[22.41155367]
2021,2,NCAAF_20210910_NDK@UTAHST,Utah St.,Aggies,North Dakota,Fighting Hawks,2-0,1-1,0,20,21,48,24,7,13,7,21,21,0,3,0,1,-1,24,0.830962575481135,[15.93828404]
2021,2,NCAAF_20210910_UTEP@BOISE,Boise St.,Broncos,UTEP,Miners,1-1,2-1,0,41,13,54,13,10,31,10,3,3,10,0,0,-1,28,41,0.9870024228427632,[37.03970487]
2021,3,NCAAF_20210919_SJST@HAWAII,Hawaii,,San Jose St.,,1-3,2-1,,7,14,13,17,7,0,6,0,0,14,0,3,-1,-7,-4,0.5934514557396142,[3.92041699]
2021,3,NCAAF_20210918_ALBANY@CUSE,Syracuse,Orange,Albany,Great Danes,2-1,0-3,1,45,10,62,24,21,24,10,7,10,0,0,14,2,35,38,0.963989581281069,[29.82998133]
2021,3,NCAAF_20210918_BC@TEMPLE,Temple,Owls,Boston College,Eagles,1-2,3-0,0,0,21,3,28,0,0,0,3,14,7,0,7,-2,-21,-25,0.2864474619424938,[-9.34856374]
2021,3,NCAAF_20210918_CINCY@IND,Indiana,Hoosiers,Cincinnati,Bearcats,1-2,3-0,0,14,10,24,38,7,7,10,0,0,10,13,15,-2,4,-14,0.6111109513055483,[4.67957408]
2021,3,NCAAF_20210918_CSTCAR@BUFF,Buffalo,Bulls,C. Carolina,Chanticleers,1-2,3-0,1,14,14,25,28,14,0,3,8,7,7,7,7,-2,0,-3,0.7262520986560608,[9.97408112]
2021,3,NCAAF_20210918_MICHST@MIAMI,Miami (Fla.),Hurricanes,Michigan St.,Spartans,1-2,3-0,1,7,10,17,38,0,7,7,3,0,10,7,21,-2,-3,-21,0.5309528949099289,[1.28781283]
2021,3,NCAAF_20210918_NEB@OKLA,Oklahoma,Sooners,Nebraska,Cornhuskers,3-0,2-2,1,7,3,23,16,7,0,9,7,3,0,6,7,1,4,7,0.8785209196430626,[19.36102756]
2021,3,NCAAF_20210918_NILL@MICH,Michigan,Wolverines,N. Illinois,Huskies,3-0,1-2,0,35,3,63,10,14,21,28,0,3,0,0,7,2,32,53,0.9686961885477573,[30.87431182]
2021,3,NCAAF_20210918_NMEX@TXAM,Texas A&M,Aggies,New Mexico,Lobos,3-0,2-1,0,24,0,34,0,14,10,10,0,0,0,0,0,1,24,34,0.959283399253979,[28.89219188]
2021,3,NCAAF_20210918_SEMOST@MIZZOU,Missouri,Tigers,SE Missouri St.,Redhawks,2-1,0-3,1,38,0,59,28,21,17,14,7,0,0,7,21,2,38,31,0.99768304682652,[46.94964663]
2021,3,NCAAF_20210918_TNCHAT@UK,Kentucky,Wildcats,Chattanooga,Mocs,3-0,1-2,1,14,10,28,23,7,7,0,14,7,3,3,10,2,4,5,0.9820065627196235,[34.77276438]
2021,3,NCAAF_20210918_TNTECH@TENN,Tennessee,Volunteers,Tenn. Tech,Golden Eagles,2-1,0-3,1,28,0,56,0,14,14,21,7,0,0,0,0,2,28,56,0.9967315908834109,[45.09457325]
2021,3,NCAAF_20210918_UCONN@ARMY,Army,Black Knights,UConn,Huskies,3-0,0-4,0,42,0,52,21,14,28,7,3,0,0,14,7,3,42,31,0.9415176001586757,[25.99392654]
2021,3,NCAAF_20210918_VATECH@WVU,West Virginia,Mountaineers,Virginia Tech,Hokies,2-1,2-1,0,24,7,27,21,14,10,3,0,7,0,7,7,0,17,6,0.533490440144239,[1.39362831]
2021,3,NCAAF_20210918_WMICH@PITT,Pittsburgh,Panthers,W. Michigan,Broncos,2-1,2-1,0,27,27,41,44,7,20,7,7,14,13,7,10,0,0,-3,0.7406059876512253,[10.69866037]
2021,3,NCAAF_20210918_MINN@COLO,Colorado,Buffaloes,Minnesota,Golden Gophers,1-2,2-1,1,0,13,0,30,0,0,0,0,0,13,7,10,-1,-13,-30,0.28453331069744814,[-9.44197648]
2021,3,NCAAF_20210918_NEVADA@KSTATE,Kansas State,Wildcats,Nevada,Wolf Pack,3-0,2-1,1,17,7,38,17,7,10,0,21,7,0,10,0,1,10,21,0.8110383244084192,[14.62043371]
2021,3,NCAAF_20210918_PURDUE@ND,Notre Dame,Fighting Irish,Purdue,Boilermakers,3-0,2-1,1,10,3,27,13,0,10,7,10,3,0,10,0,1,7,14,0.7363932982070052,[10.48394163]
2021,3,NCAAF_20210918_BAMA@FLA,Florida,Gators,Alabama,Crimson Tide,2-1,3-0,0,9,21,29,31,3,6,14,6,21,0,7,3,-1,-12,-2,0.12343407065170309,[-19.20126744]
2021,3,NCAAF_20210918_BAYLOR@KANSAS,Kansas,Jayhawks,Baylor,Bears,1-2,3-0,0,7,14,7,45,0,7,0,0,7,7,14,17,-2,-7,-38,0.17288421887122296,[-15.63356365]
2021,3,NCAAF_20210918_BRY@AKRON,Akron,,Bryant,,1-2,1-2,,14,7,35,14,7,7,0,21,0,7,7,0,0,7,21,,
2021,3,NCAAF_20210918_DE@RUT,Rutgers,,Delaware,,3-0,2-1,,35,10,45,13,7,28,3,7,0,10,3,0,1,25,32,0.5724308445698804,[3.0272325]
2021,3,NCAAF_20210918_ELON@APLST,App. St.,,Elon,,2-1,1-2,,13,3,44,10,7,6,14,17,3,0,7,0,1,10,34,0.9930889067312959,[40.82131307]
2021,3,NCAAF_20210918_EMICH@UMASS,UMass,,E. Michigan,,0-3,2-1,,7,21,28,42,0,7,7,14,14,7,7,14,-2,-14,-14,0.12386227923003923,[-19.16651181]
2021,3,NCAAF_20210918_FSU@WAKE,Wake Forest,Demon Deacons,Florida State,Seminoles,3-0,0-3,1,27,14,35,14,14,13,8,0,7,7,0,0,3,13,21,0.5995488179679305,[4.18152596]
2021,3,NCAAF_20210918_GATECH@CLEM,Clemson,Tigers,Georgia Tech,Yellow Jackets,2-1,1-2,1,7,3,14,8,7,0,0,7,0,3,0,5,1,4,6,0.9697335040544808,[31.12176604]
2021,3,NCAAF_20210918_IDAHO@OREGST,Oregon State,,Idaho,,2-1,1-2,,28,0,42,0,14,14,14,0,0,0,0,0,1,28,42,0.7716118841758771,[12.33942045]
2021,3,NCAAF_20210918_KENTST@IOWA,Iowa,Hawkeyes,Kent St.,Golden Flashes,3-0,1-2,1,16,7,30,7,9,7,7,7,7,0,0,0,2,9,23,0.9928481477249078,[40.6172427]
2021,3,NCAAF_20210918_LIUPOST@MIAOH,Miami-OH,,LIU,,1-2,0-3,,21,7,42,7,7,14,14,7,0,7,0,0,1,14,35,0.9964153768867519,[44.58577527]
2021,3,NCAAF_20210918_SMU@LATECH,Louisiana Tech,Bulldogs,SMU,Mustangs,1-2,3-0,1,14,16,37,39,7,7,14,9,7,9,17,6,-2,-2,-2,0.26412810276053855,[-10.45748864]
2021,3,NCAAF_20210918_TULSA@OHIOST,Ohio State,Buckeyes,Tulsa,Golden Hurricane,2-1,0-3,1,13,6,41,20,3,10,14,14,3,3,7,7,2,7,21,0.9915748048404668,[39.62917391]
2021,3,NCAAF_20210918_USC@WASHST,Washington St.,Cougars,USC,Trojans,1-2,2-1,0,14,7,14,45,7,7,0,0,0,7,28,10,-1,7,-31,0.4779602813977335,[-0.9165205]
2021,3,NCAAF_20210918_BALLST@WYO,Wyoming,,Ball St.,,3-0,1-2,,31,0,45,12,10,21,0,14,0,0,6,6,2,31,33,0.7915248012428342,[13.45963071]
2021,3,NCAAF_20210918_COLOST@TOLEDO,Toledo,,Colorado St.,,1-2,1-2,,3,3,6,22,0,3,3,0,3,0,10,9,0,0,-16,0.5718091830068123,[3.00096347]
2021,3,NCAAF_20210918_GAS@ARK,Arkansas,Razorbacks,Ga. Southern,Eagles,3-0,1-2,0,24,10,45,10,14,10,14,7,0,10,0,0,2,14,35,0.6684862601180319,[7.22519638]
2021,3,NCAAF_20210918_MISSST@MEMP,Memphis,Tigers,Miss. State,Bulldogs,3-0,2-1,0,7,17,31,29,7,0,7,17,3,14,0,12,1,-10,2,0.3710201787827573,[-5.4578599]
2021,3,NCAAF_20210918_NWEST@DUKE,Duke,Blue Devils,Northwestern,Wildcats,2-1,1-2,0,30,7,30,23,21,9,0,0,0,7,13,3,1,23,7,0.2832982765826104,[-9.50240679]
2021,3,NCAAF_20210918_SACST@CAL,California,,Sacramento St.,,1-2,1-2,,21,6,42,30,14,7,14,7,6,0,14,10,0,15,12,0.8922047010575134,[20.53356996]
2021,3,NCAAF_20210918_ARKST@WASH,Washington,,Arkansas St.,,1-2,1-2,,28,0,52,3,14,14,7,17,0,0,3,0,0,28,49,0.9265061272901127,[24.04745576]
2021,3,NCAAF_20210918_MURYST@BGREEN,Bowling Green,,Murray St.,,1-2,1-2,,10,10,27,10,7,3,10,7,0,10,0,0,0,0,17,0.6698875687932757,[7.28929441]
2021,3,NCAAF_20210918_ECU@MRSHL,Marshall,,East Carolina,,2-1,1-2,,24,21,38,42,10,14,14,0,7,14,0,21,1,3,-4,0.7852438049850758,[13.09986068]
2021,3,NCAAF_20210918_FORD@FAU,FAU,,Fordham,,2-1,0-3,,14,7,45,14,7,7,14,17,0,7,0,7,2,7,31,0.9978349668333533,[47.30812884]
2021,3,NCAAF_20210918_MTSU@TXSA,UTSA,,Middle Tenn.,,3-0,1-2,,10,0,27,13,7,3,7,10,0,0,0,13,2,10,14,0.34752498390724407,[-6.50015243]
2021,3,NCAAF_20210918_ODU@LIB,Liberty,,Old Dominion,,3-0,1-2,,28,17,45,17,14,14,14,3,3,14,0,0,2,11,28,0.7907513436510729,[13.41498758]
2021,3,NCAAF_20210918_CHARLO@GAST,Georgia St.,,Charlotte,,1-2,2-1,,7,7,20,9,0,7,6,7,0,7,2,0,-1,0,11,0.5194222782830464,[0.80758247]
2021,3,NCAAF_20210918_FAMU@SFLA,South Florida,,Florida A&M,,1-2,1-2,,24,3,38,17,10,14,7,7,3,0,7,7,0,21,21,0.9952465838010475,[43.00042143]
2021,3,NCAAF_20210918_FIU@TXTECH,Texas Tech,,FIU,,3-0,1-2,,35,14,54,21,7,28,9,10,7,7,7,0,2,21,33,0.8268890703879564,[15.61887325]
2021,3,NCAAF_20210918_GRAM@HOU,Houston,,Grambling,,2-1,1-2,,21,0,45,0,7,14,21,3,0,0,0,0,1,21,45,0.9798369362310743,[33.99868745]
2021,3,NCAAF_20210918_SC@UGA,Georgia,Bulldogs,South Carolina,Gamecocks,3-0,2-1,1,26,6,40,13,14,12,14,0,6,0,0,7,1,20,27,0.9069830018858449,[21.92749041]
2021,3,NCAAF_20210918_TROY@USM,So. Miss,,Troy,,1-2,2-1,,3,0,9,21,3,0,0,6,0,0,14,7,-1,3,-12,0.3986372241722177,[-4.25940316]
2021,3,NCAAF_20210918_UIW@TXSTSM,Texas St.,,Incarnate Word,,1-2,2-1,,17,14,34,42,7,10,7,10,14,0,14,14,-1,3,-8,0.9447886099292315,[26.46905675]
2021,3,NCAAF_20210918_AUBURN@PSU,Penn State,Nittany Lions,Auburn,Tigers,3-0,2-1,1,14,10,28,20,7,7,7,7,3,7,7,3,1,4,8,0.6170791128117254,[4.93829043]
2021,3,NCAAF_20210918_CMICH@LSU,LSU,Tigers,C. Michigan,Chippewas,2-1,1-2,1,35,7,49,21,21,14,7,7,7,0,7,7,1,28,28,0.9505197298565354,[27.35812944]
2021,3,NCAAF_20210918_FUR@NCST,NC State,,Furman,,2-1,2-1,,38,0,45,7,10,28,7,0,0,0,7,0,0,38,38,0.9091595199575573,[22.14627127]
2021,3,NCAAF_20210918_STONYBRK@OREG,Oregon,Ducks,Stony Brook,Seawolves,3-0,1-2,0,17,7,48,7,10,7,14,17,7,0,0,0,2,10,41,0.9993641997107103,[53.43094534]
2021,3,NCAAF_20210918_UAB@NTEXAS,North Texas,,UAB,,1-2,2-1,,0,30,6,40,0,0,0,6,17,13,3,7,-1,-30,-34,0.4048758467561555,[-3.99194792]
2021,3,NCAAF_20210918_UTAHST@AF,Air Force,,Utah St.,,2-1,3-0,,24,13,45,49,10,14,14,7,7,6,21,15,-1,11,-4,0.5033589794225255,[0.13961353]
2021,3,NCAAF_20210918_UVA@UNC,North Carolina,Tar Heels,Virginia,Cavaliers,2-1,2-1,0,24,28,59,39,21,3,21,14,7,21,3,8,0,-4,20,0.483125842228846,[-0.70156305]
2021,3,NCAAF_20210918_ALCORN@SALA,South Alabama,,Alcorn St.,,3-0,1-2,,7,14,28,21,7,0,21,0,0,14,0,7,2,-7,7,0.6994193513327509,[8.66769384]
2021,3,NCAAF_20210918_JACKST@LAMON,UL-Monroe,,Jackson St.,,1-1,2-1,,3,7,12,7,3,0,3,6,0,7,0,0,-1,-4,5,0.9443263945548823,[26.40059395]
2021,3,NCAAF_20210918_RICE@TEXAS,Texas,Longhorns,Rice,Owls,2-1,0-3,1,44,0,58,0,16,28,14,0,0,0,0,0,2,44,58,0.9834728791162936,[35.3423095]
2021,3,NCAAF_20210918_SCST@NMEXST,New Mexico St.,,SC State,,1-3,0-3,,36,13,43,35,15,21,7,0,0,13,7,15,1,23,8,0.6576717847443985,[6.73405373]
2021,3,NCAAF_20210918_STNFRD@VANDY,Vanderbilt,Commodores,Stanford,Cardinal,1-2,2-1,0,14,27,23,41,7,7,3,6,14,13,7,7,-1,-13,-18,0.18339639644047057,[-14.9648024]
2021,3,NCAAF_20210918_TULANE@MISS,Ole Miss,Rebels,Tulane,Green Wave,3-0,1-2,1,40,21,61,21,19,21,21,0,7,14,0,0,2,19,40,0.5990673981777439,[4.16087309]
2021,3,NCAAF_20210918_OKLAST@BOISE,Boise St.,Broncos,Oklahoma State,Cowboys,1-2,3-0,1,20,21,20,21,10,10,0,0,7,14,0,0,-2,-1,-1,0.4233429765710991,[-3.20601966]
2021,3,NCAAF_20210918_NAZ@ARIZ,Arizona,Wildcats,N. Arizona,Lumberjacks,0-3,1-2,1,13,7,19,21,10,3,0,6,0,7,7,7,-1,6,-2,0.9692266832471422,[31.]
2021,3,NCAAF_20210918_ARIZST@BYU,BYU,Cougars,Arizona St.,Sun Devils,3-0,2-1,1,21,7,27,17,7,14,0,6,7,0,10,0,1,14,10,0.41643270527897425,[-3.49917146]
2021,3,NCAAF_20210918_IOWAST@UNLV,UNLV,Rebels,Iowa St.,Cyclones,0-3,2-1,0,0,24,3,48,0,0,3,0,7,17,14,10,-2,-24,-45,0.031617510964827567,[-30.80081476]
2021,3,NCAAF_20210918_FRESNO@UCLA,UCLA,Bruins,Fresno St.,Bulldogs,2-1,3-1,0,10,23,37,40,7,3,7,20,6,17,3,14,-1,-13,-3,0.4938033211028241,[-0.25756776]
2021,3,NCAAF_20210917_UCF@LVILLE,Louisville,Cardinals,UCF,Knights,2-1,2-1,1,21,14,42,35,7,14,7,14,7,7,7,14,0,7,7,0.2003808853542327,[-13.93283795]
2021,3,NCAAF_20210917_MD@ILL,Illinois,Fighting Illini,Maryland,Terrapins,1-3,3-0,1,3,3,17,20,0,3,7,7,0,3,7,10,-2,0,-3,0.3954940329206301,[-4.39457114]
2021,3,NCAAF_20210916_OHIO@LALAF,Louisiana,Ragin' Cajuns,Ohio,Bobcats,2-1,0-3,0,21,7,49,14,7,14,7,21,0,7,7,0,2,14,35,0.41416392939541513,[-3.59565337]
2021,4,NCAAF_20210925_BGREEN@MINN,Minnesota,Golden Gophers,Bowling Green,Falcons,2-2,2-2,0,3,7,10,14,3,0,7,0,0,7,7,0,0,-4,-4,0.9892036087192853,[38.10999172]
2021,4,NCAAF_20210925_BOISE@UTAHST,Utah St.,Aggies,Boise St.,Broncos,3-1,2-2,1,0,10,3,27,0,0,0,3,10,0,7,10,1,-10,-24,0.30236705207608694,[-8.58598056]
2021,4,NCAAF_20210925_FIU@CMICH,C. Michigan,Chippewas,FIU,Panthers,2-2,1-3,1,10,14,31,27,0,10,0,21,0,14,13,0,1,-4,4,0.5509491407413524,[2.12424309]
2021,4,NCAAF_20210925_LSU@MISSST,Miss. State,Bulldogs,LSU,Tigers,2-2,3-1,1,3,7,25,28,0,3,7,15,7,0,14,7,-1,-4,-3,0.3241055154595991,[-7.56821548]
2021,4,NCAAF_20210925_MIAOH@ARMY,Army,Black Knights,Miami-OH,RedHawks,4-0,1-3,0,17,3,23,10,7,10,0,6,0,3,0,7,3,14,13,0.6985077887703182,[8.62759749]
2021,4,NCAAF_20210925_ND@WISC,Wisconsin,Badgers,Notre Dame,Fighting Irish,1-2,4-0,0,3,10,13,41,3,0,7,3,0,10,0,31,-3,-7,-28,0.5639850653138612,[2.67199169]
2021,4,NCAAF_20210925_NH@PITT,Pittsburgh,Panthers,New Hamp.,Wildcats,3-1,3-1,0,49,7,77,7,28,21,21,7,0,7,0,0,0,42,70,0.917713335132295,[23.05476804]
2021,4,NCAAF_20210925_NOVA@PSU,Penn State,Nittany Lions,Villanova,Wildcats,4-0,3-1,0,17,3,38,17,7,10,14,7,3,0,0,14,1,14,21,0.9783161236673097,[33.51008058]
2021,4,NCAAF_20210925_OHIO@NWEST,Northwestern,Wildcats,Ohio,Bobcats,2-2,0-4,0,17,0,35,6,14,3,0,18,0,0,0,6,2,17,29,0.7535986651942694,[11.37695103]
2021,4,NCAAF_20210925_RICH@VATECH,Virginia Tech,Hokies,Richmond,Spiders,3-1,2-2,1,14,7,21,10,7,7,7,0,0,7,3,0,1,7,11,0.9783020776539477,[33.505588]
2021,4,NCAAF_20210925_SMU@TCU,TCU,Horned Frogs,SMU,Mustangs,2-1,4-0,0,21,21,34,42,14,7,6,7,14,7,14,7,-2,0,-8,0.7625884271905914,[11.85460939]
2021,4,NCAAF_20210925_TXTECH@TEXAS,Texas,Longhorns,Texas Tech,Red Raiders,3-1,3-1,1,42,14,70,35,14,28,21,7,0,14,14,7,0,28,35,0.7042019432720894,[8.89982044]
2021,4,NCAAF_20210925_UGA@VANDY,Vanderbilt,Commodores,Georgia,Bulldogs,1-3,4-0,1,0,38,0,62,0,0,0,0,35,3,17,7,-3,-38,-62,0.02304646135527011,[-33.08527454]
2021,4,NCAAF_20210925_WAG@TEMPLE,Temple,Owls,Wagner,Seahawks,2-2,0-4,0,17,7,41,7,0,17,17,7,7,0,0,0,2,10,34,0.9909799223263337,[39.22697395]
2021,4,NCAAF_20210925_CCTST@MIAMI,Miami (Fla.),Hurricanes,CCSU,Blue Devils,2-2,1-3,1,49,0,69,0,21,28,13,7,0,0,0,0,1,49,69,0.9891793505502622,[38.09588311]
2021,4,NCAAF_20210925_UMASS@CSTCAR,C. Carolina,Chanticleers,UMass,Minutemen,4-0,0-4,0,36,0,53,3,13,23,14,3,0,0,0,3,4,36,50,0.8296931777466721,[15.80750726]
2021,4,NCAAF_20210925_SJST@WMICH,W. Michigan,Broncos,San Jose St.,Spartans,3-1,2-2,1,20,3,23,3,13,7,0,3,3,0,0,0,1,17,20,0.7023293987428836,[8.8100377]
2021,4,NCAAF_20210925_TOLEDO@BALLST,Ball St.,Cardinals,Toledo,Rockets,1-3,2-2,1,9,14,12,22,6,3,0,3,7,7,0,8,-1,-5,-10,0.24223252792557814,[-11.59725836]
2021,4,NCAAF_20210925_TXSTSM@EMICH,E. Michigan,Eagles,Texas St.,Bobcats,3-1,1-3,0,28,14,59,21,14,14,10,21,7,7,7,0,2,14,38,0.8125038164937805,[14.71614323]
2021,4,NCAAF_20210925_ME@NILL,N. Illinois,Huskies,Maine,Black Bears,2-2,1-3,1,21,14,41,14,7,14,3,17,7,7,0,0,1,7,27,0.798754733941997,[13.88709274]
2021,4,NCAAF_20210925_WASHST@UTAH,Utah,Utes,Washington St.,Cougars,2-2,1-3,0,7,6,24,13,0,7,3,14,0,6,7,0,1,1,11,0.6216862180757431,[5.14079946]
2021,4,NCAAF_20210925_COLOST@IOWA,Iowa,Hawkeyes,Colorado St.,Rams,4-0,1-3,0,7,14,24,14,0,7,14,3,0,14,0,0,3,-7,10,0.9540173020054941,[27.95262252]
2021,4,NCAAF_20210925_ILL@PURDUE,Purdue,,Illinois,,3-1,1-4,,6,3,13,9,6,0,0,7,0,3,3,3,2,3,4,0.7915614273870202,[13.46691167]
2021,4,NCAAF_20210925_IOWAST@BAYLOR,Baylor,Bears,Iowa St.,Cyclones,4-0,2-2,0,21,13,31,29,7,14,7,3,7,6,10,6,2,8,2,0.24722334302669724,[-11.33374776]
2021,4,NCAAF_20210925_KENTST@MD,Maryland,,Kent St.,,4-0,1-3,,24,9,37,16,7,17,13,0,6,3,0,7,3,15,21,0.8749482240862945,[19.07772139]
2021,4,NCAAF_20210925_LVILLE@FSU,Florida State,Seminoles,Louisville,Cardinals,0-4,3-1,0,13,31,23,31,0,13,7,3,17,14,0,0,-3,-18,-8,0.486745052515137,[-0.55123853]
2021,4,NCAAF_20210925_RUT@MICH,Michigan,Wolverines,Rutgers,Scarlet Knights,4-0,3-1,1,20,3,20,13,7,13,0,0,3,0,7,3,1,17,7,0.9633602730932046,[29.71037917]
2021,4,NCAAF_20210925_TWST@SDGST,San Diego St.,,Towson,,4-0,1-3,,21,14,48,21,7,14,24,3,7,7,0,7,3,7,27,0.9771742609590292,[33.15262499]
2021,4,NCAAF_20210925_TXAM@ARK,Arkansas,Razorbacks,Texas A&M,Aggies,4-0,3-1,0,17,3,20,10,10,7,0,3,0,3,7,0,1,14,10,0.16853792124249967,[-15.92371455]
2021,4,NCAAF_20210925_TXSA@MEMP,Memphis,,UTSA,,3-1,4-0,,21,7,28,31,21,0,7,0,0,7,7,17,-1,14,-3,0.9051813287971995,[21.75757806]
2021,4,NCAAF_20210925_WYO@UCONN,UConn,Huskies,Wyoming,Cowboys,0-5,4-0,1,13,3,22,24,10,3,0,9,0,3,7,14,-4,10,-2,0.06190577009523679,[-25.52830258]
2021,4,NCAAF_20210925_GAST@AUBURN,Auburn,Tigers,Georgia St.,Panthers,3-1,1-3,0,12,24,34,24,6,6,7,15,3,21,0,0,2,-12,10,0.9876188297183895,[37.24135659]
2021,4,NCAAF_20210925_KANSAS@DUKE,Duke,,Kansas,,3-1,1-3,,21,24,52,33,7,14,21,10,3,21,3,6,2,-3,19,0.7527183995192072,[11.33068877]
2021,4,NCAAF_20210925_ARKST@TULSA,Tulsa,Golden Hurricane,Arkansas St.,Red Wolves,1-3,1-3,0,24,14,41,34,7,17,14,3,14,0,17,3,0,10,7,0.5641020591937151,[2.6769199]
2021,4,NCAAF_20210925_BUFF@ODU,Old Dominion,,Buffalo,,1-3,2-2,,7,35,34,35,7,0,14,13,7,28,0,0,-1,-28,-1,0.12259084979747481,[-19.27734817]
2021,4,NCAAF_20210925_CHARSO@ECU,East Carolina,,Charleston So.,,2-2,1-2,,24,14,31,28,0,24,7,0,14,0,0,14,1,10,3,0.9104065973116795,[22.28192805]
2021,4,NCAAF_20210925_UCLA@STNFRD,Stanford,Cardinal,UCLA,Bruins,2-2,3-1,1,7,21,24,35,0,7,7,10,14,7,0,14,-1,-14,-11,0.6239518193243037,[5.23972878]
2021,4,NCAAF_20210925_UL@GAS,Ga. Southern,,Louisiana,,1-3,3-1,,13,14,20,28,7,6,0,7,0,14,14,0,-2,-1,-8,0.33180887701516304,[-7.21447686]
2021,4,NCAAF_20210925_TXSO@RICE,Rice,,Texas Southern,,1-3,0-3,,20,6,48,34,14,6,14,14,0,6,7,21,1,14,14,0.9792363316877605,[33.80991112]
2021,4,NCAAF_20210925_KSTATE@OKLAST,Oklahoma State,Cowboys,Kansas State,Wildcats,4-0,3-1,0,31,13,31,20,21,10,0,0,10,3,7,0,1,18,11,0.6246320890902294,[5.26946957]
2021,4,NCAAF_20210925_NAVY@HOU,Houston,Cougars,Navy,Midshipmen,3-1,0-3,0,7,17,28,20,7,0,7,14,7,10,0,3,3,-10,8,0.5899930351539964,[3.77419859]
2021,4,NCAAF_20210925_NTEXAS@LATECH,Louisiana Tech,,North Texas,,2-2,1-3,,24,7,24,17,14,10,0,0,0,7,0,10,1,17,7,0.5743133278313148,[3.10801757]
2021,4,NCAAF_20210925_TENN@FLA,Florida,Gators,Tennessee,Volunteers,3-1,2-2,0,17,14,38,14,10,7,14,7,7,7,0,0,1,3,24,0.8005151799070807,[13.99128638]
2021,4,NCAAF_20210925_UK@SC,South Carolina,Gamecocks,Kentucky,Wildcats,2-2,4-0,0,0,10,10,16,0,0,7,3,7,3,3,3,-2,-10,-6,0.4456037801986463,[-2.26883427]
2021,4,NCAAF_20210925_AKRON@OHIOST,Ohio State,Buckeyes,Akron,Zips,3-1,1-3,0,38,7,59,7,14,24,14,7,7,0,0,0,2,31,52,0.9997136083455009,[57.13183624]
2021,4,NCAAF_20210925_UNC@GATECH,Georgia Tech,Yellow Jackets,North Carolina,Tar Heels,2-2,2-2,0,13,7,45,22,0,13,14,18,7,0,7,8,0,6,23,0.4021902493777536,[-4.1085261]
2021,4,NCAAF_20210925_USM@BAMA,Alabama,Crimson Tide,So. Miss,Golden Eagles,4-0,1-3,0,42,7,63,14,21,21,7,14,0,7,0,7,3,35,49,0.9972083191718857,[45.97001378]
2021,4,NCAAF_20210925_WVU@OKLA,Oklahoma,Sooners,West Virginia,Mountaineers,4-0,2-2,0,7,10,16,13,7,0,3,6,7,3,3,0,2,-3,3,0.8303854610109038,[15.85289388]
2021,4,NCAAF_20210925_FAU@AF,Air Force,Falcons,FAU,Owls,3-1,2-2,0,24,7,31,7,14,10,7,0,0,7,0,0,1,17,24,0.5400212764097132,[1.66687474]
2021,4,NCAAF_20210925_HAWAII@NMEXST,New Mexico St.,,Hawaii,,1-4,2-3,,13,17,21,41,3,10,0,8,10,7,7,17,-1,-4,-20,0.26970241820053675,[-10.18022054]
2021,4,NCAAF_20210925_IND@WKY,W. Kentucky,Hilltoppers,Indiana,Hoosiers,1-2,2-2,0,14,23,31,33,0,14,10,7,14,9,3,7,-1,-9,-2,0.1006195073559425,[-21.19983987]
2021,4,NCAAF_20210925_TROY@LAMON,UL-Monroe,,Troy,,2-1,2-2,,10,3,29,16,7,3,10,9,0,3,7,6,0,7,13,0.1850823461803518,[-14.86550366]
2021,4,NCAAF_20210925_UAB@TULANE,Tulane,,UAB,,1-3,3-1,,14,21,21,28,0,14,0,7,7,14,7,0,-2,-7,-7,0.6640727988889223,[7.02671074]
2021,4,NCAAF_20210925_NMEX@UTEP,UTEP,,New Mexico,,3-1,2-2,,3,13,20,13,0,3,14,3,7,6,0,0,1,-10,7,0.23531321193959054,[-11.96751735]
2021,4,NCAAF_20210925_SFLA@BYU,BYU,Cougars,South Florida,Bulls,4-0,1-3,1,28,6,35,27,21,7,7,0,0,6,14,7,3,22,8,0.7580558689978056,[11.61257464]
2021,4,NCAAF_20210925_ARIZ@OREG,Oregon,Ducks,Arizona,Wildcats,4-0,0-4,1,24,10,41,19,17,7,0,17,7,3,9,0,4,14,22,0.8502800632122318,[17.21220196]
2021,4,NCAAF_20210925_COLO@ARIZST,Arizona St.,Sun Devils,Colorado,Buffaloes,3-1,1-3,1,14,3,35,13,7,7,7,14,0,3,7,3,2,11,22,0.6457492921616418,[6.20171378]
2021,4,NCAAF_20210925_OREGST@USC,USC,Trojans,Oregon State,Beavers,2-2,3-1,1,17,21,27,45,7,10,0,10,7,14,14,10,-1,-4,-18,0.8644500714138125,[18.25554718]
2021,4,NCAAF_20210924_MTSU@CHARLO,Charlotte,49ers,Middle Tenn.,Blue Raiders,3-1,1-3,0,14,17,42,39,14,0,14,14,7,10,7,15,2,-3,3,0.32369496467499337,[-7.5871635]
2021,4,NCAAF_20210924_WAKE@UVA,Virginia,Cavaliers,Wake Forest,Demon Deacons,2-2,4-0,0,3,20,17,37,0,3,14,0,10,10,14,3,-2,-17,-20,0.4759213547765636,[-1.00179212]
2021,4,NCAAF_20210924_LIB@CUSE,Syracuse,Orange,Liberty,Flames,3-1,3-1,1,14,7,24,21,0,14,7,3,0,7,7,7,0,7,3,0.649872428539703,[6.38594877]
2021,4,NCAAF_20210924_UNLV@FRESNO,Fresno St.,Bulldogs,UNLV,Rebels,4-1,0-4,1,9,14,38,30,0,9,13,16,14,0,7,9,4,-5,8,0.8858768299042364,[19.98658337]
2021,4,NCAAF_20210923_MRSHL@APLST,App. St.,Mountaineers,Marshall,Thundering Herd,3-1,2-2,0,21,20,31,30,7,14,0,10,6,14,10,0,1,1,1,0.6405065049966506,[5.96854576]
2021,5,NCAAF_20211002_ARK@UGA,Georgia,Bulldogs,Arkansas,Razorbacks,5-0,4-1,1,24,0,37,0,21,3,3,10,0,0,0,0,1,24,37,0.963608843487412,[29.80592068]
2021,5,NCAAF_20211002_CHARLO@ILL,Illinois,Fighting Illini,Charlotte,49ers,2-4,3-2,1,10,14,24,14,3,7,14,0,7,7,0,0,-1,-4,10,0.7955788166588065,[13.72075057]
2021,5,NCAAF_20211002_DUKE@UNC,North Carolina,Tar Heels,Duke,Blue Devils,3-2,3-2,1,24,0,38,7,7,17,0,14,0,0,7,0,0,24,31,0.6045441689768115,[4.40440437]
2021,5,NCAAF_20211002_MEMP@TEMPLE,Temple,Owls,Memphis,Tigers,3-2,3-2,1,17,17,34,31,0,17,7,10,3,14,6,8,0,0,3,0.261200195690525,[-10.62613844]
2021,5,NCAAF_20211002_MICH@WISC,Wisconsin,Badgers,Michigan,Wolverines,1-3,5-0,0,10,13,17,38,0,10,0,7,7,6,7,18,-4,-3,-21,0.46745586335954925,[-1.35668344]
2021,5,NCAAF_20211002_MINN@PURDUE,Purdue,Boilermakers,Minnesota,Golden Gophers,3-2,3-2,1,13,10,13,20,3,10,0,0,7,3,7,3,0,3,-7,0.4930674914294826,[-0.2886925]
2021,5,NCAAF_20211002_PITT@GATECH,Georgia Tech,Yellow Jackets,Pittsburgh,Panthers,2-3,4-1,0,14,42,21,52,7,7,7,0,21,21,7,3,-2,-28,-31,0.4110462515094294,[-3.73538002]
2021,5,NCAAF_20211002_TENN@MIZZOU,Missouri,Tigers,Tennessee,Volunteers,2-3,3-2,1,10,45,24,62,3,7,7,7,28,17,10,7,-1,-35,-38,0.6839101220500927,[7.95172619]
2021,5,NCAAF_20211002_TEXAS@TCU,TCU,Horned Frogs,Texas,Longhorns,2-2,4-1,1,17,23,27,32,14,3,3,7,13,10,3,6,-2,-6,-5,0.43165352001076307,[-2.86009623]
2021,5,NCAAF_20211002_TOLEDO@UMASS,UMass,Minutemen,Toledo,Rockets,0-5,3-2,0,0,31,7,45,0,0,0,7,7,24,7,7,-3,-31,-38,0.0804375165784752,[-23.29287141]
2021,5,NCAAF_20211002_WMICH@BUFF,Buffalo,Bulls,W. Michigan,Broncos,2-3,4-1,0,7,7,17,24,7,0,3,7,7,0,0,17,-2,0,-7,0.578987713921219,[3.31093281]
2021,5,NCAAF_20211002_LVILLE@WAKE,Wake Forest,Demon Deacons,Louisville,Cardinals,5-0,3-2,1,20,17,37,34,10,10,7,10,10,7,0,17,2,3,3,0.6097347272401756,[4.62868475]
2021,5,NCAAF_20211002_APLST@GAST,Georgia St.,Panthers,App. St.,Mountaineers,1-4,4-1,1,6,14,16,45,0,6,3,7,7,7,17,14,-3,-8,-29,0.12212946857085893,[-19.34364294]
2021,5,NCAAF_20211002_USC@COLO,Colorado,Buffaloes,USC,Trojans,1-4,3-2,0,7,20,14,37,0,7,7,0,10,10,10,7,-2,-13,-23,0.249211713433924,[-11.24616111]
2021,5,NCAAF_20211002_CINCY@ND,Notre Dame,Fighting Irish,Cincinnati,Bearcats,4-1,4-0,1,0,17,13,24,0,0,7,6,0,17,0,7,0,-17,-11,0.819407474977736,[15.16896933]
2021,5,NCAAF_20211002_EMICH@NILL,N. Illinois,Huskies,E. Michigan,Eagles,3-2,3-2,0,17,3,27,20,10,7,7,3,0,3,14,3,0,14,7,0.4925515595189257,[-0.31018002]
2021,5,NCAAF_20211002_LAMON@CSTCAR,C. Carolina,Chanticleers,UL-Monroe,Warhawks,5-0,2-2,0,38,3,59,6,14,24,0,21,3,0,3,0,3,35,53,0.7331302013529587,[10.33804534]
2021,5,NCAAF_20211002_BGREEN@KENTST,Kent St.,,Bowling Green,,2-3,2-3,,13,6,27,20,10,3,7,7,3,3,14,0,0,7,7,0.6826098135390044,[7.89106053]
2021,5,NCAAF_20211002_CMICH@MIAOH,Miami-OH,,C. Michigan,,2-3,2-3,,14,7,28,17,14,0,0,14,0,7,3,7,0,7,11,0.4955433621544221,[-0.18558361]
2021,5,NCAAF_20211002_CUSE@FSU,Florida State,Seminoles,Syracuse,Orange,1-4,3-2,0,16,13,33,30,3,13,7,10,0,13,7,10,-2,3,3,0.5183151982695493,[0.76293493]
2021,5,NCAAF_20211002_FIU@FAU,FAU,Owls,FIU,Panthers,3-2,1-4,1,34,21,58,21,7,27,10,14,7,14,0,0,2,13,37,0.7393177395621383,[10.6526153]
2021,5,NCAAF_20211002_MISS@BAMA,Alabama,Crimson Tide,Ole Miss,Rebels,5-0,3-1,0,28,0,42,21,7,21,7,7,0,0,7,14,2,28,21,0.9591547654977458,[28.92159657]
2021,5,NCAAF_20211002_NEVADA@BOISE,Boise St.,Broncos,Nevada,Wolf Pack,2-3,3-1,0,21,20,31,41,14,7,3,7,10,10,18,3,-1,1,-10,0.8524142485255726,[17.39062915]
2021,5,NCAAF_20211002_OHIO@AKRON,Akron,,Ohio,,1-4,1-4,,10,10,17,34,0,10,7,0,3,7,7,17,0,0,-17,0.11142413910530813,[-20.25037961]
2021,5,NCAAF_20211002_OHIOST@RUT,Rutgers,Scarlet Knights,Ohio State,Buckeyes,3-2,4-1,1,6,45,13,52,6,0,0,7,24,21,7,0,-1,-39,-39,0.010216752549139896,[-38.51246075]
2021,5,NCAAF_20211002_OKLA@KSTATE,Kansas State,Wildcats,Oklahoma,Sooners,3-2,5-0,1,10,13,31,37,7,3,7,14,3,10,14,10,-2,-3,-6,0.1584743749805957,[-16.62485798]
2021,5,NCAAF_20211002_TROY@SC,South Carolina,Gamecocks,Troy,Trojans,3-2,2-3,1,17,7,23,14,3,14,3,3,0,7,7,0,1,10,9,0.7602326830539003,[11.74584292]
2021,5,NCAAF_20211002_TULANE@ECU,East Carolina,,Tulane,,3-2,1-4,,31,7,52,29,17,14,0,21,0,7,16,6,2,24,23,0.18634186260417773,[-14.80928166]
2021,5,NCAAF_20211002_TXTECH@WVU,West Virginia,Mountaineers,Texas Tech,Red Raiders,2-3,4-1,0,0,17,20,23,0,0,17,3,14,3,0,6,-2,-17,-3,0.5916071441743761,[3.84878726]
2021,5,NCAAF_20211002_UCF@NAVY,Navy,Midshipmen,UCF,Knights,1-3,2-2,1,17,23,34,30,7,10,0,17,13,10,7,0,-1,-6,4,0.147670343989307,[-17.38453743]
2021,5,NCAAF_20211002_ARKST@GAS,Ga. Southern,,Arkansas St.,,2-3,1-4,,31,19,59,33,10,21,14,14,3,16,0,14,1,12,26,0.4063606975161468,[-3.93576372]
2021,5,NCAAF_20211002_SFLA@SMU,SMU,Mustangs,South Florida,Bulls,5-0,1-4,1,17,3,41,17,10,7,10,14,0,3,14,0,4,14,24,0.7089010769495334,[9.13978291]
2021,5,NCAAF_20211002_ARMY@BALLST,Ball St.,Cardinals,Army,Black Knights,2-3,4-1,0,21,14,28,16,21,0,0,7,0,14,0,2,-2,7,12,0.172816623649104,[-15.66707417]
2021,5,NCAAF_20211002_WASHST@CAL,California,Golden Bears,Washington St.,Cougars,1-4,2-3,0,6,14,6,21,6,0,0,0,14,0,7,0,-1,-8,-15,0.3576082143192799,[-6.06120164]
2021,5,NCAAF_20211002_FLA@UK,Kentucky,Wildcats,Florida,Gators,5-0,3-2,0,7,10,20,13,7,0,6,7,7,3,0,3,2,-3,7,0.2925611766692876,[-9.06902619]
2021,5,NCAAF_20211002_LATECH@NCST,NC State,Wolfpack,Louisiana Tech,Bulldogs,4-1,2-3,0,13,10,34,27,7,6,14,7,0,10,3,14,2,3,7,0.8095117600930957,[14.55412976]
2021,5,NCAAF_20211002_UNLV@TXSA,UTSA,,UNLV,,5-0,0-5,,17,10,24,17,7,10,7,0,7,3,0,7,5,7,7,0.5115476578682135,[0.48092549]
2021,5,NCAAF_20211002_AF@NMEX,New Mexico,Lobos,Air Force,Falcons,2-3,4-1,1,0,24,10,38,0,0,7,3,7,17,7,7,-2,-24,-28,0.13860458981201107,[-18.05123906]
2021,5,NCAAF_20211002_USM@RICE,Rice,,So. Miss,,2-3,1-4,,10,7,24,19,7,3,14,0,7,0,7,5,1,3,5,0.2497532147886825,[-11.21782182]
2021,5,NCAAF_20211002_BAYLOR@OKLAST,Oklahoma State,Cowboys,Baylor,Bears,5-0,4-1,1,14,0,24,14,7,7,0,10,0,0,7,7,1,14,10,0.6920392266983662,[8.33344379]
2021,5,NCAAF_20211002_KANSAS@IOWAST,Iowa St.,Cyclones,Kansas,Jayhawks,3-2,1-4,0,38,0,59,7,28,10,14,7,0,0,7,0,2,38,52,0.951566193074096,[27.58051093]
2021,5,NCAAF_20211002_LIB@UAB,UAB,Blazers,Liberty,Flames,3-2,4-1,1,3,3,12,36,3,0,0,9,0,3,21,12,-1,0,-24,0.4986038208889869,[-0.05813869]
2021,5,NCAAF_20211002_MISSST@TXAM,Texas A&M,Aggies,Miss. State,Bulldogs,3-2,3-2,1,13,17,22,26,7,6,6,3,10,7,7,2,0,-4,-4,0.5192064289515208,[0.80008795]
2021,5,NCAAF_20211002_MRSHL@MTSU,Middle Tenn.,,Marshall,,2-3,2-3,,28,14,34,28,7,21,6,0,0,14,0,14,0,14,6,0.3135536548778186,[-8.07035999]
2021,5,NCAAF_20211002_BC@CLEM,Clemson,Tigers,Boston College,Eagles,3-2,4-1,1,13,6,19,13,7,6,3,3,3,3,7,0,-1,7,6,0.9390980831679653,[25.70353099]
2021,5,NCAAF_20211002_IND@PSU,Penn State,Nittany Lions,Indiana,Hoosiers,5-0,2-3,0,14,0,24,0,7,7,7,3,0,0,0,0,3,14,24,0.8252639813688787,[15.54282452]
2021,5,NCAAF_20211002_NWEST@NEB,Nebraska,Cornhuskers,Northwestern,Wildcats,3-3,2-3,1,35,7,56,7,21,14,14,7,7,0,0,0,1,28,49,0.41615272584766727,[-3.51761131]
2021,5,NCAAF_20211002_UCONN@VANDY,Vanderbilt,Commodores,UConn,Huskies,2-3,0-6,0,17,16,30,28,3,14,0,13,6,10,0,12,2,1,2,0.8787143011487831,[19.41302096]
2021,5,NCAAF_20211002_WKY@MICHST,Michigan St.,Spartans,W. Kentucky,Hilltoppers,5-0,1-3,0,42,16,48,31,21,21,3,3,10,6,0,15,4,26,17,0.8898548612323882,[20.36280229]
2021,5,NCAAF_20211002_UL@SALA,South Alabama,,Louisiana,,3-1,4-1,,6,20,18,20,0,6,6,6,14,6,0,0,-1,-14,-2,0.16613186028044458,[-16.10682386]
2021,5,NCAAF_20211002_AUBURN@LSU,LSU,Tigers,Auburn,Tigers,3-2,4-1,1,13,10,19,24,7,6,6,0,0,10,0,14,-1,3,-5,0.47474380855088893,[-1.05240161]
2021,5,NCAAF_20211002_ODU@UTEP,UTEP,,Old Dominion,,4-1,1-4,,17,7,28,21,3,14,3,8,0,7,14,0,3,10,7,0.33796134296306424,[-6.94455301]
2021,5,NCAAF_20211002_WASH@OREGST,Oregon State,Beavers,Washington,Huskies,4-1,2-3,0,14,10,27,24,0,14,3,10,7,3,0,14,2,4,3,0.08358015820186226,[-22.94818489]
2021,5,NCAAF_20211002_ARIZST@UCLA,UCLA,Bruins,Arizona St.,Sun Devils,3-2,4-1,1,23,24,23,42,3,20,0,0,3,21,8,10,-1,-1,-19,0.4226748393307628,[-3.24034304]
2021,5,NCAAF_20211002_NMEXST@SJST,San Jose St.,Spartans,New Mexico St.,Aggies,3-2,1-5,0,24,14,37,31,7,17,6,7,0,14,7,10,2,10,6,0.6540221308288606,[6.58188628]
2021,5,NCAAF_20211002_FRESNO@HAWAII,Hawaii,Rainbow Warriors,Fresno St.,Bulldogs,3-3,4-2,0,10,14,27,24,10,0,0,17,7,7,10,0,-1,-4,3,0.18680053042604983,[-14.78088568]
2021,5,NCAAF_20211001_HOU@TULSA,Tulsa,Golden Hurricane,Houston,Cougars,1-4,4-1,0,3,28,10,45,0,3,0,7,14,14,7,10,-3,-25,-35,0.3584517109819991,[-6.02367539]
2021,5,NCAAF_20211001_IOWA@MD,Maryland,Terrapins,Iowa,Hawkeyes,4-1,5-0,1,7,34,14,51,7,0,7,0,3,31,10,7,-1,-27,-37,0.10789766195285533,[-20.56264399]
2021,5,NCAAF_20211001_BYU@UTAHST,Utah St.,Aggies,BYU,Cougars,3-2,5-0,1,13,24,20,34,3,10,0,7,10,14,0,10,-2,-11,-14,0.43454218119421006,[-2.73808898]
2021,5,NCAAF_20210930_UVA@MIAMI,Miami (Fla.),Hurricanes,Virginia,Cavaliers,2-3,3-2,0,7,16,28,30,0,7,14,7,9,7,11,3,-1,-9,-2,0.6498866296058741,[6.39602688]
2021,6,NCAAF_20211009_AKRON@BGREEN,Bowling Green,Falcons,Akron,Zips,2-4,2-4,1,13,7,20,35,10,3,0,7,0,7,21,7,0,6,-15,0.4305575998814173,[-2.91378083]
2021,6,NCAAF_20211009_ARK@MISS,Ole Miss,Rebels,Arkansas,Razorbacks,4-1,4-2,0,21,14,52,51,0,21,10,21,7,7,17,20,0,7,1,0.6972982973807578,[8.60446987]
2021,6,NCAAF_20211009_MD@OHIOST,Ohio State,Buckeyes,Maryland,Terrapins,5-1,4-2,0,35,10,66,17,14,21,21,10,3,7,7,0,1,25,49,0.9763410760935143,[33.03323721]
2021,6,NCAAF_20211009_MICHST@RUT,Rutgers,Scarlet Knights,Michigan St.,Spartans,3-3,6-0,0,13,21,13,31,7,6,0,0,7,14,7,3,-3,-8,-18,0.18327352399170793,[-15.03833508]
2021,6,NCAAF_20211009_NILL@TOLEDO,Toledo,Rockets,N. Illinois,Huskies,3-3,4-2,0,14,16,20,22,0,14,0,6,3,13,0,6,-1,-2,-2,0.587864742240771,[3.69822322]
2021,6,NCAAF_20211009_OKLA@TEXAS,Texas,Longhorns,Oklahoma,Sooners,4-2,6-0,1,38,20,48,55,28,10,3,7,7,13,10,25,-2,18,-7,0.29600130333985,[-8.92574167]
2021,6,NCAAF_20211009_SC@TENN,Tennessee,Volunteers,South Carolina,Gamecocks,4-2,3-3,0,38,7,45,20,28,10,0,7,0,7,7,6,1,31,25,0.45405381122881716,[-1.92235728]
2021,6,NCAAF_20211009_VANDY@FLA,Florida,Gators,Vanderbilt,Commodores,4-2,2-4,0,21,0,42,0,14,7,21,0,0,0,0,0,2,21,42,0.9183699135358381,[23.21951827]
2021,6,NCAAF_20211009_WVU@BAYLOR,Baylor,Bears,West Virginia,Mountaineers,5-1,2-4,1,28,10,45,20,21,7,14,3,7,3,3,7,3,18,25,0.4042336427545087,[-4.03711026]
2021,6,NCAAF_20211009_GATECH@DUKE,Duke,Blue Devils,Georgia Tech,Yellow Jackets,3-3,3-3,1,14,17,27,31,7,7,3,10,14,3,7,7,0,-3,-4,0.4635169821998051,[-1.52517105]
2021,6,NCAAF_20211009_UVA@LVILLE,Louisville,Cardinals,Virginia,Cavaliers,3-3,4-2,0,10,13,33,34,10,0,20,3,10,3,0,21,-1,-3,-1,0.42921683764759844,[-2.9706334]
2021,6,NCAAF_20211009_BALLST@WMICH,W. Michigan,Broncos,Ball St.,Cardinals,4-2,3-3,0,17,17,20,45,14,3,3,0,7,10,7,21,1,0,-25,0.7311802101469331,[10.26559597]
2021,6,NCAAF_20211009_BOISE@BYU,BYU,Cougars,Boise St.,Broncos,5-1,3-3,1,10,20,17,26,10,0,0,7,3,17,3,3,2,-10,-9,0.36604335296970136,[-5.70168036]
2021,6,NCAAF_20211009_CMICH@OHIO,Ohio,Bobcats,C. Michigan,Chippewas,1-5,3-3,1,10,13,27,30,3,7,9,8,7,6,7,10,-2,-3,-3,0.6397168429288648,[5.95734265]
2021,6,NCAAF_20211009_FAU@UAB,UAB,Blazers,FAU,Owls,4-2,3-3,1,24,14,31,14,14,10,7,0,7,7,0,0,1,10,17,0.3464131367571901,[-6.57889603]
2021,6,NCAAF_20211009_FSU@UNC,North Carolina,Tar Heels,Florida State,Seminoles,3-3,2-4,1,10,21,25,35,10,0,7,8,0,21,14,0,1,-11,-10,0.59947645997756,[4.19680028]
2021,6,NCAAF_20211009_MIAOH@EMICH,E. Michigan,Eagles,Miami-OH,RedHawks,4-2,2-4,1,10,6,13,12,0,10,3,0,6,0,3,3,2,4,1,0.5283176986150031,[1.1831621]
2021,6,NCAAF_20211009_MTSU@LIB,Liberty,Flames,Middle Tenn.,Blue Raiders,5-1,2-4,0,24,7,41,13,14,10,10,7,0,7,6,0,3,17,28,0.6043944312394034,[4.40907828]
2021,6,NCAAF_20211009_SJST@COLOST,Colorado St.,Rams,San Jose St.,Spartans,2-3,3-3,1,16,7,32,14,10,6,10,6,0,7,0,7,-1,9,18,0.7083583606217152,[9.13656991]
2021,6,NCAAF_20211009_SMU@NAVY,Navy,Midshipmen,SMU,Mustangs,1-4,6-0,0,21,21,24,31,7,14,3,0,7,14,3,7,-5,0,-7,0.3953790784125889,[-4.41887146]
2021,6,NCAAF_20211009_UCONN@UMASS,UMass,Minutemen,UConn,Huskies,1-5,0-7,0,7,10,27,13,7,0,3,17,10,0,0,3,1,-3,14,0.45212139171651033,[-2.0035916]
2021,6,NCAAF_20211009_UGA@AUBURN,Auburn,Tigers,Georgia,Bulldogs,4-2,6-0,1,3,17,10,34,3,0,7,0,3,14,7,10,-2,-14,-24,0.3295508853616247,[-7.34718619]
2021,6,NCAAF_20211009_WISC@ILL,Illinois,Fighting Illini,Wisconsin,Badgers,2-5,2-3,1,0,10,0,24,0,0,0,0,3,7,14,0,0,-10,-24,0.06314882679972833,[-25.46247487]
2021,6,NCAAF_20211009_NTEXAS@MIZZOU,Missouri,Tigers,North Texas,Mean Green,3-3,1-4,1,31,7,48,35,14,17,0,17,0,7,7,21,2,24,13,0.8950456049410145,[20.88166291]
2021,6,NCAAF_20211009_OREGST@WASHST,Washington St.,Cougars,Oregon State,Beavers,3-3,4-2,1,3,10,31,24,0,3,14,14,0,10,7,7,-1,-7,7,0.8119349631198035,[14.74003824]
2021,6,NCAAF_20211009_PSU@IOWA,Iowa,Hawkeyes,Penn State,Nittany Lions,6-0,5-1,1,10,17,23,20,3,7,3,10,14,3,3,0,1,-7,3,0.41073641337647304,[-3.75810188]
2021,6,NCAAF_20211009_ECU@UCF,UCF,Knights,East Carolina,Pirates,3-2,3-3,0,3,3,20,16,0,3,7,10,0,3,10,3,0,0,4,0.9549737173505579,[28.23135677]
2021,6,NCAAF_20211009_BUFF@KENTST,Kent St.,Golden Flashes,Buffalo,Bulls,3-3,2-4,1,31,10,48,38,14,17,3,14,0,10,28,0,1,21,10,0.16486654281147672,[-16.23232004]
2021,6,NCAAF_20211009_GAS@TROY,Troy,Trojans,Ga. Southern,Eagles,3-3,2-4,1,17,3,27,24,10,7,7,3,0,3,15,6,1,14,3,0.6111027880525219,[4.69980267]
2021,6,NCAAF_20211009_TCU@TXTECH,Texas Tech,Red Raiders,TCU,Horned Frogs,4-2,3-2,0,10,35,31,52,7,3,14,7,14,21,10,7,1,-25,-21,0.3388944816786734,[-6.9196411]
2021,6,NCAAF_20211009_TXSA@WKY,W. Kentucky,Hilltoppers,UTSA,Roadrunners,1-4,6-0,0,24,28,46,52,10,14,13,9,14,14,14,10,-5,-4,-6,0.6046174715137005,[4.41872227]
2021,6,NCAAF_20211009_UTEP@USM,So. Miss,Golden Eagles,UTEP,Miners,1-5,5-1,0,7,14,13,26,7,0,0,6,7,7,7,5,-4,-7,-13,0.8294235197598347,[15.85323036]
2021,6,NCAAF_20211009_WYO@AF,Air Force,Falcons,Wyoming,Cowboys,5-1,4-1,1,14,14,24,14,7,7,7,3,0,14,0,0,1,0,10,0.5862571821077592,[3.62946925]
2021,6,NCAAF_20211009_LSU@UK,Kentucky,Wildcats,LSU,Tigers,6-0,3-3,0,14,0,42,21,7,7,14,14,0,0,7,14,3,14,21,0.24855024511808455,[-11.30937682]
2021,6,NCAAF_20211009_MICH@NEB,Nebraska,Cornhuskers,Michigan,Wolverines,3-4,6-0,0,0,13,29,32,0,0,22,7,0,13,6,13,-3,-13,-3,0.1460364314920959,[-17.54691781]
2021,6,NCAAF_20211009_ND@VATECH,Virginia Tech,Hokies,Notre Dame,Fighting Irish,3-2,5-1,0,13,14,29,32,7,6,9,7,0,14,7,11,-2,-1,-3,0.1996250943673482,[-14.0390823]
2021,6,NCAAF_20211009_BAMA@TXAM,Texas A&M,Aggies,Alabama,Crimson Tide,4-2,5-1,1,24,10,41,38,17,7,7,10,7,3,14,14,-1,14,3,0.08918037141448698,[-22.41392863]
2021,6,NCAAF_20211009_GAST@LAMON,UL-Monroe,Warhawks,Georgia St.,Panthers,2-3,2-4,1,7,28,21,55,7,0,7,7,7,21,14,13,0,-21,-34,0.3750661664733268,[-5.30386813]
2021,6,NCAAF_20211009_UTAH@USC,USC,Trojans,Utah,Utes,3-3,3-2,1,10,21,26,42,3,7,0,16,7,14,14,7,0,-11,-16,0.416374042368862,[-3.51706682]
2021,6,NCAAF_20211009_MEMP@TULSA,Tulsa,Golden Hurricane,Memphis,Tigers,2-4,3-3,0,14,13,35,29,7,7,7,14,0,13,0,16,-1,1,6,0.2514782527586883,[-11.15592526]
2021,6,NCAAF_20211009_NMEX@SDGST,San Diego St.,Aztecs,New Mexico,Lobos,5-0,2-4,0,17,0,31,7,7,10,7,7,0,0,7,0,3,17,24,0.8708723767932884,[18.82830331]
2021,6,NCAAF_20211009_NMEXST@NEVADA,Nevada,Wolf Pack,New Mexico St.,Aggies,4-1,1-6,0,31,7,55,28,3,28,21,3,7,0,0,21,3,24,27,0.8113479306987914,[14.70381731]
2021,6,NCAAF_20211009_UCLA@ARIZ,Arizona,Wildcats,UCLA,Bruins,0-5,4-2,1,13,14,16,34,3,10,3,0,7,7,10,10,-4,-1,-18,0.378308098892128,[-5.16168016]
2021,6,NCAAF_20211008_CHARLO@FIU,FIU,Panthers,Charlotte,49ers,1-5,4-2,1,6,17,33,45,3,3,7,20,7,10,14,14,-3,-11,-12,0.6295181858167118,[5.50559796]
2021,6,NCAAF_20211008_TEMPLE@CINCY,Cincinnati,Bearcats,Temple,Owls,5-0,3-3,0,17,3,52,3,10,7,28,7,0,3,0,0,2,14,49,0.7515159954380866,[11.31285944]
2021,6,NCAAF_20211008_STNFRD@ARIZST,Arizona St.,Sun Devils,Stanford,Cardinal,5-1,3-3,0,21,7,28,10,14,7,7,0,7,0,3,0,2,14,18,0.47538743679488693,[-1.02814351]
2021,6,NCAAF_20211007_CSTCAR@ARKST,Arkansas St.,Red Wolves,C. Carolina,Chanticleers,1-5,6-0,1,0,24,20,52,0,0,14,6,10,14,14,14,-5,-24,-32,0.5210372732348739,[0.87864205]
2021,6,NCAAF_20211007_HOU@TULANE,Tulane,Green Wave,Houston,Cougars,1-5,5-1,1,15,17,22,40,0,15,7,0,14,3,9,14,-4,-2,-18,0.44074766719059444,[-2.48274856]
2021,7,NCAAF_20211016_AUBURN@ARK,Arkansas,Razorbacks,Auburn,Tigers,4-3,5-2,0,10,14,23,38,3,7,13,0,7,7,14,10,-1,-4,-15,0.09095066290517084,[-22.25138494]
2021,7,NCAAF_20211016_FLA@LSU,LSU,Tigers,Florida,Gators,4-3,4-3,1,21,13,49,42,0,21,14,14,6,7,22,7,0,8,7,0.5421166575468936,[1.76300508]
2021,7,NCAAF_20211016_MICHST@IND,Indiana,Hoosiers,Michigan St.,Spartans,2-4,7-0,0,9,7,15,20,3,6,0,6,7,0,10,3,-5,2,-5,0.4921383725060291,[-0.32849678]
2021,7,NCAAF_20211016_NEB@MINN,Minnesota,Golden Gophers,Nebraska,Cornhuskers,4-2,3-5,0,21,9,30,23,7,14,0,9,3,6,7,7,1,12,7,0.5758826096981988,[3.18990092]
2021,7,NCAAF_20211016_OHIO@BUFF,Buffalo,Bulls,Ohio,Bobcats,3-4,1-6,1,10,21,27,26,0,10,0,17,21,0,5,0,2,-11,1,0.5157541481603605,[0.65841299]
2021,7,NCAAF_20211016_OKLAST@TEXAS,Texas,Longhorns,Oklahoma State,Cowboys,4-3,6-0,1,17,13,24,32,10,7,7,0,3,10,3,16,-2,4,-8,0.548168215143956,[2.01748549]
2021,7,NCAAF_20211016_RUT@NWEST,Northwestern,Wildcats,Rutgers,Scarlet Knights,3-3,3-4,1,14,7,21,7,7,7,0,7,0,7,0,0,0,7,14,0.7809464221273639,[12.9247688]
2021,7,NCAAF_20211016_TULSA@SFLA,South Florida,Bulls,Tulsa,Golden Hurricane,1-5,3-4,1,24,20,31,32,3,21,7,0,3,17,0,12,-2,4,-1,0.4421247174755063,[-2.42669745]
2021,7,NCAAF_20211016_TXAM@MIZZOU,Missouri,Tigers,Texas A&M,Aggies,3-4,5-2,1,7,28,14,35,0,7,7,0,21,7,7,0,-2,-21,-21,0.4106463958558152,[-3.76515828]
2021,7,NCAAF_20211016_UCF@CINCY,Cincinnati,Bearcats,UCF,Knights,6-0,3-3,0,35,7,56,21,14,21,7,14,0,7,7,7,3,28,35,0.35990805357840494,[-5.97912348]
2021,7,NCAAF_20211016_YALE@UCONN,UConn,Huskies,Yale,Bulldogs,1-7,2-3,1,14,0,21,15,0,14,7,0,0,0,9,6,-1,14,6,,
2021,7,NCAAF_20211016_DUKE@UVA,Virginia,Cavaliers,Duke,Blue Devils,5-2,3-4,1,34,0,48,0,10,24,7,7,0,0,0,0,2,34,48,0.6217267605606027,[5.167601]
2021,7,NCAAF_20211016_BALLST@EMICH,E. Michigan,Eagles,Ball St.,Cardinals,4-3,4-3,0,14,17,31,38,0,14,3,14,14,3,7,14,0,-3,-7,0.6624889937748156,[6.98859496]
2021,7,NCAAF_20211016_AKRON@MIAOH,Miami-OH,RedHawks,Akron,Zips,3-4,2-5,0,21,7,34,21,14,7,13,0,0,7,0,14,1,14,13,0.8065708876988791,[14.42387267]
2021,7,NCAAF_20211016_TROY@TXSTSM,Texas St.,Bobcats,Troy,Trojans,2-4,4-3,1,14,17,28,31,7,7,14,0,10,7,7,7,-2,-3,-3,0.1638488355049823,[-16.31464528]
2021,7,NCAAF_20211016_ARIZ@COLO,Colorado,Buffaloes,Arizona,Wildcats,2-4,0-6,0,6,0,34,0,3,3,21,7,0,0,0,0,2,6,34,0.5364891280015901,[1.52672536]
2021,7,NCAAF_20211016_BGREEN@NILL,N. Illinois,Huskies,Bowling Green,Falcons,5-2,2-5,0,21,13,34,26,0,21,10,3,7,6,3,10,3,8,8,0.8741455198060069,[19.10575353]
2021,7,NCAAF_20211016_BYU@BAYLOR,Baylor,Bears,BYU,Cougars,6-1,5-2,1,17,7,38,24,3,14,14,7,0,7,7,10,1,10,14,0.5424575381886849,[1.77732834]
2021,7,NCAAF_20211016_FRESNO@WYO,Wyoming,Cowboys,Fresno St.,Bulldogs,4-2,5-2,0,0,7,0,17,0,0,0,0,7,0,7,3,-1,-7,-17,0.36981416497306085,[-5.53975438]
2021,7,NCAAF_20211016_KENTST@WMICH,W. Michigan,Broncos,Kent St.,Golden Flashes,5-2,3-4,1,23,17,64,31,17,6,27,14,7,10,6,8,2,6,33,0.7656525244777443,[12.07817696]
2021,7,NCAAF_20211016_MIAMI@UNC,North Carolina,Tar Heels,Miami (Fla.),Hurricanes,4-3,2-4,1,31,17,45,42,14,17,7,7,10,7,17,8,2,14,3,0.3601979657981027,[-5.96620721]
2021,7,NCAAF_20211016_PITT@VATECH,Virginia Tech,Hokies,Pittsburgh,Panthers,3-3,5-1,0,0,21,7,28,0,0,7,0,7,14,7,0,-2,-21,-21,0.5238058310747447,[0.99524929]
2021,7,NCAAF_20211016_PURDUE@IOWA,Iowa,Hawkeyes,Purdue,Boilermakers,6-1,4-2,1,7,14,7,24,0,7,0,0,7,7,3,7,2,-7,-17,0.7733390715182731,[12.49963429]
2021,7,NCAAF_20211016_UAB@USM,So. Miss,Golden Eagles,UAB,Blazers,1-6,5-2,0,0,31,0,34,0,0,0,0,3,28,3,0,-4,-31,-34,0.3709486216635429,[-5.48968791]
2021,7,NCAAF_20211016_UK@UGA,Georgia,Bulldogs,Kentucky,Wildcats,7-0,6-1,0,14,7,30,13,0,14,10,6,0,7,0,6,1,7,17,0.8793965805948991,[19.53525982]
2021,7,NCAAF_20211016_WKY@ODU,Old Dominion,Monarchs,W. Kentucky,Hilltoppers,1-6,2-4,0,3,30,20,43,0,3,3,14,14,16,3,10,-1,-27,-23,0.2763419787904381,[-9.8968999]
2021,7,NCAAF_20211016_TXTECH@KANSAS,Kansas,Jayhawks,Texas Tech,Red Raiders,1-5,5-2,0,0,24,14,41,0,0,0,14,7,17,14,3,-4,-24,-27,0.14597594725552043,[-17.56625333]
2021,7,NCAAF_20211016_VANDY@SC,South Carolina,Gamecocks,Vanderbilt,Commodores,4-3,2-5,1,14,10,21,20,14,0,0,7,3,7,7,3,2,4,1,0.7622317315334224,[11.89308341]
2021,7,NCAAF_20211016_RICE@TXSA,UTSA,Roadrunners,Rice,Owls,7-0,2-4,1,31,0,45,0,17,14,14,0,0,0,0,0,5,31,45,0.663878557120523,[7.05203849]
2021,7,NCAAF_20211016_BAMA@MISSST,Miss. State,Bulldogs,Alabama,Crimson Tide,3-3,6-1,1,6,21,9,49,3,3,3,0,14,7,14,14,-3,-15,-40,0.08929354895983321,[-22.42131224]
2021,7,NCAAF_20211016_COLOST@NMEX,New Mexico,Lobos,Colorado St.,Rams,2-5,3-3,1,7,13,7,36,0,7,0,0,7,6,10,13,-1,-6,-29,0.2500393066781915,[-11.24077657]
2021,7,NCAAF_20211016_LIB@LAMON,UL-Monroe,Warhawks,Liberty,Flames,3-3,5-2,0,0,14,31,28,0,0,28,3,0,14,0,14,-2,-14,3,0.15803881870889058,[-16.71117562]
2021,7,NCAAF_20211016_UTAHST@UNLV,UNLV,Rebels,Utah St.,Aggies,0-6,4-2,1,17,14,24,28,17,0,7,0,7,7,7,7,-4,3,-4,0.16277616313990784,[-16.38715644]
2021,7,NCAAF_20211016_IOWAST@KSTATE,Kansas State,Wildcats,Iowa St.,Cyclones,3-3,4-2,0,7,20,20,33,7,0,0,13,10,10,7,6,-1,-13,-13,0.3129095711870391,[-8.12796778]
2021,7,NCAAF_20211016_MISS@TENN,Tennessee,Volunteers,Ole Miss,Rebels,4-3,5-1,0,12,24,26,31,9,3,7,7,10,14,7,0,-1,-12,-5,0.4459516356906784,[-2.26520858]
2021,7,NCAAF_20211016_NCST@BC,Boston College,Eagles,NC State,Wolfpack,4-2,5-1,0,7,10,7,33,7,0,0,0,7,3,21,2,-1,-3,-26,0.5003882112785427,[0.0162203]
2021,7,NCAAF_20211016_STNFRD@WASHST,Washington St.,Cougars,Stanford,Cardinal,4-3,3-4,0,20,16,34,31,0,20,7,7,13,3,0,15,1,4,3,0.5347478739596528,[1.45368068]
2021,7,NCAAF_20211016_TCU@OKLA,Oklahoma,Sooners,TCU,Horned Frogs,7-0,3-3,1,24,14,52,31,14,10,21,7,7,7,10,7,4,10,21,0.7567168448730411,[11.59772628]
2021,7,NCAAF_20211016_ARMY@WISC,Wisconsin,Badgers,Army,Black Knights,3-3,4-2,1,13,0,20,14,0,13,0,7,0,0,0,14,-1,13,6,0.9093238899111279,[22.2793789]
2021,7,NCAAF_20211016_UCLA@WASH,Washington,Huskies,UCLA,Bruins,2-4,5-2,1,10,17,17,24,3,7,7,0,7,10,0,7,-3,-7,-7,0.7817228495618866,[12.96863111]
2021,7,NCAAF_20211016_AF@BOISE,Boise St.,Broncos,Air Force,Falcons,3-4,6-1,1,14,21,17,24,7,7,0,3,7,14,0,3,-3,-7,-7,0.6806629924113917,[7.82682711]
2021,7,NCAAF_20211016_LATECH@UTEP,UTEP,Miners,Louisiana Tech,Bulldogs,6-1,2-4,1,16,3,19,3,14,2,3,0,0,3,0,0,4,13,16,0.13962755248375236,[-18.03539016]
2021,7,NCAAF_20211016_ARIZST@UTAH,Utah,Utes,Arizona St.,Sun Devils,4-2,5-2,0,7,21,35,21,7,0,14,14,7,14,0,0,-1,-14,14,0.6685532459850381,[7.26623002]
2021,7,NCAAF_20211016_HAWAII@NEVADA,Nevada,Wolf Pack,Hawaii,Rainbow Warriors,5-1,3-4,1,20,17,34,17,3,17,14,0,7,10,0,0,2,3,17,0.5988214913458496,[4.17212904]
2021,7,NCAAF_20211015_CLEM@CUSE,Syracuse,Orange,Clemson,Tigers,3-4,4-2,1,7,14,14,17,0,7,0,7,0,14,0,3,-1,-7,-3,0.032745649812298105,[-30.70182597]
2021,7,NCAAF_20211015_MRSHL@NTEXAS,North Texas,Mean Green,Marshall,Thundering Herd,1-5,4-3,0,7,42,21,49,0,7,0,14,14,28,0,7,-3,-35,-28,0.2959185260156092,[-8.9373306]
2021,7,NCAAF_20211015_CAL@OREG,Oregon,Ducks,California,Golden Bears,5-1,1-5,1,10,7,24,17,3,7,0,14,7,0,3,7,4,3,7,0.7749982553633903,[12.59165698]
2021,7,NCAAF_20211014_GAS@SALA,South Alabama,Jaguars,Ga. Southern,Eagles,4-2,2-5,1,31,8,41,14,10,21,7,3,0,8,3,3,2,23,27,0.2961418718319706,[-8.92655803]
2021,7,NCAAF_20211014_NAVY@MEMP,Memphis,Tigers,Navy,Midshipmen,4-3,1-5,1,28,10,35,17,14,14,7,0,7,3,7,0,3,18,18,0.6772933692150768,[7.66997325]
2021,7,NCAAF_20211012_APLST@UL,Louisiana,Ragin' Cajuns,App. St.,Mountaineers,5-1,4-2,1,20,6,41,13,20,0,7,14,3,3,7,0,1,14,28,0.3110054299672693,[-8.21768863]
2021,8,NCAAF_20211023_ARPB@ARK,Arkansas,Razorbacks,Ark.-Pine Bluff,Golden Lions,5-3,1-6,1,45,0,45,3,17,28,0,0,0,0,0,3,4,45,42,0.998180835641607,[48.58751566]
2021,8,NCAAF_20211023_CINCY@NAVY,Navy,Midshipmen,Cincinnati,Bearcats,1-6,7-0,0,10,13,20,27,7,3,0,10,7,6,14,0,-6,-3,-7,0.25135358238371885,[-11.1987382]
2021,8,NCAAF_20211023_EMICH@BGREEN,Bowling Green,Falcons,E. Michigan,Eagles,2-6,5-3,0,10,24,24,55,3,7,7,7,0,24,21,10,-3,-14,-31,0.13409304204965533,[-18.5006346]
2021,8,NCAAF_20211023_KSTATE@TXTECH,Texas Tech,Red Raiders,Kansas State,Wildcats,5-3,4-3,1,24,10,24,25,14,10,0,0,0,10,9,6,1,14,-1,0.43903967538141386,[-2.56317966]
2021,8,NCAAF_20211023_NILL@CMICH,C. Michigan,Chippewas,N. Illinois,Huskies,4-4,6-2,1,28,18,38,39,14,14,7,3,7,11,11,10,-2,10,-1,0.46663546373151354,[-1.39901828]
2021,8,NCAAF_20211023_NWEST@MICH,Michigan,Wolverines,Northwestern,Wildcats,7-0,3-4,0,10,7,33,7,0,10,17,6,0,7,0,0,4,3,26,0.8307330531779409,[15.99127445]
2021,8,NCAAF_20211023_OKLA@KANSAS,Kansas,Jayhawks,Oklahoma,Sooners,1-6,8-0,1,10,0,23,35,7,3,7,6,0,0,14,21,-7,10,-12,0.013442395200799817,[-36.97934008]
2021,8,NCAAF_20211023_UMASS@FSU,Florida State,Seminoles,UMass,Minutemen,3-4,1-6,0,38,3,59,3,10,28,14,7,3,0,0,0,2,35,56,0.9554735283962654,[28.41162032]
2021,8,NCAAF_20211023_WAKE@ARMY,Army,Black Knights,Wake Forest,Demon Deacons,4-3,7-0,0,21,28,56,70,7,14,14,21,14,14,21,21,-3,-7,-14,0.3501530867579957,[-6.43127641]
2021,8,NCAAF_20211023_CUSE@VATECH,Virginia Tech,Hokies,Syracuse,Orange,3-4,4-4,1,19,13,36,41,7,12,7,10,7,6,7,21,-1,6,-5,0.6348445097484965,[5.75966739]
2021,8,NCAAF_20211023_KENTST@OHIO,Ohio,Bobcats,Kent St.,Golden Flashes,1-7,4-4,1,7,17,27,34,0,7,10,10,10,7,14,3,-3,-10,-7,0.8157410500904068,[15.0252966]
2021,8,NCAAF_20211023_TXSTSM@GAST,Georgia St.,Panthers,Texas St.,Bobcats,3-4,2-5,0,14,13,28,16,7,7,7,7,6,7,3,0,1,1,12,0.6652281316963701,[7.13081862]
2021,8,NCAAF_20211023_WISC@PURDUE,Purdue,Boilermakers,Wisconsin,Badgers,4-3,4-3,0,13,13,13,30,0,13,0,0,7,6,7,10,0,0,-17,0.24628618326211082,[-11.46585762]
2021,8,NCAAF_20211023_BUFF@AKRON,Akron,Zips,Buffalo,Bulls,2-6,4-4,1,10,24,10,45,0,10,0,0,3,21,21,0,-2,-14,-35,0.11137166754084449,[-20.37227484]
2021,8,NCAAF_20211023_BYU@WASHST,Washington St.,Cougars,BYU,Cougars,4-4,6-2,1,7,7,19,21,7,0,6,6,7,0,7,7,-2,0,-2,0.6394853914016243,[5.966382]
2021,8,NCAAF_20211023_CLEM@PITT,Pittsburgh,Panthers,Clemson,Tigers,6-1,4-3,1,14,7,27,17,0,14,10,3,7,0,3,7,2,7,10,0.07527337087404551,[-24.02039259]
2021,8,NCAAF_20211023_COLO@CAL,California,Golden Bears,Colorado,Buffaloes,2-5,2-5,0,23,3,26,3,10,13,0,3,0,3,0,0,0,20,23,0.5697438123151141,[2.9360754]
2021,8,NCAAF_20211023_LSU@MISS,Ole Miss,Rebels,LSU,Tigers,6-1,4-4,1,17,7,31,17,0,17,14,0,7,0,0,10,2,10,14,0.2288072466139508,[-12.41085566]
2021,8,NCAAF_20211023_MD@MINN,Minnesota,Golden Gophers,Maryland,Terrapins,5-2,4-3,0,17,10,34,16,3,14,14,3,3,7,0,6,1,7,18,0.7283262170120737,[10.15482127]
2021,8,NCAAF_20211023_MIAOH@BALLST,Ball St.,Cardinals,Miami-OH,RedHawks,4-4,4-4,1,10,16,17,24,7,3,7,0,10,6,0,8,0,-6,-7,0.37003525965842365,[-5.54325831]
2021,8,NCAAF_20211023_NMEX@WYO,Wyoming,Cowboys,New Mexico,Lobos,4-3,3-5,0,3,14,3,14,0,3,0,0,7,7,0,0,1,-11,-11,0.8127956457830829,[14.84137574]
2021,8,NCAAF_20211023_OKLAST@IOWAST,Iowa St.,Cyclones,Oklahoma State,Cowboys,5-2,6-1,1,7,14,24,21,0,7,10,7,7,7,0,7,-1,-7,3,0.5628735212982665,[2.64428776]
2021,8,NCAAF_20211023_OREG@UCLA,UCLA,Bruins,Oregon,Ducks,5-3,6-1,1,17,14,31,34,14,3,0,14,0,14,13,7,-1,3,-3,0.24703092395168125,[-11.42641734]
2021,8,NCAAF_20211023_RICE@UAB,UAB,Blazers,Rice,Owls,5-3,3-4,0,14,20,24,30,14,0,7,3,13,7,7,3,2,-6,-6,0.8441017507058792,[16.9001163]
2021,8,NCAAF_20211023_WMICH@TOLEDO,Toledo,Rockets,W. Michigan,Broncos,4-4,5-3,1,13,15,34,15,3,10,21,0,0,15,0,0,-1,-2,19,0.5336312397947496,[1.41022799]
2021,8,NCAAF_20211023_BC@LVILLE,Louisville,Cardinals,Boston College,Eagles,4-3,4-3,0,21,7,28,14,7,14,0,7,7,0,0,7,0,14,14,0.4171211995686839,[-3.49651192]
2021,8,NCAAF_20211023_LIB@NTEXAS,North Texas,Mean Green,Liberty,Flames,1-6,6-2,1,20,14,26,35,7,13,6,0,0,14,14,7,-5,6,-9,0.35200867760349364,[-6.34766454]
2021,8,NCAAF_20211023_MISSST@VANDY,Vanderbilt,Commodores,Miss. State,Bulldogs,2-6,4-3,0,3,24,6,45,0,3,3,0,10,14,7,14,-2,-21,-39,0.13096119204458123,[-18.74474044]
2021,8,NCAAF_20211023_NEVADA@FRESNO,Fresno St.,Bulldogs,Nevada,Wolf Pack,6-2,5-2,0,14,10,34,32,7,7,14,6,3,7,6,16,1,4,2,0.7223081189688824,[9.85328614]
2021,8,NCAAF_20211023_SALA@LAMON,UL-Monroe,Warhawks,South Alabama,Jaguars,4-3,4-3,1,24,17,41,31,7,17,14,3,7,10,14,0,0,7,10,0.4515399588718406,[-2.03463779]
2021,8,NCAAF_20211023_SDGST@AF,Air Force,Falcons,San Diego St.,Aztecs,6-2,7-0,1,0,13,14,20,0,0,7,7,3,10,7,0,-1,-13,-6,0.4964891698414564,[-0.14704373]
2021,8,NCAAF_20211023_TEMPLE@SFLA,South Florida,Bulls,Temple,Owls,2-5,3-4,1,17,7,34,14,0,17,10,7,0,7,7,0,-1,10,20,0.44363391214354375,[-2.36865418]
2021,8,NCAAF_20211023_TENN@BAMA,Alabama,Crimson Tide,Tennessee,Volunteers,7-1,4-4,0,21,14,52,24,7,14,3,28,14,0,3,7,3,7,28,0.968736255672095,[31.12045689]
2021,8,NCAAF_20211023_TXSA@LATECH,Louisiana Tech,Bulldogs,UTSA,Roadrunners,2-5,8-0,1,10,21,16,45,10,0,0,6,7,14,7,17,-6,-11,-29,0.6150468849823363,[4.8872368]
2021,8,NCAAF_20211023_WKY@FIU,FIU,Panthers,W. Kentucky,Hilltoppers,1-6,3-4,1,12,17,19,34,6,6,0,7,0,17,7,10,-2,-5,-15,0.45216782598739935,[-2.00814809]
2021,8,NCAAF_20211023_GATECH@UVA,Virginia,Cavaliers,Georgia Tech,Yellow Jackets,6-2,3-4,0,24,16,48,40,7,17,17,7,13,3,8,16,3,8,8,0.6039476476990945,[4.40403919]
2021,8,NCAAF_20211023_NCST@MIAMI,Miami (Fla.),Hurricanes,NC State,Wolfpack,3-4,5-2,0,14,17,31,30,7,7,10,7,3,14,3,10,-2,-3,1,0.5989351700236089,[4.18704992]
2021,8,NCAAF_20211023_OHIOST@IND,Indiana,Hoosiers,Ohio State,Buckeyes,2-5,6-1,0,7,44,7,54,7,0,0,0,14,30,7,3,-4,-37,-47,0.07351046147130269,[-24.22978325]
2021,8,NCAAF_20211023_SC@TXAM,Texas A&M,Aggies,South Carolina,Gamecocks,6-2,4-4,0,31,0,44,14,14,17,10,3,0,0,0,14,2,31,30,0.704244295706995,[8.96664394]
2021,8,NCAAF_20211023_USC@ND,Notre Dame,Fighting Irish,USC,Trojans,6-1,3-4,1,17,3,31,16,7,10,7,7,0,3,0,13,3,14,15,0.7111031039364287,[9.30020014]
2021,8,NCAAF_20211023_UTAH@OREGST,Oregon State,Beavers,Utah,Utes,5-2,4-3,0,14,24,42,34,7,7,21,7,14,10,7,3,1,-10,8,0.11339931283652471,[-20.19484374]
2021,8,NCAAF_20211023_WVU@TCU,TCU,Horned Frogs,West Virginia,Mountaineers,3-4,3-4,0,17,20,17,29,7,10,0,0,10,10,3,6,0,-3,-12,0.596009992685382,[4.06074739]
2021,8,NCAAF_20211023_NMEXST@HAWAII,Hawaii,,New Mexico St.,,4-4,1-7,,24,13,48,34,10,14,10,14,3,10,14,7,3,11,14,0.741433079633304,[10.82335371]
2021,8,NCAAF_20211022_MTSU@UCONN,UConn,Huskies,Middle Tenn.,Blue Raiders,1-8,3-4,1,13,24,13,44,0,13,0,0,3,21,10,10,-2,-11,-31,0.17837124006059812,[-15.39851692]
2021,8,NCAAF_20211022_MEMP@UCF,UCF,Knights,Memphis,Tigers,4-3,4-4,1,14,7,24,7,14,0,7,3,0,7,0,0,0,7,17,0.6716492868880524,[7.42652202]
2021,8,NCAAF_20211022_COLOST@UTAHST,Utah St.,Aggies,Colorado St.,Rams,5-2,3-4,0,20,14,26,24,0,20,3,3,0,14,0,10,2,6,2,0.6280935549339552,[5.46052257]
2021,8,NCAAF_20211022_WASH@ARIZ,Arizona,Wildcats,Washington,Huskies,0-7,3-4,0,13,0,16,21,3,10,3,0,0,0,7,14,-3,13,-5,0.12968301966637275,[-18.84552318]
2021,8,NCAAF_20211021_FAU@CHARLO,Charlotte,49ers,FAU,Owls,4-3,4-3,1,9,7,9,38,3,6,0,0,0,7,21,10,0,2,-29,0.16231806573779184,[-16.45760175]
2021,8,NCAAF_20211021_TULANE@SMU,SMU,Mustangs,Tulane,Green Wave,7-0,1-6,1,31,7,55,26,17,14,7,17,7,0,12,7,6,24,29,0.5730535963668748,[3.07695973]
2021,8,NCAAF_20211021_UL@ARKST,Arkansas St.,Red Wolves,Louisiana,Ragin' Cajuns,1-6,6-1,0,10,14,27,28,0,10,17,0,0,14,14,0,-5,-4,-1,0.37684469592008674,[-5.24280993]
2021,8,NCAAF_20211021_SJST@UNLV,UNLV,Rebels,San Jose St.,Spartans,0-7,4-4,1,17,13,20,27,7,10,3,0,3,10,0,14,-4,4,-7,0.4893626907846267,[-0.44556835]
2021,8,NCAAF_20211020_CSTCAR@APLST,App. St.,Mountaineers,C. Carolina,Chanticleers,5-2,6-1,1,14,20,30,27,0,14,13,3,14,6,7,0,-1,-6,3,0.7603644920014075,[11.82095504]
2021,9,NCAAF_20211030_BGREEN@BUFF,Buffalo,Bulls,Bowling Green,Falcons,4-5,3-6,0,10,28,44,56,0,10,13,21,14,14,0,28,1,-18,-12,0.9257211197722768,[24.10927005]
2021,9,NCAAF_20211030_CINCY@TULANE,Tulane,Green Wave,Cincinnati,Bearcats,1-7,8-0,1,12,14,12,31,0,12,0,0,7,7,7,10,-7,-2,-19,0.2737614215052473,[-10.03786918]
2021,9,NCAAF_20211030_IND@MD,Maryland,Terrapins,Indiana,Hoosiers,5-3,2-6,0,14,10,38,35,14,0,14,10,0,10,7,18,3,4,3,0.2887900049459018,[-9.29433355]
2021,9,NCAAF_20211030_IOWA@WISC,Wisconsin,Badgers,Iowa,Hawkeyes,5-3,6-2,0,20,0,27,7,7,13,0,7,0,0,7,0,-1,20,20,0.5067649022414483,[0.2830058]
2021,9,NCAAF_20211030_MIAMI@PITT,Pittsburgh,Panthers,Miami (Fla.),Hurricanes,6-2,4-4,1,17,31,34,38,10,7,14,3,21,10,7,0,2,-14,-4,0.4135331969735947,[-3.64591079]
2021,9,NCAAF_20211030_MICH@MICHST,Michigan St.,Spartans,Michigan,Wolverines,8-0,7-1,1,14,23,37,33,0,14,8,15,10,13,7,3,1,-9,4,0.2024861323290622,[-13.89793145]
2021,9,NCAAF_20211030_RUT@ILL,Illinois,Fighting Illini,Rutgers,Scarlet Knights,3-6,4-4,0,14,10,14,20,0,14,0,0,7,3,0,10,-1,4,-6,0.5418881918928268,[1.75551667]
2021,9,NCAAF_20211030_TEXAS@BAYLOR,Baylor,Bears,Texas,Longhorns,7-1,4-4,1,10,14,31,24,10,0,7,14,14,0,7,3,3,-4,7,0.2899807588429629,[-9.23622155]
2021,9,NCAAF_20211030_TXSTSM@UL,Louisiana,Ragin' Cajuns,Texas St.,Bobcats,7-1,2-6,0,17,0,45,0,0,17,18,10,0,0,0,0,5,17,45,0.8697379408203079,[18.77736847]
2021,9,NCAAF_20211030_UCF@TEMPLE,Temple,Owls,UCF,Knights,3-5,5-3,1,0,21,7,49,0,0,0,7,7,14,21,7,-2,-21,-42,0.12865627789235068,[-18.90441537]
2021,9,NCAAF_20211030_UMASS@LIB,Liberty,Flames,UMass,Minutemen,7-2,1-7,0,41,3,62,17,21,20,7,14,3,0,7,7,6,38,45,0.911080527334257,[22.48703116]
2021,9,NCAAF_20211030_VATECH@GATECH,Georgia Tech,Yellow Jackets,Virginia Tech,Hokies,3-5,4-4,0,7,20,17,26,7,0,10,0,14,6,3,3,-1,-13,-9,0.3755078858610944,[-5.29533585]
2021,9,NCAAF_20211030_IOWAST@WVU,West Virginia,Mountaineers,Iowa St.,Cyclones,4-4,5-3,1,17,17,38,31,14,3,7,14,14,3,14,0,-1,0,7,0.3267941172936919,[-7.48961377]
2021,9,NCAAF_20211030_HAWAII@UTAHST,Utah St.,Aggies,Hawaii,Rainbow Warriors,6-2,4-5,0,20,10,51,31,14,6,21,10,0,10,15,6,2,10,20,0.7448472100504729,[10.9872192]
2021,9,NCAAF_20211030_MIZZOU@VANDY,Vanderbilt,Commodores,Missouri,Tigers,2-7,4-4,0,14,17,28,37,7,7,7,7,10,7,7,13,-2,-3,-9,0.16592681889185146,[-16.19451798]
2021,9,NCAAF_20211030_WASHST@ARIZST,Arizona St.,Sun Devils,Washington St.,Cougars,5-3,5-4,1,7,28,21,34,0,7,0,14,14,14,0,6,0,-21,-13,0.4615480725118801,[-1.61103591]
2021,9,NCAAF_20211030_BC@CUSE,Syracuse,Orange,Boston College,Eagles,5-4,4-4,1,0,3,21,6,0,0,21,0,0,3,3,0,1,-3,15,0.4015196836626047,[-4.16242644]
2021,9,NCAAF_20211030_COLO@OREG,Oregon,Ducks,Colorado,Buffaloes,7-1,2-6,1,31,14,52,29,14,17,14,7,0,14,0,15,5,17,23,0.8243976137650417,[15.55814356]
2021,9,NCAAF_20211030_FIU@MRSHL,Marshall,Thundering Herd,FIU,Panthers,5-3,1-7,0,24,0,38,0,3,21,7,7,0,0,0,0,4,24,38,0.7348053003345512,[10.47069914]
2021,9,NCAAF_20211030_FSU@CLEM,Clemson,Tigers,Florida State,Seminoles,5-3,3-5,1,17,13,30,20,3,14,0,13,6,7,0,7,2,4,10,0.953006831602782,[27.94917748]
2021,9,NCAAF_20211030_LAMON@APLST,App. St.,Mountaineers,UL-Monroe,Warhawks,6-2,4-4,1,49,7,59,28,21,28,3,7,0,7,14,7,2,42,31,0.9257915477465983,[24.11763766]
2021,9,NCAAF_20211030_LATECH@ODU,Old Dominion,Monarchs,Louisiana Tech,Bulldogs,2-6,2-6,1,10,10,23,20,0,10,7,6,0,10,3,7,0,0,3,0.2512639488568359,[-11.19008129]
2021,9,NCAAF_20211030_MINN@NWEST,Northwestern,Wildcats,Minnesota,Golden Gophers,3-5,6-2,0,7,20,14,41,0,7,0,7,13,7,0,21,-3,-13,-27,0.43370136858486397,[-2.78632317]
2021,9,NCAAF_20211030_PURDUE@NEB,Nebraska,Cornhuskers,Purdue,Boilermakers,3-6,5-3,0,17,14,23,28,7,10,0,6,0,14,7,7,-2,3,-5,0.42667223364808016,[-3.08495744]
2021,9,NCAAF_20211030_TCU@KSTATE,Kansas State,Wildcats,TCU,Horned Frogs,5-3,3-5,0,21,5,31,12,7,14,0,10,0,5,0,7,2,16,19,0.39799530308030073,[-4.31469289]
2021,9,NCAAF_20211030_TXTECH@OKLA,Oklahoma,Sooners,Texas Tech,Red Raiders,9-0,5-4,0,28,7,52,21,14,14,10,14,7,0,7,7,4,21,31,0.8669149461914567,[18.55661792]
2021,9,NCAAF_20211030_UGA@FLA,Florida,Gators,Georgia,Bulldogs,4-4,8-0,0,0,24,7,34,0,0,0,7,0,24,3,7,-4,-24,-27,0.24991743359206087,[-11.26070811]
2021,9,NCAAF_20211030_USM@MTSU,Middle Tenn.,Blue Raiders,So. Miss,Golden Eagles,4-4,1-7,1,21,7,35,10,14,7,14,0,7,0,3,0,3,14,25,0.5466671963343327,[1.95667548]
2021,9,NCAAF_20211030_CHARLO@WKY,W. Kentucky,Hilltoppers,Charlotte,49ers,4-4,4-4,0,28,13,45,13,14,14,7,10,3,10,0,0,0,15,32,0.6688977355579382,[7.29082708]
2021,9,NCAAF_20211030_DUKE@WAKE,Wake Forest,Demon Deacons,Duke,Blue Devils,8-0,3-5,1,28,0,45,7,14,14,10,7,0,0,0,7,5,28,38,0.6768816296186384,[7.66006332]
2021,9,NCAAF_20211030_WYO@SJST,San Jose St.,Spartans,Wyoming,Cowboys,5-4,4-4,1,17,7,27,21,0,17,10,0,0,7,7,7,1,10,6,0.23576291063108934,[-12.01585708]
2021,9,NCAAF_20211030_ARKST@SALA,South Alabama,Jaguars,Arkansas St.,Red Wolves,5-3,1-7,1,28,7,31,13,14,14,0,3,0,7,3,3,4,21,18,0.25987942574954614,[-10.74281662]
2021,9,NCAAF_20211030_GAST@GAS,Ga. Southern,Eagles,Georgia St.,Panthers,2-6,4-4,1,7,0,14,21,0,7,0,7,0,0,7,14,-2,7,-7,0.5806590319462651,[3.39748538]
2021,9,NCAAF_20211030_UTEP@FAU,FAU,Owls,UTEP,Miners,5-3,6-2,1,14,10,28,25,7,7,7,7,3,7,0,15,-1,4,3,0.9348351061594039,[25.24674259]
2021,9,NCAAF_20211030_ARIZ@USC,USC,Trojans,Arizona,Wildcats,4-4,0-8,1,35,14,41,34,14,21,3,3,7,7,7,13,4,21,7,0.7866747007471266,[13.26646932]
2021,9,NCAAF_20211030_BOISE@COLOST,Colorado St.,Rams,Boise St.,Broncos,3-5,4-4,1,16,7,19,28,13,3,3,0,0,7,14,7,-1,9,-9,0.19367110765533624,[-14.42652032]
2021,9,NCAAF_20211030_KANSAS@OKLAST,Oklahoma State,Cowboys,Kansas,Jayhawks,7-1,1-7,0,38,0,55,3,17,21,7,10,0,0,3,0,6,38,52,0.9379616259235214,[25.66533357]
2021,9,NCAAF_20211030_MISS@AUBURN,Auburn,Tigers,Ole Miss,Rebels,6-2,6-2,1,28,17,31,20,14,14,0,3,3,14,3,0,0,11,11,0.7861150636196608,[13.23438385]
2021,9,NCAAF_20211030_OREGST@CAL,California,Golden Bears,Oregon State,Beavers,3-5,5-3,0,17,10,39,25,10,7,14,8,0,10,7,8,-2,7,14,0.6882684838991543,[8.19329902]
2021,9,NCAAF_20211030_SMU@HOU,Houston,Cougars,SMU,Mustangs,7-1,7-1,1,23,20,44,37,17,6,7,14,7,13,14,3,0,3,7,0.48552453538194074,[-0.60567667]
2021,9,NCAAF_20211030_UK@MISSST,Miss. State,Bulldogs,Kentucky,Wildcats,5-3,6-2,0,14,10,31,17,0,14,17,0,7,3,0,7,-1,4,14,0.5867241071670273,[3.65693519]
2021,9,NCAAF_20211030_LVILLE@NCST,NC State,Wolfpack,Louisville,Cardinals,6-2,4-4,1,7,7,28,13,7,0,0,21,7,0,3,3,2,0,15,0.5995888672450547,[4.21028205]
2021,9,NCAAF_20211030_PSU@OHIOST,Ohio State,Buckeyes,Penn State,Nittany Lions,7-1,5-3,1,17,10,33,24,3,14,10,6,7,3,14,0,2,7,9,0.7007423507334196,[8.7872258]
2021,9,NCAAF_20211030_UNC@ND,Notre Dame,Fighting Irish,North Carolina,Tar Heels,7-1,4-4,1,17,13,44,34,7,10,14,13,0,13,14,7,3,4,10,0.8258549789387337,[15.65253894]
2021,9,NCAAF_20211030_UCLA@UTAH,Utah,Utes,UCLA,Bruins,5-3,5-4,1,28,10,44,24,7,21,0,16,3,7,7,7,0,18,20,0.7313885041971145,[10.29723805]
2021,9,NCAAF_20211030_UVA@BYU,BYU,Cougars,Virginia,Cavaliers,7-2,6-3,0,38,42,66,49,21,17,7,21,7,35,7,0,1,-4,17,0.456299353925707,[-1.83177526]
2021,9,NCAAF_20211030_FRESNO@SDGST,San Diego St.,Aztecs,Fresno St.,Bulldogs,7-1,7-2,0,7,20,20,30,0,7,6,7,7,13,3,7,0,-13,-10,0.4705769972686822,[-1.23195341]
2021,9,NCAAF_20211030_WASH@STNFRD,Stanford,Cardinal,Washington,Huskies,3-5,4-4,1,3,9,13,20,3,0,0,10,0,9,3,8,-1,-6,-7,0.3164475157160672,[-7.97146876]
2021,9,NCAAF_20211029_NAVY@TULSA,Tulsa,Golden Hurricane,Navy,Midshipmen,3-5,2-6,0,3,3,17,20,0,3,7,7,0,3,7,10,1,0,-3,0.436045409131523,[-2.68693888]
2021,9,NCAAF_20211029_UNLV@NEVADA,Nevada,Wolf Pack,UNLV,Rebels,6-2,0-8,1,20,0,51,20,10,10,21,10,0,0,7,13,6,20,31,0.7187183606362646,[9.66341019]
2021,9,NCAAF_20211028_SFLA@ECU,East Carolina,Pirates,South Florida,Bulls,4-4,2-6,0,6,14,29,14,0,6,13,10,0,14,0,0,2,-8,15,0.3523164195580254,[-6.32626207]
2021,9,NCAAF_20211028_TROY@CSTCAR,C. Carolina,Chanticleers,Troy,Trojans,7-1,4-4,0,21,14,35,28,7,14,7,7,7,7,7,7,3,7,7,0.46047929732782444,[-1.65596006]
2021,10,NCAAF_20211106_ILL@MINN,Minnesota,Golden Gophers,Illinois,Fighting Illini,6-3,4-6,1,0,14,6,14,0,0,0,6,7,7,0,0,2,-14,-8,0.8059480787493403,[14.39898124]
2021,10,NCAAF_20211106_KSTATE@KANSAS,Kansas,Jayhawks,Kansas State,Wildcats,1-8,6-3,1,3,21,10,35,3,0,7,0,14,7,7,7,-5,-18,-25,0.10478966419804892,[-20.93331738]
2021,10,NCAAF_20211106_LATECH@UAB,UAB,Blazers,Louisiana Tech,Bulldogs,6-3,2-7,1,24,21,52,38,7,17,7,21,7,14,0,17,4,3,14,0.5939793719718275,[3.96725562]
2021,10,NCAAF_20211106_LIB@MISS,Ole Miss,Rebels,Liberty,Flames,7-2,7-3,1,24,0,27,14,10,14,3,0,0,0,14,0,0,24,13,0.7546028065466697,[11.49577735]
2021,10,NCAAF_20211106_MIZZOU@UGA,Georgia,Bulldogs,Missouri,Tigers,9-0,4-5,0,26,3,43,6,7,19,14,3,3,0,0,3,5,23,37,0.8786938480817081,[19.4945092]
2021,10,NCAAF_20211106_OHIOST@NEB,Nebraska,Cornhuskers,Ohio State,Buckeyes,3-7,8-1,0,10,17,17,26,0,10,7,0,0,17,6,3,-5,-7,-9,0.04990157855319044,[-27.45804041]
2021,10,NCAAF_20211106_PITT@DUKE,Duke,Blue Devils,Pittsburgh,Panthers,3-6,7-2,1,19,30,29,54,12,7,3,7,7,23,14,10,-4,-11,-25,0.30063604446770653,[-8.71839174]
2021,10,NCAAF_20211106_SMU@MEMP,Memphis,Tigers,SMU,Mustangs,5-4,7-2,1,7,10,28,25,0,7,14,7,0,10,0,15,-2,-3,3,0.5719634507501767,[3.02599393]
2021,10,NCAAF_20211106_WAKE@UNC,North Carolina,Tar Heels,Wake Forest,Demon Deacons,5-4,8-1,1,24,31,58,55,14,10,10,24,10,21,17,7,-3,-7,3,0.4517120840921318,[-2.02433883]
2021,10,NCAAF_20211106_GATECH@MIAMI,Miami (Fla.),Hurricanes,Georgia Tech,Yellow Jackets,5-4,3-6,0,17,21,33,30,14,3,7,9,7,14,7,2,2,-4,3,0.7198050905069386,[9.71424569]
2021,10,NCAAF_20211106_APLST@ARKST,Arkansas St.,Red Wolves,App. St.,Mountaineers,1-8,7-2,1,14,24,14,48,0,14,0,0,14,10,14,10,-6,-10,-34,0.2262607402049086,[-12.53303259]
2021,10,NCAAF_20211106_CAL@ARIZ,Arizona,Wildcats,California,Golden Bears,1-8,3-6,0,0,0,10,3,0,0,3,7,0,0,3,0,-2,0,7,0.3566974101176942,[-6.12790199]
2021,10,NCAAF_20211106_LAMON@TXSTSM,Texas St.,Bobcats,UL-Monroe,Warhawks,3-6,4-5,1,20,16,27,19,10,10,0,7,6,10,3,0,-1,4,8,0.4557449518770045,[-1.85454168]
2021,10,NCAAF_20211106_NTEXAS@USM,So. Miss,Golden Eagles,North Texas,Mean Green,1-8,3-6,0,14,7,14,38,14,0,0,0,0,7,21,10,-2,7,-24,0.48435283325897427,[-0.6545265]
2021,10,NCAAF_20211106_TEMPLE@ECU,East Carolina,Pirates,Temple,Owls,5-4,3-6,0,21,0,45,3,7,14,14,10,0,0,0,3,2,21,42,0.3407411916223646,[-6.84764227]
2021,10,NCAAF_20211106_AUBURN@TXAM,Texas A&M,Aggies,Auburn,Tigers,7-2,6-3,0,3,3,20,3,3,0,3,14,3,0,0,0,1,0,17,0.357007524653972,[-6.11403024]
2021,10,NCAAF_20211106_BAYLOR@TCU,TCU,Horned Frogs,Baylor,Bears,4-5,7-2,1,16,14,30,28,7,9,7,7,7,7,7,7,-3,2,2,0.6318797335483332,[5.6196426]
2021,10,NCAAF_20211106_COLOST@WYO,Wyoming,Cowboys,Colorado St.,Rams,5-4,3-6,0,17,10,31,17,7,10,7,7,7,3,0,7,2,7,14,0.5393256617595823,[1.64725691]
2021,10,NCAAF_20211106_IDST@BYU,BYU,Cougars,Idaho State,Bengals,8-2,1-8,0,42,7,59,14,21,21,7,10,0,7,7,0,7,35,45,0.9458246722984045,[26.78806207]
2021,10,NCAAF_20211106_MICHST@PURDUE,Purdue,Boilermakers,Michigan St.,Spartans,6-3,8-1,0,21,14,40,29,7,14,10,9,7,7,7,8,-2,7,11,0.48895228056230455,[-0.46207054]
2021,10,NCAAF_20211106_MTSU@WKY,W. Kentucky,Hilltoppers,Middle Tenn.,Blue Raiders,5-4,4-5,0,31,14,48,21,21,10,17,0,7,7,0,7,1,17,27,0.5001628751319434,[0.00681138]
2021,10,NCAAF_20211106_NAVY@ND,Notre Dame,Fighting Irish,Navy,Midshipmen,8-1,2-7,1,17,3,34,6,0,17,0,17,3,0,3,0,6,14,28,0.9189764871317538,[23.32736533]
2021,10,NCAAF_20211106_OKLAST@WVU,West Virginia,Mountaineers,Oklahoma State,Cowboys,4-5,8-1,1,3,10,3,24,3,0,0,0,0,10,7,7,-4,-7,-21,0.38070576293106684,[-5.0656085]
2021,10,NCAAF_20211106_PSU@MD,Maryland,Terrapins,Penn State,Nittany Lions,5-4,6-3,0,6,7,14,31,0,6,0,8,7,0,7,17,-1,-1,-17,0.06485732713718906,[-25.27948397]
2021,10,NCAAF_20211106_RI@UMASS,UMass,Minutemen,Rhode Island,Rams,1-8,6-3,1,16,21,22,35,6,10,0,6,7,14,14,0,-5,-5,-13,0.36811897536856486,[-5.61969975]
2021,10,NCAAF_20211106_SALA@TROY,Troy,Trojans,South Alabama,Jaguars,5-4,5-4,0,31,14,31,24,10,21,0,0,7,7,7,3,0,17,7,0.7655221035671335,[12.08192614]
2021,10,NCAAF_20211106_TULSA@CINCY,Cincinnati,Bearcats,Tulsa,Golden Hurricane,9-0,3-6,0,14,12,28,20,14,0,14,0,0,12,0,8,6,2,8,0.798031463208207,[13.92432063]
2021,10,NCAAF_20211106_WISC@RUT,Rutgers,Scarlet Knights,Wisconsin,Badgers,4-5,6-3,0,3,31,3,52,3,0,0,0,7,24,21,0,-2,-28,-49,0.052358819474490614,[-27.0675062]
2021,10,NCAAF_20211106_MISSST@ARK,Arkansas,Razorbacks,Miss. State,Bulldogs,6-3,5-4,1,13,7,31,28,10,3,3,15,0,7,7,14,1,6,3,0.19368990178949175,[-14.42096523]
2021,10,NCAAF_20211106_NCST@FSU,Florida State,Seminoles,NC State,Wolfpack,3-6,7-2,1,0,14,14,28,0,0,14,0,7,7,7,7,-4,-14,-14,0.38972627353019385,[-4.67195531]
2021,10,NCAAF_20211106_TULANE@UCF,UCF,Knights,Tulane,Green Wave,6-3,1-8,1,7,0,14,10,7,0,0,7,0,0,10,0,5,7,4,0.8191567145064582,[15.21806175]
2021,10,NCAAF_20211106_UTAHST@NMEXST,New Mexico St.,Aggies,Utah St.,Aggies,1-8,7-2,1,13,7,13,35,10,3,0,0,0,7,21,7,-6,6,-22,0.0926944385679952,[-22.09484453]
2021,10,NCAAF_20211106_CSTCAR@GAS,Ga. Southern,Eagles,C. Carolina,Chanticleers,2-7,8-1,0,0,21,8,28,0,0,0,8,0,21,7,0,-6,-21,-20,0.41251517739378774,[-3.68840936]
2021,10,NCAAF_20211106_MRSHL@FAU,FAU,Owls,Marshall,Thundering Herd,5-4,6-3,1,13,21,13,28,10,3,0,0,7,14,7,0,-1,-8,-15,0.515333234894177,[0.64138808]
2021,10,NCAAF_20211106_BOISE@FRESNO,Fresno St.,Bulldogs,Boise St.,Broncos,7-3,5-4,0,7,16,14,40,0,7,0,7,10,6,7,17,2,-9,-26,0.3697252057190251,[-5.5486577]
2021,10,NCAAF_20211106_IOWA@NWEST,Northwestern,Wildcats,Iowa,Hawkeyes,3-6,7-2,1,3,14,12,17,0,3,3,6,7,7,3,0,-4,-11,-5,0.20122703068475478,[-13.96829831]
2021,10,NCAAF_20211106_LSU@BAMA,Alabama,Crimson Tide,LSU,Tigers,8-1,4-5,1,14,7,20,14,0,14,6,0,7,0,7,0,4,7,6,0.8412256040917705,[16.67540366]
2021,10,NCAAF_20211106_ODU@FIU,FIU,Panthers,Old Dominion,Monarchs,1-8,3-6,1,10,24,24,47,10,0,7,7,24,0,6,17,-2,-14,-23,0.6678858833517487,[7.24207278]
2021,10,NCAAF_20211106_TENN@UK,Kentucky,Wildcats,Tennessee,Volunteers,6-3,5-4,0,21,24,42,45,7,14,14,7,14,10,14,7,1,-3,-3,0.6105902520243731,[4.6857232]
2021,10,NCAAF_20211106_UNLV@NMEX,New Mexico,Lobos,UNLV,Rebels,3-6,1-8,1,17,21,17,31,7,10,0,0,7,14,3,7,2,-4,-14,0.4851012734257356,[-0.62320405]
2021,10,NCAAF_20211106_CLEM@LVILLE,Louisville,Cardinals,Clemson,Tigers,4-5,6-3,1,17,17,24,30,14,3,7,0,7,10,0,13,-2,0,-6,0.051228811282341136,[-27.2452478]
2021,10,NCAAF_20211106_FLA@SC,South Carolina,Gamecocks,Florida,Gators,5-4,4-5,0,30,10,40,17,10,20,10,0,7,3,0,7,1,20,23,0.2289457311418287,[-12.38463758]
2021,10,NCAAF_20211106_HOU@SFLA,South Florida,Bulls,Houston,Cougars,2-7,8-1,0,28,26,42,54,14,14,7,7,9,17,21,7,-6,2,-12,0.27966456417501684,[-9.74053369]
2021,10,NCAAF_20211106_IND@MICH,Michigan,Wolverines,Indiana,Hoosiers,8-1,2-7,0,17,7,29,7,3,14,6,6,0,7,0,0,6,10,22,0.811376581393213,[14.73130699]
2021,10,NCAAF_20211106_OREG@WASH,Washington,Huskies,Oregon,Ducks,4-5,8-1,0,9,10,16,26,9,0,0,7,3,7,7,9,-4,-1,-10,0.5074814030789473,[0.31288781]
2021,10,NCAAF_20211106_TEXAS@IOWAST,Iowa St.,Cyclones,Texas,Longhorns,6-3,4-5,0,3,7,30,7,3,0,21,6,0,7,0,0,2,-4,23,0.5267600842984637,[1.11993721]
2021,10,NCAAF_20211106_SJST@NEVADA,Nevada,Wolf Pack,San Jose St.,Spartans,7-2,5-5,1,7,7,27,24,7,0,10,10,7,0,7,10,2,0,3,0.7074805953818397,[9.10991295]
2021,10,NCAAF_20211106_TXSA@UTEP,UTEP,Miners,UTSA,Roadrunners,6-3,9-0,0,9,30,23,44,6,3,7,7,16,14,7,7,-3,-21,-21,0.2341933479221192,[-12.09739869]
2021,10,NCAAF_20211106_USC@ARIZST,Arizona St.,Sun Devils,USC,Trojans,6-3,4-5,0,14,10,31,16,7,7,3,14,0,10,6,0,2,4,15,0.4203068896525146,[-3.35521613]
2021,10,NCAAF_20211106_SDGST@HAWAII,Hawaii,Rainbow Warriors,San Diego St.,Aztecs,4-6,8-1,0,7,14,10,17,7,0,0,3,7,7,0,3,-4,-7,-7,0.2159109131471868,[-13.1146228]
2021,10,NCAAF_20211105_VATECH@BC,Boston College,Eagles,Virginia Tech,Hokies,5-4,4-5,0,10,0,17,3,7,3,7,0,0,0,3,0,1,10,14,0.46071408429686755,[-1.64558663]
2021,10,NCAAF_20211105_UTAH@STNFRD,Stanford,Cardinal,Utah,Utes,3-6,6-3,0,0,38,7,52,0,0,7,0,14,24,0,14,-3,-38,-45,0.3416545510146497,[-6.80611041]
2021,10,NCAAF_20211104_GAST@UL,Louisiana,Ragin' Cajuns,Georgia St.,Panthers,8-1,4-5,1,0,3,21,17,0,0,7,14,3,0,7,7,4,-3,4,0.76025973218663,[11.79762414]
2021,10,NCAAF_20211103_CMICH@WMICH,W. Michigan,Broncos,C. Michigan,Chippewas,5-4,5-4,0,14,21,30,42,7,7,10,6,0,21,7,14,0,-7,-12,0.5833627155621668,[3.51196287]
2021,10,NCAAF_20211103_NILL@KENTST,Kent St.,Golden Flashes,N. Illinois,Huskies,5-4,6-3,0,31,21,52,47,0,31,14,7,7,14,6,20,-1,10,5,0.2715773788549606,[-10.14446172]
2021,10,NCAAF_20211102_BALLST@AKRON,Akron,Zips,Ball St.,Cardinals,2-7,5-4,0,10,21,25,31,3,7,0,15,7,14,7,3,-3,-11,-6,0.2893057531683436,[-9.2663144]
2021,10,NCAAF_20211102_EMICH@TOLEDO,Toledo,Rockets,E. Michigan,Eagles,4-5,6-3,1,28,24,49,52,14,14,8,13,14,10,21,7,-2,4,-3,0.5973278863661535,[4.11145476]
2021,10,NCAAF_20211102_MIAOH@OHIO,Ohio,Bobcats,Miami-OH,RedHawks,2-7,4-5,1,14,0,35,33,7,7,14,7,0,0,13,20,-2,14,2,0.6136204542029777,[4.81769082]
2021,11,NCAAF_20211113_BUCK@ARMY,Army,Black Knights,Bucknell,Bison,6-3,1-9,0,42,0,63,10,21,21,7,14,0,0,10,0,5,42,53,0.9989289960833566,[51.19344828]
2021,11,NCAAF_20211113_CUSE@LVILLE,Louisville,Cardinals,Syracuse,Orange,5-5,5-5,0,35,3,41,3,14,21,3,3,3,0,0,0,0,32,38,0.5309456928795055,[1.29488262]
2021,11,NCAAF_20211113_HOU@TEMPLE,Temple,Owls,Houston,Cougars,3-7,9-1,1,0,10,8,37,0,0,0,8,7,3,14,13,-6,-10,-29,0.2861663527902438,[-9.41585546]
2021,11,NCAAF_20211113_ME@UMASS,UMass,Minutemen,Maine,Black Bears,1-9,5-5,1,10,14,10,35,10,0,0,0,0,14,7,14,-4,-4,-25,0.3879854000950791,[-4.74568291]
2021,11,NCAAF_20211113_MICH@PSU,Penn State,Nittany Lions,Michigan,Wolverines,6-4,9-1,1,6,7,17,21,3,3,0,11,0,7,7,7,-3,-1,-4,0.5352929368102213,[1.47723447]
2021,11,NCAAF_20211113_MISSST@AUBURN,Auburn,Tigers,Miss. State,Bulldogs,6-4,6-4,1,28,10,34,43,14,14,0,6,3,7,13,20,0,18,-9,0.6746134165211324,[7.54924208]
2021,11,NCAAF_20211113_NMEXST@BAMA,Alabama,Crimson Tide,New Mexico St.,Aggies,9-1,1-9,0,49,3,59,3,14,35,0,10,3,0,0,0,8,46,56,0.9995929899686605,[55.83252563]
2021,11,NCAAF_20211113_NWEST@WISC,Wisconsin,Badgers,Northwestern,Wildcats,7-3,3-7,1,21,0,35,7,0,21,14,0,0,0,0,7,4,21,28,0.8197250496447586,[15.24758934]
2021,11,NCAAF_20211113_OKLA@BAYLOR,Baylor,Bears,Oklahoma,Sooners,8-2,9-1,0,7,7,27,14,0,7,3,17,0,7,0,7,-1,0,13,0.14150717026141102,[-17.90339518]
2021,11,NCAAF_20211113_RUT@IND,Indiana,Hoosiers,Rutgers,Scarlet Knights,2-8,5-5,1,3,17,3,38,0,3,0,0,14,3,14,7,-3,-14,-35,0.8034256008936713,[14.24038373]
2021,11,NCAAF_20211113_SAMF@FLA,Florida,Gators,Samford,Bulldogs,5-5,4-6,0,35,42,70,52,14,21,21,14,21,21,0,10,1,-7,18,0.9589137783049797,[28.98733063]
2021,11,NCAAF_20211113_UCF@SMU,SMU,Mustangs,UCF,Knights,8-2,6-4,1,38,14,55,28,21,17,7,10,14,0,7,7,2,24,27,0.2556547010179616,[-10.95310625]
2021,11,NCAAF_20211113_UCONN@CLEM,Clemson,Tigers,UConn,Huskies,7-3,1-9,1,30,7,44,7,10,20,7,7,7,0,0,0,6,23,37,0.9995776331618295,[55.66112582]
2021,11,NCAAF_20211113_WVU@KSTATE,Kansas State,Wildcats,West Virginia,Mountaineers,7-3,4-6,0,17,3,34,17,14,3,7,10,0,3,7,7,3,14,17,0.49224182113539217,[-0.32432552]
2021,11,NCAAF_20211113_GAST@CSTCAR,C. Carolina,Chanticleers,Georgia St.,Panthers,8-2,5-5,1,23,28,40,42,14,9,3,14,14,14,0,14,3,-5,-2,0.6592041274565617,[6.84222105]
2021,11,NCAAF_20211113_UTAH@ARIZ,Arizona,Wildcats,Utah,Utes,1-9,7-3,0,17,21,29,38,14,3,3,9,7,14,10,7,-6,-4,-9,0.1483238169107337,[-17.40438387]
2021,11,NCAAF_20211113_WKY@RICE,Rice,Owls,W. Kentucky,Hilltoppers,3-7,6-4,0,0,28,21,42,0,0,7,14,7,21,0,14,-3,-28,-21,0.22316824466222307,[-12.69974329]
2021,11,NCAAF_20211113_SALA@APLST,App. St.,Mountaineers,South Alabama,Jaguars,8-2,5-5,1,14,7,31,7,14,0,3,14,0,7,0,0,3,7,24,0.9124197743820988,[22.6100767]
2021,11,NCAAF_20211113_GAS@TXSTSM,Texas St.,Bobcats,Ga. Southern,Eagles,3-7,3-7,1,17,17,30,38,0,17,7,6,3,14,14,7,0,0,-8,0.2658841194580901,[-10.42794537]
2021,11,NCAAF_20211113_BC@GATECH,Georgia Tech,Yellow Jackets,Boston College,Eagles,3-7,6-4,0,21,28,30,41,14,7,3,6,7,21,0,13,-3,-7,-11,0.4047873430834308,[-4.01860731]
2021,11,NCAAF_20211113_CHARLO@LATECH,Louisiana Tech,Bulldogs,Charlotte,49ers,3-7,5-5,0,14,7,42,32,7,7,14,14,0,7,10,15,-2,7,10,0.6821425165096261,[7.89961605]
2021,11,NCAAF_20211113_DUKE@VATECH,Virginia Tech,Hokies,Duke,Blue Devils,5-5,3-7,1,17,3,48,17,7,10,10,21,0,3,7,7,2,14,31,0.6894761734970478,[8.24427956]
2021,11,NCAAF_20211113_FAU@ODU,Old Dominion,Monarchs,FAU,Owls,4-6,5-5,0,11,3,30,16,2,9,6,13,3,0,7,6,-1,8,14,0.13392271176734938,[-18.47815767]
2021,11,NCAAF_20211113_FIU@MTSU,Middle Tenn.,Blue Raiders,FIU,Panthers,5-5,1-9,1,34,3,50,10,7,27,9,7,3,0,0,7,4,31,40,0.5855838480642834,[3.60544238]
2021,11,NCAAF_20211113_IOWAST@TXTECH,Texas Tech,Red Raiders,Iowa St.,Cyclones,6-4,6-4,1,31,14,41,38,14,17,0,10,7,7,7,17,0,17,3,0.2517509561481377,[-11.15638776]
2021,11,NCAAF_20211113_MIAMI@FSU,Florida State,Seminoles,Miami (Fla.),Hurricanes,4-6,5-5,0,20,7,31,28,14,6,0,11,0,7,7,14,-1,13,3,0.3062920673298587,[-8.44476628]
2021,11,NCAAF_20211113_MINN@IOWA,Iowa,Hawkeyes,Minnesota,Golden Gophers,8-2,6-4,0,10,13,27,22,3,7,7,10,3,10,3,6,2,-3,5,0.735704659007333,[10.50882226]
2021,11,NCAAF_20211113_PURDUE@OHIOST,Ohio State,Buckeyes,Purdue,Boilermakers,9-1,6-4,0,45,17,59,31,21,24,7,7,7,10,14,0,3,28,28,0.9218766746282571,[23.64403747]
2021,11,NCAAF_20211113_UAB@MRSHL,Marshall,Thundering Herd,UAB,Blazers,6-4,7-3,0,7,14,14,21,0,7,7,0,14,0,7,0,-1,-7,-7,0.605874339298333,[4.47899963]
2021,11,NCAAF_20211113_UGA@TENN,Tennessee,Volunteers,Georgia,Bulldogs,5-5,10-0,1,10,24,17,41,10,0,0,7,7,17,3,14,-5,-14,-24,0.06988477581943553,[-24.62529962]
2021,11,NCAAF_20211113_UL@TROY,Troy,Trojans,Louisiana,Ragin' Cajuns,5-5,9-1,1,13,14,21,35,10,3,0,8,14,0,14,7,-4,-1,-14,0.4144280005615577,[-3.60493538]
2021,11,NCAAF_20211113_USM@TXSA,UTSA,Roadrunners,So. Miss,Golden Eagles,10-0,1-9,0,10,10,27,17,0,10,7,10,0,10,7,0,9,0,10,0.4986812119933052,[-0.05512768]
2021,11,NCAAF_20211113_HAWAII@UNLV,UNLV,Rebels,Hawaii,Rainbow Warriors,2-8,4-7,0,10,10,27,13,7,3,10,7,10,0,0,3,-2,0,14,0.38210118628267453,[-5.00238858]
2021,11,NCAAF_20211113_MD@MICHST,Michigan St.,Spartans,Maryland,Terrapins,9-1,5-5,1,27,14,40,21,13,14,7,6,7,7,7,0,4,13,19,0.724470973299464,[9.94209908]
2021,11,NCAAF_20211113_SC@MIZZOU,Missouri,Tigers,South Carolina,Gamecocks,5-5,5-5,0,17,14,31,28,0,17,7,7,7,7,0,14,0,3,3,0.5883007805978914,[3.721789]
2021,11,NCAAF_20211113_UTEP@NTEXAS,North Texas,Mean Green,UTEP,Miners,4-6,6-4,0,3,7,20,17,0,3,14,3,0,7,0,10,-2,-4,3,0.7993951863411817,[13.99927396]
2021,11,NCAAF_20211113_ARKST@LAMON,UL-Monroe,Warhawks,Arkansas St.,Red Wolves,4-6,2-8,0,7,10,24,27,0,7,17,0,7,3,7,10,2,-3,-3,0.24188341302645155,[-11.67781212]
2021,11,NCAAF_20211113_STNFRD@OREGST,Oregon State,Beavers,Stanford,Cardinal,6-4,3-7,0,14,0,35,14,7,7,14,7,0,0,7,7,3,14,21,0.24138056124081197,[-11.7046878]
2021,11,NCAAF_20211113_AF@COLOST,Colorado St.,Rams,Air Force,Falcons,3-7,7-3,1,14,21,21,35,7,7,7,0,21,0,14,0,-4,-7,-14,0.33320888351696953,[-7.1887176]
2021,11,NCAAF_20211113_ARIZST@WASH,Washington,Huskies,Arizona St.,Sun Devils,4-6,7-3,1,17,7,30,35,14,3,7,6,0,7,7,21,-3,10,-5,0.6819361797023638,[7.88996806]
2021,11,NCAAF_20211113_NMEX@FRESNO,Fresno St.,Bulldogs,New Mexico,Lobos,8-3,3-7,0,24,0,34,7,7,17,10,0,0,0,7,0,5,24,27,0.8877995928403712,[20.26038842]
2021,11,NCAAF_20211113_TXAM@MISS,Ole Miss,Rebels,Texas A&M,Aggies,8-2,7-3,1,15,0,29,19,10,5,0,14,0,0,10,9,1,15,10,0.32692389072949724,[-7.47811485]
2021,11,NCAAF_20211113_UK@VANDY,Vanderbilt,Commodores,Kentucky,Wildcats,2-8,7-3,1,3,31,17,34,3,0,8,6,7,24,0,3,-5,-28,-17,0.17765760337630065,[-15.41453636]
2021,11,NCAAF_20211113_NCST@WAKE,Wake Forest,Demon Deacons,NC State,Wolfpack,9-1,7-3,1,24,20,45,42,7,17,7,14,6,14,7,15,2,4,3,0.4995535320127049,[-0.01866313]
2021,11,NCAAF_20211113_ND@UVA,Virginia,Cavaliers,Notre Dame,Fighting Irish,6-4,9-1,0,0,21,3,28,0,0,0,3,7,14,7,0,-3,-21,-25,0.1781108931351496,[-15.38551299]
2021,11,NCAAF_20211113_TCU@OKLAST,Oklahoma State,Cowboys,TCU,Horned Frogs,9-1,4-6,1,28,3,63,17,7,21,14,21,3,0,0,14,5,25,46,0.5641442075450245,[2.69299577]
2021,11,NCAAF_20211113_COLO@UCLA,UCLA,Bruins,Colorado,Buffaloes,6-4,3-7,0,10,20,44,20,0,10,20,14,7,13,0,0,3,-10,24,0.6023296340012012,[4.32557053]
2021,11,NCAAF_20211113_NEVADA@SDGST,San Diego St.,Aztecs,Nevada,Wolf Pack,9-1,7-3,1,10,7,23,21,7,3,7,6,0,7,7,7,2,3,2,0.6794228614944343,[7.77265972]
2021,11,NCAAF_20211113_UTAHST@SJST,San Jose St.,Spartans,Utah St.,Aggies,5-6,8-2,1,14,24,17,48,7,7,3,0,0,24,7,17,-3,-10,-31,0.18498252001542093,[-14.95109996]
2021,11,NCAAF_20211113_WASHST@OREG,Oregon,Ducks,Washington St.,Cougars,9-1,5-5,0,14,14,38,24,14,0,10,14,0,14,0,10,4,0,14,0.6463729721496327,[6.26278889]
2021,11,NCAAF_20211112_CINCY@SFLA,South Florida,Bulls,Cincinnati,Bearcats,2-8,10-0,1,7,24,28,45,7,0,14,7,7,17,7,14,-8,-17,-17,0.16437782387863475,[-16.28662664]
2021,11,NCAAF_20211112_WYO@BOISE,Boise St.,Broncos,Wyoming,Cowboys,6-4,5-5,0,10,7,23,13,7,3,3,10,0,7,0,6,1,3,10,0.77912626417484,[12.82829983]
2021,11,NCAAF_20211110_BALLST@NILL,N. Illinois,Huskies,Ball St.,Cardinals,7-3,5-5,0,17,17,30,29,0,17,3,10,10,7,9,3,2,0,1,0.6480869583707557,[6.33973816]
2021,11,NCAAF_20211110_TOLEDO@BGREEN,Bowling Green,Falcons,Toledo,Rockets,3-7,5-5,1,10,35,17,49,7,3,0,7,14,21,7,7,-2,-25,-32,0.09134122931139044,[-22.22207609]
2021,11,NCAAF_20211110_KENTST@CMICH,C. Michigan,Chippewas,Kent St.,Golden Flashes,6-4,5-5,1,26,17,54,30,0,26,14,14,14,3,13,0,1,9,24,0.6987799729951624,[8.68668468]
2021,11,NCAAF_20211109_AKRON@WMICH,W. Michigan,Broncos,Akron,Zips,6-4,2-8,0,24,14,45,40,7,17,7,14,7,7,10,16,4,10,5,0.8534293411492697,[17.53122481]
2021,11,NCAAF_20211109_BUFF@MIAOH,Miami-OH,RedHawks,Buffalo,Bulls,5-5,4-6,0,24,10,45,18,10,14,14,7,7,3,0,8,1,14,27,0.37278137970787695,[-5.411442]
2021,11,NCAAF_20211109_OHIO@EMICH,E. Michigan,Eagles,Ohio,Bobcats,6-4,3-7,0,13,20,26,34,7,6,7,6,14,6,7,7,3,-7,-8,0.41458267338067845,[-3.59831723]
2021,12,NCAAF_20211120_CHARSO@UGA,Georgia,Bulldogs,Charleston So.,Buccaneers,11-0,4-6,1,49,0,56,7,28,21,7,0,0,0,7,0,7,49,49,0.9998555542289052,[60.51181692]
2021,12,NCAAF_20211120_FAU@WKY,W. Kentucky,Hilltoppers,FAU,Owls,7-4,5-6,0,31,10,52,17,14,17,7,14,3,7,7,0,2,21,35,0.3340001281064664,[-7.15937013]
2021,12,NCAAF_20211120_FSU@BC,Boston College,Eagles,Florida State,Seminoles,6-5,5-6,1,3,19,23,26,0,3,7,13,7,12,7,0,1,-16,-3,0.569786381801856,[2.93507022]
2021,12,NCAAF_20211120_IOWAST@OKLA,Oklahoma,Sooners,Iowa St.,Cyclones,10-1,6-5,0,14,7,28,21,7,7,7,7,7,0,0,14,4,7,7,0.6740219962334036,[7.52915166]
2021,12,NCAAF_20211120_KENTST@AKRON,Akron,Zips,Kent St.,Golden Flashes,2-9,6-5,1,0,29,0,38,0,0,0,0,7,22,3,6,-4,-29,-38,0.3730324231780259,[-5.40561522]
2021,12,NCAAF_20211120_MICHST@OHIOST,Ohio State,Buckeyes,Michigan St.,Spartans,10-1,9-2,1,49,0,56,7,21,28,0,7,0,0,0,7,1,49,49,0.9218837243164438,[23.66775626]
2021,12,NCAAF_20211120_NMEXST@UK,Kentucky,Wildcats,New Mexico St.,Aggies,8-3,1-10,0,35,16,56,16,21,14,14,7,7,9,0,0,7,19,40,0.9608748197624539,[29.39453704]
2021,12,NCAAF_20211120_PRARIE@TXAM,Texas A&M,Aggies,Prairie View,Panthers,8-3,7-3,0,38,0,52,3,21,17,7,7,0,0,3,0,1,38,49,0.9962481725880155,[44.62980697]
2021,12,NCAAF_20211120_PURDUE@NWEST,Northwestern,Wildcats,Purdue,Boilermakers,3-8,7-4,0,7,13,14,32,0,7,7,0,0,13,13,6,-4,-6,-18,0.4248350813212438,[-3.16390872]
2021,12,NCAAF_20211120_RUT@PSU,Penn State,Nittany Lions,Rutgers,Scarlet Knights,7-4,5-6,1,7,0,28,0,0,7,14,7,0,0,0,0,2,7,28,0.9624973645223036,[29.7200892]
2021,12,NCAAF_20211120_SFLA@TULANE,Tulane,Green Wave,South Florida,Bulls,2-9,2-9,0,35,7,45,14,28,7,7,3,7,0,0,7,0,28,31,0.645833450876752,[6.24464044]
2021,12,NCAAF_20211120_TEXAS@WVU,West Virginia,Mountaineers,Texas,Longhorns,5-6,4-7,1,21,10,31,23,7,14,7,3,0,10,7,6,1,11,8,0.3614475747363761,[-5.91907471]
2021,12,NCAAF_20211120_TNST@MISSST,Miss. State,Bulldogs,Tennessee St.,Tigers,7-4,5-6,0,35,0,55,10,21,14,14,6,0,0,0,10,2,35,45,0.9537307796058635,[28.07961594]
2021,12,NCAAF_20211120_UMASS@ARMY,Army,Black Knights,UMass,Minutemen,7-3,1-10,0,19,10,33,17,8,11,0,14,3,7,0,7,6,9,16,0.9572951491638167,[28.71340702]
2021,12,NCAAF_20211120_WAKE@CLEM,Clemson,Tigers,Wake Forest,Demon Deacons,8-3,9-2,0,17,10,48,27,10,7,21,10,0,10,3,14,-1,7,21,0.9027691695560645,[21.6585644]
2021,12,NCAAF_20211120_WOFF@UNC,North Carolina,Tar Heels,Wofford,Terriers,6-5,1-10,1,20,7,34,14,10,10,14,0,0,7,0,7,5,13,20,0.8598074764402797,[18.01893588]
2021,12,NCAAF_20211120_TXSTSM@CSTCAR,C. Carolina,Chanticleers,Texas St.,Bobcats,9-2,3-8,1,14,14,35,21,7,7,14,7,0,14,7,0,6,0,14,0.8066122586074126,[14.44713201]
2021,12,NCAAF_20211120_ARKST@GAST,Georgia St.,Panthers,Arkansas St.,Red Wolves,6-5,2-9,1,14,13,28,20,7,7,0,14,3,10,0,7,4,1,8,0.38193075742217697,[-5.01469605]
2021,12,NCAAF_20211120_ILL@IOWA,Iowa,Hawkeyes,Illinois,Fighting Illini,9-2,4-7,0,17,13,33,23,7,10,3,13,10,3,3,7,5,4,10,0.9235497060751374,[23.85978511]
2021,12,NCAAF_20211120_GATECH@ND,Notre Dame,Fighting Irish,Georgia Tech,Yellow Jackets,10-1,3-8,1,45,0,55,0,24,21,10,0,0,0,0,0,7,45,55,0.8852381242673822,[20.05763632]
2021,12,NCAAF_20211120_WASH@COLO,Colorado,Buffaloes,Washington,Huskies,4-7,4-7,1,10,10,20,17,10,0,0,10,0,10,0,7,0,0,3,0.16683954208166285,[-16.13726142]
2021,12,NCAAF_20211120_APLST@TROY,Troy,Trojans,App. St.,Mountaineers,5-6,9-2,1,7,10,7,45,7,0,0,0,3,7,21,14,-4,-3,-38,0.25812819456246106,[-10.8356324]
2021,12,NCAAF_20211120_ARK@BAMA,Alabama,Crimson Tide,Arkansas,Razorbacks,10-1,7-4,0,24,14,42,35,3,21,10,8,0,14,7,14,3,10,7,0.9854148219070562,[36.40956771]
2021,12,NCAAF_20211120_ECU@NAVY,Navy,Midshipmen,East Carolina,Pirates,2-8,7-4,0,21,24,35,38,7,14,0,14,14,10,0,14,-5,-3,-3,0.7196950932204103,[9.71404006]
2021,12,NCAAF_20211120_MICH@MD,Maryland,Terrapins,Michigan,Wolverines,5-6,10-1,0,3,24,18,59,0,3,15,0,14,10,28,7,-5,-21,-41,0.07549904893567061,[-23.9708614]
2021,12,NCAAF_20211120_MINN@IND,Indiana,Hoosiers,Minnesota,Golden Gophers,2-9,7-4,0,7,21,14,35,7,0,0,7,0,21,7,7,-5,-14,-21,0.43412132601489617,[-2.76915826]
2021,12,NCAAF_20211120_MRSHL@CHARLO,Charlotte,49ers,Marshall,Thundering Herd,5-6,7-4,1,14,21,28,49,7,7,0,14,7,14,21,7,-2,-7,-21,0.16026487703263959,[-16.58195227]
2021,12,NCAAF_20211120_NEB@WISC,Wisconsin,Badgers,Nebraska,Cornhuskers,8-3,3-8,0,14,14,35,28,14,0,14,7,7,7,7,7,5,0,7,0.8247835489328388,[15.58673938]
2021,12,NCAAF_20211120_ODU@MTSU,Middle Tenn.,Blue Raiders,Old Dominion,Monarchs,5-6,5-6,1,10,10,17,24,7,3,0,7,7,3,0,14,0,0,-7,0.7146626779928006,[9.46569098]
2021,12,NCAAF_20211120_SMU@CINCY,Cincinnati,Bearcats,SMU,Mustangs,11-0,8-3,0,27,0,48,14,14,13,14,7,0,0,0,14,3,27,34,0.6310291701625126,[5.58502523]
2021,12,NCAAF_20211120_UAB@TXSA,UTSA,Roadrunners,UAB,Blazers,11-0,7-4,0,17,24,34,31,7,10,10,7,14,10,0,7,4,-7,3,0.3297297392037575,[-7.35576567]
2021,12,NCAAF_20211120_UVA@PITT,Pittsburgh,Panthers,Virginia,Cavaliers,9-2,6-5,0,24,21,48,38,0,24,10,14,7,14,10,7,3,3,10,0.5491063988404022,[2.05993669]
2021,12,NCAAF_20211120_BYU@GAS,Ga. Southern,Eagles,BYU,Cougars,3-8,9-2,1,17,20,17,34,3,14,0,0,7,13,7,7,-6,-3,-17,0.15401388757881684,[-17.01594805]
2021,12,NCAAF_20211120_CUSE@NCST,NC State,Wolfpack,Syracuse,Orange,8-3,5-6,1,28,7,41,17,0,28,10,3,0,7,3,7,3,21,24,0.6474853816860026,[6.31883263]
2021,12,NCAAF_20211120_KANSAS@TCU,TCU,Horned Frogs,Kansas,Jayhawks,5-6,2-9,0,7,14,31,28,7,0,14,10,7,7,0,14,3,-7,3,0.9212476551351515,[23.59525968]
2021,12,NCAAF_20211120_RICE@UTEP,UTEP,Miners,Rice,Owls,7-4,3-8,1,14,21,38,28,7,7,10,14,0,21,0,7,4,-7,10,0.42370443464434504,[-3.21208818]
2021,12,NCAAF_20211120_TEMPLE@TULSA,Tulsa,Golden Hurricane,Temple,Owls,5-6,3-8,0,27,0,44,10,10,17,7,10,0,0,10,0,2,27,34,0.5645736249281477,[2.71381067]
2021,12,NCAAF_20211120_UCLA@USC,USC,Trojans,UCLA,Bruins,4-6,7-4,1,17,28,33,62,10,7,9,7,7,21,14,20,-3,-11,-29,0.6410235096891601,[6.02930904]
2021,12,NCAAF_20211120_UCONN@UCF,UCF,Knights,UConn,Huskies,7-4,1-10,0,35,14,49,17,21,14,0,14,0,14,0,3,6,21,32,0.9893011252311485,[38.4079282]
2021,12,NCAAF_20211120_UL@LIB,Liberty,Flames,Louisiana,Ragin' Cajuns,7-4,10-1,1,7,21,14,42,0,7,7,0,7,14,7,14,-3,-14,-28,0.4586123491149685,[-1.73486896]
2021,12,NCAAF_20211120_BAYLOR@KSTATE,Kansas State,Wildcats,Baylor,Bears,7-4,9-2,0,7,17,10,20,0,7,3,0,7,10,0,3,-2,-10,-10,0.5448242112134654,[1.87950785]
2021,12,NCAAF_20211120_AUBURN@SC,South Carolina,Gamecocks,Auburn,Tigers,6-5,6-5,0,14,14,21,17,0,14,7,0,14,0,3,0,0,0,4,0.187467893829947,[-14.81079792]
2021,12,NCAAF_20211120_CAL@STNFRD,Stanford,Cardinal,California,Golden Bears,3-8,4-6,1,3,14,11,41,0,3,0,8,0,14,13,14,-1,-11,-30,0.5715579498688603,[3.01038142]
2021,12,NCAAF_20211120_NTEXAS@FIU,FIU,Panthers,North Texas,Mean Green,1-10,5-6,0,0,35,7,49,0,0,7,0,7,28,14,0,-4,-35,-42,0.42974755219684235,[-2.95487732]
2021,12,NCAAF_20211120_OREG@UTAH,Utah,Utes,Oregon,Ducks,8-3,9-2,1,28,0,38,7,7,21,7,3,0,0,7,0,-1,28,31,0.4836467056394096,[-0.68444973]
2021,12,NCAAF_20211120_SALA@TENN,Tennessee,Volunteers,South Alabama,Jaguars,6-5,5-6,0,35,7,60,14,14,21,14,11,0,7,0,7,1,28,46,0.9107244769827121,[22.45541883]
2021,12,NCAAF_20211120_VANDY@MISS,Ole Miss,Rebels,Vanderbilt,Commodores,9-2,2-9,1,24,9,31,17,10,14,0,7,3,6,0,8,7,15,14,0.8064515816530785,[14.43735708]
2021,12,NCAAF_20211120_VATECH@MIAMI,Miami (Fla.),Hurricanes,Virginia Tech,Hokies,6-5,5-6,0,28,13,38,26,14,14,3,7,3,10,13,0,1,15,12,0.5850517702213183,[3.58614992]
2021,12,NCAAF_20211120_OKLAST@TXTECH,Texas Tech,Red Raiders,Oklahoma State,Cowboys,6-5,10-1,1,0,13,0,23,0,0,0,0,3,10,3,7,-4,-13,-23,0.27926774064823934,[-9.76549059]
2021,12,NCAAF_20211120_WYO@UTAHST,Utah St.,Aggies,Wyoming,Cowboys,8-3,6-5,0,17,24,17,44,14,3,0,0,14,10,17,3,2,-7,-27,0.590606740339305,[3.82438125]
2021,12,NCAAF_20211120_LAMON@LSU,LSU,Tigers,UL-Monroe,Warhawks,5-6,4-7,0,17,7,27,14,7,10,7,3,0,7,0,7,1,10,13,0.990701914873759,[39.28657755]
2021,12,NCAAF_20211120_NMEX@BOISE,Boise St.,Broncos,New Mexico,Lobos,7-4,3-8,0,24,0,37,0,10,14,6,7,0,0,0,0,4,24,37,0.9450927281944381,[26.69196587]
2021,12,NCAAF_20211120_ARIZST@OREGST,Oregon State,Beavers,Arizona St.,Sun Devils,7-4,7-4,0,17,0,24,10,3,14,0,7,0,0,3,7,0,17,14,0.23559011440621702,[-12.02804052]
2021,12,NCAAF_20211120_COLOST@HAWAII,Hawaii,Rainbow Warriors,Colorado St.,Rams,5-7,3-8,1,29,10,50,45,9,20,7,14,7,3,7,28,2,19,5,0.36677934846429383,[-5.68209536]
2021,12,NCAAF_20211119_USM@LATECH,Louisiana Tech,Bulldogs,So. Miss,Golden Eagles,3-8,2-9,0,9,21,19,35,3,6,0,10,7,14,0,14,1,-12,-16,0.5763067238210962,[3.2125638]
2021,12,NCAAF_20211119_ARIZ@WASHST,Washington St.,Cougars,Arizona,Wildcats,6-5,1-10,1,21,7,44,18,7,14,16,7,0,7,3,8,5,14,26,0.7468729318854894,[11.09528282]
2021,12,NCAAF_20211119_MEMP@HOU,Houston,Cougars,Memphis,Tigers,10-1,5-6,0,21,3,31,13,0,21,0,10,0,3,7,3,5,18,18,0.43445153750006715,[-2.75515102]
2021,12,NCAAF_20211119_SDGST@UNLV,UNLV,Rebels,San Diego St.,Aztecs,2-9,10-1,1,10,21,20,28,3,7,10,0,7,14,0,7,-8,-11,-8,0.1488631563596654,[-17.38239321]
2021,12,NCAAF_20211118_LVILLE@DUKE,Duke,Blue Devils,Louisville,Cardinals,3-8,6-5,0,9,35,22,62,3,6,7,6,14,21,13,14,-3,-26,-40,0.36515609275540095,[-5.75412023]
2021,12,NCAAF_20211117_CMICH@BALLST,Ball St.,Cardinals,C. Michigan,Chippewas,5-6,7-4,1,17,28,17,37,7,10,0,0,7,21,6,3,-2,-11,-20,0.36652142880524274,[-5.69353232]
2021,12,NCAAF_20211116_TOLEDO@OHIO,Ohio,Bobcats,Toledo,Rockets,3-8,6-5,0,6,14,23,35,0,6,3,14,0,14,14,7,-3,-8,-12,0.4942929164901879,[-0.23880514]
2021,12,NCAAF_20211116_WMICH@EMICH,E. Michigan,Eagles,W. Michigan,Broncos,7-4,6-5,1,6,7,22,21,0,6,10,6,0,7,14,0,1,-1,1,0.4679940068484293,[-1.34064137]
2021,12,NCAAF_20211116_BGREEN@MIAOH,Miami-OH,RedHawks,Bowling Green,Falcons,6-5,3-8,0,20,7,34,7,6,14,14,0,7,0,0,0,3,13,27,0.8609267013454296,[18.10302484]
2021,13,NCAAF_20211127_AKRON@TOLEDO,Toledo,Rockets,Akron,Zips,7-5,2-10,0,21,7,49,14,7,14,14,14,0,7,0,7,5,14,35,0.8909400491941433,[20.62763602]
2021,13,NCAAF_20211127_ARMY@LIB,Liberty,Flames,Army,Black Knights,7-5,8-3,1,3,24,16,31,0,3,13,0,10,14,7,0,-1,-21,-15,0.3806710514900108,[-5.0871163]
2021,13,NCAAF_20211127_FSU@FLA,Florida,Gators,Florida State,Seminoles,6-6,5-7,1,7,7,24,21,7,0,10,7,0,7,0,14,1,0,3,0.7843909348687405,[13.18362213]
2021,13,NCAAF_20211127_HOU@UCONN,UConn,Huskies,Houston,Cougars,1-11,11-1,1,10,21,17,45,0,10,0,7,7,14,17,7,-10,-11,-28,0.043230389872417674,[-28.71471514]
2021,13,NCAAF_20211127_MD@RUT,Rutgers,Scarlet Knights,Maryland,Terrapins,5-7,6-6,0,2,20,16,40,2,0,14,0,13,7,6,14,-1,-18,-24,0.40154785904572776,[-4.17634685]
2021,13,NCAAF_20211127_NAVY@TEMPLE,Temple,Owls,Navy,Midshipmen,3-9,3-8,0,7,17,14,38,0,7,7,0,7,10,7,14,0,-10,-24,0.3685782360914214,[-5.62146392]
2021,13,NCAAF_20211127_OHIOST@MICH,Michigan,Wolverines,Ohio State,Buckeyes,11-1,10-2,1,14,13,42,27,7,7,14,14,3,10,0,14,1,1,15,0.27052539608886106,[-10.23766405]
2021,13,NCAAF_20211127_TXTECH@BAYLOR,Baylor,Bears,Texas Tech,Red Raiders,10-2,6-6,1,17,10,27,24,10,7,0,10,3,7,0,14,4,7,3,0.5434270785071663,[1.8268837]
2021,13,NCAAF_20211127_UGA@GATECH,Georgia Tech,Yellow Jackets,Georgia,Bulldogs,3-9,12-0,1,0,24,0,45,0,0,0,0,10,14,14,7,-9,-24,-45,0.04601277991756958,[-28.21957255]
2021,13,NCAAF_20211127_WAKE@BC,Boston College,Eagles,Wake Forest,Demon Deacons,6-6,10-2,0,10,24,10,41,7,3,0,0,14,10,10,7,-4,-14,-31,0.4492854453241488,[-2.13499698]
2021,13,NCAAF_20211127_MIAMI@DUKE,Duke,Blue Devils,Miami (Fla.),Hurricanes,3-9,7-5,1,10,30,10,47,10,0,0,0,10,20,17,0,-4,-20,-37,0.21103704177296723,[-13.44691043]
2021,13,NCAAF_20211127_LATECH@RICE,Rice,Owls,Louisiana Tech,Bulldogs,4-8,3-9,0,14,10,35,31,7,7,7,14,10,0,14,7,1,4,4,0.2367568071231807,[-12.00555166]
2021,13,NCAAF_20211127_CHARLO@ODU,Old Dominion,Monarchs,Charlotte,49ers,6-6,5-7,0,28,14,56,34,14,14,7,21,0,14,14,6,1,14,22,0.48417845235758383,[-0.66443534]
2021,13,NCAAF_20211127_TROY@GAST,Georgia St.,Panthers,Troy,Trojans,7-5,5-7,0,17,3,37,10,7,10,13,7,0,3,0,7,2,14,27,0.3394090124246223,[-6.93554509]
2021,13,NCAAF_20211127_TXSA@NTEXAS,North Texas,Mean Green,UTSA,Roadrunners,6-6,11-1,1,31,13,45,23,17,14,14,0,3,10,0,10,-5,18,22,0.5394371267876403,[1.65845739]
2021,13,NCAAF_20211127_TXSTSM@ARKST,Arkansas St.,Red Wolves,Texas St.,Bobcats,2-10,4-8,0,10,17,22,24,7,3,3,9,14,3,7,0,-2,-7,-2,0.7752642744196495,[12.66753227]
2021,13,NCAAF_20211127_GAS@APLST,App. St.,Mountaineers,Ga. Southern,Eagles,10-2,3-9,0,7,0,27,3,7,0,10,10,0,0,3,0,7,7,24,0.8401648941740502,[16.66795396]
2021,13,NCAAF_20211127_FIU@USM,So. Miss,Golden Eagles,FIU,Panthers,3-9,1-11,0,21,14,37,17,21,0,3,13,7,7,3,0,2,7,20,0.5619788601181375,[2.61271375]
2021,13,NCAAF_20211127_HAWAII@WYO,Wyoming,Cowboys,Hawaii,Rainbow Warriors,6-6,6-7,0,7,31,14,38,0,7,7,0,14,17,0,7,0,-24,-24,0.6928644966133257,[8.44148127]
2021,13,NCAAF_20211127_UMASS@NMEXST,New Mexico St.,Aggies,UMass,Minutemen,2-10,1-11,1,27,13,44,27,7,20,7,10,0,13,14,0,1,14,17,0.6653379536048324,[7.15327519]
2021,13,NCAAF_20211127_IND@PURDUE,Purdue,Boilermakers,Indiana,Hoosiers,8-4,2-10,1,17,7,44,7,7,10,14,13,7,0,0,0,6,10,37,0.5718326493990384,[3.03234766]
2021,13,NCAAF_20211127_NWEST@ILL,Illinois,Fighting Illini,Northwestern,Wildcats,5-7,3-9,1,37,7,47,14,14,23,3,7,0,7,0,7,2,30,33,0.2866630285931363,[-9.43260392]
2021,13,NCAAF_20211127_OREGST@OREG,Oregon,Ducks,Oregon State,Beavers,10-2,7-5,1,24,3,38,29,14,10,0,14,3,0,6,20,3,21,9,0.8708620745400226,[18.93481855]
2021,13,NCAAF_20211127_PSU@MICHST,Michigan St.,Spartans,Penn State,Nittany Lions,10-2,7-5,1,17,14,30,27,14,3,6,7,7,7,6,7,3,3,3,0.1821334401476602,[-15.19616175]
2021,13,NCAAF_20211127_WKY@MRSHL,Marshall,Thundering Herd,W. Kentucky,Hilltoppers,7-5,8-4,0,14,6,21,53,7,7,0,7,0,6,23,24,-1,8,-32,0.6621184887603228,[7.00547774]
2021,13,NCAAF_20211127_VANDY@TENN,Tennessee,Volunteers,Vanderbilt,Commodores,7-5,2-10,0,24,7,45,21,7,17,14,7,0,7,6,8,5,17,24,0.7523332546651675,[11.42060456]
2021,13,NCAAF_20211127_VATECH@UVA,Virginia,Cavaliers,Virginia Tech,Hokies,6-6,6-6,0,21,17,24,29,14,7,3,0,7,10,7,5,0,4,-5,0.46423201708638173,[-1.50372149]
2021,13,NCAAF_20211127_ARIZ@ARIZST,Arizona St.,Sun Devils,Arizona,Wildcats,8-4,1-11,0,14,9,38,15,7,7,17,7,3,6,6,0,7,5,23,0.7152188386774178,[9.52533514]
2021,13,NCAAF_20211127_LAMON@UL,Louisiana,Ragin' Cajuns,UL-Monroe,Warhawks,11-1,4-8,1,14,10,21,16,14,0,7,0,3,7,0,6,7,4,5,0.8583815394248235,[17.97341088]
2021,13,NCAAF_20211127_TULSA@SMU,SMU,Mustangs,Tulsa,Golden Hurricane,8-4,6-6,1,17,14,31,34,10,7,0,14,0,14,14,6,2,3,-3,0.660455610504777,[6.92935306]
2021,13,NCAAF_20211127_WISC@MINN,Minnesota,Golden Gophers,Wisconsin,Badgers,8-4,8-4,1,6,10,23,13,3,3,14,3,0,10,3,0,0,-4,10,0.2434247786286663,[-11.64635072]
2021,13,NCAAF_20211127_MTSU@FAU,FAU,Owls,Middle Tenn.,Blue Raiders,5-7,6-6,1,14,3,17,27,7,7,3,0,0,3,7,17,-1,11,-10,0.6706284528613485,[7.39737024]
2021,13,NCAAF_20211127_TXAM@LSU,LSU,Tigers,Texas A&M,Aggies,6-6,8-4,1,17,7,27,24,3,14,3,7,0,7,3,14,-2,10,3,0.5883440767196584,[3.73993554]
2021,13,NCAAF_20211127_WVU@KANSAS,Kansas,Jayhawks,West Virginia,Mountaineers,2-10,6-6,1,13,21,28,34,6,7,8,7,7,14,10,3,-4,-8,-6,0.10621067054517952,[-20.88544534]
2021,13,NCAAF_20211127_CLEM@SC,South Carolina,Gamecocks,Clemson,Tigers,6-6,9-3,0,0,17,0,30,0,0,0,0,10,7,3,10,-3,-17,-30,0.07724283023651135,[-23.84891564]
2021,13,NCAAF_20211127_OKLA@OKLAST,Oklahoma State,Cowboys,Oklahoma,Sooners,11-1,10-2,1,24,24,37,33,14,10,0,13,7,17,9,0,1,0,4,0.31194306525112236,[-8.213084]
2021,13,NCAAF_20211127_PITT@CUSE,Syracuse,Orange,Pittsburgh,Panthers,5-7,10-2,1,7,14,14,31,7,0,7,0,0,14,14,3,-5,-7,-17,0.3443904776262102,[-6.70831187]
2021,13,NCAAF_20211127_TULANE@MEMP,Memphis,Tigers,Tulane,Green Wave,6-6,2-10,1,14,14,33,28,7,7,6,13,7,7,7,7,4,0,5,0.6421784047353092,[6.10160979]
2021,13,NCAAF_20211127_UK@LVILLE,Louisville,Cardinals,Kentucky,Wildcats,6-6,9-3,0,7,24,21,52,7,0,0,14,14,10,14,14,-3,-17,-31,0.39161832190830614,[-4.60782749]
2021,13,NCAAF_20211127_ND@STNFRD,Stanford,Cardinal,Notre Dame,Fighting Irish,3-9,11-1,1,0,24,14,45,0,0,7,7,7,17,7,14,-8,-24,-31,0.18399418509368726,[-15.07863482]
2021,13,NCAAF_20211127_NEVADA@COLOST,Colorado St.,Rams,Nevada,Wolf Pack,3-9,8-4,0,0,31,10,52,0,0,7,3,14,17,7,14,-5,-31,-42,0.4998045645993261,[-0.00820527]
2021,13,NCAAF_20211127_BYU@USC,USC,Trojans,BYU,Cougars,4-7,10-2,1,13,21,31,35,3,10,10,8,7,14,7,7,-6,-8,-4,0.6269589574227054,[5.42362726]
2021,13,NCAAF_20211127_CAL@UCLA,UCLA,Bruins,California,Golden Bears,8-4,4-7,0,17,14,42,14,3,14,10,15,0,14,0,0,4,3,28,0.5182753497087824,[0.76755153]
2021,13,NCAAF_20211126_BOISE@SDGST,San Diego St.,Aztecs,Boise St.,Broncos,11-1,7-5,0,13,16,27,16,3,10,14,0,7,9,0,0,4,-3,11,0.31383954376810563,[-8.12340696]
2021,13,NCAAF_20211126_EMICH@CMICH,C. Michigan,Chippewas,E. Michigan,Eagles,8-4,7-5,0,10,3,31,10,7,3,7,14,0,3,7,0,1,7,21,0.4797737807629491,[-0.84955355]
2021,13,NCAAF_20211126_KSTATE@TEXAS,Texas,Longhorns,Kansas State,Wildcats,5-7,7-5,1,16,17,22,17,7,9,3,3,7,10,0,0,-2,-1,5,0.6300606624019283,[5.56104426]
2021,13,NCAAF_20211126_OHIO@BGREEN,Bowling Green,Falcons,Ohio,Bobcats,4-8,3-9,1,10,10,21,10,3,7,3,8,0,10,0,0,1,0,11,0.09162153624709957,[-22.29073463]
2021,13,NCAAF_20211126_UTAHST@NMEX,New Mexico,Lobos,Utah St.,Aggies,3-9,9-3,1,0,28,10,35,0,0,3,7,7,21,7,0,-6,-28,-25,0.1496515794339347,[-17.38471346]
2021,13,NCAAF_20211126_IOWA@NEB,Nebraska,Cornhuskers,Iowa,Hawkeyes,3-9,10-2,1,14,6,21,28,7,7,7,0,0,6,3,19,-7,8,-7,0.21395212817680465,[-13.27866053]
2021,13,NCAAF_20211126_UTEP@UAB,UAB,Blazers,UTEP,Miners,8-4,7-5,1,14,17,42,25,7,7,14,14,7,10,8,0,1,-3,17,0.8762356062306558,[19.36857737]
2021,13,NCAAF_20211126_MIZZOU@ARK,Arkansas,Razorbacks,Missouri,Tigers,8-4,6-6,0,10,6,34,17,3,7,14,10,0,6,3,8,2,4,17,0.2794904340896599,[-9.78762657]
2021,13,NCAAF_20211126_SFLA@UCF,UCF,Knights,South Florida,Bulls,8-4,2-10,1,14,7,17,13,7,7,0,3,7,0,6,0,6,7,4,0.8888366705724218,[20.44040821]
2021,13,NCAAF_20211126_UNLV@AF,Air Force,Falcons,UNLV,Rebels,9-3,2-10,1,24,0,48,14,14,10,17,7,0,0,7,7,7,24,34,0.8483752532885159,[17.24336617]
2021,13,NCAAF_20211126_CINCY@ECU,East Carolina,Pirates,Cincinnati,Bearcats,7-5,12-0,1,3,21,13,35,3,0,3,7,0,21,0,14,-5,-18,-22,0.10343959196459473,[-21.14101608]
2021,13,NCAAF_20211126_COLO@UTAH,Utah,Utes,Colorado,Buffaloes,9-3,4-8,1,14,6,28,13,0,14,14,0,3,3,7,0,5,8,15,0.8321221457888592,[16.1227504]
2021,13,NCAAF_20211126_TCU@IOWAST,Iowa St.,Cyclones,TCU,Horned Frogs,7-5,5-7,1,17,7,48,14,3,14,10,21,0,7,0,7,2,10,34,0.6276670067641676,[5.45496399]
2021,13,NCAAF_20211126_UNC@NCST,NC State,Wolfpack,North Carolina,Tar Heels,9-3,6-6,0,14,10,34,30,14,0,7,13,0,10,14,6,3,4,4,0.5523795150985776,[2.20548897]
2021,13,NCAAF_20211126_WASHST@WASH,Washington,Huskies,Washington St.,Cougars,4-8,7-5,0,7,13,13,40,0,7,0,6,10,3,10,17,-3,-6,-27,0.6274721489327946,[5.44633811]
2021,13,NCAAF_20211125_FRESNO@SJST,San Jose St.,Spartans,Fresno St.,Bulldogs,5-7,9-3,1,9,23,9,40,3,6,0,0,7,16,10,7,-4,-14,-31,0.13714374255826933,[-18.31117908]
2021,13,NCAAF_20211125_MISS@MISSST,Miss. State,Bulldogs,Ole Miss,Rebels,7-5,10-2,0,6,10,21,31,6,0,0,15,3,7,7,14,-3,-4,-10,0.6261854033400545,[5.38941312]
2021,13,NCAAF_20211123_BUFF@BALLST,Ball St.,Cardinals,Buffalo,Bulls,6-6,4-8,1,17,3,20,3,14,3,3,0,0,3,0,0,2,14,17,0.2654343552862457,[-10.49653822]
2021,13,NCAAF_20211123_WMICH@NILL,N. Illinois,Huskies,W. Michigan,Broncos,8-4,7-5,1,7,28,21,42,0,7,0,14,7,21,7,7,1,-21,-21,0.4578110751997463,[-1.77459902]
2021,14,NCAAF_20211204_BAYLOR@OKLAST,Oklahoma State,Cowboys,Baylor,Bears,11-2,11-2,0,6,21,16,21,3,3,7,3,7,14,0,0,0,-15,-5,0.6965734723290576,[8.64691535]
2021,14,NCAAF_20211204_KENTST@NILL,N. Illinois,Huskies,Kent St.,Golden Flashes,9-4,7-6,1,17,0,41,23,10,7,7,17,0,0,10,13,2,17,18,0.7050564404346062,[9.05742243]
2021,14,NCAAF_20211204_UTAHST@SDGST,San Diego St.,Aztecs,Utah St.,Aggies,11-2,10-3,1,3,14,13,46,0,3,3,7,0,14,15,17,1,-11,-33,0.5449871298458475,[1.89896933]
2021,14,NCAAF_20211204_APLST@UL,Louisiana,Ragin' Cajuns,App. St.,Mountaineers,12-1,10-3,1,17,7,24,16,7,10,0,7,0,7,3,6,2,10,8,0.3328404497782602,[-7.26078555]
2021,14,NCAAF_20211204_HOU@CINCY,Cincinnati,Bearcats,Houston,Cougars,13-0,11-2,0,14,13,35,20,14,0,21,0,10,3,0,7,2,1,15,0.6437642346944484,[6.19297558]
2021,14,NCAAF_20211204_UGA@BAMA,Alabama,Crimson Tide,Georgia,Bulldogs,12-1,12-1,0,24,17,41,24,0,24,7,10,3,14,0,7,0,7,17,0.6330417683348236,[5.71206859]
2021,14,NCAAF_20211204_MICH@IOWA,Iowa,Hawkeyes,Michigan,Wolverines,10-3,12-1,0,3,14,3,42,3,0,0,0,14,0,7,21,-2,-11,-39,0.4079685718877073,[-3.91156057]
2021,14,NCAAF_20211204_PITT@WAKE,Wake Forest,Demon Deacons,Pittsburgh,Panthers,10-3,11-2,0,21,24,21,45,21,0,0,0,14,10,7,14,-1,-3,-24,0.5107600933296679,[0.45328861]
2021,14,NCAAF_20211204_USC@CAL,California,Golden Bears,USC,Trojans,5-7,4-8,0,17,7,24,14,3,14,0,7,0,7,0,7,1,10,10,0.36052388860354534,[-6.00006457]
2021,14,NCAAF_20211203_WKY@TXSA,UTSA,Roadrunners,W. Kentucky,Hilltoppers,12-1,8-5,0,28,13,49,41,14,14,14,7,10,3,13,15,4,15,8,0.3805392367349134,[-5.10954711]
2021,14,NCAAF_20211203_OREG@UTAH,Utah,Utes,Oregon,Ducks,10-3,10-3,1,23,0,38,10,14,9,8,7,0,0,3,7,0,23,28,0.5127348677011496,[0.53650567]
2021,15,NCAAF_20211211_ARMY@NAVY,Navy,Midshipmen,Army,Black Knights,4-8,8-4,0,7,13,17,13,7,0,7,3,10,3,0,0,-4,-6,4,0.44259440275831174,[-2.42848992]
2022,1,NCAAF_20220905_CLEM@GATECH,Georgia Tech,Yellow Jackets,Clemson,Tigers,0-1,1-0,1,3,14,10,41,0,3,7,0,0,14,10,17,-1,-11,-31,0.041374773559372136,[-29.17546958]
2022,1,NCAAF_20220904_FSU@LSU,LSU,Tigers,Florida State,Seminoles,1-1,2-0,1,3,7,23,24,3,0,7,13,0,7,10,7,-1,-4,-1,0.8207392060247036,[15.44049837]
2022,1,NCAAF_20220903_BUFF@MD,Maryland,Terrapins,Buffalo,Bulls,1-0,0-1,0,17,7,31,10,7,10,7,7,0,7,0,3,1,10,21,0.5832118943434559,[3.53339596]
2022,1,NCAAF_20220903_CCTST@UCONN,UConn,,CCSU,,1-1,0-1,,7,3,28,3,0,7,7,14,0,3,0,0,1,4,25,0.75982339954491,[11.86785245]
2022,1,NCAAF_20220903_COLOST@MICH,Michigan,Wolverines,Colorado St.,Rams,1-0,0-1,1,23,0,51,7,10,13,14,14,0,0,0,7,1,23,44,0.9666463907185638,[30.83508668]
2022,1,NCAAF_20220903_DE@NAVY,Navy,Midshipmen,Delaware,Fightin' Blue Hens,0-1,1-0,1,0,7,7,14,0,0,7,0,7,0,7,0,-1,-7,-7,0.8198242349928618,[15.38180324]
2022,1,NCAAF_20220903_NCST@ECU,East Carolina,Pirates,NC State,Wolfpack,0-1,1-0,1,7,21,20,21,7,0,7,6,14,7,0,0,-1,-14,-1,0.12403036821323576,[-19.42405843]
2022,1,NCAAF_20220903_RUT@BC,Boston College,Eagles,Rutgers,Scarlet Knights,0-1,1-0,0,14,6,21,22,7,7,7,0,0,6,9,7,-1,8,-1,0.7204646714377141,[9.82446644]
2022,1,NCAAF_20220903_SAMST@TXAM,Texas A&M,Aggies,Sam Houston,Bearkats,1-0,0-1,0,17,0,31,0,7,10,7,7,0,0,0,0,1,17,31,0.9898838701625868,[39.04768515]
2022,1,NCAAF_20220903_SDST@IOWA,Iowa,Hawkeyes,S. Dakota St.,Jackrabbits,1-0,0-1,1,3,3,7,3,3,0,2,2,0,3,0,0,1,0,4,0.7449952065386298,[11.07896848]
2022,1,NCAAF_20220903_UNC@APLST,App. St.,Mountaineers,North Carolina,Tar Heels,0-1,2-0,1,21,28,61,63,14,7,0,40,7,21,13,22,-2,-7,-2,0.47874717575104786,[-0.89627832]
2022,1,NCAAF_20220903_RICH@UVA,Virginia,Cavaliers,Richmond,Spiders,1-0,0-1,0,28,10,34,17,14,14,0,6,7,3,7,0,1,18,17,0.8919323308852951,[20.79959103]
2022,1,NCAAF_20220903_NOIOWA@AF,Air Force,Falcons,Northern Iowa,Panthers,1-0,0-1,0,27,3,48,17,14,13,14,7,3,0,0,14,1,24,31,0.5187496734946029,[0.79063193]
2022,1,NCAAF_20220903_SEMOST@IOWAST,Iowa St.,Cyclones,SE Missouri St.,Redhawks,1-0,0-1,0,21,10,42,10,7,14,7,14,0,10,0,0,1,11,32,0.9984819902380786,[49.84467619]
2022,1,NCAAF_20220903_BGREEN@UCLA,UCLA,Bruins,Bowling Green,Falcons,1-0,0-1,1,24,17,45,17,7,17,7,14,10,7,0,0,1,7,28,0.9667961586256794,[30.86906057]
2022,1,NCAAF_20220903_ARIZ@SDGST,San Diego St.,Aztecs,Arizona,Wildcats,0-1,1-0,1,10,24,20,38,0,10,10,0,10,14,7,7,-1,-14,-18,0.5943350753757588,[4.01423488]
2022,1,NCAAF_20220903_BTHN@MIAMI,Miami (Fla.),Hurricanes,Bethune-Cook.,Wildcats,1-0,0-1,0,42,10,70,13,14,28,14,14,3,7,3,0,1,32,57,0.9964235926923143,[45.22990033]
2022,1,NCAAF_20220903_CINCY@ARK,Arkansas,Razorbacks,Cincinnati,Bearcats,1-0,0-1,1,14,0,31,24,7,7,10,7,0,0,17,7,1,14,7,0.27544489870263755,[-10.02970719]
2022,1,NCAAF_20220903_NDK@NEB,Nebraska,,North Dakota,,1-1,0-1,,7,7,38,17,7,0,17,14,0,7,10,0,1,0,21,0.9335846920948475,[25.275465]
2022,1,NCAAF_20220903_NRFST@MRSHL,Marshall,,Norfolk St.,,1-0,0-1,,38,0,55,3,10,28,17,0,0,0,3,0,1,38,52,0.9698009990612964,[31.57896254]
2022,1,NCAAF_20220903_OREG@UGA,Georgia,Bulldogs,Oregon,Ducks,1-0,0-1,0,28,3,49,3,7,21,14,7,0,3,0,0,1,25,46,0.7859167979928352,[13.32412188]
2022,1,NCAAF_20220903_UTEP@OKLA,Oklahoma,Sooners,UTEP,Miners,1-0,0-1,1,28,10,45,13,21,7,14,3,0,10,0,3,1,18,32,0.9981263746258454,[48.74527402]
2022,1,NCAAF_20220903_DAVIS@CAL,California,Golden Bears,UC-Davis,Aggies,1-0,0-1,1,17,7,34,13,0,17,10,7,7,0,6,0,1,10,21,0.8216023718651388,[15.49604316]
2022,1,NCAAF_20220903_TROY@MISS,Ole Miss,Rebels,Troy,Trojans,1-0,0-1,0,21,3,28,10,7,14,7,0,0,3,0,7,1,18,18,0.8227091493804422,[15.56751274]
2022,1,NCAAF_20220903_NICHST@SALA,South Alabama,,Nicholls St.,,1-0,0-1,,27,0,48,7,10,17,14,7,0,0,0,7,1,27,41,0.5080432056088584,[0.33906211]
2022,1,NCAAF_20220903_TXSTSM@NEVADA,Nevada,,Texas St.,,2-0,0-1,,14,7,38,14,14,0,24,0,0,7,0,7,2,7,24,0.8569584147508791,[17.93885823]
2022,1,NCAAF_20220903_FAU@OHIO,Ohio,,FAU,,1-0,1-1,,13,17,41,38,3,10,14,14,10,7,0,21,0,-4,3,0.46870949551009744,[-1.32032013]
2022,1,NCAAF_20220903_MRGNST@GAS,Ga. Southern,,Morgan St.,,1-0,0-1,,17,7,59,7,0,17,14,28,0,7,0,0,1,10,52,0.9948242161204082,[43.11464511]
2022,1,NCAAF_20220903_MTSU@JMAD,James Madison,Dukes,Middle Tenn.,Blue Raiders,1-0,0-1,1,21,0,44,7,0,21,16,7,0,0,7,0,1,21,37,0.8069427557028848,[14.57444869]
2022,1,NCAAF_20220903_RICE@USC,USC,Trojans,Rice,Owls,1-0,0-1,1,31,14,66,14,7,24,28,7,7,7,0,0,1,17,52,0.968882471636929,[31.35598547]
2022,1,NCAAF_20220903_BYU@SFLA,South Florida,Bulls,BYU,Cougars,0-1,1-0,0,7,38,21,50,0,7,14,0,28,10,9,3,-1,-31,-29,0.22200507918327528,[-12.87186077]
2022,1,NCAAF_20220903_ALBANY@BAYLOR,Baylor,Bears,Albany,Great Danes,1-0,0-1,0,35,7,69,10,21,14,14,20,7,0,3,0,1,28,59,0.9902441707712385,[39.27631776]
2022,1,NCAAF_20220903_ARMY@CSTCAR,C. Carolina,Chanticleers,Army,Black Knights,1-0,0-1,0,14,14,38,28,7,7,10,14,7,7,7,7,1,0,10,0.3206293583807154,[-7.83538563]
2022,1,NCAAF_20220903_ELON@VANDY,Vanderbilt,,Elon,,2-0,0-1,,28,10,42,31,21,7,7,7,7,3,14,7,2,18,11,0.940833825621432,[26.26391163]
2022,1,NCAAF_20220903_GRAM@ARKST,Arkansas St.,Red Wolves,Grambling,Tigers,1-0,0-1,1,30,0,58,3,16,14,21,7,0,0,3,0,1,30,55,0.9393851424641977,[26.05910428]
2022,1,NCAAF_20220903_ILST@WISC,Wisconsin,Badgers,Illinois St.,Redbirds,1-0,0-1,0,17,0,38,0,7,10,14,7,0,0,0,0,1,17,38,0.9858202022873435,[36.86599217]
2022,1,NCAAF_20220903_MERCER@AUBURN,Auburn,Tigers,Mercer,Bears,1-0,1-0,1,28,7,42,16,14,14,14,0,0,7,0,9,0,21,26,0.9917922841545528,[40.35150625]
2022,1,NCAAF_20220903_MIAOH@UK,Kentucky,Wildcats,Miami-OH,RedHawks,1-0,0-1,0,13,10,37,13,7,6,17,7,7,3,3,0,1,3,24,0.8347901162777873,[16.36678934]
2022,1,NCAAF_20220903_SD@KSTATE,Kansas State,Wildcats,South Dakota,Coyotes,1-0,0-1,1,27,0,34,0,20,7,7,0,0,0,0,0,1,27,34,0.964161315922187,[30.28889832]
2022,1,NCAAF_20220903_SELOU@UL,Louisiana,Ragin' Cajuns,SE Louisiana,Lions,1-0,0-1,0,17,0,24,7,10,7,0,7,0,0,7,0,1,17,17,0.6465379270372353,[6.32276893]
2022,1,NCAAF_20220903_UMASS@TULANE,Tulane,Green Wave,UMass,Minutemen,1-0,0-1,0,21,10,42,10,7,14,21,0,0,10,0,0,1,11,32,0.9512991191353042,[27.87442297]
2022,1,NCAAF_20220903_UTAH@FLA,Florida,Gators,Utah,Utes,1-0,0-1,1,14,13,29,26,7,7,0,15,7,6,6,7,1,1,3,0.47574711155689997,[-1.02294411]
2022,1,NCAAF_20220903_GAST@SC,South Carolina,Gamecocks,Georgia St.,Panthers,1-0,0-1,0,12,7,35,14,0,12,16,7,0,7,7,0,1,5,21,0.867142791500175,[18.71631966]
2022,1,NCAAF_20220903_MEMP@MISSST,Miss. State,Bulldogs,Memphis,Tigers,1-0,0-1,1,28,3,49,23,14,14,7,14,0,3,7,13,1,25,26,0.6730731634157073,[7.54068713]
2022,1,NCAAF_20220903_ND@OHIOST,Ohio State,Buckeyes,Notre Dame,Fighting Irish,1-0,0-1,0,7,10,21,10,7,0,7,7,3,7,0,0,1,-3,11,0.7626265176554952,[12.01990916]
2022,1,NCAAF_20220903_SMU@NTEXAS,North Texas,Mean Green,SMU,Mustangs,1-1,1-0,0,10,31,10,48,0,10,0,0,14,17,7,10,0,-21,-38,0.2235188533621949,[-12.78649859]
2022,1,NCAAF_20220903_UTAHST@BAMA,Alabama,Crimson Tide,Utah St.,Aggies,1-0,1-1,0,41,0,55,0,17,24,14,0,0,0,0,0,0,41,55,0.9753527672280774,[33.0614708]
2022,1,NCAAF_20220903_COLG@STNFRD,Stanford,Cardinal,Colgate,Raiders,1-0,0-1,1,28,7,41,10,7,21,0,13,0,7,3,0,1,21,31,0.9867928056694995,[37.3332952]
2022,1,NCAAF_20220903_LAMON@TEXAS,Texas,Longhorns,UL-Monroe,Warhawks,1-0,0-1,0,24,3,52,10,14,10,21,7,3,0,0,7,1,21,42,0.9808763231704499,[34.8466585]
2022,1,NCAAF_20220903_LVILLE@CUSE,Syracuse,Orange,Louisville,Cardinals,1-0,0-1,1,17,7,31,7,10,7,0,14,7,0,0,0,1,10,24,0.42233298586736234,[-3.29479798]
2022,1,NCAAF_20220903_ME@NMEX,New Mexico,Lobos,Maine,Black Bears,1-0,0-1,1,21,0,41,0,0,21,13,7,0,0,0,0,1,21,41,0.5932117517415485,[3.96553255]
2022,1,NCAAF_20220903_MURYST@TXTECH,Texas Tech,Red Raiders,Murray St.,Racers,1-0,0-1,0,42,10,63,10,14,28,14,7,3,7,0,0,1,32,53,0.990735779639594,[39.6004778]
2022,1,NCAAF_20220903_IDAHO@WASHST,Washington St.,Cougars,Idaho,Vandals,1-0,0-1,1,10,10,24,17,0,10,7,7,10,0,0,7,1,0,7,0.9690012694336572,[31.3845149]
2022,1,NCAAF_20220903_BOISE@OREGST,Oregon State,Beavers,Boise St.,Broncos,1-0,0-1,0,24,0,34,17,14,10,3,7,0,0,10,7,1,24,17,0.21805165454286768,[-13.09637824]
2022,1,NCAAF_20220903_KENTST@WASH,Washington,Huskies,Kent St.,Golden Flashes,1-0,0-1,0,31,13,45,20,21,10,7,7,7,6,0,7,1,18,25,0.970619307477814,[31.78239708]
2022,1,NCAAF_20220903_WKY@HAWAII,Hawaii,,W. Kentucky,,0-2,2-0,,10,21,17,49,3,7,0,7,0,21,7,21,-2,-11,-32,0.4545768376987861,[-1.9188439]
2022,1,NCAAF_20220902_EKY@EMICH,E. Michigan,Eagles,E. Kentucky,Colonels,1-0,0-1,0,14,10,42,34,0,14,14,14,0,10,7,17,1,4,8,0.882104512507893,[19.93696403]
2022,1,NCAAF_20220902_VATECH@ODU,Old Dominion,Monarchs,Virginia Tech,Hokies,1-0,0-1,0,10,7,20,17,0,10,0,10,7,0,10,0,1,3,3,0.07120293371896191,[-24.66768542]
2022,1,NCAAF_20220902_WMICH@MICHST,Michigan St.,Spartans,W. Michigan,Broncos,1-0,0-1,1,21,3,35,13,7,14,0,14,3,0,10,0,1,18,22,0.8138873791236387,[15.0054112]
2022,1,NCAAF_20220902_WMMARY@CHARLO,Charlotte,,William & Mary,,0-2,1-0,,17,17,24,41,3,14,7,0,10,7,3,21,-1,0,-17,0.7319127471221514,[10.40270767]
2022,1,NCAAF_20220902_TEMPLE@DUKE,Duke,Blue Devils,Temple,Owls,1-0,0-1,1,24,0,30,0,10,14,3,3,0,0,0,0,1,24,30,0.6208764231237572,[5.17578136]
2022,1,NCAAF_20220902_ILL@IND,Indiana,,Illinois,,1-0,1-1,,16,10,23,20,3,13,0,7,7,3,7,3,0,6,3,0.7020714015646499,[8.91882378]
2022,1,NCAAF_20220902_TNTECH@KANSAS,Kansas,Jayhawks,Tenn. Tech,Golden Eagles,1-0,0-1,0,35,3,56,10,21,14,7,14,0,3,0,7,1,32,46,0.9750756271120166,[32.98115155]
2022,1,NCAAF_20220902_TCU@COLO,Colorado,Buffaloes,TCU,Horned Frogs,0-1,1-0,1,6,7,13,38,3,3,0,7,0,7,10,21,-1,-1,-25,0.2613589151201072,[-10.74833969]
2022,1,NCAAF_20220901_BALLST@TENN,Tennessee,Volunteers,Ball St.,Cardinals,1-0,0-1,0,38,0,59,10,17,21,14,7,0,0,7,3,1,38,49,0.8558056800066164,[17.85325744]
2022,1,NCAAF_20220901_CMICH@OKLAST,Oklahoma State,Cowboys,C. Michigan,Chippewas,1-0,0-1,0,44,15,58,44,16,28,7,7,7,8,7,22,1,29,14,0.9169865334394891,[23.29199503]
2022,1,NCAAF_20220901_LIUPOST@TOLEDO,Toledo,Rockets,LIU,Sharks,1-0,0-1,1,20,0,37,0,3,17,0,17,0,0,0,0,1,20,37,0.9980911265064636,[48.64691119]
2022,1,NCAAF_20220901_SCST@UCF,UCF,Knights,SC State,Bulldogs,1-0,0-1,1,28,3,56,10,21,7,14,14,0,3,7,0,1,25,46,0.9934923546784357,[41.76079641]
2022,1,NCAAF_20220901_WVU@PITT,Pittsburgh,Panthers,West Virginia,Mountaineers,1-0,0-1,0,10,10,38,31,3,7,14,14,0,10,7,14,1,0,7,0.4702198336080068,[-1.25646883]
2022,1,NCAAF_20220901_VMI@WAKE,Wake Forest,Demon Deacons,VMI,Keydets,1-0,0-1,0,23,3,44,10,17,6,14,7,0,3,7,0,1,20,34,0.9999470788503773,[65.19335788]
2022,1,NCAAF_20220901_ALAM@UAB,UAB,Blazers,Alabama A&M,Bulldogs,1-0,0-1,1,38,0,59,0,28,10,21,0,0,0,0,0,1,38,59,0.9953349129104775,[43.71758308]
2022,1,NCAAF_20220901_EIL@NILL,N. Illinois,Huskies,E. Illinois,Panthers,1-0,0-1,1,21,6,34,27,7,14,7,6,3,3,7,14,1,15,7,0.9755108856804069,[33.10763591]
2022,1,NCAAF_20220901_LATECH@MIZZOU,Missouri,Tigers,Louisiana Tech,Bulldogs,1-0,0-1,0,24,10,52,24,0,24,14,14,3,7,0,14,1,14,28,0.8636307492812674,[18.44375791]
2022,1,NCAAF_20220901_PSU@PURDUE,Purdue,Boilermakers,Penn State,Nittany Lions,0-1,1-0,0,10,21,31,35,3,7,14,7,0,21,0,14,-1,-11,-4,0.20993092281518888,[-13.56506144]
2022,1,NCAAF_20220901_NMEXST@MINN,Minnesota,Golden Gophers,New Mexico St.,Aggies,1-0,0-2,0,24,0,38,0,7,17,14,0,0,0,0,0,1,24,38,0.97265496759939,[32.30968974]
2022,1,NCAAF_20220901_NAZ@ARIZST,Arizona St.,Sun Devils,N. Arizona,Lumberjacks,1-0,0-1,0,24,3,40,3,3,21,13,3,0,3,0,0,1,21,37,0.9628889207991381,[30.02117566]
2022,1,NCAAF_20220901_CPOLY@FRESNO,Fresno St.,Bulldogs,Cal-Poly,Mustangs,1-0,0-1,0,21,7,35,7,21,0,7,7,0,7,0,0,1,14,28,0.9968973115226318,[46.02165191]
2022,1,NCAAF_20220901_PORTST@SJST,San Jose St.,Spartans,Portland St.,Vikings,1-0,0-1,1,14,7,21,17,7,7,0,7,7,0,3,7,1,7,4,0.5438883621603892,[1.85374031]
2022,1,NCAAF_20220827_AP@WKY,W. Kentucky,Hilltoppers,Austin Peay,Governors,2-0,2-1,1,21,17,38,27,7,14,0,17,10,7,3,7,0,4,11,0.8712935024304135,[19.04492398]
2022,1,NCAAF_20220827_NEB@NWEST,Northwestern,Wildcats,Nebraska,Cornhuskers,1-0,0-1,0,17,14,31,28,3,14,7,7,7,7,14,0,1,3,3,0.46364473546892027,[-1.53458309]
2022,1,NCAAF_20220827_IDST@UNLV,UNLV,Rebels,Idaho State,Bengals,1-0,0-1,1,45,7,52,21,10,35,0,7,7,0,7,7,1,38,31,0.7082219526835577,[9.21866462]
2022,1,NCAAF_20220827_UCONN@UTAHST,Utah St.,,UConn,,1-0,0-1,,24,14,31,20,0,24,0,7,14,0,0,6,1,10,11,0.9478803605132706,[27.32045221]
2022,1,NCAAF_20220827_WYO@ILL,Illinois,Fighting Illini,Wyoming,Cowboys,1-0,0-1,1,17,3,38,6,7,10,7,14,3,0,3,0,1,14,32,0.5091356820880265,[0.38512313]
2022,1,NCAAF_20220827_DUQ@FSU,Florida State,,Duquesne,,1-0,0-1,,26,0,47,7,20,6,14,7,0,0,7,0,1,26,40,0.9225324462574166,[23.91807502]
2022,1,NCAAF_20220827_CHARLO@FAU,FAU,Owls,Charlotte,49ers,1-1,0-2,0,26,7,43,13,10,16,7,10,7,0,6,0,1,19,30,0.8236969135211877,[15.63153539]
2022,1,NCAAF_20220827_FAMU@UNC,North Carolina,,Florida A&M,,1-0,0-1,,28,14,56,24,14,14,7,21,7,7,10,0,1,14,32,0.9986909071251209,[50.60594581]
2022,1,NCAAF_20220827_NTEXAS@UTEP,UTEP,,North Texas,,0-2,1-1,,13,14,13,31,0,13,0,0,0,14,14,3,-1,-1,-18,0.19849268073910142,[-14.24370984]
2022,1,NCAAF_20220827_NEVADA@NMEXST,New Mexico St.,Aggies,Nevada,Wolf Pack,0-2,1-0,1,2,17,12,23,0,2,7,3,0,17,0,6,-1,-15,-11,0.15724204338431025,[-16.91481376]
2022,1,NCAAF_20220827_VANDY@HAWAII,Hawaii,Rainbow Warriors,Vanderbilt,Commodores,0-1,1-0,1,10,21,10,63,7,3,0,0,14,7,35,7,-1,-11,-53,0.44185272490374383,[-2.45978141]
2022,2,NCAAF_20220910_ARKST@OHIOST,Ohio State,Buckeyes,Arkansas St.,Red Wolves,2-0,1-1,0,24,9,45,12,14,10,21,0,3,6,3,0,1,15,33,0.9948335590183153,[43.13485686]
2022,2,NCAAF_20220910_BAMA@TEXAS,Texas,Longhorns,Alabama,Crimson Tide,1-1,2-0,0,10,10,19,20,3,7,3,6,10,0,0,10,-1,0,-1,0.1101149318685889,[-20.62002471]
2022,2,NCAAF_20220910_DUKE@NWEST,Northwestern,Wildcats,Duke,Blue Devils,1-1,2-0,1,10,21,23,31,0,10,6,7,14,7,0,10,-1,-11,-8,0.7067413061259318,[9.14826827]
2022,2,NCAAF_20220910_MIZZOU@KSTATE,Kansas State,Wildcats,Missouri,Tigers,2-0,1-1,0,20,3,40,12,7,13,6,14,3,0,3,6,1,17,28,0.4994919312371454,[-0.02142104]
2022,2,NCAAF_20220910_OHIO@PSU,Penn State,Nittany Lions,Ohio,Bobcats,2-0,1-1,0,26,7,46,10,14,12,14,6,0,7,0,3,1,19,36,0.9570711150562465,[28.8912605]
2022,2,NCAAF_20220910_SC@ARK,Arkansas,Razorbacks,South Carolina,Gamecocks,2-0,1-1,0,21,9,44,30,7,14,0,23,3,6,7,14,1,12,14,0.36758594467509975,[-5.68945718]
2022,2,NCAAF_20220910_UNC@GAST,Georgia St.,Panthers,North Carolina,Tar Heels,0-2,3-0,0,10,21,28,35,3,7,18,0,7,14,7,7,-3,-11,-7,0.13401970485912795,[-18.62973404]
2022,2,NCAAF_20220910_USM@MIAMI,Miami (Fla.),Hurricanes,So. Miss,Golden Eagles,2-0,0-2,1,10,7,30,7,3,7,14,6,0,7,0,0,2,3,23,0.916164593860824,[23.20711395]
2022,2,NCAAF_20220910_WAKE@VANDY,Vanderbilt,Commodores,Wake Forest,Demon Deacons,2-1,2-0,1,10,21,25,45,3,7,8,7,14,7,14,10,0,-11,-20,0.2207411232296843,[-12.94629188]
2022,2,NCAAF_20220910_WIL@MINN,Minnesota,,W. Illinois,,2-0,0-2,,31,3,62,10,14,17,21,10,3,0,0,7,2,28,52,0.9067070450491339,[22.21506212]
2022,2,NCAAF_20220910_CHARSO@NCST,NC State,Wolfpack,Charleston So.,Buccaneers,2-0,0-2,1,38,0,55,3,10,28,10,7,0,0,3,0,2,38,52,0.9846732219776683,[36.35729737]
2022,2,NCAAF_20220910_SALA@CMICH,C. Michigan,,South Alabama,,0-2,2-0,,10,31,24,38,7,3,0,14,20,11,0,7,-2,-21,-14,0.7374013596652114,[10.68671268]
2022,2,NCAAF_20220910_SUT@UTAH,Utah,Utes,So. Utah,Thunderbirds,1-1,1-1,1,45,7,73,7,7,38,14,14,7,0,0,0,0,38,66,0.998954013022124,[51.75294011]
2022,2,NCAAF_20220910_LAF@TEMPLE,Temple,,Lafayette,,1-1,1-1,,21,7,30,14,7,14,0,9,7,0,7,0,0,14,16,0.7061004888027822,[9.11695934]
2022,2,NCAAF_20220910_WMICH@BALLST,Ball St.,Cardinals,W. Michigan,Broncos,0-2,1-1,1,16,14,30,37,10,6,7,7,7,7,7,16,-1,2,-7,0.3027060932275454,[-8.68981318]
2022,2,NCAAF_20220910_MRSHL@ND,Notre Dame,Fighting Irish,Marshall,Thundering Herd,0-2,2-0,1,7,9,21,26,0,7,0,14,0,9,3,14,-2,-2,-5,0.9162175274796082,[23.21289656]
2022,2,NCAAF_20220910_APLST@TXAM,Texas A&M,Aggies,App. St.,Mountaineers,1-1,1-1,0,7,7,14,17,0,7,7,0,0,7,7,3,0,0,-3,0.7218408776783684,[9.89557168]
2022,2,NCAAF_20220910_COLO@AF,Air Force,Falcons,Colorado,Buffaloes,2-0,0-2,0,20,10,41,10,13,7,7,14,0,10,0,0,2,10,31,0.5796688144374534,[3.38161494]
2022,2,NCAAF_20220910_FUR@CLEM,Clemson,Tigers,Furman,Paladins,2-0,1-1,1,28,9,35,12,14,14,7,0,3,6,3,0,1,19,23,0.9979388068898497,[48.25078266]
2022,2,NCAAF_20220910_KENSAW@CINCY,Cincinnati,Bearcats,Kennesaw St.,Owls,1-1,0-2,1,21,3,63,10,7,14,21,21,0,3,0,7,1,18,53,0.9862407275951731,[37.07284452]
2022,2,NCAAF_20220910_MD@CHARLO,Charlotte,49ers,Maryland,Terrapins,0-3,2-0,0,14,35,21,56,7,7,0,7,21,14,14,7,-2,-21,-35,0.12686192128568474,[-19.19761747]
2022,2,NCAAF_20220910_MEMP@NAVY,Navy,Midshipmen,Memphis,Tigers,0-2,1-1,0,7,13,13,37,7,0,0,6,10,3,10,14,-1,-6,-24,0.3316411660732286,[-7.32322614]
2022,2,NCAAF_20220910_WASHST@WISC,Wisconsin,Badgers,Washington St.,Cougars,1-1,2-0,1,14,7,14,17,0,14,0,0,0,7,10,0,-1,7,-3,0.7731709680909171,[12.60379835]
2022,2,NCAAF_20220910_AKRON@MICHST,Michigan St.,Spartans,Akron,Zips,2-0,1-1,0,24,0,52,0,14,10,28,0,0,0,0,0,1,24,52,0.9790146816563841,[34.20886777]
2022,2,NCAAF_20220910_INST@PURDUE,Purdue,Boilermakers,Indiana St.,Sycamores,1-1,1-1,0,35,0,56,0,21,14,14,7,0,0,0,0,0,35,56,0.9688141952942946,[31.34665463]
2022,2,NCAAF_20220910_IOWAST@IOWA,Iowa,Hawkeyes,Iowa St.,Cyclones,1-1,2-0,0,7,3,7,10,7,0,0,0,0,3,0,7,-1,4,-3,0.571340621690015,[3.02405395]
2022,2,NCAAF_20220910_MTSU@COLOST,Colorado St.,Rams,Middle Tenn.,Blue Raiders,0-2,1-1,1,0,27,19,34,0,0,19,0,10,17,7,0,-1,-27,-15,0.5727578896722376,[3.0848018]
2022,2,NCAAF_20220910_NCO@WYO,Wyoming,,N. Colorado,,2-1,0-2,,9,0,33,10,3,6,7,17,0,0,3,7,2,9,23,0.9285059307861356,[24.63727448]
2022,2,NCAAF_20220910_NRFST@JMAD,James Madison,,Norfolk St.,,2-0,0-2,,35,0,63,7,21,14,21,7,0,0,7,0,2,35,56,0.9983944868748142,[49.56505958]
2022,2,NCAAF_20220910_PORTST@WASH,Washington,Huskies,Portland St.,Vikings,2-0,0-2,0,31,3,52,6,14,17,14,7,0,3,3,0,2,28,46,0.9692483309702392,[31.45118645]
2022,2,NCAAF_20220910_SAMF@UGA,Georgia,Bulldogs,Samford,Bulldogs,2-0,1-1,1,30,0,33,0,13,17,0,3,0,0,0,0,1,30,33,0.9904263150320819,[39.40355028]
2022,2,NCAAF_20220910_UNLV@CAL,California,Golden Bears,UNLV,Rebels,2-0,1-1,0,17,7,20,14,14,3,3,0,0,7,7,0,1,10,6,0.8719558427365394,[19.10231736]
2022,2,NCAAF_20220910_UVA@ILL,Illinois,Fighting Illini,Virginia,Cavaliers,2-1,1-1,1,21,3,24,3,14,7,3,0,3,0,0,0,1,18,21,0.3511565606624214,[-6.4286325]
2022,2,NCAAF_20220910_WAG@RUT,Rutgers,Scarlet Knights,Wagner,Seahawks,2-0,0-2,0,38,7,66,7,28,10,14,14,0,7,0,0,2,31,59,0.9911473747651812,[39.89260978]
2022,2,NCAAF_20220910_ALST@UCLA,UCLA,Bruins,Alabama St.,Hornets,2-0,2-1,0,31,7,45,7,14,17,7,7,0,7,0,0,0,24,38,0.9919263388102234,[40.46185656]
2022,2,NCAAF_20220910_UIW@NEVADA,Nevada,,Incarnate Word,,2-1,2-0,,17,24,41,55,17,0,14,10,9,15,14,17,0,-7,-14,0.9835048792426049,[35.86380978]
2022,2,NCAAF_20220910_GRDWB@CSTCAR,C. Carolina,Chanticleers,Gardner-Webb,Runnin' Bulldogs,2-0,1-1,1,17,10,31,27,3,14,7,7,0,10,10,7,1,7,4,0.9766515196454247,[33.45578657]
2022,2,NCAAF_20220910_HOLY@BUFF,Buffalo,,Holy Cross,,0-2,2-0,,21,14,31,37,7,14,7,3,0,14,14,9,-2,7,-6,0.9599165509316631,[29.43040616]
2022,2,NCAAF_20220910_ODU@ECU,East Carolina,Pirates,Old Dominion,Monarchs,1-1,1-1,1,16,7,39,21,9,7,6,17,7,0,7,7,0,9,18,0.643502090178094,[6.18702445]
2022,2,NCAAF_20220910_ROB@MIAOH,Miami-OH,,Robert Morris,,1-1,0-2,,24,7,31,14,10,14,0,7,7,0,0,7,1,17,17,0.9807701762510175,[34.81625497]
2022,2,NCAAF_20220910_SELOU@FAU,FAU,,SE Louisiana,,2-1,0-2,,28,3,42,9,7,21,7,7,0,3,0,6,2,25,33,0.6833830514620466,[8.02620729]
2022,2,NCAAF_20220910_UAB@LIB,Liberty,Flames,UAB,Blazers,2-0,1-1,1,7,7,21,14,0,7,7,7,7,0,0,7,1,0,7,0.48574603925693793,[-0.60109899]
2022,2,NCAAF_20220910_ALAM@TROY,Troy,,Alabama A&M,,1-1,0-2,,7,3,38,17,0,7,21,10,3,0,0,14,1,4,21,0.9956409035079935,[44.11758159]
2022,2,NCAAF_20220910_ALCORN@TULANE,Tulane,,Alcorn St.,,2-0,0-2,,31,0,52,0,17,14,14,7,0,0,0,0,2,31,52,0.9549880357188292,[28.51460308]
2022,2,NCAAF_20220910_CAR@MISS,Ole Miss,Rebels,Cent. Ark.,Bears,2-0,0-2,1,31,0,59,3,28,3,21,7,0,0,0,3,2,31,56,0.9649811583622354,[30.47238282]
2022,2,NCAAF_20220910_CUSE@UCONN,UConn,Huskies,Syracuse,Orange,1-2,2-0,0,7,27,14,48,0,7,7,0,17,10,14,7,-1,-20,-34,0.060855180867800396,[-26.03133395]
2022,2,NCAAF_20220910_EMICH@UL,Louisiana,Ragin' Cajuns,E. Michigan,Eagles,2-0,1-1,0,0,14,49,21,0,0,21,28,7,7,7,0,1,-14,28,0.6297721087282856,[5.57164883]
2022,2,NCAAF_20220910_FIU@TXSTSM,Texas St.,,FIU,,1-1,1-1,,20,6,41,12,10,10,0,21,3,3,0,6,0,14,29,0.3450870181078869,[-6.70480191]
2022,2,NCAAF_20220910_HOW@SFLA,South Florida,Bulls,Howard,Bison,1-1,0-3,1,14,7,42,20,0,14,14,14,7,0,7,6,1,7,22,0.9890362003680829,[38.54522733]
2022,2,NCAAF_20220910_KENTST@OKLA,Oklahoma,Sooners,Kent St.,Golden Flashes,2-0,0-2,0,7,3,33,3,0,7,24,2,0,3,0,0,2,4,30,0.9923331598719507,[40.77861326]
2022,2,NCAAF_20220910_LAMAR@SMU,SMU,Mustangs,Lamar,Cardinals,2-0,0-2,0,24,10,45,16,14,10,14,7,0,10,3,3,2,14,29,0.9998903796416587,[62.1627717]
2022,2,NCAAF_20220910_NILL@TULSA,Tulsa,Golden Hurricane,N. Illinois,Huskies,1-1,1-1,1,24,7,38,35,7,17,0,14,0,7,14,14,0,17,3,0.5905608417795686,[3.851595]
2022,2,NCAAF_20220910_SFA@LATECH,Louisiana Tech,,S.F. Austin,,1-1,1-2,,38,7,52,17,21,17,14,0,7,0,3,7,0,31,35,0.8783364737497821,[19.62417486]
2022,2,NCAAF_20220910_UK@FLA,Florida,Gators,Kentucky,Wildcats,1-1,2-0,1,16,13,16,26,3,13,0,0,0,13,10,3,-1,3,-10,0.6498591769834572,[6.47472685]
2022,2,NCAAF_20220910_UMASS@TOLEDO,Toledo,,UMass,,2-0,0-2,,28,7,55,10,14,14,17,10,0,7,0,3,2,21,45,0.9411121333587431,[26.30960264]
2022,2,NCAAF_20220910_WBRST@UTAHST,Utah St.,,Weber St.,,1-2,2-0,,7,13,7,35,7,0,0,0,13,0,15,7,-1,-6,-28,0.6860276269082053,[8.15137533]
2022,2,NCAAF_20220910_WCAR@GATECH,Georgia Tech,Yellow Jackets,W. Carolina,Catamounts,1-1,1-1,1,28,14,35,17,14,14,7,0,14,0,0,3,0,14,18,0.9869590879682941,[37.42453227]
2022,2,NCAAF_20220910_ARIZST@OKLAST,Oklahoma State,Cowboys,Arizona St.,Sun Devils,2-0,1-1,1,17,3,34,17,0,17,3,14,3,0,7,7,1,14,17,0.6847534152675594,[8.09101083]
2022,2,NCAAF_20220910_GAS@NEB,Nebraska,Cornhuskers,Ga. Southern,Eagles,1-2,2-0,1,28,28,42,45,7,21,7,7,14,14,7,10,-1,0,-3,0.8749297797463162,[19.34323266]
2022,2,NCAAF_20220910_MCN@RICE,Rice,,McNeese St.,,1-1,0-2,,31,0,52,10,10,21,14,7,0,0,10,0,1,31,42,0.42890196020785476,[-3.01366022]
2022,2,NCAAF_20220910_SJST@AUBURN,Auburn,Tigers,San Jose St.,Spartans,2-0,1-1,0,7,10,24,16,0,7,10,7,0,10,0,6,1,-3,8,0.9801237275673554,[34.58731719]
2022,2,NCAAF_20220910_SO@LSU,LSU,Tigers,Southern U.,Jaguars,1-1,1-1,1,51,0,65,17,37,14,7,7,0,0,7,10,0,51,48,0.9999522470698152,[65.62748907]
2022,2,NCAAF_20220910_TXSO@NTEXAS,North Texas,Mean Green,Texas Southern,Tigers,2-1,0-2,0,45,17,59,27,10,35,7,7,3,14,7,3,2,28,32,0.9906743298165841,[39.56801482]
2022,2,NCAAF_20220910_USC@STNFRD,Stanford,Cardinal,USC,Trojans,1-1,2-0,1,14,35,28,41,7,7,0,14,21,14,6,0,-1,-21,-13,0.4001024479452816,[-4.25685857]
2022,2,NCAAF_20220910_BC@VATECH,Virginia Tech,Hokies,Boston College,Eagles,1-1,0-2,0,17,3,27,10,10,7,7,3,0,3,7,0,1,14,17,0.5441178346849913,[1.86389006]
2022,2,NCAAF_20220910_HAWAII@MICH,Michigan,Wolverines,Hawaii,Rainbow Warriors,2-0,0-3,0,42,0,56,10,21,21,0,14,0,0,3,7,2,42,46,0.9866160176298102,[37.25454254]
2022,2,NCAAF_20220910_IDAHO@IND,Indiana,Hoosiers,Idaho,Vandals,2-0,0-2,1,0,10,35,22,0,0,23,12,0,10,0,12,2,-10,13,0.9413525913928393,[26.34411211]
2022,2,NCAAF_20220910_IDST@SDGST,San Diego St.,Aztecs,Idaho State,Bengals,1-1,0-2,0,21,7,38,7,14,7,3,14,7,0,0,0,1,14,31,0.9530318590468729,[28.17345905]
2022,2,NCAAF_20220910_NICHST@LAMON,UL-Monroe,,Nicholls St.,,1-1,0-2,,21,7,35,7,0,21,7,7,7,0,0,0,1,14,28,0.6171411363026378,[5.01206303]
2022,2,NCAAF_20220910_TRLST@TCU,TCU,,Tarleton St.,,2-0,1-1,,38,7,59,17,21,17,14,7,0,7,10,0,1,31,42,,
2022,2,NCAAF_20220910_EWASH@OREG,Oregon,Ducks,E. Washington,Eagles,1-1,1-1,0,42,7,70,14,14,28,21,7,0,7,7,0,0,35,56,0.9938401387683269,[42.09816361]
2022,2,NCAAF_20220910_NMEXST@UTEP,UTEP,Miners,New Mexico St.,Aggies,1-2,0-3,1,17,0,20,13,3,14,3,0,0,0,6,7,1,17,7,0.4219388718085839,[-3.31247674]
2022,2,NCAAF_20220910_OREGST@FRESNO,Fresno St.,Bulldogs,Oregon State,Beavers,1-1,2-0,0,13,14,32,35,7,6,10,9,7,7,7,14,-1,-1,-3,0.6468383413123866,[6.33778196]
2022,2,NCAAF_20220910_MISSST@ARIZ,Arizona,Wildcats,Miss. State,Bulldogs,1-1,2-0,1,10,18,17,39,7,3,7,0,15,3,7,14,-1,-8,-22,0.1801683198834937,[-15.38572816]
2022,2,NCAAF_20220909_LVILLE@UCF,UCF,Knights,Louisville,Cardinals,1-1,1-1,0,14,7,14,20,7,7,0,0,7,0,10,3,0,7,-6,0.6976700420408946,[8.70794084]
2022,2,NCAAF_20220909_BOISE@NMEX,New Mexico,Lobos,Boise St.,Broncos,1-1,1-1,1,0,10,14,31,0,0,0,14,0,10,7,14,0,-10,-17,0.06327959409137607,[-25.69792309]
2022,3,NCAAF_20220917_WOFF@VATECH,Virginia Tech,Hokies,Wofford,Terriers,2-1,0-3,1,20,0,27,7,3,17,0,7,0,0,0,7,2,20,20,0.8834079326753873,[20.09263496]
2022,3,NCAAF_20220917_ABIL@MIZZOU,Missouri,Tigers,Abil Christian,Wildcats,2-1,2-1,0,17,3,34,17,14,3,14,3,3,0,7,7,0,14,17,0.9940768526153959,[42.4149286]
2022,3,NCAAF_20220917_CINCY@MIAOH,Miami-OH,RedHawks,Cincinnati,Bearcats,1-2,2-1,1,17,24,17,38,10,7,0,0,7,17,7,7,-1,-7,-21,0.15231479483078159,[-17.30101666]
2022,3,NCAAF_20220917_LIUPOST@KENTST,Kent St.,,LIU,,1-2,0-3,,35,10,63,10,7,28,14,14,7,3,0,0,1,25,53,0.969124063553382,[31.48348998]
2022,3,NCAAF_20220917_NOVA@ARMY,Army,Black Knights,Villanova,Wildcats,1-2,2-2,0,21,7,49,10,14,7,7,21,7,0,3,0,-1,14,39,0.58764388449726,[3.73284376]
2022,3,NCAAF_20220917_OKLA@NEB,Nebraska,Cornhuskers,Oklahoma,Sooners,1-3,3-1,0,7,35,14,49,7,0,0,7,14,21,14,0,-2,-28,-35,0.15722701510117265,[-16.95322987]
2022,3,NCAAF_20220917_PURDUE@CUSE,Syracuse,Orange,Purdue,Boilermakers,3-0,1-2,1,3,9,32,29,3,0,7,22,6,3,0,20,2,-6,3,0.2579825207581563,[-10.94762954]
2022,3,NCAAF_20220917_SIL@NWEST,Northwestern,Wildcats,S. Illinois,Salukis,1-2,1-2,0,14,14,24,31,7,7,0,10,0,14,3,14,0,0,-7,0.8523624386735393,[17.63915561]
2022,3,NCAAF_20220917_TXSTSM@BAYLOR,Baylor,Bears,Texas St.,Bobcats,2-1,1-2,1,21,7,42,7,7,14,7,14,0,7,0,0,1,14,35,0.9606034359429968,[29.62385912]
2022,3,NCAAF_20220917_UCONN@MICH,Michigan,Wolverines,UConn,Huskies,3-0,1-3,1,38,0,59,0,17,21,7,14,0,0,0,0,2,38,59,0.9987955666339101,[51.14282853]
2022,3,NCAAF_20220917_UGA@SC,South Carolina,Gamecocks,Georgia,Bulldogs,1-2,3-0,1,0,24,7,48,0,0,0,7,14,10,21,3,-2,-24,-41,0.077486013446044,[-23.9687636]
2022,3,NCAAF_20220917_YST@UK,Kentucky,Wildcats,Youngstown St.,Penguins,4-0,2-1,1,21,0,31,0,0,21,7,3,0,0,0,0,2,21,31,0.9681197165492774,[31.24378702]
2022,3,NCAAF_20220917_BUCK@CMICH,C. Michigan,Chippewas,Bucknell,Bison,1-3,0-3,0,7,0,41,0,0,7,13,21,0,0,0,0,1,7,41,0.9963494736014458,[45.21430727]
2022,3,NCAAF_20220917_BUFF@CSTCAR,C. Carolina,Chanticleers,Buffalo,Bulls,3-0,0-3,1,14,16,38,26,7,7,3,21,6,10,3,7,3,-2,12,0.4419616487048068,[-2.4605639]
2022,3,NCAAF_20220917_TWST@WVU,West Virginia,Mountaineers,Towson,Tigers,1-2,2-1,1,45,7,65,7,21,24,6,14,7,0,0,0,-1,38,58,0.9893903027939785,[38.83133946]
2022,3,NCAAF_20220917_MURYST@BALLST,Ball St.,Cardinals,Murray St.,Racers,1-2,0-3,0,14,0,31,0,7,7,10,7,0,0,0,0,1,14,31,0.8952707616671165,[21.15202967]
2022,3,NCAAF_20220917_ODU@UVA,Virginia,Cavaliers,Old Dominion,Monarchs,2-1,1-2,1,10,7,16,14,7,3,0,6,0,7,0,7,1,3,2,0.907200070684604,[22.30906449]
2022,3,NCAAF_20220917_OHIO@IOWAST,Iowa St.,Cyclones,Ohio,Bobcats,3-0,1-2,1,30,3,43,10,14,16,7,6,0,3,7,0,2,27,33,0.901964672235341,[21.78861558]
2022,3,NCAAF_20220917_RUT@TEMPLE,Temple,Owls,Rutgers,Scarlet Knights,1-2,3-0,0,7,10,14,16,7,0,0,7,3,7,3,3,-2,-3,-2,0.3840711980617385,[-4.9684932]
2022,3,NCAAF_20220917_SALA@UCLA,UCLA,Bruins,South Alabama,Jaguars,3-0,2-1,0,13,17,32,31,6,7,10,9,10,7,14,0,1,-4,1,0.9086576366535872,[22.45780643]
2022,3,NCAAF_20220917_CAL@ND,Notre Dame,Fighting Irish,California,Golden Bears,1-2,2-1,1,7,10,24,17,0,7,7,10,0,10,7,0,-1,-3,7,0.8490776682765291,[17.40095215]
2022,3,NCAAF_20220917_NTEXAS@UNLV,UNLV,Rebels,North Texas,Mean Green,2-1,2-2,1,23,20,58,27,9,14,14,21,10,10,7,0,0,3,31,0.39037790563616614,[-4.69089365]
2022,3,NCAAF_20220917_TULANE@KSTATE,Kansas State,Wildcats,Tulane,Green Wave,2-1,3-0,0,10,7,10,17,0,10,0,0,7,0,3,7,-1,3,-7,0.7376725934679863,[10.72194304]
2022,3,NCAAF_20220917_BYU@OREG,Oregon,Ducks,BYU,Cougars,2-1,2-1,0,24,7,41,20,10,14,14,3,0,7,0,13,0,17,21,0.7177185155078039,[9.70889287]
2022,3,NCAAF_20220917_COLO@MINN,Minnesota,Golden Gophers,Colorado,Buffaloes,3-0,0-3,1,35,0,49,7,14,21,7,7,0,0,0,7,3,35,42,0.7844792250456816,[13.27059015]
2022,3,NCAAF_20220917_GAS@UAB,UAB,Blazers,Ga. Southern,Eagles,2-1,3-1,0,21,7,35,21,7,14,0,14,0,7,7,7,-1,14,14,0.6478362718312832,[6.39564042]
2022,3,NCAAF_20220917_MISS@GATECH,Georgia Tech,Yellow Jackets,Ole Miss,Rebels,1-2,3-0,0,0,21,0,42,0,0,0,0,14,7,21,0,-2,-21,-42,0.29548133044613945,[-9.05774752]
2022,3,NCAAF_20220917_NMEXST@WISC,Wisconsin,Badgers,New Mexico St.,Aggies,2-1,0-4,1,35,0,66,7,7,28,21,10,0,0,0,7,2,35,59,0.9948894396978168,[43.28401577]
2022,3,NCAAF_20220917_PSU@AUBURN,Auburn,Tigers,Penn State,Nittany Lions,2-1,3-0,0,6,14,12,41,3,3,0,6,7,7,17,10,-1,-8,-29,0.36442883974121,[-5.84217441]
2022,3,NCAAF_20220917_STONYBRK@UMASS,UMass,,Stony Brook,,1-2,0-2,,17,3,20,3,7,10,3,0,0,3,0,0,1,14,17,0.62441556449472,[5.34420561]
2022,3,NCAAF_20220917_TROY@APLST,App. St.,Mountaineers,Troy,Trojans,2-1,1-2,0,14,21,32,28,7,7,10,8,7,14,0,7,1,-7,4,0.7771993616681159,[12.85529124]
2022,3,NCAAF_20220917_VANDY@NILL,N. Illinois,Huskies,Vanderbilt,Commodores,1-2,3-1,0,21,14,28,38,7,14,7,0,7,7,21,3,-2,7,-10,0.45163306514508905,[-2.04830961]
2022,3,NCAAF_20220917_KANSAS@HOU,Houston,Cougars,Kansas,Jayhawks,1-2,3-0,0,14,28,30,48,14,0,13,3,14,14,14,6,-2,-14,-18,0.7903381107393556,[13.61076688]
2022,3,NCAAF_20220917_LAMON@BAMA,Alabama,Crimson Tide,UL-Monroe,Warhawks,3-0,1-2,1,35,7,63,7,28,7,14,14,0,7,0,0,2,28,56,0.9993488666810888,[54.19194894]
2022,3,NCAAF_20220917_TNMART@BOISE,Boise St.,Broncos,UT Martin,Skyhawks,2-1,1-2,0,20,7,30,7,7,13,0,10,7,0,0,0,1,13,23,0.9905366103865894,[39.55455672]
2022,3,NCAAF_20220917_COLOST@WASHST,Washington St.,Cougars,Colorado St.,Rams,3-0,0-3,0,28,0,38,7,21,7,3,7,0,0,0,7,3,28,31,0.8436071617720478,[17.01177927]
2022,3,NCAAF_20220917_LIB@WAKE,Wake Forest,Demon Deacons,Liberty,Flames,3-0,2-1,0,20,8,37,36,3,17,0,17,0,8,15,13,1,12,1,0.770061395008212,[12.45553115]
2022,3,NCAAF_20220917_CAMP@ECU,East Carolina,,Campbell,,2-2,1-2,,21,10,49,10,7,14,21,7,10,0,0,0,1,11,39,0.9147335660401552,[23.09755455]
2022,3,NCAAF_20220917_MISSST@LSU,LSU,Tigers,Miss. State,Bulldogs,2-1,2-1,1,7,13,31,16,0,7,3,21,6,7,3,0,0,-6,15,0.5986916299842099,[4.21272361]
2022,3,NCAAF_20220917_NCAT@DUKE,Duke,Blue Devils,NC A&T,Aggies,3-0,0-3,1,28,6,49,20,21,7,14,7,0,6,0,14,3,22,29,0.9227083447650757,[23.99135803]
2022,3,NCAAF_20220917_AKRON@TENN,Tennessee,Volunteers,Akron,Zips,3-0,1-2,1,35,0,63,6,14,21,14,14,0,0,3,3,2,35,57,0.961763012836407,[29.85626532]
2022,3,NCAAF_20220917_ARKST@MEMP,Memphis,Tigers,Arkansas St.,Red Wolves,2-1,1-2,1,21,17,44,32,7,14,0,23,7,10,0,15,1,4,12,0.7929312551177948,[13.76310944]
2022,3,NCAAF_20220917_ARPB@OKLAST,Oklahoma State,Cowboys,Ark.-Pine Bluff,Golden Lions,3-0,2-2,1,49,7,63,7,28,21,7,7,0,7,0,0,1,42,56,0.9999606868632908,[66.54670157]
2022,3,NCAAF_20220917_CHARLO@GAST,Georgia St.,Panthers,Charlotte,49ers,0-3,1-3,1,20,21,41,42,14,6,7,14,7,14,7,14,-1,-1,-1,0.6399135536334607,[6.03737558]
2022,3,NCAAF_20220917_JAXST@TULSA,Tulsa,,Jacksonville St.,,2-1,3-1,,40,3,54,17,12,28,7,7,0,3,7,7,-1,37,37,0.7511947560866366,[11.43092888]
2022,3,NCAAF_20220917_MOST@ARK,Arkansas,Razorbacks,Missouri St.,Bears,3-0,2-1,0,14,17,38,27,0,14,3,21,7,10,7,3,1,-3,11,0.9066246426437427,[22.25081886]
2022,3,NCAAF_20220917_NWST@USM,So. Miss,,Northwestern St.,,1-2,0-3,,41,0,64,10,13,28,16,7,0,0,10,0,1,41,54,0.9339476806205081,[25.37884618]
2022,3,NCAAF_20220917_TNST@MTSU,Middle Tenn.,,Tennessee St.,,3-1,0-3,,42,0,49,6,21,21,7,0,0,0,6,0,3,42,43,0.7211075204361732,[9.87839671]
2022,3,NCAAF_20220917_TOLEDO@OHIOST,Ohio State,Buckeyes,Toledo,Rockets,3-0,2-1,1,42,14,77,21,28,14,14,21,7,7,7,0,1,28,56,0.9852621852627531,[36.69109038]
2022,3,NCAAF_20220917_TXTECH@NCST,NC State,Wolfpack,Texas Tech,Red Raiders,3-0,2-1,0,20,7,27,14,6,14,0,7,0,7,0,7,1,13,13,0.5322252462261463,[1.36285068]
2022,3,NCAAF_20220917_ME@BC,Boston College,Eagles,Maine,Black Bears,1-3,0-3,1,28,10,38,17,14,14,3,7,10,0,7,0,1,18,21,0.9617566383369875,[29.85497212]
2022,3,NCAAF_20220917_MICHST@WASH,Washington,Huskies,Michigan St.,Spartans,3-0,2-1,1,29,8,39,28,9,20,7,3,0,8,6,14,1,21,11,0.5880003347336167,[3.74827762]
2022,3,NCAAF_20220917_NEVADA@IOWA,Iowa,Hawkeyes,Nevada,Wolf Pack,2-1,2-2,1,17,0,27,0,14,3,3,7,0,0,0,0,0,17,27,0.9342829791740777,[25.42294925]
2022,3,NCAAF_20220917_PITT@WMICH,W. Michigan,Broncos,Pittsburgh,Panthers,1-2,2-1,0,6,13,13,34,3,3,7,0,10,3,7,14,-1,-7,-21,0.20640980936214093,[-13.80200007]
2022,3,NCAAF_20220917_SFLA@FLA,Florida,Gators,South Florida,Bulls,2-1,1-2,0,24,13,31,28,3,21,0,7,7,6,8,7,1,11,3,0.9243927010220218,[24.18899878]
2022,3,NCAAF_20220917_SMU@MD,Maryland,Terrapins,SMU,Mustangs,3-0,2-1,0,17,20,34,27,3,14,3,14,6,14,7,0,1,-3,7,0.46316289393266397,[-1.55841447]
2022,3,NCAAF_20220917_UCF@FAU,FAU,Owls,UCF,Knights,2-2,2-1,1,14,16,14,40,14,0,0,0,7,9,14,10,0,-2,-26,0.20359050019167713,[-13.96923437]
2022,3,NCAAF_20220917_UL@RICE,Rice,Owls,Louisiana,Ragin' Cajuns,2-1,2-1,0,13,14,33,21,3,10,6,14,7,7,0,7,0,-1,12,0.12203677969024562,[-19.63200514]
2022,3,NCAAF_20220917_LATECH@CLEM,Clemson,Tigers,Louisiana Tech,Bulldogs,3-0,1-2,1,13,6,48,20,10,3,21,14,0,6,0,14,2,7,28,0.9889767078542623,[38.58707308]
2022,3,NCAAF_20220917_MTST@OREGST,Oregon State,Beavers,Montana St.,Bobcats,3-0,2-1,1,34,14,68,28,7,27,20,14,7,7,7,7,1,20,40,0.8303415925938304,[16.10374749]
2022,3,NCAAF_20220917_TXSA@TEXAS,Texas,Longhorns,UTSA,Roadrunners,2-1,1-2,1,17,17,41,20,0,17,14,10,3,14,3,0,1,0,21,0.9478304263812968,[27.37290889]
2022,3,NCAAF_20220917_UTEP@NMEX,New Mexico,Lobos,UTEP,Miners,2-1,1-3,1,20,3,27,10,10,10,0,7,3,0,0,7,1,17,17,0.6694073754735661,[7.38648813]
2022,3,NCAAF_20220917_MIAMI@TXAM,Texas A&M,Aggies,Miami (Fla.),Hurricanes,2-1,2-1,1,10,3,17,9,10,0,7,0,3,0,3,3,0,7,8,0.5777969266588474,[3.30767061]
2022,3,NCAAF_20220917_SDGST@UTAH,Utah,Utes,San Diego St.,Aztecs,2-1,1-2,1,21,0,35,7,0,21,14,0,0,0,0,7,1,21,28,0.8171856557857062,[15.24718388]
2022,3,NCAAF_20220917_FRESNO@USC,USC,Trojans,Fresno St.,Bulldogs,4-0,1-2,1,21,10,45,17,14,7,14,10,0,10,7,0,3,11,28,0.6487193320256106,[6.43574897]
2022,3,NCAAF_20220917_EMICH@ARIZST,Arizona St.,Sun Devils,E. Michigan,Eagles,1-2,2-1,0,14,24,21,30,0,14,0,7,10,14,3,3,-1,-10,-9,0.8281783051852718,[15.96007086]
2022,3,NCAAF_20220917_NDST@ARIZ,Arizona,Wildcats,N. Dakota St.,Bison,2-1,2-1,1,17,14,31,28,7,10,7,7,7,7,14,0,0,3,3,,
2022,3,NCAAF_20220917_DUQ@HAWAII,Hawaii,,Duquesne,,1-3,1-3,,14,6,24,14,7,7,0,10,3,3,0,8,0,8,10,0.7930316054571123,[13.76902743]
2022,3,NCAAF_20220916_FSU@LVILLE,Louisville,Cardinals,Florida State,Seminoles,1-2,3-0,1,21,14,31,35,14,7,0,10,14,0,7,14,-2,7,-4,0.5072745443589792,[0.30733271]
2022,3,NCAAF_20220916_AF@WYO,Wyoming,Cowboys,Air Force,Falcons,3-1,2-1,1,10,0,17,14,3,7,0,7,0,0,7,7,1,10,3,0.34135568533168015,[-6.88912054]
2022,4,NCAAF_20220924_BAYLOR@IOWAST,Iowa St.,Cyclones,Baylor,Bears,3-1,3-1,0,14,17,24,31,7,7,0,10,7,10,7,7,0,-3,-7,0.6964765772120809,[8.66258235]
2022,4,NCAAF_20220924_BGREEN@MISSST,Miss. State,Bulldogs,Bowling Green,Falcons,3-1,1-3,1,31,7,45,14,17,14,7,7,0,7,0,7,2,24,31,0.9893357646956519,[38.77610031]
2022,4,NCAAF_20220924_BUFF@EMICH,E. Michigan,Eagles,Buffalo,Bulls,2-2,1-3,0,24,30,31,50,14,10,7,0,13,17,10,10,1,-6,-19,0.44205128863332366,[-2.45530804]
2022,4,NCAAF_20220924_CMICH@PSU,Penn State,Nittany Lions,C. Michigan,Chippewas,4-0,1-3,0,21,14,33,14,14,7,6,6,0,14,0,0,3,7,19,0.9762684983541163,[33.38657217]
2022,4,NCAAF_20220924_DUKE@KANSAS,Kansas,Jayhawks,Duke,Blue Devils,4-0,3-1,1,21,13,35,27,7,14,7,7,7,6,0,14,1,8,8,0.33624225922514295,[-7.12049794]
2022,4,NCAAF_20220924_KENTST@UGA,Georgia,Bulldogs,Kent St.,Golden Flashes,4-0,1-3,1,26,13,39,22,12,14,6,7,3,10,3,6,3,13,17,0.9967653841325489,[45.8652557]
2022,4,NCAAF_20220924_MD@MICH,Michigan,Wolverines,Maryland,Terrapins,4-0,3-1,1,17,13,34,27,10,7,0,17,10,3,0,14,1,4,7,0.9303220737925146,[24.89819316]
2022,4,NCAAF_20220924_RI@PITT,Pittsburgh,Panthers,Rhode Island,Rams,3-1,2-2,0,24,14,45,24,14,10,7,14,7,7,3,7,1,10,21,0.9591649383873054,[29.32609988]
2022,4,NCAAF_20220924_SFLA@LVILLE,Louisville,Cardinals,South Florida,Bulls,2-2,1-3,1,28,0,41,3,14,14,3,10,0,0,0,3,1,28,38,0.7454468957449867,[11.12068857]
2022,4,NCAAF_20220924_TCU@SMU,SMU,Mustangs,TCU,Horned Frogs,2-2,3-0,0,14,28,34,42,0,14,7,13,14,14,0,14,-1,-14,-8,0.2930696205584524,[-9.17034802]
2022,4,NCAAF_20220924_FORD@OHIO,Ohio,Bobcats,Fordham,Rams,2-2,3-1,1,31,21,59,52,14,17,7,21,0,21,28,3,-1,10,7,0.9878579191020943,[37.94208031]
2022,4,NCAAF_20220924_UCLA@COLO,Colorado,Buffaloes,UCLA,Bruins,0-4,4-0,1,10,21,17,45,0,10,0,7,14,7,17,7,-4,-11,-28,0.3515435030811488,[-6.42007205]
2022,4,NCAAF_20220924_UMASS@TEMPLE,Temple,Owls,UMass,Minutemen,2-2,1-3,0,7,0,28,0,0,7,14,7,0,0,0,0,1,7,28,0.8823063833197649,[19.98660668]
2022,4,NCAAF_20220924_FIU@WKY,W. Kentucky,Hilltoppers,FIU,Panthers,3-1,1-2,0,42,0,73,0,14,28,17,14,0,0,0,0,2,42,73,0.6995026768226151,[8.80873902]
2022,4,NCAAF_20220924_FLA@TENN,Tennessee,Volunteers,Florida,Gators,4-0,3-2,0,17,14,38,33,3,14,14,7,0,14,7,12,1,3,5,0.28486506098967657,[-9.57476009]
2022,4,NCAAF_20220924_IND@CINCY,Cincinnati,Bearcats,Indiana,Hoosiers,3-1,3-1,0,38,10,45,24,10,28,0,7,3,7,7,7,0,28,21,0.5527831830449366,[2.23508958]
2022,4,NCAAF_20220924_JMAD@APLST,App. St.,,James Madison,,2-2,3-0,,28,10,28,32,0,28,0,0,3,7,7,15,-1,18,-4,0.28322241587145647,[-9.65638779]
2022,4,NCAAF_20220924_MINN@MICHST,Michigan St.,Spartans,Minnesota,Golden Gophers,2-2,4-0,0,0,17,7,34,0,0,0,7,14,3,7,10,-2,-17,-27,0.4533929461500329,[-1.9722842]
2022,4,NCAAF_20220924_MTSU@MIAMI,Miami (Fla.),Hurricanes,Middle Tenn.,Blue Raiders,2-2,3-2,0,10,24,31,45,3,7,7,14,17,7,7,14,-1,-14,-14,0.8726012996084234,[19.18111979]
2022,4,NCAAF_20220924_ND@UNC,North Carolina,Tar Heels,Notre Dame,Fighting Irish,4-1,2-2,1,14,24,32,45,7,7,6,12,0,24,14,7,2,-10,-13,0.16947242564937592,[-16.10678346]
2022,4,NCAAF_20220924_NTEXAS@MEMP,Memphis,Tigers,North Texas,Mean Green,3-1,2-3,1,20,13,44,34,6,14,7,17,10,3,7,14,1,7,10,0.8278588370658793,[15.9296835]
2022,4,NCAAF_20220924_TOLEDO@SDGST,San Diego St.,Aztecs,Toledo,Rockets,2-2,2-2,1,7,0,17,14,0,7,3,7,0,0,0,14,0,7,3,0.5949320486049874,[4.04670057]
2022,4,NCAAF_20220924_TXSO@TXSA,UTSA,Roadrunners,Texas Southern,Tigers,2-2,1-3,0,21,17,52,24,14,7,14,17,7,10,7,0,1,4,28,0.9859894714879207,[37.00537038]
2022,4,NCAAF_20220924_GATECH@UCF,UCF,Knights,Georgia Tech,Yellow Jackets,3-1,1-3,1,13,7,27,10,3,10,3,11,0,7,3,0,2,6,17,0.7917093710365097,[13.68322577]
2022,4,NCAAF_20220924_OREG@WASHST,Washington St.,Cougars,Oregon,Ducks,3-1,3-1,1,17,9,41,44,10,7,10,14,3,6,6,29,0,8,-3,0.3998496796640979,[-4.27384566]
2022,4,NCAAF_20220924_SACST@COLOST,Colorado St.,,Sacramento St.,,0-4,4-0,,10,24,10,41,0,10,0,0,7,17,7,10,-4,-14,-31,0.6840637394506504,[8.06967694]
2022,4,NCAAF_20220924_TULSA@MISS,Ole Miss,Rebels,Tulsa,Golden Hurricane,4-0,2-2,1,35,17,35,27,7,28,0,0,14,3,3,7,2,18,8,0.7747849052412759,[12.71187474]
2022,4,NCAAF_20220924_ARIZ@CAL,California,Golden Bears,Arizona,Wildcats,3-1,2-2,1,21,24,49,31,7,14,14,14,14,10,0,7,1,-3,18,0.645906426731917,[6.30444464]
2022,4,NCAAF_20220924_AKRON@LIB,Liberty,Flames,Akron,Zips,3-1,1-3,0,14,3,21,12,7,7,0,7,0,3,3,6,2,11,9,0.879934517954089,[19.7855619]
2022,4,NCAAF_20220924_ARKST@ODU,Old Dominion,Monarchs,Arkansas St.,Red Wolves,2-2,1-3,0,0,12,29,26,0,0,21,8,0,12,7,7,1,-12,3,0.30505018926386485,[-8.58908902]
2022,4,NCAAF_20220924_BALLST@GAS,Ga. Southern,Eagles,Ball St.,Cardinals,3-1,1-3,1,13,10,34,23,3,10,7,14,3,7,10,3,2,3,11,0.5713702351205769,[3.02956341]
2022,4,NCAAF_20220924_RICE@HOU,Houston,Cougars,Rice,Owls,2-2,2-2,0,10,14,34,27,7,3,14,10,0,14,10,3,0,-4,7,0.9106909915560304,[22.65509514]
2022,4,NCAAF_20220924_ARK@TXAM,Texas A&M,Aggies,Arkansas,Razorbacks,3-1,3-1,0,13,14,23,21,0,13,10,0,14,0,0,7,0,-1,2,0.7994774598158215,[14.14456587]
2022,4,NCAAF_20220924_HOUBP@TXSTSM,Texas St.,Bobcats,Houston Christian,Huskies,2-2,1-2,1,24,0,34,0,7,17,3,7,0,0,0,0,1,24,34,0.6275631366104619,[5.48102902]
2022,4,NCAAF_20220924_IOWA@RUT,Rutgers,Scarlet Knights,Iowa,Hawkeyes,3-1,3-1,1,3,17,10,27,3,0,0,7,7,10,7,3,0,-14,-17,0.07587325795686217,[-24.14352354]
2022,4,NCAAF_20220924_LATECH@SALA,South Alabama,Jaguars,Louisiana Tech,Bulldogs,4-1,1-3,1,17,7,38,14,14,3,14,7,0,7,0,7,3,10,24,0.33425613893827755,[-7.21229749]
2022,4,NCAAF_20220924_MRSHL@TROY,Troy,Trojans,Marshall,Thundering Herd,2-2,2-2,1,10,0,16,7,10,0,0,6,0,0,7,0,0,10,9,0.3443681684687724,[-6.74707283]
2022,4,NCAAF_20220924_NILL@UK,Kentucky,Wildcats,N. Illinois,Huskies,4-0,1-3,0,14,14,31,23,7,7,10,7,7,7,0,9,3,0,8,0.8639230573359835,[18.49628749]
2022,4,NCAAF_20220924_UNLV@UTAHST,Utah St.,Aggies,UNLV,Rebels,1-3,3-1,0,16,27,24,34,7,9,0,8,14,13,7,0,-2,-11,-10,0.7941961225358682,[13.8297813]
2022,4,NCAAF_20220924_USM@TULANE,Tulane,Green Wave,So. Miss,Golden Eagles,4-1,2-2,0,17,10,24,27,7,10,0,7,0,10,7,10,2,7,-3,0.7423586926391379,[10.95906017]
2022,4,NCAAF_20220924_CHARLO@SC,South Carolina,Gamecocks,Charlotte,49ers,2-2,1-4,1,20,14,56,20,3,17,22,14,7,7,0,6,1,6,36,0.9173974402463322,[23.375231]
2022,4,NCAAF_20220924_FAU@PURDUE,Purdue,Boilermakers,FAU,Owls,2-2,2-3,1,14,13,28,26,7,7,7,7,0,13,7,6,0,1,2,0.7938184119442984,[13.80745383]
2022,4,NCAAF_20220924_MIAOH@NWEST,Northwestern,Wildcats,Miami-OH,RedHawks,1-3,2-2,0,7,7,14,17,7,0,0,7,0,7,0,10,-1,0,-3,0.7947417102018159,[13.8620754]
2022,4,NCAAF_20220924_NMEX@LSU,LSU,Tigers,New Mexico,Lobos,3-1,2-2,0,17,0,38,0,10,7,14,7,0,0,0,0,1,17,38,0.9785243816960215,[34.09465882]
2022,4,NCAAF_20220924_UCONN@NCST,NC State,Wolfpack,UConn,Huskies,4-0,1-4,1,31,3,41,10,17,14,7,3,0,3,0,7,3,28,31,0.975414091581254,[33.13313817]
2022,4,NCAAF_20220924_VANDY@BAMA,Alabama,Crimson Tide,Vanderbilt,Commodores,5-0,3-2,1,31,3,55,3,14,17,10,14,3,0,0,0,2,28,52,0.9930177395789147,[41.4046522]
2022,4,NCAAF_20220924_WISC@OHIOST,Ohio State,Buckeyes,Wisconsin,Badgers,4-0,2-2,1,31,7,52,21,21,10,14,7,0,7,0,14,2,24,31,0.7589115663587644,[11.83781754]
2022,4,NCAAF_20220924_BC@FSU,Florida State,Seminoles,Boston College,Eagles,4-0,1-3,0,31,0,44,14,21,10,6,7,0,0,7,7,3,31,30,0.47202095963315305,[-1.18226717]
2022,4,NCAAF_20220924_HAWAII@NMEXST,New Mexico St.,Aggies,Hawaii,Rainbow Warriors,1-5,1-4,0,35,10,45,26,14,21,7,3,7,3,7,9,0,25,19,0.2889290854452925,[-9.37376435]
2022,4,NCAAF_20220924_KSTATE@OKLA,Oklahoma,Sooners,Kansas State,Wildcats,3-1,3-1,0,17,24,34,41,7,10,3,14,14,10,3,14,0,-7,-7,0.8092712724483286,[14.7418051]
2022,4,NCAAF_20220924_UL@LAMON,UL-Monroe,Warhawks,Louisiana,Ragin' Cajuns,2-2,2-2,1,7,17,21,17,7,0,0,14,14,3,0,0,0,-10,4,0.15253434441085822,[-17.27526464]
2022,4,NCAAF_20220924_USC@OREGST,Oregon State,Beavers,USC,Trojans,3-1,4-0,0,7,3,14,17,0,7,0,7,0,3,0,14,-1,4,-3,0.22822418422754254,[-12.54360315]
2022,4,NCAAF_20220924_WYO@BYU,BYU,Cougars,Wyoming,Cowboys,3-1,3-2,1,14,10,38,24,7,7,14,10,3,7,0,14,0,4,14,0.6842094160865336,[8.07657617]
2022,4,NCAAF_20220924_STNFRD@WASH,Washington,Huskies,Stanford,Cardinal,4-0,1-2,0,17,7,40,22,7,10,13,10,0,7,0,15,3,10,18,0.7088204991774952,[9.2630382]
2022,4,NCAAF_20220924_UTAH@ARIZST,Arizona St.,Sun Devils,Utah,Utes,1-3,3-1,0,6,24,13,34,0,6,0,7,14,10,7,3,-2,-18,-21,0.29032900263126216,[-9.30483757]
2022,4,NCAAF_20220924_WMICH@SJST,San Jose St.,Spartans,W. Michigan,Broncos,2-1,1-3,1,17,0,34,6,3,14,7,10,0,0,6,0,1,17,28,0.30219601437863164,[-8.72661351]
2022,4,NCAAF_20220923_UVA@CUSE,Syracuse,Orange,Virginia,Cavaliers,4-0,2-2,1,16,0,22,20,10,6,3,3,0,0,13,7,2,16,2,0.4250155788593841,[-3.18477629]
2022,4,NCAAF_20220923_NEVADA@AF,Air Force,,Nevada,,4-1,2-3,,24,7,48,20,10,14,17,7,0,7,0,13,2,17,28,0.6966115397105929,[8.6690869]
2022,4,NCAAF_20220923_BOISE@UTEP,UTEP,Miners,Boise St.,Broncos,2-3,2-2,1,10,3,27,10,0,10,10,7,3,0,7,0,0,7,17,0.02748219005743957,[-32.32563389]
2022,4,NCAAF_20220922_CSTCAR@GAST,Georgia St.,Panthers,C. Carolina,Chanticleers,0-4,4-0,0,17,27,24,41,7,10,0,7,21,6,7,7,-4,-10,-17,0.3692274742009599,[-5.62409867]
2022,4,NCAAF_20220922_WVU@VATECH,Virginia Tech,Hokies,West Virginia,Mountaineers,2-2,2-2,0,7,13,10,33,0,7,3,0,3,10,3,17,0,-6,-23,0.41747331562176127,[-3.50957145]
2022,4,NCAAF_20220922_TNCHAT@ILL,Illinois,Fighting Illini,Chattanooga,Mocs,3-1,3-1,0,24,0,31,0,10,14,7,0,0,0,0,0,0,24,31,0.8654678789803175,[18.61594779]
2022,5,NCAAF_20221002_EWASH@FLA,Florida,Gators,E. Washington,Eagles,3-2,1-3,0,35,3,52,17,14,21,10,7,3,0,0,14,2,32,35,0.9968510314617874,[46.15143794]
2022,5,NCAAF_20221001_GAST@ARMY,Army,Black Knights,Georgia St.,Panthers,1-3,1-4,0,0,17,14,31,0,0,7,7,3,14,0,14,0,-17,-17,0.7850417374438563,[13.33488]
2022,5,NCAAF_20221001_ILL@WISC,Wisconsin,Badgers,Illinois,Fighting Illini,2-3,4-1,1,10,14,10,34,7,3,0,0,7,7,17,3,-2,-4,-24,0.9113585911351301,[22.79261998]
2022,5,NCAAF_20221001_LVILLE@BC,Boston College,Eagles,Louisville,Cardinals,2-3,2-3,0,21,23,34,33,7,14,7,6,7,16,10,0,0,-2,1,0.49803744849129516,[-0.08310761]
2022,5,NCAAF_20221001_MICH@IOWA,Iowa,Hawkeyes,Michigan,Wolverines,3-2,5-0,0,0,13,14,27,0,0,0,14,7,6,7,7,-2,-13,-13,0.36613561838125586,[-5.77947677]
2022,5,NCAAF_20221001_NAVY@AF,Air Force,Falcons,Navy,Midshipmen,4-1,1-3,1,10,3,13,10,10,0,0,3,0,3,0,7,3,7,3,0.6328388829792135,[5.73345478]
2022,5,NCAAF_20221001_OKLA@TCU,TCU,Horned Frogs,Oklahoma,Sooners,4-0,3-2,0,41,17,55,24,27,14,14,0,10,7,0,7,1,24,31,0.22572352330985412,[-12.72113181]
2022,5,NCAAF_20221001_PURDUE@MINN,Minnesota,Golden Gophers,Purdue,Boilermakers,4-1,4-2,1,3,10,10,20,0,3,7,0,10,0,0,10,0,-7,-10,0.5410105396324695,[1.7397246]
2022,5,NCAAF_20221001_TEMPLE@MEMP,Memphis,Tigers,Temple,Owls,4-2,2-3,1,0,3,24,3,0,0,7,17,0,3,0,0,2,-3,21,0.8010663207864621,[14.28265175]
2022,5,NCAAF_20221001_TXTECH@KSTATE,Kansas State,Wildcats,Texas Tech,Red Raiders,4-1,3-2,1,13,10,37,28,13,0,7,17,0,10,10,8,1,3,9,0.5947249920304434,[4.04972949]
2022,5,NCAAF_20221001_UK@MISS,Ole Miss,Rebels,Kentucky,Wildcats,5-0,4-1,1,19,12,22,19,14,5,3,0,6,6,7,0,1,7,3,0.48505146761998263,[-0.63316687]
2022,5,NCAAF_20221001_TXSTSM@JMAD,James Madison,Dukes,Texas St.,Bobcats,4-0,2-3,0,19,0,40,13,7,12,7,14,0,0,7,6,2,19,27,0.9794315458103163,[34.4996841]
2022,5,NCAAF_20221001_OREGST@UTAH,Utah,Utes,Oregon State,Beavers,4-1,3-2,0,21,13,42,16,14,7,14,7,7,6,3,0,1,8,26,0.8687705110265913,[18.9311895]
2022,5,NCAAF_20221001_UMASS@EMICH,E. Michigan,Eagles,UMass,Minutemen,3-2,1-4,1,0,10,20,13,0,0,14,6,7,3,3,0,2,-10,7,0.8957480612853224,[21.24719699]
2022,5,NCAAF_20221001_ECU@SFLA,South Florida,Bulls,East Carolina,Pirates,1-4,3-2,0,7,41,28,48,0,7,14,7,14,27,7,0,-2,-34,-20,0.5554631952268547,[2.35629209]
2022,5,NCAAF_20221001_BAMA@ARK,Arkansas,Razorbacks,Alabama,Crimson Tide,3-2,5-0,0,7,28,26,49,0,7,16,3,14,14,0,21,-2,-21,-23,0.019442959663974135,[-34.89237467]
2022,5,NCAAF_20221001_BGREEN@AKRON,Akron,Zips,Bowling Green,Falcons,1-4,2-3,0,14,24,28,31,7,7,7,7,10,14,0,7,-1,-10,-3,0.5172514710530658,[0.73076798]
2022,5,NCAAF_20221001_CIT@APLST,App. St.,Mountaineers,The Citadel,Bulldogs,3-2,1-3,1,35,0,49,0,14,21,7,7,0,0,0,0,2,35,49,0.9433091024450773,[26.74586771]
2022,5,NCAAF_20221001_CMICH@TOLEDO,Toledo,Rockets,C. Michigan,Chippewas,3-2,1-4,0,31,3,38,17,3,28,0,7,3,0,8,6,2,28,21,0.6062338562113705,[4.55316404]
2022,5,NCAAF_20221001_FRESNO@UCONN,UConn,Huskies,Fresno St.,Bulldogs,2-4,1-3,1,6,7,19,14,3,3,6,7,0,7,7,0,1,-1,5,0.04611680174436783,[-28.44466463]
2022,5,NCAAF_20221001_GRDWB@MRSHL,Marshall,Thundering Herd,Gardner-Webb,Runnin' Bulldogs,3-2,2-4,1,14,7,28,7,7,7,7,7,7,0,0,0,1,7,21,0.9822536061475413,[35.52249681]
2022,5,NCAAF_20221001_IOWAST@KANSAS,Kansas,Jayhawks,Iowa St.,Cyclones,5-0,3-2,0,14,8,14,11,0,14,0,0,0,8,3,0,2,6,3,0.053355144057319115,[-27.25240306]
2022,5,NCAAF_20221001_MIAOH@BUFF,Buffalo,Bulls,Miami-OH,RedHawks,2-3,2-3,0,14,10,24,20,7,7,3,7,7,3,10,0,0,4,4,0.5689095418817289,[2.93274494]
2022,5,NCAAF_20221001_MICHST@MD,Maryland,Terrapins,Michigan St.,Spartans,4-1,2-3,1,21,13,27,13,14,7,3,3,7,6,0,0,2,8,14,0.30199661859041205,[-8.76226392]
2022,5,NCAAF_20221001_NWEST@PSU,Penn State,Nittany Lions,Northwestern,Wildcats,5-0,1-5,0,14,0,17,7,7,7,0,3,0,0,7,0,4,14,10,0.878311993925329,[19.70816763]
2022,5,NCAAF_20221001_OKLAST@BAYLOR,Baylor,Bears,Oklahoma State,Cowboys,3-2,5-0,1,3,16,25,36,3,0,22,0,7,9,17,3,-2,-13,-11,0.33567002505238186,[-7.16821242]
2022,5,NCAAF_20221001_RUT@OHIOST,Ohio State,Buckeyes,Rutgers,Scarlet Knights,5-0,3-2,0,28,7,49,10,14,14,14,7,7,0,3,0,2,21,39,0.9890100678285623,[38.69895244]
2022,5,NCAAF_20221001_VATECH@UNC,North Carolina,Tar Heels,Virginia Tech,Hokies,4-1,2-3,1,24,10,41,10,7,17,17,0,3,7,0,0,2,14,31,0.46977311810752476,[-1.2812311]
2022,5,NCAAF_20221001_WAKE@FSU,Florida State,Seminoles,Wake Forest,Demon Deacons,4-1,4-1,1,7,21,21,31,7,0,6,8,7,14,7,3,0,-14,-10,0.4226175718097698,[-3.29770155]
2022,5,NCAAF_20221001_FAU@NTEXAS,North Texas,Mean Green,FAU,Owls,3-3,2-4,0,28,21,45,28,7,21,14,3,7,14,0,7,1,7,17,0.3043115608757505,[-8.65031224]
2022,5,NCAAF_20221001_TXAM@MISSST,Miss. State,Bulldogs,Texas A&M,Aggies,4-1,3-2,1,14,0,42,24,0,14,7,21,0,0,10,14,1,14,18,0.47420775570984075,[-1.09297436]
2022,5,NCAAF_20221001_SALA@UL,Louisiana,Ragin' Cajuns,South Alabama,Jaguars,2-3,4-1,0,7,7,17,20,7,0,0,10,0,7,3,10,-2,0,-3,0.8008099370121465,[14.26713686]
2022,5,NCAAF_20221001_WAG@CUSE,Syracuse,Orange,Wagner,Seahawks,5-0,0-5,1,49,0,59,0,21,28,7,3,0,0,0,0,5,49,59,0.9978434849150811,[48.22023232]
2022,5,NCAAF_20221001_CAL@WASHST,Washington St.,Cougars,California,Golden Bears,4-2,3-2,0,7,3,28,9,0,7,7,14,0,3,0,6,1,4,19,0.6333443747024626,[5.75613473]
2022,5,NCAAF_20221001_LIB@ODU,Old Dominion,Monarchs,Liberty,Flames,2-3,5-1,1,17,21,24,38,14,3,7,0,14,7,10,7,-3,-4,-14,0.24621048974151916,[-11.59699229]
2022,5,NCAAF_20221001_NH@WMICH,W. Michigan,Broncos,New Hamp.,Wildcats,2-3,3-2,1,28,7,44,7,21,7,3,13,0,7,0,0,-1,21,37,0.9302635609936644,[24.96496713]
2022,5,NCAAF_20221001_UTEP@CHARLO,Charlotte,49ers,UTEP,Miners,1-5,3-4,1,7,24,35,41,7,0,14,14,7,17,10,7,-2,-17,-6,0.6041543937829215,[4.46191498]
2022,5,NCAAF_20221001_CINCY@TULSA,Tulsa,Golden Hurricane,Cincinnati,Bearcats,2-3,4-1,0,14,24,21,31,7,7,7,0,14,10,7,0,-2,-10,-10,0.21519033517757835,[-13.32146474]
2022,5,NCAAF_20221001_GAS@CSTCAR,C. Carolina,Chanticleers,Ga. Southern,Eagles,5-0,3-2,0,7,7,34,30,7,0,7,20,0,7,10,13,2,0,4,0.5954151354131763,[4.07981299]
2022,5,NCAAF_20221001_LAMON@ARKST,Arkansas St.,Red Wolves,UL-Monroe,Warhawks,2-3,2-3,1,24,14,45,28,10,14,14,7,7,7,7,7,0,10,17,0.724459366424661,[10.07109666]
2022,5,NCAAF_20221001_LSU@AUBURN,Auburn,Tigers,LSU,Tigers,3-2,4-1,1,17,14,17,21,7,10,0,0,0,14,7,0,-1,3,-4,0.52637334183469,[1.11763456]
2022,5,NCAAF_20221001_TROY@WKY,W. Kentucky,Hilltoppers,Troy,Trojans,3-2,3-2,1,17,13,27,34,7,10,3,7,10,3,7,14,0,4,-7,0.5184386074840726,[0.78108948]
2022,5,NCAAF_20221001_IND@NEB,Nebraska,Cornhuskers,Indiana,Hoosiers,2-3,3-2,0,21,21,35,21,7,14,0,14,0,21,0,0,-1,0,14,0.5057940082349394,[0.24536484]
2022,5,NCAAF_20221001_NCST@CLEM,Clemson,Tigers,NC State,Wolfpack,5-0,4-1,1,13,10,30,20,3,10,7,10,3,7,3,7,1,3,10,0.888120080526256,[20.55287835]
2022,5,NCAAF_20221001_SJST@WYO,Wyoming,Cowboys,San Jose St.,Spartans,3-3,3-1,0,10,19,16,33,3,7,6,0,2,17,7,7,0,-9,-17,0.7249260342334826,[10.09471109]
2022,5,NCAAF_20221001_UAB@RICE,Rice,Owls,UAB,Blazers,3-2,3-2,1,7,17,28,24,7,0,14,7,7,10,7,0,0,-10,4,0.17937820589138853,[-15.50409463]
2022,5,NCAAF_20221001_UGA@MIZZOU,Missouri,Tigers,Georgia,Bulldogs,2-3,5-0,0,16,6,22,26,3,13,3,3,0,6,6,14,-3,10,-4,0.1109428021342822,[-20.63630714]
2022,5,NCAAF_20221001_UVA@DUKE,Duke,Blue Devils,Virginia,Cavaliers,4-1,2-3,1,21,7,38,17,14,7,7,10,0,7,3,7,2,14,21,0.33404137775189446,[-7.24374829]
2022,5,NCAAF_20221001_WVU@TEXAS,Texas,Longhorns,West Virginia,Mountaineers,4-2,2-3,0,28,7,38,20,14,14,7,3,0,7,0,13,2,21,18,0.6296648038693367,[5.59127709]
2022,5,NCAAF_20221001_FIU@NMEXST,New Mexico St.,Aggies,FIU,Panthers,1-5,2-3,0,7,21,7,21,0,7,0,0,7,14,0,0,-1,-14,-14,0.4071233761676152,[-3.96922166]
2022,5,NCAAF_20221001_GATECH@PITT,Pittsburgh,Panthers,Georgia Tech,Yellow Jackets,3-2,2-3,0,7,6,21,26,0,7,0,14,3,3,3,17,1,1,-5,0.7138299881001265,[9.53839938]
2022,5,NCAAF_20221001_COLO@ARIZ,Arizona,Wildcats,Colorado,Buffaloes,3-3,0-5,1,26,13,43,20,13,13,10,7,7,6,7,0,3,13,23,0.49034151283336547,[-0.4090435]
2022,5,NCAAF_20221001_ARIZST@USC,USC,Trojans,Arizona St.,Sun Devils,5-0,1-4,1,21,17,42,25,14,7,7,14,7,10,0,8,4,4,17,0.5677919857678488,[2.88471359]
2022,5,NCAAF_20221001_STNFRD@OREG,Oregon,Ducks,Stanford,Cardinal,4-1,1-3,0,31,3,45,27,10,21,7,7,0,3,14,10,3,28,18,0.705337162942675,[9.11951506]
2022,5,NCAAF_20220930_TXSA@MTSU,Middle Tenn.,Blue Raiders,UTSA,Roadrunners,3-2,3-2,1,20,31,30,45,0,20,0,10,10,21,7,7,0,-11,-15,0.5787820733430827,[3.35813294]
2022,5,NCAAF_20220930_SDGST@BOISE,Boise St.,Broncos,San Diego St.,Aztecs,3-2,2-3,1,0,13,35,13,0,0,21,14,6,7,0,0,1,-13,22,0.6529529238245653,[6.64442803]
2022,5,NCAAF_20220930_WASH@UCLA,UCLA,Bruins,Washington,Huskies,5-0,4-1,0,26,10,40,32,9,17,14,0,7,3,6,16,1,16,8,0.28212920850479273,[-9.7397622]
2022,5,NCAAF_20220930_NMEX@UNLV,UNLV,Rebels,New Mexico,Lobos,4-1,2-3,0,9,17,31,20,0,9,8,14,14,3,0,3,2,-8,11,0.5649581008143096,[2.76301985]
2022,5,NCAAF_20220929_SCST@SC,South Carolina,Gamecocks,SC State,Bulldogs,3-2,1-3,1,22,0,50,10,8,14,14,14,0,0,7,3,2,22,40,0.9825990043143319,[35.65703602]
2022,5,NCAAF_20220929_UTAHST@BYU,BYU,Cougars,Utah St.,Aggies,4-1,1-4,0,17,17,38,26,14,3,14,7,7,10,3,6,3,0,12,0.6268039398760479,[5.46346809]
2022,6,NCAAF_20221008_ARK@MISSST,Miss. State,Bulldogs,Arkansas,Razorbacks,5-1,3-3,1,21,10,40,17,14,7,13,6,0,10,7,0,2,11,23,0.7743316394619638,[12.72442697]
2022,6,NCAAF_20221008_BUFF@BGREEN,Bowling Green,Falcons,Buffalo,Bulls,2-4,3-3,0,0,31,7,38,0,0,7,0,17,14,7,0,-1,-31,-31,0.11432735273855532,[-20.3376295]
2022,6,NCAAF_20221008_EMICH@WMICH,W. Michigan,Broncos,E. Michigan,Eagles,2-4,4-2,0,7,35,23,45,0,7,9,7,14,21,7,3,-2,-28,-22,0.5461189756465276,[1.95737933]
2022,6,NCAAF_20221008_LVILLE@UVA,Virginia,Cavaliers,Louisville,Cardinals,2-4,3-3,0,10,13,17,34,10,0,7,0,0,13,14,7,-1,-3,-17,0.49792519662402257,[-0.08786248]
2022,6,NCAAF_20221008_MICH@IND,Indiana,Hoosiers,Michigan,Wolverines,3-3,6-0,0,10,10,10,31,7,3,0,0,10,0,7,14,-3,0,-21,0.12884611381708866,[-19.12177972]
2022,6,NCAAF_20221008_MIZZOU@FLA,Florida,Gators,Missouri,Tigers,4-3,2-4,0,10,10,24,17,10,0,7,7,0,10,0,7,2,0,7,0.6506389870307068,[6.53879014]
2022,6,NCAAF_20221008_PURDUE@MD,Maryland,Terrapins,Purdue,Boilermakers,4-2,4-2,0,17,17,29,31,7,10,0,12,3,14,0,14,0,0,-2,0.2805403785962959,[-9.81946551]
2022,6,NCAAF_20221008_TCU@KANSAS,Kansas,Jayhawks,TCU,Horned Frogs,5-1,5-0,0,3,10,31,38,0,3,21,7,3,7,21,7,0,-7,-7,0.09964538940939094,[-21.68481881]
2022,6,NCAAF_20221008_TENN@LSU,LSU,Tigers,Tennessee,Volunteers,4-2,5-0,0,7,23,13,40,0,7,0,6,13,10,14,3,-1,-16,-27,0.7549546347010324,[11.65969671]
2022,6,NCAAF_20221008_TEXAS@OKLA,Oklahoma,Sooners,Texas,Longhorns,3-3,4-2,0,0,28,0,49,0,0,0,0,7,21,14,7,-1,-28,-49,0.674397367041448,[7.63761973]
2022,6,NCAAF_20221008_AKRON@OHIO,Ohio,Bobcats,Akron,Zips,3-3,1-5,1,28,13,55,34,14,14,20,7,0,13,7,14,2,15,21,0.8754049120820426,[19.46736604]
2022,6,NCAAF_20221008_GAS@GAST,Georgia St.,Panthers,Ga. Southern,Eagles,2-4,4-3,0,27,17,41,33,13,14,7,7,7,10,13,3,-2,10,8,0.4668679735076934,[-1.40466486]
2022,6,NCAAF_20221008_SFLA@CINCY,Cincinnati,Bearcats,South Florida,Bulls,5-1,1-6,0,14,17,28,24,7,7,7,7,10,7,0,7,4,-3,4,0.8617261063009601,[18.38257323]
2022,6,NCAAF_20221008_AUBURN@UGA,Georgia,Bulldogs,Auburn,Tigers,6-0,3-3,0,14,0,42,10,0,14,7,21,0,0,3,7,3,14,32,0.7206687944228114,[9.88015696]
2022,6,NCAAF_20221008_BALLST@CMICH,C. Michigan,Chippewas,Ball St.,Cardinals,1-5,3-3,0,10,7,16,17,10,0,6,0,0,7,7,3,-2,3,-1,0.6428230210658561,[6.18348607]
2022,6,NCAAF_20221008_ECU@TULANE,Tulane,Green Wave,East Carolina,Pirates,5-1,3-3,0,14,9,24,9,0,14,7,3,3,6,0,0,2,5,15,0.718959313204019,[9.79439084]
2022,6,NCAAF_20221008_KENTST@MIAOH,Miami-OH,RedHawks,Kent St.,Golden Flashes,3-3,2-4,1,17,7,27,24,17,0,10,0,0,7,7,10,1,10,3,0.6854079150711775,[8.15773801]
2022,6,NCAAF_20221008_LIB@UMASS,UMass,Minutemen,Liberty,Flames,1-5,5-1,1,10,21,24,42,7,3,0,14,0,21,14,7,-4,-11,-18,0.07905345031227395,[-23.84544395]
2022,6,NCAAF_20221008_MTSU@UAB,UAB,Blazers,Middle Tenn.,Blue Raiders,3-2,3-3,1,38,7,41,14,21,17,3,0,7,0,7,0,0,31,27,0.588303239297271,[3.77046258]
2022,6,NCAAF_20221008_TOLEDO@NILL,N. Illinois,Huskies,Toledo,Rockets,1-5,4-2,0,7,35,32,52,7,0,0,25,21,14,10,7,-3,-28,-20,0.3758545451148205,[-5.34506139]
2022,6,NCAAF_20221008_TULSA@NAVY,Navy,Midshipmen,Tulsa,Golden Hurricane,2-4,2-4,0,36,14,53,21,10,26,10,7,7,7,0,7,0,22,32,0.5223106010578815,[0.94528419]
2022,6,NCAAF_20221008_TXTECH@OKLAST,Oklahoma State,Cowboys,Texas Tech,Red Raiders,5-1,3-3,0,20,24,41,31,17,3,14,7,14,10,7,0,2,-4,10,0.7299386686333763,[10.34978]
2022,6,NCAAF_20221008_UTAH@UCLA,UCLA,Bruins,Utah,Utes,6-0,5-2,0,14,10,42,32,7,7,14,14,0,10,8,14,1,4,10,0.2475759858331602,[-11.52408854]
2022,6,NCAAF_20221008_VATECH@PITT,Pittsburgh,Panthers,Virginia Tech,Hokies,4-2,2-5,0,17,16,45,29,7,10,14,14,6,10,7,6,2,1,16,0.5465743855775579,[1.97679584]
2022,6,NCAAF_20221008_WISC@NWEST,Northwestern,Wildcats,Wisconsin,Badgers,1-5,3-4,0,0,28,7,42,0,0,0,7,7,21,0,14,-2,-28,-35,0.17197607415978278,[-15.98831017]
2022,6,NCAAF_20221008_MISS@VANDY,Vanderbilt,Commodores,Ole Miss,Rebels,3-3,6-0,0,20,17,28,52,3,17,0,8,3,14,21,14,-3,3,-24,0.17717069304011424,[-15.6473213]
2022,6,NCAAF_20221008_OHIOST@MICHST,Michigan St.,Spartans,Ohio State,Buckeyes,3-4,6-0,1,13,35,20,49,7,6,0,7,14,21,14,0,-3,-22,-29,0.07146232167716027,[-24.74960083]
2022,6,NCAAF_20221008_UNC@MIAMI,Miami (Fla.),Hurricanes,North Carolina,Tar Heels,2-3,5-1,1,17,21,24,27,0,17,0,7,7,14,3,3,-3,-4,-3,0.608077584219831,[4.63425038]
2022,6,NCAAF_20221008_WASH@ARIZST,Arizona St.,Sun Devils,Washington,Huskies,2-4,5-2,0,24,17,45,38,3,21,14,7,7,10,14,7,-3,7,7,0.32610727813713325,[-7.61395755]
2022,6,NCAAF_20221008_WKY@TXSA,UTSA,Roadrunners,W. Kentucky,Hilltoppers,4-2,3-3,1,17,14,31,28,7,10,7,7,7,7,0,14,1,3,3,0.39001562126211997,[-4.71815111]
2022,6,NCAAF_20221008_AF@UTAHST,Utah St.,Aggies,Air Force,Falcons,2-4,4-2,0,13,14,34,27,10,3,7,14,7,7,3,10,-2,-1,7,0.40167448196619127,[-4.20688475]
2022,6,NCAAF_20221008_APLST@TXSTSM,Texas St.,Bobcats,App. St.,Mountaineers,3-4,3-3,1,24,3,36,24,7,17,9,3,0,3,7,14,0,21,12,0.06012296464403,[-26.24904914]
2022,6,NCAAF_20221008_JMAD@ARKST,Arkansas St.,Red Wolves,James Madison,Dukes,2-4,5-0,0,3,14,20,42,0,3,10,7,0,14,7,21,-3,-11,-22,0.10758726288281706,[-20.93957052]
2022,6,NCAAF_20221008_UCONN@FIU,FIU,Panthers,UConn,Huskies,2-3,3-4,1,0,20,12,33,0,0,10,2,7,13,6,7,-1,-20,-21,0.6835145354174205,[8.06775973]
2022,6,NCAAF_20221008_USM@TROY,Troy,Trojans,So. Miss,Golden Eagles,4-2,2-3,0,10,7,27,10,3,7,7,10,0,7,3,0,2,3,17,0.5993317644733799,[4.25085259]
2022,6,NCAAF_20221008_UTEP@LATECH,Louisiana Tech,Bulldogs,UTEP,Miners,2-4,3-4,1,30,10,41,31,20,10,0,11,3,7,0,21,-1,20,10,0.7775749178195288,[12.90756354]
2022,6,NCAAF_20221008_WYO@NMEX,New Mexico,Lobos,Wyoming,Cowboys,2-5,4-3,1,14,7,14,27,14,0,0,0,0,7,10,10,-2,7,-13,0.22867741678175602,[-12.55584348]
2022,6,NCAAF_20221008_ARMY@WAKE,Wake Forest,Demon Deacons,Army,Black Knights,5-1,2-4,0,21,0,45,10,14,7,17,7,0,0,0,10,3,21,35,0.655136456877756,[6.74454801]
2022,6,NCAAF_20221008_BYU@ND,Notre Dame,Fighting Irish,BYU,Cougars,3-2,4-2,0,18,6,28,20,3,15,7,3,6,0,7,7,-1,12,8,0.8324343452833964,[16.28301905]
2022,6,NCAAF_20221008_CLEM@BC,Boston College,Eagles,Clemson,Tigers,2-4,7-0,0,3,10,3,31,0,3,0,0,3,7,7,14,-5,-7,-28,0.07414688814629944,[-24.42182448]
2022,6,NCAAF_20221008_IOWA@ILL,Illinois,Fighting Illini,Iowa,Hawkeyes,6-1,3-3,1,6,6,9,6,3,3,0,3,3,3,0,0,3,0,3,0.1229803739165296,[-19.60079059]
2022,6,NCAAF_20221008_KSTATE@IOWAST,Iowa St.,Cyclones,Kansas State,Wildcats,3-4,5-1,1,6,7,9,10,3,3,3,0,7,0,0,3,-2,-1,-1,0.6519384951856397,[6.59814133]
2022,6,NCAAF_20221008_SC@UK,Kentucky,Wildcats,South Carolina,Gamecocks,5-2,4-2,1,7,7,14,24,0,7,0,7,7,0,10,7,1,0,-10,0.6074851020738016,[4.60820397]
2022,6,NCAAF_20221008_WASHST@USC,USC,Trojans,Washington St.,Cougars,6-0,4-2,0,17,14,30,14,10,7,7,6,0,14,0,0,2,3,16,0.49747282024172523,[-0.10701967]
2022,6,NCAAF_20221008_CSTCAR@LAMON,UL-Monroe,Warhawks,C. Carolina,Chanticleers,2-4,6-0,0,14,28,21,28,7,7,7,0,14,14,0,0,-4,-14,-7,0.24326483692927547,[-11.75556147]
2022,6,NCAAF_20221008_TXAM@BAMA,Alabama,Crimson Tide,Texas A&M,Aggies,6-1,3-3,0,17,14,24,20,0,17,7,0,0,14,3,3,3,3,4,0.8957199684074884,[21.24489642]
2022,6,NCAAF_20221008_FSU@NCST,NC State,Wolfpack,Florida State,Seminoles,5-1,4-2,0,3,17,19,17,3,0,10,6,0,17,0,0,1,-14,2,0.6089412530657112,[4.67223833]
2022,6,NCAAF_20221008_OREG@ARIZ,Arizona,Wildcats,Oregon,Ducks,3-4,5-1,1,13,28,22,49,3,10,3,6,7,21,21,0,-2,-15,-27,0.16217388560687163,[-16.65017725]
2022,6,NCAAF_20221008_FRESNO@BOISE,Boise St.,Broncos,Fresno St.,Bulldogs,4-2,2-4,0,20,17,40,20,7,13,7,13,7,10,3,0,2,3,20,0.6188358170939903,[5.10918713]
2022,6,NCAAF_20221008_HAWAII@SDGST,San Diego St.,Aztecs,Hawaii,Rainbow Warriors,3-3,2-5,0,3,0,16,14,0,3,7,6,0,0,7,7,1,3,2,0.7798869692555235,[13.03904802]
2022,6,NCAAF_20221008_OREGST@STNFRD,Stanford,Cardinal,Oregon State,Beavers,1-4,4-2,0,17,7,27,28,7,10,7,3,0,7,3,18,-3,10,-1,0.6708155047631423,[7.46999135]
2022,6,NCAAF_20221007_NEB@RUT,Rutgers,Scarlet Knights,Nebraska,Cornhuskers,3-3,3-4,1,13,0,13,14,10,3,0,0,0,0,7,7,0,13,-1,0.24993702741214596,[-11.39823385]
2022,6,NCAAF_20221007_HOU@MEMP,Memphis,Tigers,Houston,Cougars,4-3,3-3,0,17,7,32,33,14,3,3,12,0,7,0,26,1,10,-1,0.5745517382855232,[3.17565933]
2022,6,NCAAF_20221007_COLOST@NEVADA,Nevada,Wolf Pack,Colorado St.,Rams,2-4,1-4,0,7,14,14,17,0,7,0,7,14,0,0,3,1,-7,-3,0.5514811150557625,[2.18616646]
2022,6,NCAAF_20221007_UNLV@SJST,San Jose St.,Spartans,UNLV,Rebels,4-1,4-2,0,23,0,40,7,7,16,10,7,0,0,7,0,0,23,33,0.5050828018765648,[0.21524818]
2022,6,NCAAF_20221005_SMU@UCF,UCF,Knights,SMU,Mustangs,4-1,2-3,0,10,13,41,19,3,7,14,17,7,6,0,6,2,-3,22,0.7132641401425461,[9.51045483]
2022,7,NCAAF_20221015_AUBURN@MISS,Ole Miss,Rebels,Auburn,Tigers,7-1,3-4,1,28,17,48,34,14,14,10,10,0,17,14,3,4,11,14,0.29438411304923007,[-9.13488561]
2022,7,NCAAF_20221015_CMICH@AKRON,Akron,Zips,C. Michigan,Chippewas,1-6,2-5,1,7,14,21,28,7,0,7,7,7,7,7,7,-1,-7,-7,0.16594338201799275,[-16.39550097]
2022,7,NCAAF_20221015_COLG@ARMY,Army,Black Knights,Colgate,Raiders,2-4,1-5,0,28,17,42,17,14,14,14,0,10,7,0,0,1,11,25,0.9636238124538445,[30.31964778]
2022,7,NCAAF_20221015_IOWAST@TEXAS,Texas,Longhorns,Iowa St.,Cyclones,5-3,3-4,0,14,7,24,21,0,14,3,7,7,0,7,7,2,7,3,0.5057976726398667,[0.24556609]
2022,7,NCAAF_20221015_KANSAS@OKLA,Oklahoma,Sooners,Kansas,Jayhawks,4-3,5-3,1,35,21,52,42,14,21,14,3,14,7,7,14,-1,14,10,0.9711735433388728,[32.07603622]
2022,7,NCAAF_20221015_MIAOH@BGREEN,Bowling Green,Falcons,Miami-OH,RedHawks,3-4,3-4,0,7,10,17,13,0,7,3,7,3,7,3,0,0,-3,4,0.15133060746669935,[-17.41646477]
2022,7,NCAAF_20221015_MINN@ILL,Illinois,Fighting Illini,Minnesota,Golden Gophers,6-1,4-3,1,13,7,26,14,7,6,7,6,0,7,7,0,2,6,12,0.2304927241246918,[-12.45688979]
2022,7,NCAAF_20221015_ODU@CSTCAR,C. Carolina,Chanticleers,Old Dominion,Monarchs,6-1,3-4,0,7,14,21,49,0,7,7,7,7,7,21,14,3,-7,-28,0.731447185584404,[10.4287535]
2022,7,NCAAF_20221015_PSU@MICH,Michigan,Wolverines,Penn State,Nittany Lions,7-0,6-1,1,16,14,41,17,6,10,15,10,0,14,3,0,1,2,24,0.5234385822764447,[0.99330092]
2022,7,NCAAF_20221015_MIAMI@VATECH,Virginia Tech,Hokies,Miami (Fla.),Hurricanes,2-5,3-4,1,0,17,14,20,0,0,0,14,10,7,3,0,-1,-17,-6,0.3943294571892527,[-4.52928172]
2022,7,NCAAF_20221015_BUFF@UMASS,UMass,Minutemen,Buffalo,Bulls,1-6,5-3,1,7,24,7,34,0,7,0,0,3,21,3,7,-4,-17,-27,0.07711218942707454,[-24.07429231]
2022,7,NCAAF_20221015_UCONN@BALLST,Ball St.,Cardinals,UConn,Huskies,4-4,3-5,1,10,21,25,21,7,3,3,12,7,14,0,0,1,-11,4,0.7210503557948907,[9.90104155]
2022,7,NCAAF_20221015_ARK@BYU,BYU,Cougars,Arkansas,Razorbacks,4-4,4-3,0,21,31,35,52,13,8,14,0,7,24,14,7,0,-10,-17,0.5982908445904583,[4.2060952]
2022,7,NCAAF_20221015_BAMA@TENN,Tennessee,Volunteers,Alabama,Crimson Tide,6-0,6-1,0,28,20,52,49,21,7,6,18,7,13,15,14,0,8,3,0.04858687677530693,[-28.02725632]
2022,7,NCAAF_20221015_CHARLO@UAB,UAB,Blazers,Charlotte,49ers,4-2,1-6,1,10,14,34,20,7,3,9,15,14,0,0,6,3,-4,14,0.8070357876255696,[14.65011397]
2022,7,NCAAF_20221015_GRDWB@LIB,Liberty,Flames,Gardner-Webb,Runnin' Bulldogs,6-1,2-5,0,14,10,21,20,7,7,0,7,0,10,7,3,4,4,1,0.9574062558374355,[29.08562844]
2022,7,NCAAF_20221015_KENTST@TOLEDO,Toledo,Rockets,Kent St.,Golden Flashes,5-2,2-5,0,28,31,52,31,7,21,10,14,21,10,0,0,3,-3,21,0.7804322150529373,[13.07242408]
2022,7,NCAAF_20221015_MD@IND,Indiana,Hoosiers,Maryland,Terrapins,3-4,5-2,1,17,14,33,38,3,14,3,13,7,7,10,14,-2,3,-5,0.6059752279175614,[4.54265997]
2022,7,NCAAF_20221015_NCST@CUSE,Syracuse,Orange,NC State,Wolfpack,6-1,5-2,1,10,3,24,9,7,3,7,7,3,0,3,3,1,7,15,0.3457059990040776,[-6.70708668]
2022,7,NCAAF_20221015_NILL@EMICH,E. Michigan,Eagles,N. Illinois,Huskies,4-3,2-5,0,7,20,10,39,7,0,3,0,14,6,9,10,2,-13,-29,0.5188597208637461,[0.79909156]
2022,7,NCAAF_20221015_OHIO@WMICH,W. Michigan,Broncos,Ohio,Bobcats,2-5,4-3,0,14,20,14,33,7,7,0,0,7,13,0,13,-2,-6,-19,0.46269629498635423,[-1.58228876]
2022,7,NCAAF_20221015_TXSTSM@TROY,Troy,Trojans,Texas St.,Bobcats,5-2,3-4,1,10,7,17,14,0,10,0,7,0,7,7,0,2,3,3,0.7858310424545552,[13.38307997]
2022,7,NCAAF_20221015_VANDY@UGA,Georgia,Bulldogs,Vanderbilt,Commodores,7-0,3-5,1,28,0,55,0,14,14,6,21,0,0,0,0,4,28,55,0.9821671507272411,[35.49582813]
2022,7,NCAAF_20221015_WKY@MTSU,Middle Tenn.,Blue Raiders,W. Kentucky,Hilltoppers,3-4,5-3,1,10,14,17,35,7,3,0,7,0,14,14,7,-2,-4,-18,0.444900277760957,[-2.34118992]
2022,7,NCAAF_20221015_JMAD@GAS,Ga. Southern,Eagles,James Madison,Dukes,4-3,5-1,1,14,17,45,38,0,14,17,14,7,10,7,14,-1,-3,7,0.07902816204381091,[-23.85245535]
2022,7,NCAAF_20221015_LATECH@NTEXAS,North Texas,Mean Green,Louisiana Tech,Bulldogs,4-3,2-4,0,27,17,47,27,14,13,7,13,3,14,10,0,2,10,20,0.49919783279717744,[-0.0339754]
2022,7,NCAAF_20221015_TULANE@SFLA,South Florida,Bulls,Tulane,Green Wave,1-6,7-1,1,14,17,31,45,7,7,10,7,3,14,14,14,-6,-3,-14,0.31926115926748055,[-7.93763134]
2022,7,NCAAF_20221015_ARIZ@WASH,Washington,Huskies,Arizona,Wildcats,6-2,3-4,0,21,14,49,39,7,14,21,7,7,7,10,15,3,7,10,0.8348878810644105,[16.45196756]
2022,7,NCAAF_20221015_RICE@FAU,FAU,Owls,Rice,Owls,3-4,3-3,1,7,14,17,14,0,7,3,7,14,0,0,0,0,-7,3,0.8426150271110233,[16.98593415]
2022,7,NCAAF_20221015_ARKST@USM,So. Miss,Golden Eagles,Arkansas St.,Red Wolves,3-3,2-5,0,7,10,20,19,0,7,0,13,7,3,9,0,1,-3,1,0.43436435058998824,[-2.79262589]
2022,7,NCAAF_20221015_LAMON@SALA,South Alabama,Jaguars,UL-Monroe,Warhawks,5-1,2-5,0,17,20,41,34,10,7,17,7,7,13,0,14,3,-3,7,0.5629520991236345,[2.6774665]
2022,7,NCAAF_20221015_LSU@FLA,Florida,Gators,LSU,Tigers,4-3,6-2,1,21,28,35,45,14,7,0,14,7,21,14,3,-2,-7,-10,0.4514292429372251,[-2.06229822]
2022,7,NCAAF_20221015_UTAHST@COLOST,Colorado St.,Rams,Utah St.,Aggies,1-5,3-4,0,10,7,13,17,3,7,0,3,7,0,10,0,-2,3,-4,0.3364350383786101,[-7.13411901]
2022,7,NCAAF_20221015_CLEM@FSU,Florida State,Seminoles,Clemson,Tigers,4-3,8-0,1,14,24,28,34,7,7,0,14,7,17,10,0,-4,-10,-6,0.07132503207118335,[-24.77088505]
2022,7,NCAAF_20221015_MISSST@UK,Kentucky,Wildcats,Miss. State,Bulldogs,5-2,5-3,0,3,3,27,17,0,3,10,14,0,3,7,7,0,0,10,0.4087840306195262,[-3.89769779]
2022,7,NCAAF_20221015_NEB@PURDUE,Purdue,Boilermakers,Nebraska,Cornhuskers,5-3,3-4,1,27,13,43,37,10,17,7,9,0,13,17,7,2,14,6,0.603812310948767,[4.44775075]
2022,7,NCAAF_20221015_STNFRD@ND,Notre Dame,Fighting Irish,Stanford,Cardinal,3-3,2-4,1,0,10,14,16,0,0,7,7,7,3,3,3,1,-10,-2,0.8232869761774841,[15.67980985]
2022,7,NCAAF_20221015_NMEX@NMEXST,New Mexico St.,Aggies,New Mexico,Lobos,2-5,2-5,0,7,6,21,9,7,0,14,0,3,3,0,3,0,1,12,0.4090827426486435,[-3.88470603]
2022,7,NCAAF_20221015_UNC@DUKE,Duke,Blue Devils,North Carolina,Tar Heels,5-3,6-1,0,21,17,35,38,7,14,0,14,10,7,14,7,-1,4,-3,0.30985344866655595,[-8.38540082]
2022,7,NCAAF_20221015_USC@UTAH,Utah,Utes,USC,Trojans,5-2,6-1,0,21,28,43,42,7,14,7,15,14,14,7,7,-1,-7,1,0.6380143966307337,[5.96728175]
2022,7,NCAAF_20221015_WASHST@OREGST,Oregon State,Beavers,Washington St.,Cougars,6-2,4-3,1,10,3,24,10,7,3,7,7,0,3,7,0,2,7,14,0.2325823298351719,[-12.34104171]
2022,7,NCAAF_20221015_AF@UNLV,UNLV,Rebels,Air Force,Falcons,4-3,5-2,1,7,28,7,42,0,7,0,0,14,14,14,0,-1,-21,-35,0.1534866770442176,[-17.26186002]
2022,7,NCAAF_20221015_SJST@FRESNO,Fresno St.,Bulldogs,San Jose St.,Spartans,2-4,4-2,1,7,10,17,10,0,7,7,3,0,10,0,0,-2,-3,7,0.8196914216400545,[15.44705977]
2022,7,NCAAF_20221015_NEVADA@HAWAII,Hawaii,,Nevada,,2-5,2-5,,21,13,31,16,14,7,0,10,7,6,3,0,0,8,15,0.3550284869333944,[-6.28195774]
2022,7,NCAAF_20221014_NAVY@SMU,SMU,Mustangs,Navy,Midshipmen,3-3,2-4,1,13,7,40,34,10,3,20,7,0,7,7,20,1,6,6,0.6080517841703249,[4.63391467]
2022,7,NCAAF_20221014_TXSA@FIU,FIU,Panthers,UTSA,Roadrunners,2-4,5-2,1,3,17,10,30,0,3,0,7,0,17,7,6,-3,-14,-20,0.3484873502362613,[-6.5798173]
2022,7,NCAAF_20221013_BAYLOR@WVU,West Virginia,Mountaineers,Baylor,Bears,3-3,3-3,0,17,24,43,40,7,10,14,12,3,21,7,9,0,-7,3,0.5189774597946373,[0.80408394]
2022,7,NCAAF_20221013_TEMPLE@UCF,UCF,Knights,Temple,Owls,5-1,2-4,0,35,13,70,13,14,21,21,14,10,3,0,0,3,22,57,0.8987455077833018,[21.53413716]
2022,7,NCAAF_20221012_UL@MRSHL,Marshall,Thundering Herd,Louisiana,Ragin' Cajuns,3-3,3-3,0,7,3,13,23,0,7,0,6,3,0,13,7,0,4,-10,0.5205119490285353,[0.8691562]
2022,8,NCAAF_20221022_AKRON@KENTST,Kent St.,Golden Flashes,Akron,Zips,3-5,1-7,1,21,17,33,27,0,21,9,3,7,10,7,3,2,4,6,0.6915795710183198,[8.45546748]
2022,8,NCAAF_20221022_CINCY@SMU,SMU,Mustangs,Cincinnati,Bearcats,3-4,6-1,1,14,20,27,29,0,14,0,13,10,10,9,0,-3,-6,-2,0.34243492835749123,[-6.85834778]
2022,8,NCAAF_20221022_CUSE@CLEM,Clemson,Tigers,Syracuse,Orange,8-0,6-1,0,10,21,27,21,7,3,0,17,7,14,0,0,2,-11,6,0.9401776731810609,[26.30042888]
2022,8,NCAAF_20221022_HOU@NAVY,Navy,Midshipmen,Houston,Cougars,2-5,4-3,0,7,21,20,38,0,7,7,6,14,7,10,7,-2,-14,-18,0.3947166644236021,[-4.51300403]
2022,8,NCAAF_20221022_IND@RUT,Rutgers,Scarlet Knights,Indiana,Hoosiers,4-3,3-5,1,7,14,24,17,0,7,10,7,14,0,0,3,1,-7,7,0.27113888341483317,[-10.2982018]
2022,8,NCAAF_20221022_IOWA@OHIOST,Ohio State,Buckeyes,Iowa,Hawkeyes,7-0,3-4,0,26,10,54,10,16,10,14,14,7,3,0,0,4,16,44,0.8167269325350937,[15.25977662]
2022,8,NCAAF_20221022_KANSAS@BAYLOR,Baylor,Bears,Kansas,Jayhawks,4-3,5-3,0,28,3,35,23,14,14,0,7,3,0,7,13,-1,25,12,0.8583598264556831,[18.13302089]
2022,8,NCAAF_20221022_LAMON@ARMY,Army,Black Knights,UL-Monroe,Warhawks,3-4,2-6,0,14,17,48,24,7,7,17,17,3,14,0,7,1,-3,24,0.8538885511356792,[17.79972989]
2022,8,NCAAF_20221022_TNMART@TENN,Tennessee,Volunteers,UT Martin,Skyhawks,7-0,4-3,0,52,7,65,24,21,31,6,7,7,0,7,10,3,45,41,0.9816579075344363,[35.307875]
2022,8,NCAAF_20221022_DUKE@MIAMI,Miami (Fla.),Hurricanes,Duke,Blue Devils,3-4,5-3,0,7,17,21,45,7,0,14,0,0,17,7,21,-2,-10,-24,0.7738766867904294,[12.70307257]
2022,8,NCAAF_20221022_BGREEN@CMICH,C. Michigan,Chippewas,Bowling Green,Falcons,2-6,4-4,0,3,17,18,34,3,0,7,8,7,10,0,17,-2,-14,-16,0.8368485184564932,[16.58853054]
2022,8,NCAAF_20221022_TOLEDO@BUFF,Buffalo,Bulls,Toledo,Rockets,5-3,5-3,0,7,20,34,27,0,7,3,24,7,13,7,0,0,-13,7,0.4537150121870429,[-1.96510912]
2022,8,NCAAF_20221022_EMICH@BALLST,Ball St.,Cardinals,E. Michigan,Eagles,4-4,5-3,0,7,10,16,20,0,7,9,0,0,10,0,10,-1,-3,-4,0.3632197081132599,[-5.91262392]
2022,8,NCAAF_20221022_NILL@OHIO,Ohio,Bobcats,N. Illinois,Huskies,5-3,2-6,1,10,6,24,17,7,3,7,7,0,6,11,0,3,4,7,0.5796080631764552,[3.39499437]
2022,8,NCAAF_20221022_UNLV@ND,Notre Dame,Fighting Irish,UNLV,Rebels,4-3,4-4,1,30,7,44,21,23,7,0,14,7,0,7,7,0,23,23,0.981675332323276,[35.31442381]
2022,8,NCAAF_20221022_WVU@TXTECH,Texas Tech,Red Raiders,West Virginia,Mountaineers,4-3,3-4,1,17,3,48,10,14,3,14,17,3,0,7,0,1,14,38,0.40849864677921666,[-3.91073585]
2022,8,NCAAF_20221022_BC@WAKE,Wake Forest,Demon Deacons,Boston College,Eagles,6-1,2-5,0,21,9,43,15,7,14,15,7,3,6,6,0,4,12,28,0.5862516036356383,[3.68266468]
2022,8,NCAAF_20221022_BYU@LIB,Liberty,Flames,BYU,Cougars,7-1,4-4,0,20,14,41,14,3,17,14,7,14,0,0,0,3,6,27,0.27648895803936613,[-10.02664945]
2022,8,NCAAF_20221022_FIU@CHARLO,Charlotte,49ers,FIU,Panthers,1-7,3-4,1,0,27,15,34,0,0,0,15,14,13,7,0,-2,-27,-19,0.4740845346833855,[-1.09858458]
2022,8,NCAAF_20221022_GAS@ODU,Old Dominion,Monarchs,Ga. Southern,Eagles,3-4,5-3,0,3,14,23,28,3,0,13,7,7,7,7,7,-2,-11,-5,0.36497357261337005,[-5.83370309]
2022,8,NCAAF_20221022_MEMP@TULANE,Tulane,Green Wave,Memphis,Tigers,7-1,4-4,1,35,0,38,28,21,14,0,3,0,0,14,14,3,35,10,0.3647600038471086,[-5.84330648]
2022,8,NCAAF_20221022_MISS@LSU,LSU,Tigers,Ole Miss,Rebels,6-2,7-1,0,17,20,45,20,3,14,7,21,14,6,0,0,-1,-3,25,0.675604832486683,[7.69685145]
2022,8,NCAAF_20221022_MRSHL@JMAD,James Madison,Dukes,Marshall,Thundering Herd,5-2,4-3,0,12,9,12,26,12,0,0,0,2,7,10,7,1,3,-14,0.7259521851733013,[10.15022867]
2022,8,NCAAF_20221022_NTEXAS@TXSA,UTSA,Roadrunners,North Texas,Mean Green,6-2,4-4,1,3,6,31,27,0,3,7,21,6,0,7,14,2,-3,4,0.47895319503896105,[-0.89198281]
2022,8,NCAAF_20221022_NWEST@MD,Maryland,Terrapins,Northwestern,Wildcats,6-2,1-6,1,10,17,31,24,0,10,14,7,7,10,0,7,5,-7,7,0.43051956677842584,[-2.958317]
2022,8,NCAAF_20221022_PURDUE@WISC,Wisconsin,Badgers,Purdue,Boilermakers,4-4,5-3,1,21,3,35,24,21,0,14,0,0,3,7,14,-1,18,11,0.7257200209391212,[10.13845242]
2022,8,NCAAF_20221022_TEXAS@OKLAST,Oklahoma State,Cowboys,Texas,Longhorns,6-1,5-3,0,24,31,41,34,10,14,3,14,14,17,3,0,1,-7,7,0.48582248718093535,[-0.60070354]
2022,8,NCAAF_20221022_UCLA@OREG,Oregon,Ducks,UCLA,Bruins,6-1,6-1,1,31,13,45,30,3,28,7,7,3,10,3,14,0,18,15,0.7046127468026598,[9.08720066]
2022,8,NCAAF_20221022_WMICH@MIAOH,Miami-OH,RedHawks,W. Michigan,Broncos,3-5,3-5,0,3,6,10,16,3,0,0,7,0,6,10,0,0,-3,-6,0.4694461077813983,[-1.29556879]
2022,8,NCAAF_20221022_ARIZST@STNFRD,Stanford,Cardinal,Arizona St.,Sun Devils,3-4,2-5,0,6,14,15,14,6,0,3,6,7,7,0,0,1,-8,1,0.4565141609500981,[-1.84577735]
2022,8,NCAAF_20221022_FAU@UTEP,UTEP,Miners,FAU,Owls,4-4,3-5,1,6,7,24,21,0,6,8,10,0,7,7,7,1,-1,3,0.11473498106853586,[-20.30878698]
2022,8,NCAAF_20221022_HAWAII@COLOST,Colorado St.,Rams,Hawaii,Rainbow Warriors,2-5,2-6,0,3,13,17,13,0,3,7,7,3,10,0,0,0,-10,4,0.5939231996616732,[4.01618907]
2022,8,NCAAF_20221022_VANDY@MIZZOU,Missouri,Tigers,Vanderbilt,Commodores,3-4,3-5,1,17,0,17,14,7,10,0,0,0,0,7,7,0,17,3,0.8186351451502452,[15.38169293]
2022,8,NCAAF_20221022_ARKST@UL,Louisiana,Ragin' Cajuns,Arkansas St.,Red Wolves,4-3,2-6,0,24,9,38,18,10,14,14,0,0,9,3,6,2,15,20,0.649625174333332,[6.49469854]
2022,8,NCAAF_20221022_USM@TXSTSM,Texas St.,Bobcats,So. Miss,Golden Eagles,3-5,4-3,1,7,13,14,20,0,7,0,7,3,10,0,7,-1,-6,-6,0.3018154612439692,[-8.77408591]
2022,8,NCAAF_20221022_FRESNO@NMEX,New Mexico,Lobos,Fresno St.,Bulldogs,2-6,3-4,0,6,13,9,41,3,3,3,0,10,3,14,14,-1,-7,-32,0.12614152809220824,[-19.34713183]
2022,8,NCAAF_20221022_BOISE@AF,Air Force,Falcons,Boise St.,Broncos,5-3,5-2,0,7,19,14,19,0,7,0,7,10,9,0,0,0,-12,-5,0.38999133014424714,[-4.72078729]
2022,8,NCAAF_20221022_MISSST@BAMA,Alabama,Crimson Tide,Miss. State,Bulldogs,7-1,5-3,0,24,0,30,6,7,17,0,6,0,0,0,6,2,24,24,0.8950002986701064,[21.18489648]
2022,8,NCAAF_20221022_MINN@PSU,Penn State,Nittany Lions,Minnesota,Golden Gophers,6-1,4-3,1,17,10,45,17,0,17,21,7,3,7,0,7,2,7,28,0.7572544763538206,[11.78750463]
2022,8,NCAAF_20221022_TXAM@SC,South Carolina,Gamecocks,Texas A&M,Aggies,5-2,3-4,0,17,14,30,24,17,0,7,6,3,11,7,3,2,3,6,0.30507503488583565,[-8.61646391]
2022,8,NCAAF_20221022_UCF@ECU,East Carolina,Pirates,UCF,Knights,5-3,5-2,1,17,3,34,13,3,14,7,10,0,3,7,3,0,14,21,0.08340815313225525,[-23.36392897]
2022,8,NCAAF_20221022_COLO@OREGST,Oregon State,Beavers,Colorado,Buffaloes,6-2,1-6,0,21,3,42,9,7,14,14,7,0,3,6,0,5,18,33,0.5171595900661333,[0.72712586]
2022,8,NCAAF_20221022_KSTATE@TCU,TCU,Horned Frogs,Kansas State,Wildcats,7-0,5-2,0,17,28,38,28,10,7,14,7,7,21,0,0,2,-11,10,0.5387282710871787,[1.64316307]
2022,8,NCAAF_20221022_PITT@LVILLE,Louisville,Cardinals,Pittsburgh,Panthers,4-3,4-3,1,7,7,24,10,0,7,0,17,7,0,3,0,0,0,14,0.4112322983075041,[-3.79188829]
2022,8,NCAAF_20221022_UTAHST@WYO,Wyoming,Cowboys,Utah St.,Aggies,5-3,3-5,1,17,7,28,14,7,10,3,8,0,7,7,0,2,10,14,0.4251889643929674,[-3.18789416]
2022,8,NCAAF_20221022_SDGST@NEVADA,Nevada,Wolf Pack,San Diego St.,Aztecs,2-6,4-3,1,7,13,7,23,0,7,0,0,10,3,10,0,-2,-6,-16,0.34498298313736075,[-6.74130796]
2022,8,NCAAF_20221022_WASH@CAL,California,Golden Bears,Washington,Huskies,3-4,6-2,0,0,6,21,28,0,0,14,7,6,0,8,14,-3,-6,-7,0.2778852109907871,[-9.95620695]
2022,8,NCAAF_20221021_TULSA@TEMPLE,Temple,Owls,Tulsa,Golden Hurricane,2-5,3-4,1,10,14,16,27,10,0,0,6,0,14,0,13,-1,-4,-11,0.36853349636402566,[-5.6739011]
2022,8,NCAAF_20221021_UAB@WKY,W. Kentucky,Hilltoppers,UAB,Blazers,5-3,4-3,1,10,17,20,17,0,10,10,0,7,10,0,0,1,-7,3,0.4515917610640968,[-2.05569147]
2022,8,NCAAF_20221020_TROY@SALA,South Alabama,Jaguars,Troy,Trojans,5-2,6-2,1,3,7,6,10,0,3,0,3,0,7,0,3,-1,-4,-4,0.294728276018801,[-9.11947427]
2022,8,NCAAF_20221020_UVA@GATECH,Georgia Tech,Yellow Jackets,Virginia,Cavaliers,3-4,3-4,1,9,13,9,16,6,3,0,0,7,6,3,0,0,-4,-7,0.38976455029047574,[-4.73077701]
2022,8,NCAAF_20221019_GAST@APLST,App. St.,Mountaineers,Georgia St.,Panthers,4-3,2-5,1,7,14,42,17,0,7,21,14,14,0,0,3,2,-7,25,0.8506710831163746,[17.56411801]
2022,9,NCAAF_20221029_ARK@AUBURN,Auburn,Tigers,Arkansas,Razorbacks,3-5,5-3,0,13,17,27,41,3,10,0,14,7,10,14,10,-2,-4,-14,0.8473059945188675,[17.32114497]
2022,9,NCAAF_20221029_BC@UCONN,UConn,Huskies,Boston College,Eagles,4-5,2-6,1,10,3,13,3,10,0,0,3,0,3,0,0,2,7,10,0.05328890892149474,[-27.27194088]
2022,9,NCAAF_20221029_GATECH@FSU,Florida State,Seminoles,Georgia Tech,Yellow Jackets,5-3,3-5,0,24,3,41,16,7,17,7,10,3,0,7,6,2,21,25,0.620516213372794,[5.18540293]
2022,9,NCAAF_20221029_MIAOH@AKRON,Akron,Zips,Miami-OH,RedHawks,1-8,4-5,0,3,17,9,27,0,3,0,6,7,10,0,10,-3,-14,-18,0.17192583126375094,[-15.99681067]
2022,9,NCAAF_20221029_ND@CUSE,Syracuse,Orange,Notre Dame,Fighting Irish,6-2,5-3,1,7,21,24,41,7,0,10,7,7,14,3,17,1,-14,-17,0.1387457726369692,[-18.35242679]
2022,9,NCAAF_20221029_OHIOST@PSU,Penn State,Nittany Lions,Ohio State,Buckeyes,6-2,8-0,0,14,13,31,44,0,14,0,17,10,3,3,28,-2,1,-13,0.26823468385989957,[-10.44663596]
2022,9,NCAAF_20221029_OKLA@IOWAST,Iowa St.,Cyclones,Oklahoma,Sooners,3-5,5-3,0,6,13,13,27,3,3,0,7,3,10,7,7,-2,-7,-14,0.3632705185878575,[-5.91028476]
2022,9,NCAAF_20221029_SFLA@HOU,Houston,Cougars,South Florida,Bulls,5-3,1-7,0,28,14,42,27,14,14,7,7,14,0,7,6,4,14,15,0.7454797776650399,[11.15931993]
2022,9,NCAAF_20221029_TCU@WVU,West Virginia,Mountaineers,TCU,Horned Frogs,3-5,8-0,0,21,28,31,41,7,14,3,7,7,21,0,13,-5,-7,-10,0.4340888946845307,[-2.80487703]
2022,9,NCAAF_20221029_TOLEDO@EMICH,E. Michigan,Eagles,Toledo,Rockets,5-4,6-3,1,17,10,24,27,7,10,7,0,0,10,7,10,-1,7,-3,0.37049778772327036,[-5.58589516]
2022,9,NCAAF_20221029_CHARLO@RICE,Rice,Owls,Charlotte,49ers,4-4,2-7,1,17,28,23,56,14,3,0,6,7,21,21,7,2,-11,-33,0.499459154887262,[-0.02291068]
2022,9,NCAAF_20221029_RUT@MINN,Minnesota,Golden Gophers,Rutgers,Scarlet Knights,5-3,4-4,0,14,0,31,0,0,14,0,17,0,0,0,0,1,14,31,0.8251015847882486,[15.80079518]
2022,9,NCAAF_20221029_ODU@GAST,Georgia St.,Panthers,Old Dominion,Monarchs,3-5,3-5,1,14,14,31,17,7,7,14,3,7,7,0,3,0,0,14,0.5934483364765872,[3.99546569]
2022,9,NCAAF_20221029_CINCY@UCF,UCF,Knights,Cincinnati,Bearcats,6-2,6-2,1,10,6,25,21,10,0,2,13,0,6,7,8,0,4,4,0.5685768655683551,[2.9194324]
2022,9,NCAAF_20221029_FLA@UGA,Georgia,Bulldogs,Florida,Gators,8-0,4-4,1,28,3,42,20,14,14,7,7,0,3,17,0,4,25,22,0.7988356724161115,[14.15285559]
2022,9,NCAAF_20221029_ILL@NEB,Nebraska,Cornhuskers,Illinois,Fighting Illini,3-5,7-1,0,9,20,9,26,3,6,0,0,6,14,3,3,-4,-11,-17,0.6434945416970538,[6.21591233]
2022,9,NCAAF_20221029_NMEXST@UMASS,UMass,Minutemen,New Mexico St.,Aggies,1-7,3-5,0,13,10,13,23,3,10,0,0,0,10,6,7,-2,3,-10,0.312093097060717,[-8.27952834]
2022,9,NCAAF_20221029_NTEXAS@WKY,W. Kentucky,Hilltoppers,North Texas,Mean Green,5-4,5-4,1,13,20,13,40,7,6,0,0,17,3,0,20,0,-7,-27,0.5850323467535162,[3.62976109]
2022,9,NCAAF_20221029_NWEST@IOWA,Iowa,Hawkeyes,Northwestern,Wildcats,4-4,1-7,1,20,0,33,13,10,10,3,10,0,0,7,6,3,20,20,0.794219742515696,[13.87707111]
2022,9,NCAAF_20221029_OKLAST@KSTATE,Kansas State,Wildcats,Oklahoma State,Cowboys,6-2,6-2,1,35,0,48,0,14,21,3,10,0,0,0,0,0,35,48,0.35465668281741136,[-6.29978582]
2022,9,NCAAF_20221029_OREG@CAL,California,Golden Bears,Oregon,Ducks,3-5,7-1,1,10,21,24,42,3,7,0,14,0,21,7,14,-4,-11,-18,0.2652754818563282,[-10.59880645]
2022,9,NCAAF_20221029_ROB@APLST,App. St.,Mountaineers,Robert Morris,Colonials,5-3,0-8,1,21,3,42,3,14,7,14,7,3,0,0,0,5,18,39,0.9945036316138555,[42.97435455]
2022,9,NCAAF_20221029_SMU@TULSA,Tulsa,Golden Hurricane,SMU,Mustangs,3-5,4-4,0,7,24,34,45,7,0,13,14,14,10,21,0,-1,-17,-11,0.34939286888504617,[-6.53944998]
2022,9,NCAAF_20221029_WAKE@LVILLE,Louisville,Cardinals,Wake Forest,Demon Deacons,5-3,6-2,1,13,14,48,21,6,7,35,0,0,14,0,7,-1,-1,27,0.4184078663003896,[-3.48076935]
2022,9,NCAAF_20221029_MIZZOU@SC,South Carolina,Gamecocks,Missouri,Tigers,5-3,4-4,0,7,17,10,23,0,7,3,0,7,10,3,3,1,-10,-13,0.4334403198257548,[-2.83273609]
2022,9,NCAAF_20221029_SALA@ARKST,Arkansas St.,Red Wolves,South Alabama,Jaguars,2-7,6-2,0,3,16,3,31,3,0,0,0,14,2,8,7,-4,-13,-28,0.6601211415583833,[6.97602703]
2022,9,NCAAF_20221029_COLOST@BOISE,Boise St.,Broncos,Colorado St.,Rams,6-2,2-6,0,28,10,49,10,14,14,21,0,3,7,0,0,4,18,39,0.8270547942016374,[15.92935057]
2022,9,NCAAF_20221029_CSTCAR@MRSHL,Marshall,Thundering Herd,C. Carolina,Chanticleers,4-4,7-1,0,10,21,13,24,0,10,3,0,21,0,0,3,-3,-11,-11,0.6498172011336676,[6.50340126]
2022,9,NCAAF_20221029_UAB@FAU,FAU,Owls,UAB,Blazers,4-5,4-4,0,10,14,24,17,10,0,14,0,0,14,3,0,0,-4,7,0.5310820633414617,[1.3179984]
2022,9,NCAAF_20221029_UK@TENN,Tennessee,Volunteers,Kentucky,Wildcats,8-0,5-3,1,27,6,44,6,7,20,10,7,6,0,0,0,3,21,38,0.4442888973174851,[-2.36769445]
2022,9,NCAAF_20221029_USC@ARIZ,Arizona,Wildcats,USC,Trojans,3-5,7-1,0,13,17,37,45,10,3,16,8,10,7,14,14,-4,-4,-8,0.22599074582024004,[-12.71041316]
2022,9,NCAAF_20221029_ARIZST@COLO,Colorado,Buffaloes,Arizona St.,Sun Devils,1-7,3-5,1,17,28,34,42,3,14,3,14,14,14,7,7,-2,-11,-8,0.27201433509193873,[-10.25349781]
2022,9,NCAAF_20221029_BAYLOR@TXTECH,Texas Tech,Red Raiders,Baylor,Bears,4-4,5-3,0,3,17,17,45,0,3,14,0,3,14,7,21,-1,-14,-28,0.44463181378849026,[-2.35302583]
2022,9,NCAAF_20221029_MICHST@MICH,Michigan,Wolverines,Michigan St.,Spartans,8-0,3-5,0,13,7,29,7,3,10,6,10,7,0,0,0,5,6,22,0.8331597246991909,[16.33724597]
2022,9,NCAAF_20221029_MISS@TXAM,Texas A&M,Aggies,Ole Miss,Rebels,3-5,8-1,0,14,10,28,31,14,0,0,14,7,3,14,7,-5,4,-3,0.6040313892202276,[4.45803018]
2022,9,NCAAF_20221029_PITT@UNC,North Carolina,Tar Heels,Pittsburgh,Panthers,7-1,4-4,0,14,17,42,24,7,7,7,21,7,10,7,0,3,-3,18,0.45131193411292947,[-2.06761599]
2022,9,NCAAF_20221029_MTSU@UTEP,UTEP,Miners,Middle Tenn.,Blue Raiders,4-5,4-4,0,10,10,13,24,0,10,0,3,10,0,7,7,0,0,-11,0.21399366135122533,[-13.3952636]
2022,9,NCAAF_20221029_NEVADA@SJST,San Jose St.,Spartans,Nevada,Wolf Pack,5-2,2-7,1,7,14,35,28,0,7,14,14,7,7,7,7,3,-7,7,0.3511139125634598,[-6.46094752]
2022,9,NCAAF_20221029_SDGST@FRESNO,Fresno St.,Bulldogs,San Diego St.,Aztecs,4-4,4-4,1,10,21,32,28,3,7,7,15,7,14,7,0,0,-11,4,0.5456498234577709,[1.93800605]
2022,9,NCAAF_20221029_STNFRD@UCLA,UCLA,Bruins,Stanford,Cardinal,7-1,3-5,0,24,6,38,13,14,10,7,7,3,3,0,7,4,18,25,0.503458506637269,[0.14650721]
2022,9,NCAAF_20221029_WYO@HAWAII,Hawaii,,Wyoming,,2-7,6-3,,10,10,20,27,7,3,3,7,0,10,3,14,-4,0,-7,0.3168629865631659,[-8.05244912]
2022,9,NCAAF_20221028_ECU@BYU,BYU,Cougars,East Carolina,Pirates,4-5,6-3,0,17,17,24,27,3,14,7,0,7,10,7,3,-2,0,-3,0.7846047329854176,[13.31413108]
2022,9,NCAAF_20221027_UL@USM,So. Miss,Golden Eagles,Louisiana,Ragin' Cajuns,5-3,4-4,1,29,11,39,24,20,9,0,10,5,6,6,7,1,18,15,0.2929156655447974,[-9.20834029]
2022,9,NCAAF_20221027_VATECH@NCST,NC State,Wolfpack,Virginia Tech,Hokies,6-2,2-6,1,3,0,22,21,0,3,7,12,0,0,21,0,4,3,1,0.5580324326169991,[2.46703935]
2022,9,NCAAF_20221027_UTAH@WASHST,Washington St.,Cougars,Utah,Utes,4-4,6-2,0,7,14,17,21,0,7,0,10,0,14,7,0,-2,-7,-4,0.346977228647918,[-6.64987422]
2022,10,NCAAF_20221105_AF@ARMY,Army,Black Knights,Air Force,Falcons,3-5,6-3,0,7,3,7,13,0,7,0,0,3,0,7,3,-3,4,-6,0.4226238126481824,[-3.30315508]
2022,10,NCAAF_20221105_FLA@TXAM,Texas A&M,Aggies,Florida,Gators,3-6,5-4,0,24,20,24,41,14,10,0,0,17,3,14,7,-2,4,-17,0.46818399580965164,[-1.35106995]
2022,10,NCAAF_20221105_IOWA@PURDUE,Purdue,Boilermakers,Iowa,Hawkeyes,5-4,5-4,1,3,17,3,24,0,3,0,0,0,17,7,0,0,-14,-21,0.33021804922787346,[-7.43452691]
2022,10,NCAAF_20221105_MD@WISC,Wisconsin,Badgers,Maryland,Terrapins,5-4,6-3,0,17,0,23,10,7,10,3,3,0,0,3,7,-1,17,13,0.8731076609437942,[19.31277724]
2022,10,NCAAF_20221105_MINN@NEB,Nebraska,Cornhuskers,Minnesota,Golden Gophers,3-6,6-3,1,10,0,13,20,10,0,0,3,0,0,10,10,-3,10,-7,0.36522156939868655,[-5.8306352]
2022,10,NCAAF_20221105_OHIOST@NWEST,Northwestern,Wildcats,Ohio State,Buckeyes,1-8,9-0,0,7,7,7,21,7,0,0,0,0,7,7,7,-8,0,-14,0.037215600345844146,[-30.19010864]
2022,10,NCAAF_20221105_TULANE@TULSA,Tulsa,Golden Hurricane,Tulane,Green Wave,3-6,8-1,0,10,17,13,27,3,7,3,0,10,7,7,3,-5,-7,-14,0.40759038088833055,[-3.95574859]
2022,10,NCAAF_20221105_TXTECH@TCU,TCU,Horned Frogs,Texas Tech,Red Raiders,9-0,4-5,0,13,10,34,24,7,6,0,21,10,0,7,7,5,3,10,0.6360482640395075,[5.88782887]
2022,10,NCAAF_20221105_UK@MIZZOU,Missouri,Tigers,Kentucky,Wildcats,4-5,6-3,1,3,7,17,21,3,0,0,14,7,0,7,7,-2,-4,-4,0.48648377865628956,[-0.57346835]
2022,10,NCAAF_20221105_UNC@UVA,Virginia,Cavaliers,North Carolina,Tar Heels,3-6,8-1,1,14,10,28,31,7,7,7,7,3,7,14,7,-5,4,-3,0.44546520222887565,[-2.32062046]
2022,10,NCAAF_20221105_WKY@CHARLO,Charlotte,49ers,W. Kentucky,Hilltoppers,2-8,6-4,0,0,35,7,59,0,0,7,0,21,14,7,17,-4,-35,-52,0.24162985918331814,[-11.86429984]
2022,10,NCAAF_20221105_GATECH@VATECH,Virginia Tech,Hokies,Georgia Tech,Yellow Jackets,2-7,4-5,0,20,13,27,28,0,20,7,0,10,3,3,12,-2,7,-1,0.6615501039426525,[7.05183033]
2022,10,NCAAF_20221105_MRSHL@ODU,Old Dominion,Monarchs,Marshall,Thundering Herd,3-6,5-4,1,0,6,0,12,0,0,0,0,0,6,3,3,-2,-6,-12,0.1815182828761257,[-15.3931957]
2022,10,NCAAF_20221105_SFLA@TEMPLE,Temple,Owls,South Florida,Bulls,3-6,1-8,0,16,14,54,28,3,13,17,21,7,7,14,0,2,2,26,0.47258558026250796,[-1.16383748]
2022,10,NCAAF_20221105_BAYLOR@OKLA,Oklahoma,Sooners,Baylor,Bears,5-4,6-3,1,21,24,35,38,14,7,7,7,14,10,7,7,-1,-3,-3,0.7827162848907292,[13.22374212]
2022,10,NCAAF_20221105_GAST@USM,So. Miss,Golden Eagles,Georgia St.,Panthers,5-4,4-5,0,0,28,14,42,0,0,14,0,14,14,7,7,1,-28,-28,0.5396126141944617,[1.68313937]
2022,10,NCAAF_20221105_MTSU@LATECH,Louisiana Tech,Bulldogs,Middle Tenn.,Blue Raiders,3-6,4-5,1,27,21,40,24,14,13,13,0,7,14,0,3,-1,6,16,0.47520272647507766,[-1.05257954]
2022,10,NCAAF_20221105_CUSE@PITT,Pittsburgh,Panthers,Syracuse,Orange,5-4,6-3,0,10,6,19,9,0,10,7,2,3,3,0,3,-1,4,10,0.6194729789499036,[5.14627698]
2022,10,NCAAF_20221105_MICHST@ILL,Illinois,Fighting Illini,Michigan St.,Spartans,7-2,4-5,0,7,9,15,23,7,0,0,8,3,6,14,0,3,-2,-8,0.3086738573652188,[-8.45502131]
2022,10,NCAAF_20221105_NMEX@UTAHST,Utah St.,Aggies,New Mexico,Lobos,4-5,2-7,0,7,10,27,10,7,0,10,10,3,7,0,0,2,-3,17,0.8274994859303397,[15.98103536]
2022,10,NCAAF_20221105_OKLAST@KANSAS,Kansas,Jayhawks,Oklahoma State,Cowboys,6-3,6-3,0,24,7,37,16,10,14,7,6,0,7,3,6,0,17,21,0.07328156026913224,[-24.56866536]
2022,10,NCAAF_20221105_OREG@COLO,Colorado,Buffaloes,Oregon,Ducks,1-8,8-1,0,7,28,10,49,0,7,3,0,14,14,14,7,-7,-21,-39,0.14302631563253387,[-18.0539697]
2022,10,NCAAF_20221105_PSU@IND,Indiana,Hoosiers,Penn State,Nittany Lions,3-6,7-2,0,7,24,14,45,7,0,0,7,7,17,7,14,-4,-17,-31,0.13914005809144991,[-18.34792335]
2022,10,NCAAF_20221105_TENN@UGA,Georgia,Bulldogs,Tennessee,Volunteers,9-0,8-1,1,24,6,27,13,14,10,3,0,3,3,0,7,1,18,14,0.8949299827992724,[21.20775679]
2022,10,NCAAF_20221105_UCF@MEMP,Memphis,Tigers,UCF,Knights,4-5,7-2,0,14,21,28,35,7,7,7,7,7,14,0,14,-3,-7,-7,0.3370379131696126,[-7.11721197]
2022,10,NCAAF_20221105_WASHST@STNFRD,Stanford,Cardinal,Washington St.,Cougars,3-6,5-4,0,7,42,14,52,7,0,7,0,21,21,3,7,-2,-35,-38,0.3887115902154826,[-4.78381229]
2022,10,NCAAF_20221105_WVU@IOWAST,Iowa St.,Cyclones,West Virginia,Mountaineers,4-5,3-6,0,10,7,31,14,3,7,0,21,0,7,0,7,1,3,17,0.6683057260536213,[7.36562291]
2022,10,NCAAF_20221105_FIU@NTEXAS,North Texas,Mean Green,FIU,Panthers,6-4,4-5,1,45,14,52,14,24,21,0,7,0,14,0,0,2,31,38,0.6840942845591771,[8.10921314]
2022,10,NCAAF_20221105_LIB@ARK,Arkansas,Razorbacks,Liberty,Flames,5-4,8-1,1,3,21,19,21,0,3,2,14,7,14,0,0,-3,-18,-2,0.643999184880835,[6.24750405]
2022,10,NCAAF_20221105_NAVY@CINCY,Cincinnati,Bearcats,Navy,Midshipmen,7-2,3-6,1,13,3,20,10,6,7,7,0,0,3,7,0,4,10,10,0.756489798444463,[11.76252926]
2022,10,NCAAF_20221105_SALA@GAS,Ga. Southern,Eagles,South Alabama,Jaguars,5-4,7-2,0,24,17,31,38,21,3,7,0,7,10,7,14,-2,7,-7,0.6015463440123039,[4.35519994]
2022,10,NCAAF_20221105_TROY@UL,Louisiana,Ragin' Cajuns,Troy,Trojans,4-5,7-2,0,10,0,17,23,0,10,7,0,0,0,7,16,-3,10,-6,0.6053100066936365,[4.52044018]
2022,10,NCAAF_20221105_TXSTSM@LAMON,UL-Monroe,Warhawks,Texas St.,Bobcats,3-6,3-6,0,17,24,31,30,0,17,7,7,21,3,3,3,0,-7,1,0.5263180629173013,[1.11722422]
2022,10,NCAAF_20221105_BYU@BOISE,Boise St.,Broncos,BYU,Cougars,,5-5,0,7,7,28,31,7,0,7,14,7,0,10,14,,0,-3,0.6052281363377658,[4.5168412]
2022,10,NCAAF_20221105_HOU@SMU,SMU,Mustangs,Houston,Cougars,5-4,5-4,1,56,35,77,63,21,35,7,14,14,21,14,14,0,21,14,0.5029180471769423,[0.12378477]
2022,10,NCAAF_20221105_TEXAS@KSTATE,Kansas State,Wildcats,Texas,Longhorns,6-3,6-3,0,10,31,27,34,7,3,7,10,14,17,0,3,0,-21,-7,0.36477440789236093,[-5.85076786]
2022,10,NCAAF_20221105_UNLV@SDGST,San Diego St.,Aztecs,UNLV,Rebels,5-4,4-5,0,7,0,14,10,0,7,7,0,0,0,7,3,1,7,4,0.8101957612813333,[14.86897976]
2022,10,NCAAF_20221105_ARIZ@UTAH,Utah,Utes,Arizona,Wildcats,7-2,3-6,0,28,10,45,20,14,14,3,14,7,3,0,10,4,18,25,0.8607579502337075,[18.34013801]
2022,10,NCAAF_20221105_CLEM@ND,Notre Dame,Fighting Irish,Clemson,Tigers,6-3,8-1,1,14,0,35,14,7,7,0,21,0,0,0,14,-2,14,21,0.3334506373107473,[-7.28380186]
2022,10,NCAAF_20221105_FSU@MIAMI,Miami (Fla.),Hurricanes,Florida State,Seminoles,4-5,6-3,0,3,31,3,45,3,0,0,0,14,17,0,14,-2,-28,-42,0.6249378725308358,[5.38960803]
2022,10,NCAAF_20221105_JMAD@LVILLE,Louisville,Cardinals,James Madison,Dukes,6-3,5-3,0,10,10,34,10,7,3,10,14,3,7,0,0,1,0,24,0.4562085269356515,[-1.86138226]
2022,10,NCAAF_20221105_MICH@RUT,Rutgers,Scarlet Knights,Michigan,Wolverines,4-5,9-0,0,17,14,17,52,7,10,0,0,14,0,28,10,-5,3,-35,0.03825540057072341,[-29.97597213]
2022,10,NCAAF_20221105_SC@VANDY,Vanderbilt,Commodores,South Carolina,Gamecocks,3-6,6-3,1,14,31,27,38,7,7,7,6,17,14,7,0,-3,-17,-11,0.23897221908880262,[-12.00887707]
2022,10,NCAAF_20221105_WAKE@NCST,NC State,Wolfpack,Wake Forest,Demon Deacons,7-2,6-3,1,17,14,30,21,3,14,10,3,0,14,0,7,1,3,9,0.5119659493081223,[0.50767215]
2022,10,NCAAF_20221105_CAL@USC,USC,Trojans,California,Golden Bears,8-1,3-6,1,20,7,41,35,6,14,14,7,7,0,7,21,5,13,6,0.6464457179397998,[6.35874026]
2022,10,NCAAF_20221105_COLOST@SJST,San Jose St.,Spartans,Colorado St.,Rams,6-2,2-7,0,7,10,28,16,0,7,7,14,7,3,0,6,4,-3,12,0.3980770934074327,[-4.37171364]
2022,10,NCAAF_20221105_HAWAII@FRESNO,Fresno St.,Bulldogs,Hawaii,Rainbow Warriors,5-4,2-8,0,31,0,55,13,17,14,10,14,0,0,0,13,3,31,42,0.8036515339965915,[14.46483431]
2022,10,NCAAF_20221105_UCLA@ARIZST,Arizona St.,Sun Devils,UCLA,Bruins,3-6,8-1,0,10,28,36,50,10,0,15,11,14,14,14,8,-5,-18,-14,0.5269706129494267,[1.14496732]
2022,10,NCAAF_20221104_DUKE@BC,Boston College,Eagles,Duke,Blue Devils,2-7,6-3,0,14,24,31,38,7,7,7,10,10,14,7,7,-4,-10,-7,0.6153920913174268,[4.96526466]
2022,10,NCAAF_20221104_UMASS@UCONN,UConn,Huskies,UMass,Minutemen,5-5,1-8,0,13,10,27,10,7,6,7,7,3,7,0,0,4,3,17,0.6296303735270139,[5.59943835]
2022,10,NCAAF_20221104_OREGST@WASH,Washington,Huskies,Oregon State,Beavers,7-2,6-3,0,7,14,24,21,0,7,7,10,7,7,7,0,1,-7,3,0.8180300478348137,[15.36424139]
2022,10,NCAAF_20221103_UTEP@RICE,Rice,Owls,UTEP,Miners,5-5,4-6,0,20,17,37,30,10,10,7,10,7,10,3,10,1,3,7,0.5657591913613329,[2.80226083]
2022,10,NCAAF_20221103_APLST@CSTCAR,C. Carolina,Chanticleers,App. St.,Mountaineers,8-1,5-4,0,21,14,35,28,14,7,0,14,7,7,0,14,3,7,7,0.2301883776545528,[-12.49311709]
2022,10,NCAAF_20221102_CMICH@NILL,N. Illinois,Huskies,C. Michigan,Chippewas,2-7,3-6,1,0,21,22,35,0,0,7,15,14,7,7,7,-1,-21,-13,0.5140546648375842,[0.59632279]
2022,10,NCAAF_20221102_WMICH@BGREEN,Bowling Green,Falcons,W. Michigan,Broncos,5-4,3-6,0,6,0,13,9,0,6,7,0,0,0,6,3,2,6,4,0.15202636529231428,[-17.39329296]
2022,10,NCAAF_20221101_BALLST@KENTST,Kent St.,Golden Flashes,Ball St.,Cardinals,3-6,5-4,1,13,17,20,27,13,0,0,7,0,17,3,7,-2,-4,-7,0.4601684655762118,[-1.69247227]
2022,10,NCAAF_20221101_BUFF@OHIO,Ohio,Bobcats,Buffalo,Bulls,6-3,5-4,0,24,10,45,24,17,7,7,14,0,10,14,0,1,14,21,0.4940813915940343,[-0.2510768]
2022,11,NCAAF_20221112_IND@OHIOST,Ohio State,Buckeyes,Indiana,Hoosiers,10-0,3-7,1,28,7,56,14,21,7,14,14,7,0,0,7,7,21,42,0.9558102431571922,[28.84199726]
2022,11,NCAAF_20221112_LIB@UCONN,UConn,Huskies,Liberty,Flames,6-5,8-2,1,21,17,36,33,14,7,0,15,3,14,10,6,-2,4,3,0.14049364991331748,[-18.24795889]
2022,11,NCAAF_20221112_LSU@ARK,Arkansas,Razorbacks,LSU,Tigers,5-5,8-2,0,3,6,10,13,3,0,0,7,0,6,7,0,-3,-3,-3,0.16542278875874805,[-16.45901897]
2022,11,NCAAF_20221112_MIZZOU@TENN,Tennessee,Volunteers,Missouri,Tigers,9-1,4-6,0,28,17,66,24,7,21,21,17,7,10,7,0,5,11,42,0.48983129681707127,[-0.43147549]
2022,11,NCAAF_20221112_ND@NAVY,Navy,Midshipmen,Notre Dame,Fighting Irish,3-7,7-3,0,13,35,32,35,6,7,3,16,14,21,0,0,-4,-22,-3,0.09030085836531654,[-22.66226131]
2022,11,NCAAF_20221112_OKLA@WVU,West Virginia,Mountaineers,Oklahoma,Sooners,4-6,5-5,0,6,12,23,20,0,6,7,10,0,12,8,0,-1,-6,3,0.21269493257598793,[-13.49178163]
2022,11,NCAAF_20221112_PITT@UVA,Virginia,Cavaliers,Pittsburgh,Panthers,3-7,6-4,1,0,28,7,37,0,0,7,0,28,0,3,6,-3,-28,-30,0.4116891277950401,[-3.77791146]
2022,11,NCAAF_20221112_PURDUE@ILL,Illinois,Fighting Illini,Purdue,Boilermakers,7-3,6-4,0,14,14,24,31,7,7,7,3,0,14,7,10,1,0,-7,0.27431120454349445,[-10.15263231]
2022,11,NCAAF_20221112_RUT@MICHST,Michigan St.,Spartans,Rutgers,Scarlet Knights,5-5,4-6,1,14,7,27,21,7,7,7,6,0,7,7,7,1,7,6,0.7873356169840648,[13.49356252]
2022,11,NCAAF_20221112_SMU@SFLA,South Florida,Bulls,SMU,Mustangs,1-9,6-4,0,17,17,23,41,0,17,0,6,10,7,21,3,-5,0,-18,0.23934986988001017,[-11.99028027]
2022,11,NCAAF_20221112_VANDY@UK,Kentucky,Wildcats,Vanderbilt,Commodores,6-4,4-6,0,6,7,21,24,6,0,3,12,7,0,7,10,2,-1,-3,0.8256122526103022,[15.85907759]
2022,11,NCAAF_20221112_VATECH@DUKE,Duke,Blue Devils,Virginia Tech,Hokies,7-3,2-8,1,10,7,24,7,3,7,7,7,7,0,0,0,5,3,17,0.33698102272971964,[-7.12103683]
2022,11,NCAAF_20221112_JMAD@ODU,Old Dominion,Monarchs,James Madison,Dukes,3-7,6-3,1,3,17,3,37,0,3,0,0,7,10,13,7,-3,-14,-34,0.1186984352605428,[-19.99834531]
2022,11,NCAAF_20221112_LAMON@GAST,Georgia St.,Panthers,UL-Monroe,Warhawks,4-6,4-6,0,21,20,28,31,14,7,7,0,3,17,0,11,0,1,-3,0.6569342782826604,[6.83996311]
2022,11,NCAAF_20221112_LAMAR@NMEXST,New Mexico St.,Aggies,Lamar,Cardinals,4-5,1-9,0,37,0,51,14,17,20,14,0,0,0,7,7,3,37,37,0.9675137685849522,[31.23599169]
2022,11,NCAAF_20221112_RICE@WKY,W. Kentucky,Hilltoppers,Rice,Owls,7-4,5-5,1,24,7,45,10,7,17,7,14,0,7,3,0,2,17,35,0.7865407876366903,[13.44727635]
2022,11,NCAAF_20221112_TEMPLE@HOU,Houston,Cougars,Temple,Owls,6-4,3-7,0,14,19,43,36,0,14,14,15,7,12,7,10,3,-5,7,0.7568177360489664,[11.78221383]
2022,11,NCAAF_20221112_UMASS@ARKST,Arkansas St.,Red Wolves,UMass,Minutemen,3-7,1-9,0,14,6,35,33,14,0,21,0,3,3,13,14,2,8,2,0.8838747876803066,[20.21945867]
2022,11,NCAAF_20221112_APLST@MRSHL,Marshall,Thundering Herd,App. St.,Mountaineers,6-4,5-5,1,14,7,28,21,7,7,14,0,0,7,7,7,1,7,7,0.353035164251156,[-6.38344337]
2022,11,NCAAF_20221112_ARIZST@WASHST,Washington St.,Cougars,Arizona St.,Sun Devils,6-4,3-7,1,28,0,28,18,13,15,0,0,0,0,6,12,3,28,10,0.5826205819328192,[3.53079387]
2022,11,NCAAF_20221112_ARMY@TROY,Troy,Trojans,Army,Black Knights,8-2,3-6,0,0,9,10,9,0,0,3,7,0,9,0,0,5,-9,1,0.36496494906818777,[-5.84316315]
2022,11,NCAAF_20221112_BAMA@MISS,Ole Miss,Rebels,Alabama,Crimson Tide,8-2,8-2,1,17,14,24,30,7,10,7,0,0,14,10,6,0,3,-6,0.06926036895721954,[-25.07281654]
2022,11,NCAAF_20221112_BC@NCST,NC State,Wolfpack,Boston College,Eagles,7-3,3-7,0,17,7,20,21,14,3,3,0,7,0,7,7,4,10,-1,0.6229464695497405,[5.30169667]
2022,11,NCAAF_20221112_CHARLO@MTSU,Middle Tenn.,Blue Raiders,Charlotte,49ers,5-5,2-9,0,7,14,24,14,0,7,7,10,0,14,0,0,3,-7,10,0.7152596326227627,[9.62777015]
2022,11,NCAAF_20221112_IOWAST@OKLAST,Oklahoma State,Cowboys,Iowa St.,Cyclones,7-3,4-6,1,10,7,20,14,0,10,0,10,0,7,7,0,3,3,6,0.4615493173880114,[-1.63388559]
2022,11,NCAAF_20221112_LATECH@TXSA,UTSA,Roadrunners,Louisiana Tech,Bulldogs,8-2,3-7,0,34,7,51,7,21,13,10,7,7,0,0,0,5,27,44,0.4871113977957563,[-0.5469214]
2022,11,NCAAF_20221112_LVILLE@CLEM,Clemson,Tigers,Louisville,Cardinals,9-1,6-4,1,17,7,31,16,10,7,7,7,0,7,3,6,3,10,15,0.9046512963208431,[22.14795109]
2022,11,NCAAF_20221112_MD@PSU,Penn State,Nittany Lions,Maryland,Terrapins,8-2,6-4,0,27,0,30,0,14,13,3,0,0,0,0,0,2,27,30,0.9061175387863573,[22.29522606]
2022,11,NCAAF_20221112_MIAMI@GATECH,Georgia Tech,Yellow Jackets,Miami (Fla.),Hurricanes,4-6,5-5,0,7,14,14,35,0,7,0,7,7,7,0,21,-1,-7,-21,0.2702348066963497,[-10.36043765]
2022,11,NCAAF_20221112_NEB@MICH,Michigan,Wolverines,Nebraska,Cornhuskers,10-0,3-7,0,17,3,34,3,7,10,7,10,0,3,0,0,7,14,31,0.8764814151838008,[19.59309533]
2022,11,NCAAF_20221112_NMEX@AF,Air Force,Falcons,New Mexico,Lobos,7-3,2-8,0,14,0,35,3,14,0,14,7,0,0,3,0,5,14,32,0.8871647999031331,[20.50729151]
2022,11,NCAAF_20221112_NTEXAS@UAB,UAB,Blazers,North Texas,Mean Green,,5-5,0,17,21,41,21,14,3,10,14,0,21,0,0,,-4,20,0.6059698942617864,[4.55021528]
2022,11,NCAAF_20221112_NWEST@MINN,Minnesota,Golden Gophers,Northwestern,Wildcats,7-3,1-9,1,14,3,31,3,7,7,3,14,0,3,0,0,6,11,28,0.668453099239668,[7.37372667]
2022,11,NCAAF_20221112_UCF@TULANE,Tulane,Green Wave,UCF,Knights,8-2,8-2,0,14,24,31,38,7,7,3,14,17,7,7,7,0,-10,-7,0.23339362237730876,[-12.31730574]
2022,11,NCAAF_20221112_WISC@IOWA,Iowa,Hawkeyes,Wisconsin,Badgers,6-4,5-5,1,14,10,24,10,0,14,0,10,3,7,0,0,1,4,14,0.4435403785544818,[-2.40347179]
2022,11,NCAAF_20221112_SC@FLA,Florida,Gators,South Carolina,Gamecocks,6-4,6-4,1,24,6,38,6,21,3,7,7,0,6,0,0,0,18,32,0.7191776449258803,[9.8238385]
2022,11,NCAAF_20221112_TXSTSM@SALA,South Alabama,Jaguars,Texas St.,Bobcats,8-2,3-7,1,17,0,38,21,10,7,7,14,0,0,7,14,5,17,17,0.6124578137158667,[4.83626993]
2022,11,NCAAF_20221112_FAU@FIU,FIU,Panthers,FAU,Owls,4-6,5-5,1,7,31,7,52,0,7,0,0,21,10,14,7,-1,-24,-45,0.18669336788830648,[-15.0666094]
2022,11,NCAAF_20221112_KANSAS@TXTECH,Texas Tech,Red Raiders,Kansas,Jayhawks,5-5,6-4,1,27,21,43,28,17,10,0,16,7,14,0,7,-1,6,15,0.8025594124271254,[14.40059445]
2022,11,NCAAF_20221112_KSTATE@BAYLOR,Baylor,Bears,Kansas State,Wildcats,6-4,7-3,0,3,17,3,31,0,3,0,0,0,17,7,7,-1,-14,-28,0.4702246987474613,[-1.26445535]
2022,11,NCAAF_20221112_UGA@MISSST,Miss. State,Bulldogs,Georgia,Bulldogs,6-4,10-0,1,12,17,19,45,0,12,7,0,7,10,14,14,-4,-5,-26,0.17097853615516068,[-16.08484249]
2022,11,NCAAF_20221112_WASH@OREG,Oregon,Ducks,Washington,Huskies,8-2,8-2,0,10,13,34,37,3,7,21,3,7,6,14,10,0,-3,-3,0.5348389826880467,[1.4800014]
2022,11,NCAAF_20221112_WYO@COLOST,Colorado St.,Rams,Wyoming,Cowboys,2-8,7-3,0,10,7,13,14,7,3,0,3,0,7,0,7,-5,3,-1,0.38910627758137206,[-4.76718523]
2022,11,NCAAF_20221112_TCU@TEXAS,Texas,Longhorns,TCU,Horned Frogs,6-4,10-0,0,0,3,10,17,0,0,3,7,0,3,7,7,-4,-3,-7,0.6060251921911983,[4.55264779]
2022,11,NCAAF_20221112_TXAM@AUBURN,Auburn,Tigers,Texas A&M,Aggies,4-6,3-7,0,7,0,13,10,7,0,3,3,0,0,0,10,1,7,3,0.59970456396506,[4.2752037]
2022,11,NCAAF_20221112_UNC@WAKE,Wake Forest,Demon Deacons,North Carolina,Tar Heels,6-4,9-1,1,21,27,34,36,7,14,13,0,14,13,6,3,-3,-6,-2,0.534254462514093,[1.4551085]
2022,11,NCAAF_20221112_USM@CSTCAR,C. Carolina,Chanticleers,So. Miss,Golden Eagles,9-1,5-5,1,17,17,26,23,17,0,3,6,0,17,3,3,4,0,3,0.5960533755675899,[4.11546137]
2022,11,NCAAF_20221112_FSU@CUSE,Syracuse,Orange,Florida State,Seminoles,6-4,7-3,1,3,24,3,38,0,3,0,0,14,10,14,0,-1,-21,-35,0.4362898229258729,[-2.71463231]
2022,11,NCAAF_20221112_CAL@OREGST,Oregon State,Beavers,California,Golden Bears,7-3,3-7,0,21,7,38,10,14,7,10,7,0,7,0,3,4,14,28,0.3771027758264083,[-5.29950232]
2022,11,NCAAF_20221112_STNFRD@UTAH,Utah,Utes,Stanford,Cardinal,8-2,3-7,1,14,7,42,7,0,14,21,7,7,0,0,0,5,7,35,0.7599514754434233,[11.95221489]
2022,11,NCAAF_20221112_ARIZ@UCLA,UCLA,Bruins,Arizona,Wildcats,8-2,4-6,0,14,21,28,34,0,14,7,7,14,7,0,13,4,-7,-6,0.6864024160386569,[8.22057932]
2022,11,NCAAF_20221112_BOISE@NEVADA,Nevada,Wolf Pack,Boise St.,Broncos,2-8,7-3,0,3,21,3,41,0,3,0,0,14,7,17,3,-5,-18,-38,0.191337430033525,[-14.77600686]
2022,11,NCAAF_20221112_SJST@SDGST,San Diego St.,Aztecs,San Jose St.,Spartans,6-4,6-3,0,24,14,43,27,7,17,14,5,14,0,6,7,0,10,16,0.774239249808099,[12.74323994]
2022,11,NCAAF_20221112_UTAHST@HAWAII,Hawaii,Rainbow Warriors,Utah St.,Aggies,2-9,5-5,1,10,24,34,41,0,10,7,17,10,14,10,7,-3,-14,-7,0.25691489772700526,[-11.05072901]
2022,11,NCAAF_20221111_ECU@CINCY,Cincinnati,Bearcats,East Carolina,Pirates,8-2,6-4,1,24,12,27,25,7,17,0,3,5,7,13,0,2,12,2,0.8673627882421182,[18.85571969]
2022,11,NCAAF_20221111_COLO@USC,USC,Trojans,Colorado,Buffaloes,9-1,1-9,0,26,3,55,17,2,24,15,14,3,0,7,7,8,23,38,0.7955644728715514,[13.97885418]
2022,11,NCAAF_20221111_FRESNO@UNLV,UNLV,Rebels,Fresno St.,Bulldogs,4-6,6-4,1,16,14,30,37,10,6,3,11,7,7,10,13,-2,2,-7,0.15517386927114662,[-17.17127311]
2022,11,NCAAF_20221110_GAS@UL,Louisiana,Ragin' Cajuns,Ga. Southern,Eagles,5-5,5-5,0,27,7,36,17,7,20,3,6,0,7,7,3,0,20,19,0.6967540652827618,[8.71835631]
2022,11,NCAAF_20221110_TULSA@MEMP,Memphis,Tigers,Tulsa,Golden Hurricane,5-5,3-7,1,20,3,26,10,10,10,3,3,3,0,0,7,2,17,16,0.7121460295249525,[9.47287406]
2022,11,NCAAF_20221109_BUFF@CMICH,C. Michigan,Chippewas,Buffalo,Bulls,4-6,5-5,0,7,24,31,27,7,0,17,7,7,17,0,3,-1,-17,4,0.4067513535510383,[-3.9930015]
2022,11,NCAAF_20221109_KENTST@BGREEN,Bowling Green,Falcons,Kent St.,Golden Flashes,5-5,4-6,0,0,20,6,40,0,0,6,0,0,20,3,17,1,-20,-34,0.32012267911305714,[-7.91045032]
2022,11,NCAAF_20221109_NILL@WMICH,W. Michigan,Broncos,N. Illinois,Huskies,3-7,3-7,0,14,10,21,24,7,7,7,0,3,7,7,7,0,4,-3,0.528426254106739,[1.20706639]
2022,11,NCAAF_20221108_EMICH@AKRON,Akron,Zips,E. Michigan,Eagles,1-9,6-4,0,14,24,28,34,7,7,0,14,10,14,7,3,-5,-10,-6,0.17426273102653478,[-15.86730654]
2022,11,NCAAF_20221108_OHIO@MIAOH,Miami-OH,RedHawks,Ohio,Bobcats,4-6,7-3,1,7,10,21,37,0,7,7,7,7,3,14,13,-3,-3,-16,0.40699784697941654,[-3.9822492]
2022,11,NCAAF_20221108_BALLST@TOLEDO,Toledo,Rockets,Ball St.,Cardinals,7-3,5-5,0,14,14,28,21,7,7,7,7,7,7,7,0,2,0,7,0.7469551712761261,[11.25473437]
2022,12,NCAAF_20221119_NAVY@UCF,UCF,Knights,Navy,Midshipmen,8-3,4-7,0,6,14,14,17,0,6,8,0,7,7,3,0,4,-8,-3,0.8012366857732482,[14.31541315]
2022,12,NCAAF_20221119_AP@BAMA,Alabama,Crimson Tide,Austin Peay,Governors,9-2,7-4,1,17,0,34,0,7,10,10,7,0,0,0,0,2,17,34,0.999781193190585,[59.49697113]
2022,12,NCAAF_20221119_DUKE@PITT,Pittsburgh,Panthers,Duke,Blue Devils,7-4,7-4,0,20,14,28,26,10,10,0,8,7,7,0,12,0,6,2,0.7088604459471354,[9.30718903]
2022,12,NCAAF_20221119_ETNST@MISSST,Miss. State,Bulldogs,ETSU,Buccaneers,7-4,3-8,1,35,0,56,7,14,21,14,7,0,0,0,7,4,35,49,0.9907597259420433,[39.86176252]
2022,12,NCAAF_20221119_FLA@VANDY,Vanderbilt,Commodores,Florida,Gators,5-6,6-5,1,14,6,31,24,0,14,14,3,3,3,6,12,-1,8,7,0.09821227904235097,[-21.85780636]
2022,12,NCAAF_20221119_ILL@MICH,Michigan,Wolverines,Illinois,Fighting Illini,11-0,7-4,1,7,3,19,17,7,0,3,9,0,3,14,0,4,4,2,0.9317458870617841,[25.19306969]
2022,12,NCAAF_20221119_NWEST@PURDUE,Purdue,Boilermakers,Northwestern,Wildcats,7-4,1-10,1,14,3,17,9,7,7,0,3,0,3,0,6,6,11,8,0.6481594344023878,[6.43575977]
2022,12,NCAAF_20221119_TCU@BAYLOR,Baylor,Bears,TCU,Horned Frogs,6-5,11-0,1,14,14,28,29,7,7,0,14,7,7,6,9,-5,0,-1,0.4262618831049978,[-3.14548154]
2022,12,NCAAF_20221119_UCONN@ARMY,Army,Black Knights,UConn,Huskies,4-6,6-6,0,13,10,34,17,7,6,14,7,3,7,7,0,-2,3,17,0.9066067274490339,[22.33732645]
2022,12,NCAAF_20221119_UL@FSU,Florida State,Seminoles,Louisiana,Ragin' Cajuns,8-3,5-6,1,35,3,49,17,21,14,14,0,0,3,0,14,3,32,32,0.6596419570157863,[6.96249227]
2022,12,NCAAF_20221119_UMASS@TXAM,Texas A&M,Aggies,UMass,Minutemen,4-7,1-10,1,10,3,20,3,3,7,3,7,0,3,0,0,3,7,17,0.9936107172785749,[42.12968273]
2022,12,NCAAF_20221119_VATECH@LIB,Liberty,Flames,Virginia Tech,Hokies,8-3,3-8,0,17,17,22,23,7,10,5,0,7,10,0,6,5,0,-1,0.28034731905490473,[-9.84443295]
2022,12,NCAAF_20221119_WISC@NEB,Nebraska,Cornhuskers,Wisconsin,Badgers,3-8,6-5,1,7,0,14,15,0,7,7,0,0,0,3,12,-3,7,-1,0.18977545712403288,[-14.86832362]
2022,12,NCAAF_20221119_TXSA@RICE,Rice,Owls,UTSA,Roadrunners,5-6,9-2,0,0,28,7,41,0,0,0,7,21,7,13,0,-4,-28,-34,0.27607798688605767,[-10.0597024]
2022,12,NCAAF_20221119_GAST@JMAD,James Madison,Dukes,Georgia St.,Panthers,7-3,4-7,0,14,34,42,40,7,7,21,7,10,24,0,6,3,-20,2,0.8365842636047661,[16.5906797]
2022,12,NCAAF_20221119_HOU@ECU,East Carolina,Pirates,Houston,Cougars,6-5,7-4,1,0,21,3,42,0,0,3,0,7,14,14,7,-1,-21,-39,0.24589308980700553,[-11.63224828]
2022,12,NCAAF_20221119_KSTATE@WVU,West Virginia,Mountaineers,Kansas State,Wildcats,4-7,8-3,0,25,41,31,48,19,6,0,6,28,13,0,7,-4,-16,-17,0.45050864449888195,[-2.10449229]
2022,12,NCAAF_20221119_NAL@MEMP,Memphis,Tigers,North Alabama,Lions,6-5,1-10,1,38,0,59,0,14,24,14,7,0,0,0,0,5,38,59,0.9872102034248873,[37.77529464]
2022,12,NCAAF_20221119_WASHST@ARIZ,Arizona,Wildcats,Washington St.,Cougars,4-7,7-4,0,6,21,20,31,0,6,0,14,7,14,10,0,-3,-15,-11,0.23324537731897177,[-12.32141447]
2022,12,NCAAF_20221119_OREGST@ARIZST,Arizona St.,Sun Devils,Oregon State,Beavers,3-8,8-3,1,7,14,7,31,0,7,0,0,7,7,14,3,-5,-7,-24,0.6666724746694894,[7.28832944]
2022,12,NCAAF_20221119_BC@ND,Notre Dame,Fighting Irish,Boston College,Eagles,8-3,3-8,1,37,0,44,0,17,20,7,0,0,0,0,0,5,37,44,0.8528016603670214,[17.74142015]
2022,12,NCAAF_20221119_ODU@APLST,App. St.,Mountaineers,Old Dominion,Monarchs,6-5,3-8,0,24,0,27,14,10,14,3,0,0,0,0,14,3,24,13,0.9000242217199759,[21.68664398]
2022,12,NCAAF_20221119_FAU@MTSU,Middle Tenn.,Blue Raiders,FAU,Owls,6-5,5-6,1,28,14,49,21,14,14,14,7,7,7,7,0,1,14,28,0.33944926166969525,[-7.00446319]
2022,12,NCAAF_20221119_LAMON@TROY,Troy,Trojans,UL-Monroe,Warhawks,9-2,4-7,1,20,3,34,16,3,17,7,7,0,3,7,6,5,17,18,0.763350819071799,[12.13397202]
2022,12,NCAAF_20221119_LATECH@CHARLO,Charlotte,49ers,Louisiana Tech,Bulldogs,3-9,3-8,0,13,7,26,21,0,13,6,7,0,7,0,14,0,6,5,0.3078776825901982,[-8.49190566]
2022,12,NCAAF_20221119_MIAMI@CLEM,Clemson,Tigers,Miami (Fla.),Hurricanes,10-1,5-6,1,24,0,40,10,14,10,2,14,0,0,3,7,5,24,30,0.8590224159176452,[18.20524688]
2022,12,NCAAF_20221119_NCST@LVILLE,Louisville,Cardinals,NC State,Wolfpack,7-4,7-4,1,13,3,25,10,0,13,0,12,0,3,7,0,0,10,15,0.4367651383448167,[-2.69331317]
2022,12,NCAAF_20221119_OHIOST@MD,Maryland,Terrapins,Ohio State,Buckeyes,6-5,11-0,0,13,10,30,43,6,7,0,17,7,3,17,16,-5,3,-13,0.026787360853975928,[-32.66067355]
2022,12,NCAAF_20221119_PSU@RUT,Rutgers,Scarlet Knights,Penn State,Nittany Lions,4-7,9-2,0,10,28,10,55,10,0,0,0,14,14,20,7,-5,-18,-45,0.0451057821917733,[-28.66786719]
2022,12,NCAAF_20221119_SALA@USM,So. Miss,Golden Eagles,South Alabama,Jaguars,5-6,9-2,0,10,13,20,27,7,3,7,3,3,10,0,14,-4,-3,-7,0.589459842192741,[3.8266351]
2022,12,NCAAF_20221119_TEXAS@KANSAS,Kansas,Jayhawks,Texas,Longhorns,6-5,7-4,0,0,31,14,55,0,0,7,7,14,17,10,14,-1,-31,-41,0.07140013963571268,[-24.79580542]
2022,12,NCAAF_20221119_UGA@UK,Kentucky,Wildcats,Georgia,Bulldogs,6-5,11-0,1,0,9,6,16,0,0,0,6,3,6,7,0,-5,-9,-10,0.11552847593206095,[-20.26450557]
2022,12,NCAAF_20221119_UTTCH@BYU,BYU,Cougars,Utah Tech,Trailblazers,6-5,4-7,1,28,20,52,26,0,28,7,17,6,14,0,6,2,8,26,,
2022,12,NCAAF_20221119_CINCY@TEMPLE,Temple,Owls,Cincinnati,Bearcats,3-8,9-2,1,3,17,3,23,0,3,0,0,7,10,3,3,-6,-14,-20,0.13919204006618413,[-18.3409299]
2022,12,NCAAF_20221119_FIU@UTEP,UTEP,Miners,FIU,Panthers,5-6,4-7,1,38,0,40,6,14,24,0,2,0,0,0,6,1,38,34,0.40402752586511825,[-4.11056192]
2022,12,NCAAF_20221119_IOWA@MINN,Minnesota,Golden Gophers,Iowa,Hawkeyes,7-4,7-4,1,7,10,10,13,0,7,3,0,10,0,0,3,0,-3,-3,0.34859770030845094,[-6.58386537]
2022,12,NCAAF_20221119_WKY@AUBURN,Auburn,Tigers,W. Kentucky,Hilltoppers,5-6,7-5,0,17,17,41,17,10,7,10,14,0,17,0,0,-2,0,24,0.9145115094312493,[23.16517392]
2022,12,NCAAF_20221119_ARKST@TXSTSM,Texas St.,Bobcats,Arkansas St.,Red Wolves,4-7,3-8,1,3,7,16,13,3,0,0,13,0,7,3,3,1,-4,3,0.26561092328903657,[-10.59454438]
2022,12,NCAAF_20221119_GATECH@UNC,North Carolina,Tar Heels,Georgia Tech,Yellow Jackets,9-2,5-6,0,17,7,17,21,7,10,0,0,0,7,7,7,4,10,-4,0.6732903615208814,[7.59753013]
2022,12,NCAAF_20221119_STNFRD@CAL,California,Golden Bears,Stanford,Cardinal,4-7,3-8,0,6,10,27,20,6,0,0,21,10,0,7,3,1,-4,7,0.4885573102339855,[-0.48538585]
2022,12,NCAAF_20221119_MRSHL@GAS,Ga. Southern,Eagles,Marshall,Thundering Herd,5-6,7-4,0,10,20,10,23,3,7,0,0,6,14,3,0,-2,-10,-13,0.27763944087692083,[-9.98078319]
2022,12,NCAAF_20221119_BOISE@WYO,Wyoming,Cowboys,Boise St.,Broncos,7-4,8-3,0,10,6,17,20,7,3,7,0,0,6,7,7,-1,4,-3,0.2307325053654612,[-12.46077005]
2022,12,NCAAF_20221119_TENN@SC,South Carolina,Gamecocks,Tennessee,Volunteers,7-4,9-2,1,35,24,63,38,21,14,7,21,7,17,7,7,-2,11,25,0.4122938226510927,[-3.75036885]
2022,12,NCAAF_20221119_TXTECH@IOWAST,Iowa St.,Cyclones,Texas Tech,Red Raiders,4-7,6-5,0,3,7,10,14,0,3,0,7,0,7,0,7,-2,-4,-4,0.7296699472758784,[10.35212899]
2022,12,NCAAF_20221119_MISS@ARK,Arkansas,Razorbacks,Ole Miss,Rebels,6-5,8-3,0,35,6,42,27,14,21,7,0,3,3,0,21,-2,29,15,0.3079168558649915,[-8.49002126]
2022,12,NCAAF_20221119_NMEXST@MIZZOU,Missouri,Tigers,New Mexico St.,Aggies,5-6,4-6,0,21,0,45,14,7,14,14,10,0,0,7,7,1,21,31,0.9552985127498443,[28.74016276]
2022,12,NCAAF_20221119_OKLAST@OKLA,Oklahoma,Sooners,Oklahoma State,Cowboys,6-5,7-4,1,28,3,28,13,28,0,0,0,0,3,7,3,-1,25,15,0.6611858786040576,[7.03382193]
2022,12,NCAAF_20221119_CUSE@WAKE,Wake Forest,Demon Deacons,Syracuse,Orange,7-4,6-5,0,24,21,45,35,3,21,7,14,7,14,0,14,1,3,10,0.6294868386112444,[5.59208509]
2022,12,NCAAF_20221119_USC@UCLA,UCLA,Bruins,USC,Trojans,8-3,10-1,0,21,20,45,48,14,7,10,14,0,20,14,14,-2,1,-3,0.38329944200306487,[-5.02241196]
2022,12,NCAAF_20221119_COLO@WASH,Washington,Huskies,Colorado,Buffaloes,9-2,1-10,0,33,0,54,7,14,19,14,7,0,0,7,0,8,33,47,0.8533662306927952,[17.78296428]
2022,12,NCAAF_20221119_COLOST@AF,Air Force,Falcons,Colorado St.,Rams,8-3,2-9,0,17,0,24,12,7,10,7,0,0,0,6,6,6,17,12,0.7619805540728983,[12.05893322]
2022,12,NCAAF_20221119_UAB@LSU,LSU,Tigers,UAB,Blazers,9-2,5-6,1,28,10,41,10,14,14,6,7,7,3,0,0,4,18,31,0.8939846571449037,[21.11662121]
2022,12,NCAAF_20221119_SJST@UTAHST,Utah St.,Aggies,San Jose St.,Spartans,6-5,6-4,0,21,13,35,31,7,14,7,7,6,7,10,8,0,8,4,0.7465916155714508,[11.23177334]
2022,12,NCAAF_20221119_FRESNO@NEVADA,Nevada,Wolf Pack,Fresno St.,Bulldogs,2-9,7-4,1,0,24,14,41,0,0,7,7,17,7,3,14,-5,-24,-27,0.2806503719618797,[-9.82921314]
2022,12,NCAAF_20221119_UTAH@OREG,Oregon,Ducks,Utah,Utes,9-2,8-3,1,17,3,20,17,7,10,0,3,3,0,14,0,1,14,3,0.46328255647104044,[-1.55950362]
2022,12,NCAAF_20221119_UNLV@HAWAII,Hawaii,Rainbow Warriors,UNLV,Rebels,3-9,4-7,0,7,13,31,25,7,0,14,10,6,7,3,9,-1,-6,6,0.5432480128504236,[1.8378874]
2022,12,NCAAF_20221118_SFLA@TULSA,Tulsa,Golden Hurricane,South Florida,Bulls,4-7,1-10,0,31,20,48,42,7,24,7,10,10,10,15,7,3,11,6,0.6104630933127284,[4.74660343]
2022,12,NCAAF_20221118_SDGST@NMEX,New Mexico,Lobos,San Diego St.,Aztecs,2-9,7-4,1,10,21,10,34,7,3,0,0,7,14,10,3,-5,-11,-24,0.14681420948673507,[-17.76967487]
2022,12,NCAAF_20221117_SMU@TULANE,Tulane,Green Wave,SMU,Mustangs,9-2,6-5,0,28,7,59,24,21,7,21,10,0,7,7,10,3,21,35,0.43037220733536596,[-2.96828105]
2022,12,NCAAF_20221116_EMICH@KENTST,Kent St.,Golden Flashes,E. Michigan,Eagles,4-7,7-4,0,17,7,24,31,7,10,0,7,7,0,10,14,-3,10,-7,0.33827599048403667,[-7.05871309]
2022,12,NCAAF_20221116_MIAOH@NILL,N. Illinois,Huskies,Miami-OH,RedHawks,3-8,5-6,0,10,16,23,29,10,0,13,0,2,14,10,3,-2,-6,-6,0.5004650879037119,[0.0197258]
2022,12,NCAAF_20221116_WMICH@CMICH,C. Michigan,Chippewas,W. Michigan,Broncos,4-7,4-7,1,7,7,10,12,7,0,3,0,7,0,0,5,0,0,-2,0.4710286174592593,[-1.2298465]
2022,12,NCAAF_20221115_BGREEN@TOLEDO,Toledo,Rockets,Bowling Green,Falcons,7-4,6-5,1,14,21,35,42,0,14,0,21,14,7,6,15,1,-7,-7,0.8967193403200833,[21.37172118]
2022,12,NCAAF_20221115_OHIO@BALLST,Ball St.,Cardinals,Ohio,Bobcats,5-6,8-3,1,3,17,18,32,3,0,8,7,0,17,2,13,-3,-14,-14,0.27586530858230407,[-10.07046853]
2022,13,NCAAF_20221126_ARMY@UMASS,UMass,Minutemen,Army,Black Knights,1-11,5-6,1,7,28,7,44,7,0,0,0,7,21,0,16,-4,-21,-37,0.048764083366819144,[-28.03060985]
2022,13,NCAAF_20221126_CSTCAR@JMAD,James Madison,Dukes,C. Carolina,Chanticleers,8-3,9-2,0,20,7,47,7,3,17,20,7,7,0,0,0,-1,13,40,0.7294235021964968,[10.33742878]
2022,13,NCAAF_20221126_GAST@MRSHL,Marshall,Thundering Herd,Georgia St.,Panthers,8-4,4-8,0,14,10,28,23,0,14,0,14,7,3,7,6,4,4,5,0.736256344296023,[10.68889367]
2022,13,NCAAF_20221126_GATECH@UGA,Georgia,Bulldogs,Georgia Tech,Yellow Jackets,12-0,5-7,0,10,7,37,14,3,7,13,14,7,0,0,7,7,3,23,0.9669783995310536,[31.09550468]
2022,13,NCAAF_20221126_MICH@OHIOST,Ohio State,Buckeyes,Michigan,Wolverines,11-1,12-0,1,20,17,23,45,10,10,0,3,3,14,7,21,-1,3,-22,0.69519299997302,[8.63819442]
2022,13,NCAAF_20221126_NMEXST@LIB,Liberty,Flames,New Mexico St.,Aggies,,6-6,0,7,28,14,49,7,0,0,7,7,21,14,7,,-21,-35,0.8187494241472801,[15.40470879]
2022,13,NCAAF_20221126_ODU@SALA,South Alabama,Jaguars,Old Dominion,Monarchs,10-2,3-9,0,13,20,27,20,7,6,7,7,10,10,0,0,7,-7,7,0.5496670093414455,[2.11157155]
2022,13,NCAAF_20221126_RUT@MD,Maryland,Terrapins,Rutgers,Scarlet Knights,7-5,4-8,0,17,0,37,0,0,17,13,7,0,0,0,0,3,17,37,0.6528784997483172,[6.6501015]
2022,13,NCAAF_20221126_SC@CLEM,Clemson,Tigers,South Carolina,Gamecocks,10-2,8-4,0,23,14,30,31,14,9,7,0,0,14,14,3,2,9,-1,0.8988933775378103,[21.57366246]
2022,13,NCAAF_20221126_WVU@OKLAST,Oklahoma State,Cowboys,West Virginia,Mountaineers,7-5,5-7,1,10,7,19,24,0,10,9,0,7,0,14,3,2,3,-5,0.6410567395957386,[6.11182698]
2022,13,NCAAF_20221126_ECU@TEMPLE,Temple,Owls,East Carolina,Pirates,3-9,7-5,0,24,28,46,49,3,21,15,7,7,21,14,7,-4,-4,-3,0.5109057745241572,[0.46251078]
2022,13,NCAAF_20221126_AKRON@NILL,N. Illinois,Huskies,Akron,Zips,3-9,2-9,1,6,20,12,44,6,0,3,3,0,20,7,17,1,-14,-32,0.8215579368020882,[15.58587298]
2022,13,NCAAF_20221126_RICE@NTEXAS,North Texas,Mean Green,Rice,Owls,7-5,5-7,1,14,14,21,17,7,7,0,7,0,14,0,3,2,0,4,0.7457415467556233,[11.18460124]
2022,13,NCAAF_20221126_LVILLE@UK,Kentucky,Wildcats,Louisville,Cardinals,7-5,7-5,1,13,7,26,13,7,6,10,3,0,7,0,6,0,6,13,0.5943015196410447,[4.03678741]
2022,13,NCAAF_20221126_AUBURN@BAMA,Alabama,Crimson Tide,Auburn,Tigers,10-2,5-7,0,35,14,49,27,14,21,7,7,7,7,7,6,5,21,22,0.8319142495392362,[16.26997272]
2022,13,NCAAF_20221126_HAWAII@SJST,San Jose St.,Spartans,Hawaii,Rainbow Warriors,7-4,3-10,0,14,6,27,14,7,7,7,6,0,6,0,8,4,8,13,0.4943709921162499,[-0.2387028]
2022,13,NCAAF_20221126_ILL@NWEST,Northwestern,Wildcats,Illinois,Fighting Illini,1-11,8-4,0,0,17,3,41,0,0,0,3,7,10,17,7,-7,-17,-38,0.5766648484772288,[3.27120125]
2022,13,NCAAF_20221126_MEMP@SMU,SMU,Mustangs,Memphis,Tigers,7-5,6-6,0,14,17,34,31,0,14,10,10,7,10,6,8,1,-3,3,0.42824298065179733,[-3.05941114]
2022,13,NCAAF_20221126_MINN@WISC,Wisconsin,Badgers,Minnesota,Golden Gophers,6-6,8-4,1,6,10,16,23,3,3,10,0,7,3,3,10,-2,-4,-7,0.6859625571376691,[8.19520313]
2022,13,NCAAF_20221126_OREG@OREGST,Oregon State,Beavers,Oregon,Ducks,9-3,9-3,1,10,14,38,34,10,0,7,21,7,7,17,3,0,-4,4,0.18069573603928601,[-15.44035853]
2022,13,NCAAF_20221126_PURDUE@IND,Indiana,Hoosiers,Purdue,Boilermakers,4-8,8-4,0,7,3,16,30,7,0,0,9,3,0,14,13,-4,4,-14,0.3705196477802726,[-5.59065922]
2022,13,NCAAF_20221126_TROY@ARKST,Arkansas St.,Red Wolves,Troy,Trojans,3-9,10-2,0,13,7,19,48,3,10,6,0,7,0,7,34,-7,6,-29,0.4224231133843779,[-3.31061447]
2022,13,NCAAF_20221126_UAB@LATECH,Louisiana Tech,Bulldogs,UAB,Blazers,3-9,6-6,1,6,17,27,37,3,3,14,7,0,17,20,0,-3,-11,-10,0.34737835392734095,[-6.63833646]
2022,13,NCAAF_20221126_UTEP@TXSA,UTSA,Roadrunners,UTEP,Miners,10-2,5-7,1,14,24,34,31,0,14,17,3,14,10,7,0,5,-10,3,0.7684922977777705,[12.41516919]
2022,13,NCAAF_20221126_WAKE@DUKE,Duke,Blue Devils,Wake Forest,Demon Deacons,8-4,7-5,1,20,17,34,31,3,17,7,7,7,10,7,7,1,3,3,0.3000361191087735,[-8.86948441]
2022,13,NCAAF_20221126_IOWAST@TCU,TCU,Horned Frogs,Iowa St.,Cyclones,12-0,4-8,1,34,7,62,14,24,10,21,7,0,7,0,7,8,27,48,0.4064780348688798,[-4.00278431]
2022,13,NCAAF_20221126_MICHST@PSU,Penn State,Nittany Lions,Michigan St.,Spartans,10-2,5-7,0,14,3,35,16,7,7,7,14,0,3,7,6,5,11,19,0.8221664483227251,[15.62536124]
2022,13,NCAAF_20221126_UTAH@COLO,Colorado,Buffaloes,Utah,Utes,1-11,9-3,1,0,42,21,63,0,0,14,7,14,28,14,7,-8,-42,-42,0.10634600173334463,[-21.08181898]
2022,13,NCAAF_20221126_UL@TXSTSM,Texas St.,Bobcats,Louisiana,Ragin' Cajuns,4-8,6-6,1,6,20,13,41,3,3,7,0,7,13,7,14,-2,-14,-28,0.15297745214539749,[-17.31864239]
2022,13,NCAAF_20221126_USM@LAMON,UL-Monroe,Warhawks,So. Miss,Golden Eagles,4-8,6-6,0,7,10,10,20,0,7,3,0,10,0,0,10,-2,-3,-10,0.3303097798697896,[-7.42750809]
2022,13,NCAAF_20221126_MTSU@FIU,FIU,Panthers,Middle Tenn.,Blue Raiders,4-8,7-5,0,7,20,28,33,0,7,14,7,6,14,7,6,-3,-13,-5,0.2770582627931608,[-10.00809931]
2022,13,NCAAF_20221126_NEVADA@UNLV,UNLV,Rebels,Nevada,Wolf Pack,5-7,2-10,1,17,13,27,22,7,10,0,10,13,0,3,6,3,4,5,0.34167069626597346,[-6.90054317]
2022,13,NCAAF_20221126_LSU@TXAM,Texas A&M,Aggies,LSU,Tigers,5-7,9-3,0,17,10,38,23,7,10,7,14,0,10,7,6,-4,7,15,0.39564011913263586,[-4.47703796]
2022,13,NCAAF_20221126_UCF@SFLA,South Florida,Bulls,UCF,Knights,1-11,9-3,0,7,28,39,46,0,7,22,10,14,14,3,15,-8,-21,-7,0.10576954757471801,[-21.1350616]
2022,13,NCAAF_20221126_CUSE@BC,Boston College,Eagles,Syracuse,Orange,3-9,7-5,0,10,3,23,32,10,0,0,13,0,3,3,26,-4,7,-9,0.519851949097061,[0.84215832]
2022,13,NCAAF_20221126_ND@USC,USC,Trojans,Notre Dame,Fighting Irish,11-1,8-4,1,17,7,38,27,10,7,7,14,0,7,7,13,3,10,11,0.28195057769670817,[-9.76202221]
2022,13,NCAAF_20221126_TENN@VANDY,Vanderbilt,Commodores,Tennessee,Volunteers,5-7,10-2,0,0,21,0,56,0,0,0,0,14,7,21,14,-5,-21,-56,0.19937836546818177,[-14.27523734]
2022,13,NCAAF_20221126_TULSA@HOU,Houston,Cougars,Tulsa,Golden Hurricane,7-5,5-7,1,24,20,30,37,14,10,3,3,3,17,7,10,2,4,-7,0.6627872418391094,[7.10649457]
2022,13,NCAAF_20221126_KANSAS@KSTATE,Kansas State,Wildcats,Kansas,Jayhawks,9-3,6-6,1,30,21,47,27,23,7,7,10,7,14,0,6,3,9,20,0.8805798753170515,[19.92628039]
2022,13,NCAAF_20221126_PITT@MIAMI,Miami (Fla.),Hurricanes,Pittsburgh,Panthers,5-7,8-4,1,0,28,16,42,0,0,3,13,14,14,7,7,-3,-28,-26,0.5268428634564885,[1.13911658]
2022,13,NCAAF_20221126_AF@SDGST,San Diego St.,Aztecs,Air Force,Falcons,7-5,9-3,0,0,7,3,13,0,0,3,0,7,0,3,3,-2,-7,-10,0.42776573937473283,[-3.07998422]
2022,13,NCAAF_20221126_WASH@WASHST,Washington St.,Cougars,Washington,Huskies,7-5,10-2,1,27,28,33,51,10,17,6,0,7,21,7,16,-3,-1,-18,0.40736258555462734,[-3.96422098]
2022,13,NCAAF_20221126_BYU@STNFRD,Stanford,Cardinal,BYU,Cougars,3-9,7-5,0,12,28,26,35,3,9,0,14,14,14,0,7,-4,-16,-9,0.513939221369208,[0.59120507]
2022,13,NCAAF_20221125_BAYLOR@TEXAS,Texas,Longhorns,Baylor,Bears,8-4,6-6,0,17,19,38,27,14,3,7,14,9,10,0,8,2,-2,11,0.672079932661984,[7.53925862]
2022,13,NCAAF_20221125_CMICH@EMICH,E. Michigan,Eagles,C. Michigan,Chippewas,8-4,4-8,1,14,13,38,19,14,0,14,10,7,6,0,6,4,1,19,0.5006671138693585,[0.0282886]
2022,13,NCAAF_20221125_TOLEDO@WMICH,W. Michigan,Broncos,Toledo,Rockets,5-7,7-5,1,10,7,20,14,0,10,10,0,0,7,0,7,-2,3,6,0.40804910845912534,[-3.93430518]
2022,13,NCAAF_20221125_TULANE@CINCY,Cincinnati,Bearcats,Tulane,Green Wave,9-3,10-2,1,10,13,24,27,0,10,7,7,3,10,7,7,-1,-3,-3,0.6937381284963311,[8.56798502]
2022,13,NCAAF_20221125_UTAHST@BOISE,Boise St.,Broncos,Utah St.,Aggies,9-3,6-6,1,21,7,42,23,0,21,7,14,0,7,10,6,3,14,19,0.718841614734036,[9.80172721]
2022,13,NCAAF_20221125_ARIZST@ARIZ,Arizona,Wildcats,Arizona St.,Sun Devils,5-7,3-9,0,10,14,38,35,7,3,21,7,0,14,14,7,2,-4,3,0.3160524993121554,[-8.09924888]
2022,13,NCAAF_20221125_ARK@MIZZOU,Missouri,Tigers,Arkansas,Razorbacks,6-6,6-6,0,20,21,29,27,10,10,9,0,7,14,3,3,0,-1,2,0.6529293380067368,[6.6524305]
2022,13,NCAAF_20221125_NMEX@COLOST,Colorado St.,Rams,New Mexico,Lobos,3-9,2-10,0,7,0,17,0,0,7,3,7,0,0,0,0,1,7,17,0.7013858526377446,[8.93874088]
2022,13,NCAAF_20221125_NEB@IOWA,Iowa,Hawkeyes,Nebraska,Cornhuskers,7-5,4-8,1,0,17,17,24,0,0,7,10,10,7,7,0,3,-17,-7,0.7735447249064962,[12.69735911]
2022,13,NCAAF_20221125_UCLA@CAL,California,Golden Bears,UCLA,Bruins,4-8,9-3,0,21,17,28,35,7,14,0,7,7,10,7,11,-5,4,-7,0.452514875184994,[-2.018358]
2022,13,NCAAF_20221125_FLA@FSU,Florida State,Seminoles,Florida,Gators,9-3,6-6,1,21,24,45,38,14,7,17,7,14,10,0,14,3,-3,7,0.2807846767679797,[-9.82047638]
2022,13,NCAAF_20221125_WYO@FRESNO,Fresno St.,Bulldogs,Wyoming,Cowboys,8-4,7-5,1,23,0,30,0,14,9,7,0,0,0,0,0,1,23,30,0.6581168783923421,[6.8907551]
2022,13,NCAAF_20221124_MISSST@MISS,Ole Miss,Rebels,Miss. State,Bulldogs,8-4,8-4,1,16,14,22,24,6,10,0,6,7,7,0,10,0,2,-2,0.41393446321590144,[-3.67833994]
2022,13,NCAAF_20221122_BALLST@MIAOH,Miami-OH,RedHawks,Ball St.,Cardinals,6-6,5-7,1,3,14,18,17,0,3,3,12,7,7,3,0,1,-11,1,0.6384640438071154,[5.99461659]
2022,13,NCAAF_20221122_BGREEN@OHIO,Ohio,Bobcats,Bowling Green,Falcons,9-3,6-6,0,28,7,38,14,0,28,3,7,7,0,0,7,3,21,24,0.8811312795327684,[19.97314727]
2022,14,NCAAF_20221203_TOLEDO@OHIO,Ohio,Bobcats,Toledo,Rockets,9-4,8-5,0,7,10,7,17,0,7,0,0,7,3,0,7,1,-3,-10,0.4944554219574776,[-0.23555747]
2022,14,NCAAF_20221203_VALPO@NMEXST,New Mexico St.,,Valparaiso,,6-6,5-7,,35,3,65,3,21,14,17,13,0,3,0,0,1,32,62,,
2022,14,NCAAF_20221203_CSTCAR@TROY,Troy,Trojans,C. Carolina,Chanticleers,11-2,9-3,1,31,7,45,26,17,14,14,0,0,7,6,13,2,24,19,0.5323066581020635,[1.37398482]
2022,14,NCAAF_20221203_FRESNO@BOISE,Boise St.,Broncos,Fresno St.,Bulldogs,9-4,9-4,1,6,14,16,28,0,6,3,7,0,14,0,14,0,-8,-12,0.616950382360502,[5.04177935]
2022,14,NCAAF_20221203_LSU@UGA,Georgia,Bulldogs,LSU,Tigers,13-0,9-4,0,35,10,50,30,14,21,7,8,7,3,13,7,4,25,20,0.7608039974706216,[12.01445385]
2022,14,NCAAF_20221203_UCF@TULANE,Tulane,Green Wave,UCF,Knights,11-2,9-4,0,17,7,45,28,10,7,7,21,0,7,7,14,2,10,17,0.2570766226786506,[-11.05676308]
2022,14,NCAAF_20221203_CLEM@UNC,North Carolina,Tar Heels,Clemson,Tigers,9-4,11-2,0,10,24,10,39,7,3,0,0,14,10,15,0,-2,-14,-29,0.10355132502550746,[-21.38142652]
2022,14,NCAAF_20221203_PURDUE@MICH,Michigan,Wolverines,Purdue,Boilermakers,13-0,8-5,0,14,13,43,22,7,7,14,15,7,6,3,6,5,1,21,0.811883145403202,[14.99676534]
2022,14,NCAAF_20221202_AKRON@BUFF,Buffalo,Bulls,Akron,Zips,6-6,2-10,0,10,16,23,22,0,10,7,6,9,7,0,6,4,-6,1,0.864083810877477,[18.62361069]
2022,14,NCAAF_20221202_NTEXAS@TXSA,UTSA,Roadrunners,North Texas,Mean Green,11-2,7-6,1,24,10,48,27,7,17,10,14,7,3,10,7,4,14,21,0.4898356939527555,[-0.43185616]
2022,14,NCAAF_20221202_UTAH@USC,USC,Trojans,Utah,Utes,11-2,10-3,1,17,17,24,47,14,3,0,7,3,14,7,23,1,0,-23,0.363132655639669,[-5.9335393]
