,year,week,game_id,home_team,home_team_nickname,away_team,away_team_nickname,home_team_record,away_team_record,home_first_pos,home_team_halftime,away_team_halftime,home_team_final,away_team_final,home_team_q1,home_team_q2,home_team_q3,home_team_q4,away_team_q1,away_team_q2,away_team_q3,away_team_q4,homewins-awaywins,halftime_differential,q1_differential,q3_differential,final_differential,home_win_prob,predicted_diff,home_win_prob_last15,predicted_diff_last15
0,2017,1,NCAAF_20170903_TXAM@UCLA,UCLA,,Texas A&M,,1-0,0-1,,10,38,45,44,3,7,7,28,17,21,6,0,1,-28,-14,-28,1,,,,
1,2017,1,NCAAF_20170903_WVU@VATECH,Virginia Tech,,West Virginia,,1-0,0-1,,10,7,31,24,3,7,14,7,0,7,10,7,1,3,3,3,7,,,,
2,2017,1,NCAAF_20170902_AKRON@PSU,Penn State,,Akron,,1-0,0-1,,35,0,52,0,14,21,10,7,0,0,0,0,1,35,14,35,52,,,,
3,2017,1,NCAAF_20170902_BALLST@ILL,Illinois,,Ball St.,,1-0,0-1,,16,7,24,21,6,10,0,8,7,0,14,0,1,9,-1,9,3,,,,
4,2017,1,NCAAF_20170902_BGREEN@MICHST,Michigan St.,,Bowling Green,,1-0,0-1,,14,3,35,10,0,14,21,0,3,0,0,7,1,11,-3,11,25,,,,
5,2017,1,NCAAF_20170902_KENTST@CLEM,Clemson,,Kent St.,,1-0,0-1,,28,3,56,3,21,7,21,7,0,3,0,0,1,25,21,25,53,,,,
6,2017,1,NCAAF_20170902_MD@TEXAS,Texas,,Maryland,,0-1,1-0,,14,30,41,51,7,7,20,7,14,16,7,14,-1,-16,-7,-16,-10,,,,
7,2017,1,NCAAF_20170902_MOST@MIZZOU,Missouri,,Missouri St.,,1-0,0-1,,48,35,72,43,20,28,10,14,21,14,0,8,1,13,-1,13,29,,,,
8,2017,1,NCAAF_20170902_WYO@IOWA,Iowa,,Wyoming,,1-0,0-1,,14,3,24,3,0,14,7,3,0,3,0,0,1,11,0,11,21,,,,
9,2017,1,NCAAF_20170902_CAL@UNC,North Carolina,,California,,0-1,1-0,,17,14,30,35,7,10,7,6,7,7,7,14,-1,3,0,3,-5,,,,
10,2017,1,NCAAF_20170902_BTHN@MIAMI,Miami (Fla.),,Bethune-Cook.,,1-0,0-1,,24,6,41,13,3,21,14,3,3,3,7,0,1,18,0,18,28,,,,
11,2017,1,NCAAF_20170902_PORTST@OREGST,Oregon State,,Portland St.,,1-1,0-2,,14,6,35,32,7,7,14,7,6,0,20,6,1,8,1,8,3,,,,
12,2017,1,NCAAF_20170902_VMI@AF,Air Force,,VMI,,1-0,0-1,,35,0,62,0,14,21,14,13,0,0,0,0,1,35,14,35,62,,,,
13,2017,1,NCAAF_20170902_NCST@SC,South Carolina,,NC State,,1-0,0-1,,21,21,35,28,14,7,14,0,14,7,0,7,1,0,0,0,7,,,,
14,2017,1,NCAAF_20170902_ALAM@UAB,UAB,,Alabama A&M,,1-0,0-1,,10,7,38,7,7,3,14,14,0,7,0,0,1,3,7,3,31,,,,
15,2017,1,NCAAF_20170902_MICH@FLA,Florida,,Michigan,,0-1,1-0,,17,13,17,33,3,14,0,0,10,3,13,7,-1,4,-7,4,-16,,,,
16,2017,1,NCAAF_20170902_NEVADA@NWEST,Northwestern,,Nevada,,1-0,0-1,,7,17,31,20,7,0,10,14,7,10,0,3,1,-10,0,-10,11,,,,
17,2017,1,NCAAF_20170902_TEMPLE@ND,Notre Dame,,Temple,,1-0,0-1,,28,10,49,16,21,7,7,14,3,7,0,6,1,18,18,18,33,,,,
18,2017,1,NCAAF_20170902_UTEP@OKLA,Oklahoma,,UTEP,,1-0,0-1,,35,7,56,7,14,21,14,7,7,0,0,0,1,28,7,28,49,,,,
19,2017,1,NCAAF_20170902_WMMARY@UVA,Virginia,,William & Mary,,1-0,0-1,,14,0,28,10,7,7,7,7,0,0,3,7,1,14,7,14,18,,,,
20,2017,1,NCAAF_20170902_TROY@BOISE,Boise St.,,Troy,,1-0,0-1,,17,10,24,13,7,10,0,7,3,7,0,3,1,7,4,7,11,,,,
21,2017,1,NCAAF_20170902_CHARSO@MISSST,Miss. State,,Charleston So.,,1-0,0-1,,35,0,49,0,23,12,7,7,0,0,0,0,1,35,23,35,49,,,,
22,2017,1,NCAAF_20170902_EWASH@TXTECH,Texas Tech,,E. Washington,,1-0,0-1,,28,10,56,10,7,21,21,7,0,10,0,0,1,18,7,18,46,,,,
23,2017,1,NCAAF_20170902_STONYBRK@SFLA,South Florida,,Stony Brook,,2-0,0-1,,7,10,31,17,7,0,10,14,7,3,0,7,2,-3,0,-3,14,,,,
24,2017,1,NCAAF_20170902_UK@USM,So. Miss,,Kentucky,,0-1,1-0,,3,14,17,24,0,3,7,7,0,14,10,0,-1,-11,0,-11,-7,,,,
25,2017,1,NCAAF_20170902_WMICH@USC,USC,,W. Michigan,,1-0,0-1,,14,14,49,31,7,7,7,28,7,7,7,10,1,0,0,0,18,,,,
26,2017,1,NCAAF_20170902_ALBANY@ODU,Old Dominion,,Albany,,1-0,0-1,,21,3,31,17,7,14,3,7,3,0,0,14,1,18,4,18,14,,,,
27,2017,1,NCAAF_20170902_JMAD@ECU,East Carolina,,James Madison,,0-1,1-0,,0,7,14,34,0,0,7,7,7,0,14,13,-1,-7,-7,-7,-20,,,,
28,2017,1,NCAAF_20170902_NCCEN@DUKE,Duke,,NC Central,,1-0,0-1,,47,7,60,7,21,26,6,7,0,7,0,0,1,40,21,40,53,,,,
29,2017,1,NCAAF_20170902_APLST@UGA,Georgia,,App. St.,,1-0,0-1,,21,0,31,10,7,14,10,0,0,0,0,10,1,21,7,21,21,,,,
30,2017,1,NCAAF_20170902_MIAOH@MRSHL,Marshall,,Miami-OH,,1-0,0-1,,21,13,31,26,7,14,7,3,3,10,7,6,1,8,4,8,5,,,,
31,2017,1,NCAAF_20170902_EKY@WKY,W. Kentucky,,E. Kentucky,,1-0,0-1,,17,0,31,17,0,17,7,7,0,0,14,3,1,17,0,17,14,,,,
32,2017,1,NCAAF_20170902_HAMP@OHIO,Ohio,,Hampton,,1-0,0-1,,20,0,59,0,7,13,26,13,0,0,0,0,1,20,7,20,59,,,,
33,2017,1,NCAAF_20170902_HOUBP@TXSTSM,Texas St.,,Houston Christian,,1-0,0-1,,10,9,20,11,0,10,7,3,9,0,0,2,1,1,-9,1,9,,,,
34,2017,1,NCAAF_20170902_LAMAR@NTEXAS,North Texas,,Lamar,,1-0,0-1,,38,14,59,14,17,21,14,7,7,7,0,0,1,24,10,24,45,,,,
35,2017,1,NCAAF_20170902_LIB@BAYLOR,Baylor,,Liberty,,0-1,1-0,,17,17,45,48,0,17,14,14,6,11,17,14,-1,0,-6,0,-3,,,,
36,2017,1,NCAAF_20170902_MA@CSTCAR,C. Carolina,,UMass,,1-0,0-2,,21,14,38,28,14,7,10,7,7,7,7,7,1,7,7,7,10,,,,
37,2017,1,NCAAF_20170902_NWST@LATECH,Louisiana Tech,,Northwestern St.,,1-0,0-1,,24,10,52,24,10,14,7,21,7,3,14,0,1,14,3,14,28,,,,
38,2017,1,NCAAF_20170902_SELOU@LALAF,Louisiana,,SE Louisiana,,1-0,0-1,,35,35,51,48,21,14,7,9,21,14,0,13,1,0,0,0,3,,,,
39,2017,1,NCAAF_20170902_SEMOST@KANSAS,Kansas,,SE Missouri St.,,1-0,0-1,,21,7,38,16,14,7,14,3,0,7,3,6,1,14,14,14,22,,,,
40,2017,1,NCAAF_20170902_SFA@SMU,SMU,,S.F. Austin,,1-0,0-1,,38,7,58,14,21,17,6,14,0,7,0,7,1,31,21,31,44,,,,
41,2017,1,NCAAF_20170902_CAR@KSTATE,Kansas State,,Cent. Ark.,,1-0,0-1,,38,16,55,19,10,28,10,7,10,6,3,0,1,22,0,22,36,,,,
42,2017,1,NCAAF_20170902_CPOLY@SJST,San Jose St.,,Cal-Poly,,1-0,0-2,,7,6,34,13,0,7,13,14,3,3,0,7,1,1,-3,1,21,,,,
43,2017,1,NCAAF_20170902_GAS@AUBURN,Auburn,,Ga. Southern,,1-0,0-1,,24,7,41,7,10,14,10,7,7,0,0,0,1,17,3,17,34,,,,
44,2017,1,NCAAF_20170902_LVILLE@PURDUE,Purdue,,Louisville,,0-1,1-0,,14,10,28,35,7,7,7,7,7,3,15,10,-1,4,0,4,-7,,,,
45,2017,1,NCAAF_20170902_SALA@MISS,Ole Miss,,South Alabama,,1-0,0-1,,13,10,47,27,10,3,27,7,0,10,3,14,1,3,10,3,20,,,,
46,2017,1,NCAAF_20170902_ABIL@NMEX,New Mexico,,Abil Christian,,1-0,0-1,,14,7,38,14,7,7,10,14,7,0,0,7,1,7,0,7,24,,,,
47,2017,1,NCAAF_20170902_ARKST@NEB,Nebraska,,Arkansas St.,,1-0,0-1,,27,26,43,36,17,10,7,9,14,12,0,10,1,1,3,1,7,,,,
48,2017,1,NCAAF_20170902_FSU@BAMA,Alabama,,Florida State,,1-0,0-1,,10,7,24,7,3,7,11,3,0,7,0,0,1,3,3,3,17,,,,
49,2017,1,NCAAF_20170902_GRAM@TULANE,Tulane,,Grambling,,1-0,0-1,,24,0,43,14,14,10,7,12,0,0,7,7,1,24,14,24,29,,,,
50,2017,1,NCAAF_20170902_JACKST@TCU,TCU,,Jackson St.,,1-0,0-1,,35,0,63,0,21,14,21,7,0,0,0,0,1,35,21,35,63,,,,
51,2017,1,NCAAF_20170902_NOIOWA@IOWAST,Iowa St.,,Northern Iowa,,1-0,0-1,,21,10,42,24,14,7,14,7,7,3,7,7,1,11,7,11,18,,,,
52,2017,1,NCAAF_20170902_VANDY@MTSU,Middle Tenn.,,Vanderbilt,,0-1,1-0,,0,21,6,28,0,0,0,6,14,7,7,0,-1,-21,-14,-21,-22,,,,
53,2017,1,NCAAF_20170902_SUT@OREG,Oregon,,So. Utah,,1-0,0-1,,42,21,77,21,21,21,21,14,7,14,0,0,1,21,14,21,56,,,,
54,2017,1,NCAAF_20170902_DAVIS@SDGST,San Diego St.,,UC-Davis,,1-0,0-1,,24,3,38,17,10,14,14,0,3,0,0,14,1,21,7,21,21,,,,
55,2017,1,NCAAF_20170902_HOW@UNLV,UNLV,,Howard,,0-1,1-0,,19,21,40,43,6,13,14,7,7,14,7,15,-1,-2,-1,-2,-3,,,,
56,2017,1,NCAAF_20170902_BYU@LSU,LSU,,BYU,,1-0,1-1,,14,0,27,0,0,14,6,7,0,0,0,0,0,14,0,14,27,,,,
57,2017,1,NCAAF_20170902_UIW@FRESNO,Fresno St.,,Incarnate Word,,1-0,0-1,,34,0,66,0,17,17,32,0,0,0,0,0,1,34,17,34,66,,,,
58,2017,1,NCAAF_20170902_MTST@WASHST,Washington St.,,Montana St.,,1-0,0-1,,14,0,31,0,7,7,7,10,0,0,0,0,1,14,7,14,31,,,,
59,2017,1,NCAAF_20170902_NAZ@ARIZ,Arizona,,N. Arizona,,1-0,0-1,,34,14,62,24,14,20,14,14,7,7,0,10,1,20,7,20,38,,,,
60,2017,1,NCAAF_20170902_WCAR@HAWAII,Hawaii,,W. Carolina,,2-0,0-1,,21,10,41,18,7,14,13,7,0,10,8,0,2,11,7,11,23,,,,
61,2017,1,NCAAF_20170901_FORD@ARMY,Army,,Fordham,,1-0,0-1,,34,6,64,6,21,13,17,13,0,6,0,0,1,28,21,28,58,,,,
62,2017,1,NCAAF_20170901_CHARLO@EMICH,E. Michigan,,Charlotte,,1-0,0-1,,17,7,24,7,14,3,7,0,7,0,0,0,1,10,7,10,17,,,,
63,2017,1,NCAAF_20170901_CCTST@CUSE,Syracuse,,CCSU,,1-0,0-1,,31,0,50,7,21,10,13,6,0,0,7,0,1,31,21,31,43,,,,
64,2017,1,NCAAF_20170901_COLOST@COLO,Colorado,,Colorado St.,,1-0,1-1,,17,3,17,3,10,7,0,0,0,3,0,0,0,14,10,14,14,,,,
65,2017,1,NCAAF_20170901_NAVY@FAU,FAU,,Navy,,0-1,1-0,,10,21,19,42,3,7,3,6,7,14,14,7,-1,-11,-4,-11,-23,,,,
66,2017,1,NCAAF_20170901_WASH@RUT,Rutgers,,Washington,,0-1,1-0,,7,10,14,30,7,0,0,7,3,7,10,10,-1,-3,4,-3,-16,,,,
67,2017,1,NCAAF_20170901_UTAHST@WISC,Wisconsin,,Utah St.,,1-0,0-1,,10,10,59,10,0,10,28,21,10,0,0,0,1,0,-10,0,49,,,,
68,2017,1,NCAAF_20170901_BC@NILL,N. Illinois,,Boston College,,0-1,1-0,,10,13,20,23,3,7,7,3,3,10,7,3,-1,-3,0,-3,-3,,,,
69,2017,1,NCAAF_20170831_FIU@UCF,UCF,,FIU,,1-0,0-1,,40,10,61,17,14,26,14,7,7,3,7,0,1,30,7,30,44,,,,
70,2017,1,NCAAF_20170831_PRESBY@WAKE,Wake Forest,,Presbyterian,,1-0,0-1,,37,0,51,7,16,21,14,0,0,0,0,7,1,37,16,37,44,,,,
71,2017,1,NCAAF_20170831_AP@CINCY,Cincinnati,,Austin Peay,,1-0,0-1,,14,7,26,14,0,14,6,6,0,7,0,7,1,7,0,7,12,,,,
72,2017,1,NCAAF_20170831_BUFF@MINN,Minnesota,,Buffalo,,1-0,0-1,,14,7,17,7,14,0,0,3,7,0,0,0,1,7,7,7,10,,,,
73,2017,1,NCAAF_20170831_ELON@TOLEDO,Toledo,,Elon,,1-0,0-1,,19,7,47,13,13,6,21,7,0,7,0,6,1,12,13,12,34,,,,
74,2017,1,NCAAF_20170831_TNST@GAST,Georgia St.,,Tennessee St.,,0-1,1-0,,3,10,10,17,0,3,0,7,3,7,7,0,-1,-7,-3,-7,-7,,,,
75,2017,1,NCAAF_20170831_HOLY@UCONN,UConn,,Holy Cross,,1-0,0-1,,7,20,27,20,7,0,7,13,3,17,0,0,1,-13,4,-13,7,,,,
76,2017,1,NCAAF_20170831_NDK@UTAH,Utah,,North Dakota,,1-0,0-1,,17,9,37,16,0,17,10,10,3,6,0,7,1,8,-3,8,21,,,,
77,2017,1,NCAAF_20170831_TULSA@OKLAST,Oklahoma State,,Tulsa,,1-0,0-1,,38,17,59,24,21,17,14,7,0,17,0,7,1,21,21,21,35,,,,
78,2017,1,NCAAF_20170831_FAMU@ARK,Arkansas,,Florida A&M,,1-0,1-1,,21,0,49,7,7,14,14,14,0,0,0,7,0,21,7,21,42,,,,
79,2017,1,NCAAF_20170831_OHIOST@IND,Indiana,,Ohio State,,0-1,1-0,,14,13,21,49,7,7,7,0,3,10,22,14,-1,1,4,1,-28,,,,
80,2017,1,NCAAF_20170831_LAMON@MEMP,Memphis,,UL-Monroe,,1-0,0-1,,20,7,37,29,7,13,17,0,7,0,7,15,1,13,0,13,8,,,,
81,2017,1,NCAAF_20170831_SACST@IDAHO,Idaho,,Sacramento St.,,1-0,0-1,,14,6,28,6,0,14,7,7,0,6,0,0,1,8,0,8,22,,,,
82,2017,1,NCAAF_20170831_NMEXST@ARIZST,Arizona St.,,New Mexico St.,,1-0,0-1,,14,13,37,31,14,0,16,7,0,13,0,18,1,1,14,1,6,,,,
83,2017,1,NCAAF_20170826_OREGST@COLOST,Colorado St.,,Oregon State,,1-1,1-1,,24,20,58,27,7,17,10,24,10,10,0,7,0,4,-3,4,31,,,,
84,2017,1,NCAAF_20170826_PORTST@BYU,BYU,,Portland St.,,1-1,0-2,,14,6,20,6,7,7,0,6,0,6,0,0,1,8,7,8,14,,,,
85,2017,1,NCAAF_20170826_HAWAII@MA,UMass,,Hawaii,,0-2,2-0,,14,14,35,38,7,7,14,7,7,7,7,17,-2,0,0,0,-3,,,,
86,2017,1,NCAAF_20170826_SFLA@SJST,San Jose St.,,South Florida,,1-0,2-0,,16,28,22,42,16,0,0,6,0,28,7,7,-1,-12,16,-12,-20,,,,
87,2017,1,NCAAF_20170826_STNFRD@RICE,Rice,,Stanford,,0-1,1-0,,0,38,7,62,0,0,0,7,21,17,14,10,-1,-38,-21,-38,-55,,,,
88,2017,2,NCAAF_20170909_BUFF@ARMY,Army,,Buffalo,,2-0,0-2,,7,17,21,17,7,0,0,14,3,14,0,0,2,-10,4,-10,4,,,,
89,2017,2,NCAAF_20170909_CHARLO@KSTATE,Kansas State,,Charlotte,,2-0,0-2,,38,7,55,7,21,17,10,7,7,0,0,0,2,31,14,31,48,,,,
90,2017,2,NCAAF_20170909_CINCY@MICH,Michigan,,Cincinnati,,2-0,1-1,,17,7,36,14,14,3,7,12,7,0,7,0,1,10,7,10,22,,,,
91,2017,2,NCAAF_20170909_ECU@WVU,West Virginia,,East Carolina,,1-1,0-2,,49,3,56,20,21,28,7,0,3,0,10,7,1,46,18,46,36,,,,
92,2017,2,NCAAF_20170909_EKY@UK,Kentucky,,E. Kentucky,,2-0,0-2,,10,13,27,16,3,7,7,10,7,6,3,0,2,-3,-4,-3,11,,,,
93,2017,2,NCAAF_20170909_FAU@WISC,Wisconsin,,FAU,,2-0,0-2,,24,14,31,14,14,10,7,0,7,7,0,0,2,10,7,10,17,,,,
94,2017,2,NCAAF_20170909_LVILLE@UNC,North Carolina,,Louisville,,0-2,2-0,,14,20,35,47,7,7,14,7,10,10,7,20,-2,-6,-3,-6,-12,,,,
95,2017,2,NCAAF_20170909_NWEST@DUKE,Duke,,Northwestern,,2-0,1-1,,21,10,41,17,7,14,10,10,3,7,0,7,1,11,4,11,24,,,,
96,2017,2,NCAAF_20170909_TNMART@MISS,Ole Miss,,UT Martin,,2-0,1-1,,17,16,45,23,7,10,21,7,9,7,0,7,1,1,-2,1,22,,,,
97,2017,2,NCAAF_20170909_TWST@MD,Maryland,,Towson,,2-0,1-1,,28,7,63,17,21,7,21,14,0,7,0,10,1,21,21,21,46,,,,
98,2017,2,NCAAF_20170909_JAXST@GATECH,Georgia Tech,,Jacksonville St.,,1-1,1-1,,10,7,37,10,3,7,20,7,0,7,3,0,0,3,3,3,27,,,,
99,2017,2,NCAAF_20170909_WAKE@BC,Boston College,,Wake Forest,,1-1,2-0,,7,21,10,34,0,7,3,0,7,14,10,3,-1,-14,-7,-14,-24,,,,
100,2017,2,NCAAF_20170909_TXSTSM@COLO,Colorado,,Texas St.,,2-0,1-1,,14,0,37,3,7,7,17,6,0,0,3,0,1,14,7,14,34,,,,
101,2017,2,NCAAF_20170909_UAB@BALLST,Ball St.,,UAB,,1-1,1-1,,21,17,51,31,7,14,17,13,3,14,7,7,0,4,4,4,20,,,,
102,2017,2,NCAAF_20170909_ABIL@COLOST,Colorado St.,,Abil Christian,,2-1,0-2,,17,0,38,10,10,7,14,7,0,0,10,0,2,17,10,17,28,,,,
103,2017,2,NCAAF_20170909_AP@MIAOH,Miami-OH,,Austin Peay,,1-1,0-2,,21,7,31,10,7,14,0,10,7,0,3,0,1,14,0,14,21,,,,
104,2017,2,NCAAF_20170909_DE@VATECH,Virginia Tech,,Delaware,,2-0,1-1,,17,0,27,0,7,10,0,10,0,0,0,0,1,17,7,17,27,,,,
105,2017,2,NCAAF_20170909_EIL@NILL,N. Illinois,,E. Illinois,,1-1,1-1,,31,3,38,10,7,24,7,0,3,0,0,7,0,28,4,28,28,,,,
106,2017,2,NCAAF_20170909_EMICH@RUT,Rutgers,,E. Michigan,,0-2,2-0,,3,10,13,16,3,0,10,0,7,3,3,3,-2,-7,-4,-7,-3,,,,
107,2017,2,NCAAF_20170909_FRESNO@BAMA,Alabama,,Fresno St.,,2-0,1-1,,28,3,41,10,14,14,3,10,3,0,0,7,1,25,11,25,31,,,,
108,2017,2,NCAAF_20170909_HOW@KENTST,Kent St.,,Howard,,1-1,1-1,,21,14,38,31,14,7,2,15,7,7,10,7,0,7,7,7,7,,,,
109,2017,2,NCAAF_20170909_IND@UVA,Virginia,,Indiana,,1-1,1-1,,3,17,17,34,0,3,7,7,0,17,10,7,0,-14,0,-14,-17,,,,
110,2017,2,NCAAF_20170909_MTSU@CUSE,Syracuse,,Middle Tenn.,,1-1,1-1,,13,9,23,30,3,10,3,7,2,7,7,14,0,4,1,4,-7,,,,
111,2017,2,NCAAF_20170909_NOVA@TEMPLE,Temple,,Villanova,,1-1,1-1,,10,0,16,13,3,7,3,3,0,0,3,10,0,10,3,10,3,,,,
112,2017,2,NCAAF_20170909_ODU@MA,UMass,,Old Dominion,,0-3,2-0,,0,10,7,17,0,0,7,0,3,7,0,7,-2,-10,-3,-10,-10,,,,
113,2017,2,NCAAF_20170909_PITT@PSU,Penn State,,Pittsburgh,,2-0,1-1,,14,3,33,14,14,0,7,12,0,3,3,8,1,11,14,11,19,,,,
114,2017,2,NCAAF_20170909_SAV@APLST,App. St.,,Savannah St.,,1-1,0-1,,45,0,54,7,14,31,2,7,0,0,0,7,1,45,14,45,47,,,,
115,2017,2,NCAAF_20170909_SJST@TEXAS,Texas,,San Jose St.,,1-1,1-2,,21,0,56,0,7,14,14,21,0,0,0,0,0,21,7,21,56,,,,
116,2017,2,NCAAF_20170909_TCU@ARK,Arkansas,,TCU,,1-1,2-0,,7,14,7,28,7,0,0,0,7,7,0,14,-1,-7,0,-7,-21,,,,
117,2017,2,NCAAF_20170909_TULANE@NAVY,Navy,,Tulane,,2-0,1-1,,14,13,23,21,7,7,9,0,0,13,0,8,1,1,7,1,2,,,,
118,2017,2,NCAAF_20170909_WMICH@MICHST,Michigan St.,,W. Michigan,,2-0,0-2,,14,0,28,14,7,7,7,7,0,0,7,7,2,14,7,14,14,,,,
119,2017,2,NCAAF_20170909_ALAM@VANDY,Vanderbilt,,Alabama A&M,,2-0,0-2,,35,0,42,0,14,21,7,0,0,0,0,0,2,35,14,35,42,,,,
120,2017,2,NCAAF_20170909_CMICH@KANSAS,Kansas,,C. Michigan,,1-1,2-0,,6,24,27,45,3,3,14,7,0,24,7,14,-1,-18,3,-18,-18,,,,
121,2017,2,NCAAF_20170909_GRDWB@WYO,Wyoming,,Gardner-Webb,,1-1,0-2,,24,0,27,0,14,10,0,3,0,0,0,0,1,24,14,24,27,,,,
122,2017,2,NCAAF_20170909_INST@TENN,Tennessee,,Indiana St.,,2-0,0-2,,28,0,42,7,14,14,7,7,0,0,7,0,2,28,14,28,35,,,,
123,2017,2,NCAAF_20170909_LALAF@TULSA,Tulsa,,Louisiana,,1-1,1-1,,38,23,66,42,10,28,7,21,10,13,12,7,0,15,0,15,24,,,,
124,2017,2,NCAAF_20170909_NH@GAS,Ga. Southern,,New Hamp.,,0-2,2-0,,0,22,12,22,0,0,5,7,15,7,0,0,-2,-22,-15,-22,-10,,,,
125,2017,2,NCAAF_20170909_NEB@OREG,Oregon,,Nebraska,,2-0,1-1,,42,14,42,35,21,21,0,0,7,7,14,7,1,28,14,28,7,,,,
126,2017,2,NCAAF_20170909_HAWAII@UCLA,UCLA,,Hawaii,,2-0,2-1,,35,7,56,23,14,21,14,7,0,7,7,9,0,28,14,28,33,,,,
127,2017,2,NCAAF_20170909_WBRST@CAL,California,,Weber St.,,2-0,1-1,,17,20,33,20,7,10,0,16,10,10,0,0,1,-3,-3,-3,13,,,,
128,2017,2,NCAAF_20170909_ALST@TROY,Troy,,Alabama St.,,1-1,0-2,,20,7,34,7,7,13,7,7,7,0,0,0,1,13,0,13,27,,,,
129,2017,2,NCAAF_20170909_MRSHL@NCST,NC State,,Marshall,,1-1,1-1,,23,20,37,20,3,20,7,7,10,10,0,0,0,3,-7,3,17,,,,
130,2017,2,NCAAF_20170909_SD@BGREEN,Bowling Green,,South Dakota,,0-2,2-0,,9,21,27,35,3,6,7,11,21,0,7,7,-2,-12,-18,-12,-8,,,,
131,2017,2,NCAAF_20170909_ARPB@AKRON,Akron,,Ark.-Pine Bluff,,1-1,1-1,,31,3,52,3,14,17,14,7,0,3,0,0,0,28,14,28,49,,,,
132,2017,2,NCAAF_20170909_AUBURN@CLEM,Clemson,,Auburn,,2-0,1-1,,7,6,14,6,0,7,7,0,3,3,0,0,1,1,-3,1,8,,,,
133,2017,2,NCAAF_20170909_NICHST@TXAM,Texas A&M,,Nicholls St.,,1-1,1-1,,14,6,24,14,14,0,0,10,0,6,0,8,0,8,14,8,10,,,,
134,2017,2,NCAAF_20170909_NTEXAS@SMU,SMU,,North Texas,,2-0,1-1,,24,10,54,32,10,14,16,14,10,0,7,15,1,14,0,14,22,,,,
135,2017,2,NCAAF_20170909_SC@MIZZOU,Missouri,,South Carolina,,1-1,2-0,,10,14,13,31,3,7,3,0,0,14,10,7,-1,-4,3,-4,-18,,,,
136,2017,2,NCAAF_20170909_SO@USM,So. Miss,,Southern U.,,1-1,1-1,,35,0,45,0,28,7,10,0,0,0,0,0,0,35,28,35,45,,,,
137,2017,2,NCAAF_20170909_TOLEDO@NEVADA,Nevada,,Toledo,,0-2,2-0,,10,20,24,37,3,7,14,0,17,3,14,3,-2,-10,-14,-10,-13,,,,
138,2017,2,NCAAF_20170909_UNLV@IDAHO,Idaho,,UNLV,,1-1,1-1,,3,10,16,44,0,3,7,6,7,3,24,10,0,-7,-7,-7,-28,,,,
139,2017,2,NCAAF_20170909_MISSST@LATECH,Louisiana Tech,,Miss. State,,1-1,2-0,,14,36,21,57,9,5,0,7,16,20,21,0,-1,-22,-7,-22,-36,,,,
140,2017,2,NCAAF_20170909_OKLA@OHIOST,Ohio State,,Oklahoma,,1-1,2-0,,3,3,16,31,0,3,10,3,0,3,14,14,-1,0,0,0,-15,,,,
141,2017,2,NCAAF_20170909_TNCHAT@LSU,LSU,,Chattanooga,,2-0,0-2,,28,3,45,10,14,14,14,3,3,0,0,7,2,25,11,25,35,,,,
142,2017,2,NCAAF_20170909_UGA@ND,Notre Dame,,Georgia,,1-0,1-0,,13,10,19,20,3,10,3,3,3,7,7,3,0,3,0,3,-1,,,,
143,2017,2,NCAAF_20170909_MT@WASH,Washington,,Montana,,2-0,1-1,,35,7,63,7,21,14,14,14,7,0,0,0,1,28,14,28,56,,,,
144,2017,2,NCAAF_20170909_NMEXST@NMEX,New Mexico,,New Mexico St.,,1-1,1-1,,5,23,28,30,2,3,0,23,13,10,7,0,0,-18,-11,-18,-2,,,,
145,2017,2,NCAAF_20170909_RICE@UTEP,UTEP,,Rice,,0-2,1-1,,7,10,14,31,7,0,0,7,3,7,7,14,-1,-3,4,-3,-17,,,,
146,2017,2,NCAAF_20170909_TXSA@BAYLOR,Baylor,,UTSA,,0-2,1-0,,7,7,10,17,0,7,0,3,0,7,7,3,-1,0,0,0,-7,,,,
147,2017,2,NCAAF_20170909_WKY@ILL,Illinois,,W. Kentucky,,2-0,1-1,,13,0,20,7,3,10,7,0,0,0,0,7,1,13,3,13,13,,,,
148,2017,2,NCAAF_20170909_STNFRD@USC,USC,,Stanford,,2-0,1-1,,28,17,42,24,14,14,0,14,7,10,0,7,1,11,7,11,18,,,,
149,2017,2,NCAAF_20170909_MINN@OREGST,Oregon State,,Minnesota,,1-2,2-0,,14,20,14,48,0,14,0,0,10,10,14,14,-1,-6,-10,-6,-34,,,,
150,2017,2,NCAAF_20170909_UTAH@BYU,BYU,,Utah,,1-2,2-0,,0,9,13,19,0,0,6,7,3,6,10,0,-1,-9,-3,-9,-6,,,,
151,2017,2,NCAAF_20170909_HOU@ARIZ,Arizona,,Houston,,1-1,1-0,,10,17,16,19,3,7,3,3,3,14,2,0,0,-7,0,-7,-3,,,,
152,2017,2,NCAAF_20170909_SDGST@ARIZST,Arizona St.,,San Diego St.,,0-2,2-0,,14,20,20,30,7,7,0,6,7,13,7,3,-2,-6,0,-6,-10,,,,
153,2017,2,NCAAF_20170908_ALCORN@FIU,FIU,,Alcorn St.,,1-1,1-1,,7,7,17,10,0,7,3,7,0,7,0,3,0,0,0,0,7,,,,
154,2017,2,NCAAF_20170908_OHIO@PURDUE,Purdue,,Ohio,,1-1,1-1,,34,7,44,21,10,24,7,3,7,0,7,7,0,27,3,27,23,,,,
155,2017,2,NCAAF_20170908_OKLAST@SALA,South Alabama,,Oklahoma State,,0-2,2-0,,0,20,7,44,0,0,0,7,17,3,21,3,-2,-20,-17,-20,-37,,,,
156,2017,2,NCAAF_20170907_IDST@UTAHST,Utah St.,,Idaho State,,1-1,1-1,,38,6,51,13,17,21,7,6,0,6,7,0,0,32,17,32,38,,,,
157,2017,3,NCAAF_20170916_AF@MICH,Michigan,,Air Force,,3-0,1-1,,9,6,29,13,3,6,10,10,3,3,7,0,2,3,0,3,16,,,,
158,2017,3,NCAAF_20170916_DEST@WVU,West Virginia,,Delaware St.,,2-1,0-3,,45,10,59,16,24,21,7,7,10,0,0,6,2,35,14,35,43,,,,
159,2017,3,NCAAF_20170916_IOWAST@AKRON,Akron,,Iowa St.,,1-2,2-1,,14,20,14,41,0,14,0,0,14,6,14,7,-1,-6,-14,-6,-27,,,,
160,2017,3,NCAAF_20170916_KANSAS@OHIO,Ohio,,Kansas,,2-1,1-2,,25,14,42,30,11,14,14,3,0,14,0,16,1,11,11,11,12,,,,
161,2017,3,NCAAF_20170916_LALAF@TXAM,Texas A&M,,Louisiana,,2-1,1-2,,14,21,45,21,7,7,17,14,0,21,0,0,1,-7,7,-7,24,,,,
162,2017,3,NCAAF_20170916_NILL@NEB,Nebraska,,N. Illinois,,1-2,2-1,,0,14,17,21,0,0,10,7,14,0,0,7,-1,-14,-14,-14,-4,,,,
163,2017,3,NCAAF_20170916_OKLAST@PITT,Pittsburgh,,Oklahoma State,,1-2,3-0,,14,49,21,59,0,14,7,0,21,28,7,3,-2,-35,-21,-35,-38,,,,
164,2017,3,NCAAF_20170916_UCLA@MEMP,Memphis,,UCLA,,2-0,2-1,,27,24,48,45,7,20,14,7,7,17,14,7,0,3,0,3,3,,,,
165,2017,3,NCAAF_20170916_UCONN@UVA,Virginia,,UConn,,2-1,1-1,,24,0,38,18,7,17,7,7,0,0,6,12,1,24,7,24,20,,,,
166,2017,3,NCAAF_20170916_FUR@NCST,NC State,,Furman,,2-1,0-3,,28,13,49,16,14,14,21,0,3,10,0,3,2,15,11,15,33,,,,
167,2017,3,NCAAF_20170916_BAYLOR@DUKE,Duke,,Baylor,,3-0,0-3,,14,7,34,20,7,7,10,10,7,0,13,0,3,7,0,7,14,,,,
168,2017,3,NCAAF_20170916_CSTCAR@UAB,UAB,,C. Carolina,,2-1,1-1,,16,5,30,23,13,3,7,7,2,3,8,10,1,11,11,11,7,,,,
169,2017,3,NCAAF_20170916_NCO@COLO,Colorado,,N. Colorado,,3-0,1-1,,28,14,41,21,14,14,3,10,7,7,7,0,2,14,7,14,20,,,,
170,2017,3,NCAAF_20170916_TNTECH@BALLST,Ball St.,,Tenn. Tech,,2-1,0-3,,21,7,28,13,7,14,7,0,0,7,6,0,2,14,7,14,15,,,,
171,2017,3,NCAAF_20170916_UTAHST@WAKE,Wake Forest,,Utah St.,,3-0,1-2,,29,0,46,10,14,15,17,0,0,0,10,0,2,29,14,29,36,,,,
172,2017,3,NCAAF_20170916_CMICH@CUSE,Syracuse,,C. Michigan,,2-1,2-1,,24,17,41,17,10,14,17,0,10,7,0,0,0,7,0,7,24,,,,
173,2017,3,NCAAF_20170916_MRGNST@RUT,Rutgers,,Morgan St.,,1-2,0-3,,34,0,65,0,7,27,17,14,0,0,0,0,1,34,7,34,65,,,,
174,2017,3,NCAAF_20170916_MTSU@MINN,Minnesota,,Middle Tenn.,,3-0,1-2,,20,3,34,3,3,17,7,7,0,3,0,0,2,17,3,17,31,,,,
175,2017,3,NCAAF_20170916_ND@BC,Boston College,,Notre Dame,,1-2,2-1,,10,14,20,49,3,7,3,7,7,7,14,21,-1,-4,-4,-4,-29,,,,
176,2017,3,NCAAF_20170916_NTEXAS@IOWA,Iowa,,North Texas,,3-0,1-2,,10,14,31,14,7,3,7,14,7,7,0,0,2,-4,0,-4,17,,,,
177,2017,3,NCAAF_20170916_SMU@TCU,TCU,,SMU,,3-0,2-1,,28,22,56,36,7,21,7,21,16,6,7,7,1,6,-9,6,20,,,,
178,2017,3,NCAAF_20170916_TENN@FLA,Florida,,Tennessee,,1-1,2-1,,6,3,26,20,3,3,0,20,0,3,0,17,-1,3,3,3,6,,,,
179,2017,3,NCAAF_20170916_UNC@ODU,Old Dominion,,North Carolina,,2-1,1-2,,7,39,23,53,0,7,10,6,11,28,7,7,1,-32,-11,-32,-30,,,,
180,2017,3,NCAAF_20170916_VATECH@ECU,East Carolina,,Virginia Tech,,0-3,3-0,,17,23,17,64,17,0,0,0,7,16,34,7,-3,-6,10,-6,-47,,,,
181,2017,3,NCAAF_20170916_WISC@BYU,BYU,,Wisconsin,,1-3,3-0,,6,24,6,40,3,3,0,0,10,14,7,9,-2,-18,-7,-18,-34,,,,
182,2017,3,NCAAF_20170916_MERCER@AUBURN,Auburn,,Mercer,,2-1,1-2,,10,3,24,10,7,3,7,7,0,3,0,7,1,7,7,7,14,,,,
183,2017,3,NCAAF_20170916_PURDUE@MIZZOU,Missouri,,Purdue,,1-2,2-1,,3,28,3,35,0,3,0,0,14,14,7,0,-1,-25,-14,-25,-32,,,,
184,2017,3,NCAAF_20170916_ARMY@OHIOST,Ohio State,,Army,,2-1,2-1,,17,7,38,7,14,3,14,7,0,7,0,0,0,10,14,10,31,,,,
185,2017,3,NCAAF_20170916_OREGST@WASHST,Washington St.,,Oregon State,,3-0,1-3,,28,9,52,23,7,21,14,10,2,7,7,7,2,19,5,19,29,,,,
186,2017,3,NCAAF_20170916_COLG@BUFF,Buffalo,,Colgate,,1-2,1-2,,30,3,33,10,20,10,0,3,3,0,7,0,0,27,17,27,23,,,,
187,2017,3,NCAAF_20170916_NCAT@CHARLO,Charlotte,,NC A&T,,0-3,3-0,,10,21,31,35,7,3,7,14,14,7,7,7,-3,-11,-7,-11,-4,,,,
188,2017,3,NCAAF_20170916_TULANE@OKLA,Oklahoma,,Tulane,,3-0,1-2,,28,14,56,14,14,14,7,21,14,0,0,0,2,14,0,14,42,,,,
189,2017,3,NCAAF_20170916_BTHN@FAU,FAU,,Bethune-Cook.,,1-2,1-2,,21,0,45,0,14,7,17,7,0,0,0,0,0,21,14,21,45,,,,
190,2017,3,NCAAF_20170916_KENTST@MRSHL,Marshall,,Kent St.,,2-1,1-2,,7,0,21,0,0,7,0,14,0,0,0,0,1,7,0,7,21,,,,
191,2017,3,NCAAF_20170916_ALAM@SALA,South Alabama,,Alabama A&M,,1-2,0-3,,31,0,45,0,24,7,14,0,0,0,0,0,1,31,24,31,45,,,,
192,2017,3,NCAAF_20170916_APLST@TXSTSM,Texas St.,,App. St.,,1-2,2-1,,10,7,13,20,7,3,0,3,0,7,10,3,-1,3,7,3,-7,,,,
193,2017,3,NCAAF_20170916_ARPB@ARKST,Arkansas St.,,Ark.-Pine Bluff,,1-1,1-2,,20,3,48,3,13,7,21,7,0,3,0,0,0,17,13,17,45,,,,
194,2017,3,NCAAF_20170916_COLOST@BAMA,Alabama,,Colorado St.,,3-0,2-2,,24,10,41,23,17,7,14,3,0,10,0,13,1,14,17,14,18,,,,
195,2017,3,NCAAF_20170916_IDAHO@WMICH,W. Michigan,,Idaho,,1-2,1-2,,6,14,37,28,3,3,13,18,7,7,14,0,0,-8,-4,-8,9,,,,
196,2017,3,NCAAF_20170916_IDST@NEVADA,Nevada,,Idaho State,,0-3,2-1,,7,23,28,30,0,7,7,14,10,13,7,0,-2,-16,-10,-16,-2,,,,
197,2017,3,NCAAF_20170916_LATECH@WKY,W. Kentucky,,Louisiana Tech,,1-2,2-1,,15,13,22,23,8,7,7,0,3,10,0,10,-1,2,5,2,-1,,,,
198,2017,3,NCAAF_20170916_LSU@MISSST,Miss. State,,LSU,,3-0,2-1,,17,7,37,7,0,17,13,7,0,7,0,0,1,10,0,10,30,,,,
199,2017,3,NCAAF_20170916_OREG@WYO,Wyoming,,Oregon,,1-2,3-0,,10,42,13,49,10,0,3,0,14,28,0,7,-2,-32,-4,-32,-36,,,,
200,2017,3,NCAAF_20170916_SO@TXSA,UTSA,,Southern U.,,2-0,1-2,,48,0,51,17,21,27,3,0,0,0,7,10,1,48,21,48,34,,,,
201,2017,3,NCAAF_20170916_TULSA@TOLEDO,Toledo,,Tulsa,,3-0,1-2,,14,28,54,51,7,7,22,18,21,7,9,14,2,-14,-14,-14,3,,,,
202,2017,3,NCAAF_20170916_USM@LAMON,UL-Monroe,,So. Miss,,0-2,2-1,,10,21,17,28,0,10,7,0,7,14,7,0,-2,-11,-7,-11,-11,,,,
203,2017,3,NCAAF_20170916_BGREEN@NWEST,Northwestern,,Bowling Green,,2-1,0-3,,35,7,49,7,14,21,0,14,7,0,0,0,2,28,7,28,42,,,,
204,2017,3,NCAAF_20170916_GAST@PSU,Penn State,,Georgia St.,,3-0,0-2,,35,0,56,0,14,21,14,7,0,0,0,0,3,35,14,35,56,,,,
205,2017,3,NCAAF_20170916_KSTATE@VANDY,Vanderbilt,,Kansas State,,3-0,2-1,,7,7,14,7,7,0,0,7,0,7,0,0,1,0,7,0,7,,,,
206,2017,3,NCAAF_20170916_SAMF@UGA,Georgia,,Samford,,3-0,2-1,,21,7,42,14,14,7,21,0,0,7,0,7,1,14,14,14,28,,,,
207,2017,3,NCAAF_20170916_UK@SC,South Carolina,,Kentucky,,2-1,3-0,,6,14,13,23,6,0,0,7,7,7,3,6,-1,-8,-1,-8,-10,,,,
208,2017,3,NCAAF_20170916_ARIZST@TXTECH,Texas Tech,,Arizona St.,,2-0,1-2,,35,17,52,45,21,14,10,7,3,14,21,7,1,18,18,18,7,,,,
209,2017,3,NCAAF_20170916_CINCY@MIAOH,Miami-OH,,Cincinnati,,1-2,2-1,,7,3,17,21,7,0,7,3,3,0,0,18,-1,4,4,4,-4,,,,
210,2017,3,NCAAF_20170916_CLEM@LVILLE,Louisville,,Clemson,,2-1,3-0,,7,19,21,47,7,0,0,14,7,12,14,14,-1,-12,0,-12,-26,,,,
211,2017,3,NCAAF_20170916_RICE@HOU,Houston,,Rice,,2-0,1-2,,38,0,38,3,17,21,0,0,0,0,0,3,1,38,17,38,35,,,,
212,2017,3,NCAAF_20170916_TROY@NMEXST,New Mexico St.,,Troy,,1-2,2-1,,3,13,24,27,3,0,13,8,13,0,14,0,-1,-10,-10,-10,-3,,,,
213,2017,3,NCAAF_20170916_FRESNO@WASH,Washington,,Fresno St.,,3-0,1-2,,41,7,48,16,27,14,7,0,0,7,6,3,2,34,27,34,32,,,,
214,2017,3,NCAAF_20170916_SJST@UTAH,Utah,,San Jose St.,,3-0,1-3,,30,13,54,16,9,21,7,17,3,10,0,3,2,17,6,17,38,,,,
215,2017,3,NCAAF_20170916_MISS@CAL,California,,Ole Miss,,3-0,2-1,,7,16,27,16,7,0,10,10,10,6,0,0,1,-9,-3,-9,11,,,,
216,2017,3,NCAAF_20170916_STNFRD@SDGST,San Diego St.,,Stanford,,3-0,1-2,,10,7,20,17,0,10,3,7,0,7,3,7,2,3,0,3,3,,,,
217,2017,3,NCAAF_20170915_ILL@SFLA,South Florida,,Illinois,,3-0,2-1,,23,9,47,23,9,14,14,10,2,7,0,14,1,14,7,14,24,,,,
218,2017,3,NCAAF_20170915_MA@TEMPLE,Temple,,UMass,,2-1,0-4,,16,7,29,21,3,13,6,7,0,7,7,7,2,9,3,9,8,,,,
219,2017,3,NCAAF_20170915_ARIZ@UTEP,UTEP,,Arizona,,0-3,2-1,,9,35,16,63,0,9,7,0,0,35,14,14,-2,-26,0,-26,-47,,,,
220,2017,3,NCAAF_20170914_NMEX@BOISE,Boise St.,,New Mexico,,2-1,1-2,,14,7,28,14,7,7,0,14,0,7,0,7,1,7,7,7,14,,,,
221,2017,4,NCAAF_20170924_ECU@UCONN,UConn,,East Carolina,,1-2,1-3,,14,27,38,41,7,7,17,7,21,6,14,0,0,-13,-14,-13,-3,,,,
222,2017,4,NCAAF_20170923_ARMY@TULANE,Tulane,,Army,,2-2,2-2,,14,10,21,17,7,7,0,7,0,10,0,7,0,4,7,4,4,,,,
223,2017,4,NCAAF_20170923_KENTST@LVILLE,Louisville,,Kent St.,,3-1,1-3,,28,3,42,3,21,7,14,0,0,3,0,0,2,25,21,25,39,,,,
224,2017,4,NCAAF_20170923_MA@TENN,Tennessee,,UMass,,3-1,0-5,,14,6,17,13,0,14,3,0,0,6,7,0,3,8,0,8,4,,,,
225,2017,4,NCAAF_20170923_NCST@FSU,Florida State,,NC State,,0-2,3-1,,10,17,21,27,0,10,3,8,10,7,3,7,-3,-7,-10,-7,-6,,,,
226,2017,4,NCAAF_20170923_TXTECH@HOU,Houston,,Texas Tech,,2-1,3-0,,10,13,24,27,0,10,0,14,6,7,7,7,-1,-3,-6,-3,-3,,,,
227,2017,4,NCAAF_20170923_UNLV@OHIOST,Ohio State,,UNLV,,3-1,1-2,,44,7,54,21,16,28,10,0,0,7,7,7,2,37,16,37,33,,,,
228,2017,4,NCAAF_20170923_WVU@KANSAS,Kansas,,West Virginia,,1-3,3-1,,13,35,34,56,3,10,14,7,7,28,0,21,-2,-22,-4,-22,-22,,,,
229,2017,4,NCAAF_20170923_PITT@GATECH,Georgia Tech,,Pittsburgh,,2-1,1-3,,21,17,35,17,7,14,7,7,7,10,0,0,1,4,0,4,18,,,,
230,2017,4,NCAAF_20170923_NMEX@TULSA,Tulsa,,New Mexico,,1-3,2-2,,10,13,13,16,3,7,0,3,7,6,0,3,-1,-3,-4,-3,-3,,,,
231,2017,4,NCAAF_20170923_ODU@VATECH,Virginia Tech,,Old Dominion,,4-0,2-2,,17,0,38,0,3,14,14,7,0,0,0,0,2,17,3,17,38,,,,
232,2017,4,NCAAF_20170923_UCF@MD,Maryland,,UCF,,2-1,2-0,,3,14,10,38,3,0,7,0,0,14,7,17,0,-11,3,-11,-28,,,,
233,2017,4,NCAAF_20170923_BAMA@VANDY,Vanderbilt,,Alabama,,3-1,4-0,,0,31,0,59,0,0,0,0,21,10,21,7,-1,-31,-21,-31,-59,,,,
234,2017,4,NCAAF_20170923_BC@CLEM,Clemson,,Boston College,,4-0,1-3,,7,0,34,7,0,7,0,27,0,0,7,0,3,7,0,7,27,,,,
235,2017,4,NCAAF_20170923_CINCY@NAVY,Navy,,Cincinnati,,3-0,2-2,,21,17,42,32,14,7,14,7,7,10,7,8,1,4,7,4,10,,,,
236,2017,4,NCAAF_20170923_DUKE@UNC,North Carolina,,Duke,,1-3,4-0,,10,10,17,27,3,7,7,0,7,3,3,14,-3,0,-4,0,-10,,,,
237,2017,4,NCAAF_20170923_GAS@IND,Indiana,,Ga. Southern,,2-1,0-3,,31,7,52,17,21,10,14,7,0,7,10,0,2,24,21,24,35,,,,
238,2017,4,NCAAF_20170923_LATECH@SC,South Carolina,,Louisiana Tech,,3-1,2-2,,0,6,17,16,0,0,0,17,3,3,7,3,1,-6,-3,-6,1,,,,
239,2017,4,NCAAF_20170923_MIAOH@CMICH,C. Michigan,,Miami-OH,,2-2,2-2,,14,28,14,31,0,14,0,0,14,14,3,0,0,-14,-14,-14,-17,,,,
240,2017,4,NCAAF_20170923_RUT@NEB,Nebraska,,Rutgers,,2-2,1-3,,14,10,27,17,7,7,7,6,7,3,7,0,1,4,0,4,10,,,,
241,2017,4,NCAAF_20170923_TCU@OKLAST,Oklahoma State,,TCU,,3-1,4-0,,10,20,31,44,7,3,7,14,6,14,14,10,-1,-10,1,-10,-13,,,,
242,2017,4,NCAAF_20170923_TOLEDO@MIAMI,Miami (Fla.),,Toledo,,2-0,3-1,,10,16,52,30,10,0,14,28,0,16,0,14,-1,-6,10,-6,22,,,,
243,2017,4,NCAAF_20170923_USC@CAL,California,,USC,,3-1,4-0,,13,13,20,30,3,10,0,7,3,10,0,17,-1,0,0,0,-10,,,,
244,2017,4,NCAAF_20170923_WAKE@APLST,App. St.,,Wake Forest,,2-2,4-0,,9,3,19,20,6,3,7,3,3,0,14,3,-2,6,3,6,-1,,,,
245,2017,4,NCAAF_20170923_MICH@PURDUE,Purdue,,Michigan,,2-2,4-0,,10,7,10,28,0,10,0,0,0,7,7,14,-2,3,0,3,-18,,,,
246,2017,4,NCAAF_20170923_AKRON@TROY,Troy,,Akron,,3-1,1-3,,16,10,22,17,7,9,0,6,10,0,7,0,2,6,-3,6,5,,,,
247,2017,4,NCAAF_20170923_GAST@CHARLO,Charlotte,,Georgia St.,,0-4,1-2,,0,14,0,28,0,0,0,0,0,14,0,14,-1,-14,0,-14,-28,,,,
248,2017,4,NCAAF_20170923_NEVADA@WASHST,Washington St.,,Nevada,,4-0,0-4,,35,0,45,7,14,21,3,7,0,0,0,7,4,35,14,35,38,,,,
249,2017,4,NCAAF_20170923_OKLA@BAYLOR,Baylor,,Oklahoma,,0-4,4-0,,17,28,41,49,7,10,14,10,21,7,7,14,-4,-11,-14,-11,-8,,,,
250,2017,4,NCAAF_20170923_UAB@NTEXAS,North Texas,,UAB,,2-2,2-2,,30,14,46,43,10,20,7,9,7,7,15,14,0,16,3,16,3,,,,
251,2017,4,NCAAF_20170923_WIL@CSTCAR,C. Carolina,,W. Illinois,,1-2,3-0,,10,21,10,52,10,0,0,0,7,14,21,10,-2,-11,3,-11,-42,,,,
252,2017,4,NCAAF_20170923_ARKST@SMU,SMU,,Arkansas St.,,3-1,1-2,,30,14,44,21,10,20,7,7,14,0,0,7,2,16,-4,16,23,,,,
253,2017,4,NCAAF_20170923_BALLST@WKY,W. Kentucky,,Ball St.,,2-2,2-2,,17,7,33,21,7,10,0,16,7,0,7,7,0,10,0,10,12,,,,
254,2017,4,NCAAF_20170923_BGREEN@MTSU,Middle Tenn.,,Bowling Green,,2-2,0-4,,21,10,24,13,7,14,0,3,7,3,3,0,2,11,0,11,11,,,,
255,2017,4,NCAAF_20170923_CUSE@LSU,LSU,,Syracuse,,3-1,2-2,,14,3,35,26,7,7,14,7,3,0,16,7,1,11,4,11,9,,,,
256,2017,4,NCAAF_20170923_FAU@BUFF,Buffalo,,FAU,,2-2,1-3,,17,17,34,31,14,3,7,10,7,10,0,14,1,0,7,0,3,,,,
257,2017,4,NCAAF_20170923_MISSST@UGA,Georgia,,Miss. State,,4-0,3-1,,14,3,31,3,14,0,17,0,0,3,0,0,1,11,14,11,28,,,,
258,2017,4,NCAAF_20170923_SDGST@AF,Air Force,,San Diego St.,,1-2,4-0,,9,7,24,28,6,3,0,15,0,7,7,14,-3,2,6,2,-4,,,,
259,2017,4,NCAAF_20170923_WAG@WMICH,W. Michigan,,Wagner,,2-2,1-3,,21,7,49,14,7,14,28,0,0,7,0,7,1,14,7,14,35,,,,
260,2017,4,NCAAF_20170923_AUBURN@MIZZOU,Missouri,,Auburn,,1-3,3-1,,7,31,14,51,0,7,0,7,14,17,17,3,-2,-24,-14,-24,-37,,,,
261,2017,4,NCAAF_20170923_FIU@RICE,Rice,,FIU,,1-3,2-1,,7,10,7,13,0,7,0,0,0,10,3,0,-1,-3,0,-3,-6,,,,
262,2017,4,NCAAF_20170923_FLA@UK,Kentucky,,Florida,,3-1,2-1,,14,14,27,28,7,7,10,3,0,14,0,14,1,0,7,0,-1,,,,
263,2017,4,NCAAF_20170923_PSU@IOWA,Iowa,,Penn State,,3-1,4-0,,7,5,19,21,0,7,0,12,3,2,10,6,-1,2,-3,2,-2,,,,
264,2017,4,NCAAF_20170923_TXSA@TXSTSM,Texas St.,,UTSA,,1-3,3-0,,14,27,14,44,7,7,0,0,10,17,3,14,-2,-13,-3,-13,-30,,,,
265,2017,4,NCAAF_20170923_UTAHST@SJST,San Jose St.,,Utah St.,,1-4,2-2,,0,38,10,61,0,0,7,3,14,24,17,6,-1,-38,-14,-38,-51,,,,
266,2017,4,NCAAF_20170923_ND@MICHST,Michigan St.,,Notre Dame,,2-1,3-1,,7,28,18,38,7,0,3,8,14,14,7,3,-1,-21,-7,-21,-20,,,,
267,2017,4,NCAAF_20170923_SIL@MEMP,Memphis,,S. Illinois,,3-0,2-1,,17,21,44,31,7,10,17,10,14,7,3,7,1,-4,-7,-4,13,,,,
268,2017,4,NCAAF_20170923_UTEP@NMEXST,New Mexico St.,,UTEP,,2-2,0-4,,21,7,41,14,7,14,13,7,7,0,0,7,2,14,0,14,27,,,,
269,2017,4,NCAAF_20170923_OREG@ARIZST,Arizona St.,,Oregon,,0-1,3-1,,17,14,37,35,17,0,14,6,7,7,14,7,-3,3,10,3,2,,,,
270,2017,4,NCAAF_20170923_WASH@COLO,Colorado,,Washington,,3-1,4-0,,7,10,10,37,7,0,3,0,0,10,14,13,-1,-3,7,-3,-27,,,,
271,2017,4,NCAAF_20170923_UCLA@STNFRD,Stanford,,UCLA,,2-2,2-2,,23,13,58,34,6,17,14,21,3,10,14,7,0,10,3,10,24,,,,
272,2017,4,NCAAF_20170922_UVA@BOISE,Boise St.,,Virginia,,2-2,3-1,,14,21,23,42,7,7,0,9,7,14,14,7,-1,-7,0,-7,-19,,,,
273,2017,4,NCAAF_20170922_UTAH@ARIZ,Arizona,,Utah,,2-2,4-0,,10,13,24,30,3,7,7,7,10,3,14,3,-2,-3,-7,-3,-6,,,,
274,2017,4,NCAAF_20170921_TEMPLE@SFLA,South Florida,,Temple,,4-0,2-2,,20,7,43,7,3,17,13,10,0,7,0,0,2,13,3,13,36,,,,
275,2017,5,NCAAF_20170930_HOU@TEMPLE,Temple,,Houston,,2-3,3-1,,0,13,13,20,0,0,3,10,7,6,7,0,-1,-13,-7,-13,-7,,,,
276,2017,5,NCAAF_20170930_MD@MINN,Minnesota,,Maryland,,3-1,3-1,,10,17,24,31,0,10,7,7,7,10,0,14,0,-7,-7,-7,-7,,,,
277,2017,5,NCAAF_20170930_NMEXST@ARK,Arkansas,,New Mexico St.,,2-2,2-3,,28,10,42,24,14,14,7,7,0,10,7,7,0,18,14,18,18,,,,
278,2017,5,NCAAF_20170930_NWEST@WISC,Wisconsin,,Northwestern,,4-0,2-2,,7,10,33,24,7,0,14,12,3,7,0,14,2,-3,4,-3,9,,,,
279,2017,5,NCAAF_20170930_RICE@PITT,Pittsburgh,,Rice,,2-3,1-4,,28,0,42,10,21,7,0,14,0,0,10,0,1,28,21,28,32,,,,
280,2017,5,NCAAF_20170930_SFLA@ECU,East Carolina,,South Florida,,1-4,5-0,,24,31,31,61,10,14,7,0,21,10,17,13,-4,-7,-11,-7,-30,,,,
281,2017,5,NCAAF_20170930_UNC@GATECH,Georgia Tech,,North Carolina,,3-1,1-4,,10,0,33,7,7,3,14,9,0,0,0,7,2,10,7,10,26,,,,
282,2017,5,NCAAF_20170930_VANDY@FLA,Florida,,Vanderbilt,,3-1,3-2,,17,17,38,24,7,10,7,14,7,10,0,7,0,0,0,0,14,,,,
283,2017,5,NCAAF_20170930_CUSE@NCST,NC State,,Syracuse,,4-1,2-3,,26,7,33,25,13,13,0,7,0,7,10,8,2,19,13,19,8,,,,
284,2017,5,NCAAF_20170930_CMICH@BC,Boston College,,C. Michigan,,2-3,2-3,,21,8,28,8,14,7,7,0,2,6,0,0,0,13,12,13,20,,,,
285,2017,5,NCAAF_20170930_BAYLOR@KSTATE,Kansas State,,Baylor,,3-1,0-5,,20,3,33,20,7,13,0,13,3,0,10,7,3,17,4,17,13,,,,
286,2017,5,NCAAF_20170930_BUFF@KENTST,Kent St.,,Buffalo,,1-4,3-2,,13,20,13,27,0,13,0,0,7,13,7,0,-2,-7,-7,-7,-14,,,,
287,2017,5,NCAAF_20170930_FSU@WAKE,Wake Forest,,Florida State,,4-1,1-2,,12,13,19,26,3,9,0,7,3,10,3,10,3,-1,0,-1,-7,,,,
288,2017,5,NCAAF_20170930_IND@PSU,Penn State,,Indiana,,5-0,2-2,,28,14,45,14,28,0,10,7,0,14,0,0,3,14,28,14,31,,,,
289,2017,5,NCAAF_20170930_MURYST@LVILLE,Louisville,,Murray St.,,4-1,1-4,,35,3,55,10,14,21,10,10,3,0,7,0,3,32,11,32,45,,,,
290,2017,5,NCAAF_20170930_NAVY@TULSA,Tulsa,,Navy,,1-4,4-0,,14,14,21,31,14,0,0,7,0,14,3,14,-3,0,14,0,-10,,,,
291,2017,5,NCAAF_20170930_OHIO@MA,UMass,,Ohio,,0-6,4-1,,27,27,50,58,10,17,2,21,7,20,14,17,-4,0,3,0,-8,,,,
292,2017,5,NCAAF_20170930_UGA@TENN,Tennessee,,Georgia,,3-2,5-0,,0,24,0,41,0,0,0,0,10,14,7,10,-2,-24,-10,-24,-41,,,,
293,2017,5,NCAAF_20170930_UTEP@ARMY,Army,,UTEP,,3-2,0-5,,14,14,35,21,0,14,14,7,7,7,0,7,3,0,-7,0,14,,,,
294,2017,5,NCAAF_20170930_ARIZST@STNFRD,Stanford,,Arizona St.,,3-2,2-3,,24,17,34,24,7,17,7,3,3,14,0,7,1,7,4,7,10,,,,
295,2017,5,NCAAF_20170930_EMICH@UK,Kentucky,,E. Michigan,,4-1,2-2,,14,14,24,20,7,7,3,7,7,7,0,6,2,0,0,0,4,,,,
296,2017,5,NCAAF_20170930_IOWA@MICHST,Michigan St.,,Iowa,,3-1,3-2,,17,7,17,10,14,3,0,0,0,7,0,3,0,10,14,10,7,,,,
297,2017,5,NCAAF_20170930_TXSTSM@WYO,Wyoming,,Texas St.,,3-2,1-4,,31,10,45,10,0,31,14,0,0,10,0,0,2,21,0,21,35,,,,
298,2017,5,NCAAF_20170930_UCONN@SMU,SMU,,UConn,,4-1,1-3,,21,10,49,28,7,14,7,21,7,3,10,8,3,11,0,11,21,,,,
299,2017,5,NCAAF_20170930_MIAOH@ND,Notre Dame,,Miami-OH,,4-1,2-3,,45,14,52,17,28,17,0,7,7,7,3,0,2,31,21,31,35,,,,
300,2017,5,NCAAF_20170930_AKRON@BGREEN,Bowling Green,,Akron,,0-5,2-3,,13,20,23,34,6,7,10,0,13,7,7,7,-2,-7,-7,-7,-11,,,,
301,2017,5,NCAAF_20170930_MISSST@AUBURN,Auburn,,Miss. State,,4-1,3-2,,21,10,49,10,14,7,7,21,3,7,0,0,1,11,11,11,39,,,,
302,2017,5,NCAAF_20170930_AF@NMEX,New Mexico,,Air Force,,3-2,1-3,,14,21,56,38,7,7,21,21,0,21,3,14,2,-7,7,-7,18,,,,
303,2017,5,NCAAF_20170930_BALLST@WMICH,W. Michigan,,Ball St.,,3-2,2-3,,31,0,55,3,14,17,17,7,0,0,3,0,1,31,14,31,52,,,,
304,2017,5,NCAAF_20170930_CHARLO@FIU,FIU,,Charlotte,,3-1,0-5,,14,26,30,29,7,7,7,9,12,14,3,0,3,-12,-5,-12,1,,,,
305,2017,5,NCAAF_20170930_CSTCAR@LAMON,UL-Monroe,,C. Carolina,,2-2,1-3,,31,22,51,43,10,21,14,6,15,7,8,13,1,9,-5,9,8,,,,
306,2017,5,NCAAF_20170930_MEMP@UCF,UCF,,Memphis,,3-0,3-1,,23,7,40,13,6,17,7,10,7,0,0,6,0,16,-1,16,27,,,,
307,2017,5,NCAAF_20170930_MRSHL@CINCY,Cincinnati,,Marshall,,2-3,3-1,,0,24,21,38,0,0,7,14,7,17,7,7,-1,-24,-7,-24,-17,,,,
308,2017,5,NCAAF_20170930_MTSU@FAU,FAU,,Middle Tenn.,,2-3,2-3,,24,6,38,20,14,10,0,14,6,0,7,7,0,18,8,18,18,,,,
309,2017,5,NCAAF_20170930_NTEXAS@USM,So. Miss,,North Texas,,2-2,3-2,,21,17,28,43,14,7,7,0,7,10,16,10,-1,4,7,4,-15,,,,
310,2017,5,NCAAF_20170930_SALA@LATECH,Louisiana Tech,,South Alabama,,3-2,1-4,,17,13,34,16,14,3,0,17,7,6,3,0,2,4,7,4,18,,,,
311,2017,5,NCAAF_20170930_TROY@LSU,LSU,,Troy,,3-2,4-1,,0,10,21,24,0,0,7,14,7,3,7,7,-1,-10,-7,-10,-3,,,,
312,2017,5,NCAAF_20170930_OHIOST@RUT,Rutgers,,Ohio State,,1-4,4-1,,0,35,0,56,0,0,0,0,7,28,7,14,-3,-35,-7,-35,-56,,,,
313,2017,5,NCAAF_20170930_SC@TXAM,Texas A&M,,South Carolina,,4-1,3-2,,7,10,24,17,0,7,3,14,0,10,7,0,1,-3,0,-3,7,,,,
314,2017,5,NCAAF_20170930_CLEM@VATECH,Virginia Tech,,Clemson,,4-1,5-0,,3,17,17,31,0,3,0,14,10,7,7,7,-1,-14,-10,-14,-14,,,,
315,2017,5,NCAAF_20170930_OKLAST@TXTECH,Texas Tech,,Oklahoma State,,3-1,4-1,,17,21,34,41,7,10,3,14,7,14,13,7,-1,-4,0,-4,-7,,,,
316,2017,5,NCAAF_20170930_WASH@OREGST,Oregon State,,Washington,,1-4,5-0,,0,7,7,42,0,0,0,7,7,0,21,14,-4,-7,-7,-7,-35,,,,
317,2017,5,NCAAF_20170930_MISS@BAMA,Alabama,,Ole Miss,,5-0,2-2,,35,3,66,3,21,14,24,7,3,0,0,0,3,32,18,32,63,,,,
318,2017,5,NCAAF_20170930_NEVADA@FRESNO,Fresno St.,,Nevada,,2-2,0-5,,31,14,41,21,10,21,7,3,0,14,0,7,2,17,10,17,20,,,,
319,2017,5,NCAAF_20170930_CAL@OREG,Oregon,,California,,4-1,3-2,,17,7,45,24,17,0,7,21,0,7,7,10,1,10,17,10,21,,,,
320,2017,5,NCAAF_20170930_COLO@UCLA,UCLA,,Colorado,,3-2,3-2,,14,10,27,23,7,7,7,6,7,3,10,3,0,4,0,4,4,,,,
321,2017,5,NCAAF_20170930_NILL@SDGST,San Diego St.,,N. Illinois,,5-0,2-2,,31,14,34,28,14,17,0,3,14,0,14,0,3,17,0,17,6,,,,
322,2017,5,NCAAF_20170930_SJST@UNLV,UNLV,,San Jose St.,,2-2,1-5,,35,13,41,13,14,21,6,0,3,10,0,0,1,22,11,22,28,,,,
323,2017,5,NCAAF_20170930_COLOST@HAWAII,Hawaii,,Colorado St.,,2-3,3-2,,7,31,21,51,0,7,7,7,14,17,13,7,-1,-24,-14,-24,-30,,,,
324,2017,5,NCAAF_20170929_MIAMI@DUKE,Duke,,Miami (Fla.),,4-1,3-0,,6,17,6,31,3,3,0,0,14,3,0,14,1,-11,-11,-11,-25,,,,
325,2017,5,NCAAF_20170929_BYU@UTAHST,Utah St.,,BYU,,3-2,1-4,,24,21,40,24,7,17,3,13,7,14,0,3,2,3,0,3,16,,,,
326,2017,5,NCAAF_20170929_NEB@ILL,Illinois,,Nebraska,,2-2,3-2,,3,21,6,28,0,3,3,0,7,14,0,7,-1,-18,-7,-18,-22,,,,
327,2017,5,NCAAF_20170929_USC@WASHST,Washington St.,,USC,,5-0,4-1,,17,17,30,27,3,14,3,10,7,10,3,7,1,0,-4,0,3,,,,
328,2017,5,NCAAF_20170928_TEXAS@IOWAST,Iowa St.,,Texas,,2-2,2-2,,0,14,7,17,0,0,7,0,7,7,0,3,0,-14,-7,-14,-10,,,,
329,2017,6,NCAAF_20171007_TULSA@TULANE,Tulane,,Tulsa,,3-2,1-5,,48,7,62,28,21,27,7,7,7,0,14,7,2,41,14,41,34,,,,
330,2017,6,NCAAF_20171007_EMICH@TOLEDO,Toledo,,E. Michigan,,4-1,2-3,,10,6,20,15,3,7,7,3,6,0,3,6,2,4,-3,4,5,,,,
331,2017,6,NCAAF_20171007_ILL@IOWA,Iowa,,Illinois,,4-2,2-3,,17,13,45,16,7,10,7,21,3,10,3,0,2,4,4,4,29,,,,
332,2017,6,NCAAF_20171007_IOWAST@OKLA,Oklahoma,,Iowa St.,,4-1,3-2,,24,13,31,38,14,10,0,7,3,10,11,14,1,11,11,11,-7,,,,
333,2017,6,NCAAF_20171007_MISS@AUBURN,Auburn,,Ole Miss,,5-1,2-3,,35,3,44,23,14,21,6,3,3,0,7,13,3,32,11,32,21,,,,
334,2017,6,NCAAF_20171007_PSU@NWEST,Northwestern,,Penn State,,2-3,6-0,,0,10,7,31,0,0,0,7,3,7,14,7,-4,-10,-3,-10,-24,,,,
335,2017,6,NCAAF_20171007_TEMPLE@ECU,East Carolina,,Temple,,1-5,3-3,,3,24,10,34,3,0,7,0,0,24,7,3,-2,-21,3,-21,-24,,,,
336,2017,6,NCAAF_20171007_TXTECH@KANSAS,Kansas,,Texas Tech,,1-4,4-1,,10,35,19,65,7,3,9,0,21,14,13,17,-3,-25,-14,-25,-46,,,,
337,2017,6,NCAAF_20171007_UGA@VANDY,Vanderbilt,,Georgia,,3-3,6-0,,7,21,14,45,0,7,0,7,7,14,17,7,-3,-14,-7,-14,-31,,,,
338,2017,6,NCAAF_20171007_WAKE@CLEM,Clemson,,Wake Forest,,6-0,4-2,,14,0,28,14,14,0,7,7,0,0,0,14,2,14,14,14,14,,,,
339,2017,6,NCAAF_20171007_DUKE@UVA,Virginia,,Duke,,4-1,4-2,,14,14,28,21,7,7,7,7,7,7,0,7,0,0,0,0,7,,,,
340,2017,6,NCAAF_20171007_PITT@CUSE,Syracuse,,Pittsburgh,,3-3,2-4,,10,10,27,24,3,7,10,7,0,10,3,11,1,0,3,0,3,,,,
341,2017,6,NCAAF_20171007_CMICH@OHIO,Ohio,,C. Michigan,,4-2,3-3,,14,13,23,26,7,7,0,9,7,6,6,7,1,1,0,1,-3,,,,
342,2017,6,NCAAF_20171007_BGREEN@MIAOH,Miami-OH,,Bowling Green,,2-4,1-5,,19,17,29,37,6,13,10,0,3,14,7,13,1,2,3,2,-8,,,,
343,2017,6,NCAAF_20171007_FIU@MTSU,Middle Tenn.,,FIU,,3-3,3-2,,17,3,37,17,3,14,10,10,3,0,7,7,0,14,0,14,20,,,,
344,2017,6,NCAAF_20171007_LAMON@TXSTSM,Texas St.,,UL-Monroe,,1-5,3-2,,20,26,27,45,20,0,0,7,19,7,9,10,-2,-6,1,-6,-18,,,,
345,2017,6,NCAAF_20171007_AF@NAVY,Navy,,Air Force,,5-0,1-4,,28,10,48,45,7,21,10,10,7,3,14,21,4,18,0,18,3,,,,
346,2017,6,NCAAF_20171007_BALLST@AKRON,Akron,,Ball St.,,3-3,2-4,,17,3,31,3,7,10,0,14,3,0,0,0,1,14,4,14,28,,,,
347,2017,6,NCAAF_20171007_CHARSO@IND,Indiana,,Charleston So.,,3-2,2-3,,24,0,27,0,10,14,3,0,0,0,0,0,1,24,10,24,27,,,,
348,2017,6,NCAAF_20171007_KENTST@NILL,N. Illinois,,Kent St.,,3-2,1-5,,14,3,24,3,7,7,10,0,0,3,0,0,2,11,7,11,21,,,,
349,2017,6,NCAAF_20171007_LSU@FLA,Florida,,LSU,,3-2,4-2,,3,10,16,17,0,3,13,0,7,3,7,0,-1,-7,-7,-7,-1,,,,
350,2017,6,NCAAF_20171007_MIAMI@FSU,Florida State,,Miami (Fla.),,1-3,4-0,,3,0,20,24,3,0,0,17,0,0,10,14,-3,3,3,3,-4,,,,
351,2017,6,NCAAF_20171007_MINN@PURDUE,Purdue,,Minnesota,,3-2,3-2,,6,14,31,17,6,0,7,18,7,7,0,3,0,-8,-1,-8,14,,,,
352,2017,6,NCAAF_20171007_ND@UNC,North Carolina,,Notre Dame,,1-5,5-1,,7,16,10,33,0,7,0,3,0,16,10,7,-4,-9,0,-9,-23,,,,
353,2017,6,NCAAF_20171007_NMEXST@APLST,App. St.,,New Mexico St.,,3-2,2-4,,17,14,45,31,3,14,0,28,7,7,3,14,1,3,-4,3,14,,,,
354,2017,6,NCAAF_20171007_WVU@TCU,TCU,,West Virginia,,5-0,3-2,,7,3,31,24,0,7,17,7,3,0,14,7,2,4,-3,4,7,,,,
355,2017,6,NCAAF_20171007_ARK@SC,South Carolina,,Arkansas,,4-2,2-3,,17,10,48,22,3,14,17,14,3,7,0,12,2,7,0,7,26,,,,
356,2017,6,NCAAF_20171007_LATECH@UAB,UAB,,Louisiana Tech,,3-2,3-3,,16,10,23,22,13,3,0,7,7,3,0,12,0,6,6,6,1,,,,
357,2017,6,NCAAF_20171007_MD@OHIOST,Ohio State,,Maryland,,5-1,3-2,,41,7,62,14,20,21,14,7,7,0,0,7,2,34,13,34,48,,,,
358,2017,6,NCAAF_20171007_OREGST@USC,USC,,Oregon State,,5-1,1-5,,21,3,38,10,14,7,7,10,0,3,0,7,4,18,14,18,28,,,,
359,2017,6,NCAAF_20171007_COLOST@UTAHST,Utah St.,,Colorado St.,,3-3,4-2,,7,24,14,27,0,7,0,7,17,7,0,3,-1,-17,-17,-17,-13,,,,
360,2017,6,NCAAF_20171007_LALAF@IDAHO,Idaho,,Louisiana,,2-3,2-3,,10,14,16,21,7,3,3,3,7,7,7,0,0,-4,0,-4,-5,,,,
361,2017,6,NCAAF_20171007_FAU@ODU,Old Dominion,,FAU,,2-3,3-3,,14,31,28,58,7,7,7,7,17,14,14,13,-1,-17,-10,-17,-30,,,,
362,2017,6,NCAAF_20171007_MRSHL@CHARLO,Charlotte,,Marshall,,0-6,4-1,,0,7,3,14,0,0,3,0,7,0,7,0,-4,-7,-7,-7,-11,,,,
363,2017,6,NCAAF_20171007_ARMY@RICE,Rice,,Army,,1-5,4-2,,0,35,12,49,0,0,6,6,21,14,7,7,-3,-35,-21,-35,-37,,,,
364,2017,6,NCAAF_20171007_GAST@CSTCAR,C. Carolina,,Georgia St.,,1-4,2-2,,7,21,21,27,0,7,0,14,14,7,0,6,-1,-14,-14,-14,-6,,,,
365,2017,6,NCAAF_20171007_SMU@HOU,Houston,,SMU,,4-1,4-2,,21,12,35,22,7,14,7,7,9,3,10,0,0,9,-2,9,13,,,,
366,2017,6,NCAAF_20171007_USM@TXSA,UTSA,,So. Miss,,3-1,3-2,,13,7,29,31,3,10,0,16,7,0,14,10,0,6,-4,6,-2,,,,
367,2017,6,NCAAF_20171007_BAMA@TXAM,Texas A&M,,Alabama,,4-2,6-0,,3,17,19,27,3,0,7,9,7,10,7,3,-2,-14,-4,-14,-8,,,,
368,2017,6,NCAAF_20171007_VATECH@BC,Boston College,,Virginia Tech,,2-4,5-1,,3,17,10,23,3,0,0,7,7,10,3,3,-3,-14,-4,-14,-13,,,,
369,2017,6,NCAAF_20171007_FRESNO@SJST,San Jose St.,,Fresno St.,,1-6,3-2,,0,21,10,27,0,0,7,3,14,7,0,6,-2,-21,-14,-21,-17,,,,
370,2017,6,NCAAF_20171007_MICHST@MICH,Michigan,,Michigan St.,,4-1,4-1,,3,14,10,14,3,0,7,0,7,7,0,0,0,-11,-4,-11,-4,,,,
371,2017,6,NCAAF_20171007_MIZZOU@UK,Kentucky,,Missouri,,5-1,1-4,,20,14,40,34,10,10,7,13,0,14,13,7,4,6,10,6,6,,,,
372,2017,6,NCAAF_20171007_ARIZ@COLO,Colorado,,Arizona,,3-3,3-2,,14,21,42,45,7,7,7,21,14,7,14,10,0,-7,-7,-7,-3,,,,
373,2017,6,NCAAF_20171007_WASHST@OREG,Oregon,,Washington St.,,4-2,6-0,,10,13,10,33,10,0,0,0,7,6,10,10,-2,-3,3,-3,-23,,,,
374,2017,6,NCAAF_20171007_WISC@NEB,Nebraska,,Wisconsin,,3-3,5-0,,10,17,17,38,0,10,7,0,10,7,7,14,-2,-7,-10,-7,-21,,,,
375,2017,6,NCAAF_20171007_WKY@UTEP,UTEP,,W. Kentucky,,0-6,3-2,,14,8,14,15,0,14,0,0,0,8,7,0,-3,6,0,6,-1,,,,
376,2017,6,NCAAF_20171007_STNFRD@UTAH,Utah,,Stanford,,4-1,4-2,,10,13,20,23,7,3,3,7,3,10,3,7,0,-3,4,-3,-3,,,,
377,2017,6,NCAAF_20171007_HAWAII@NEVADA,Nevada,,Hawaii,,1-5,2-4,,21,14,35,21,7,14,7,7,7,7,7,0,-1,7,0,7,14,,,,
378,2017,6,NCAAF_20171007_CAL@WASH,Washington,,California,,6-0,3-3,,24,0,38,7,7,17,7,7,0,0,7,0,3,24,7,24,31,,,,
379,2017,6,NCAAF_20171007_SDGST@UNLV,UNLV,,San Diego St.,,2-3,6-0,,10,20,10,41,3,7,0,0,3,17,7,14,-4,-10,0,-10,-31,,,,
380,2017,6,NCAAF_20171006_MEMP@UCONN,UConn,,Memphis,,1-4,4-1,,24,35,31,70,14,10,0,7,7,28,21,14,-3,-11,7,-11,-39,,,,
381,2017,6,NCAAF_20171006_BOISE@BYU,BYU,,Boise St.,,1-5,3-2,,7,17,7,24,7,0,0,0,0,17,0,7,-2,-10,7,-10,-17,,,,
382,2017,6,NCAAF_20171005_LVILLE@NCST,NC State,,Louisville,,5-1,4-2,,17,10,39,25,0,17,7,15,0,10,3,12,1,7,0,7,14,,,,
383,2017,6,NCAAF_20171004_ARKST@GAS,Ga. Southern,,Arkansas St.,,0-4,2-2,,17,22,25,43,0,17,0,8,3,19,14,7,-2,-5,-3,-5,-18,,,,
384,2017,7,NCAAF_20171015_SJST@HAWAII,Hawaii,,San Jose St.,,3-4,1-7,,14,13,37,26,0,14,7,16,10,3,7,6,2,1,-10,1,11,,,,
385,2017,7,NCAAF_20171015_AKRON@WMICH,W. Michigan,,Akron,,4-3,4-3,,3,14,13,14,0,3,0,10,7,7,0,0,0,-11,-7,-11,-1,,,,
386,2017,7,NCAAF_20171014_BYU@MISSST,Miss. State,,BYU,,4-2,1-6,,21,3,35,10,7,14,7,7,0,3,7,0,3,18,7,18,25,,,,
387,2017,7,NCAAF_20171014_EMICH@ARMY,Army,,E. Michigan,,5-2,2-4,,14,14,28,27,7,7,7,7,7,7,0,13,3,0,0,0,1,,,,
388,2017,7,NCAAF_20171014_FSU@DUKE,Duke,,Florida State,,4-3,2-3,,3,7,10,17,0,3,7,0,7,0,3,7,2,-4,-7,-4,-7,,,,
389,2017,7,NCAAF_20171014_KANSAS@IOWAST,Iowa St.,,Kansas,,4-2,1-5,,24,0,45,0,14,10,14,7,0,0,0,0,3,24,14,24,45,,,,
390,2017,7,NCAAF_20171014_NCST@PITT,Pittsburgh,,NC State,,2-5,6-1,,14,14,17,35,7,7,0,3,14,0,7,14,-4,0,-7,0,-18,,,,
391,2017,7,NCAAF_20171014_RUT@ILL,Illinois,,Rutgers,,2-4,2-4,,10,21,24,35,3,7,0,14,7,14,7,7,0,-11,-4,-11,-11,,,,
392,2017,7,NCAAF_20171014_SC@TENN,Tennessee,,South Carolina,,3-3,5-2,,9,3,9,15,6,3,0,0,0,3,6,6,-2,6,6,6,-6,,,,
393,2017,7,NCAAF_20171014_TCU@KSTATE,Kansas State,,TCU,,3-3,6-0,,3,13,6,26,0,3,3,0,10,3,7,6,-3,-10,-10,-10,-20,,,,
394,2017,7,NCAAF_20171014_TXTECH@WVU,West Virginia,,Texas Tech,,4-2,4-2,,17,28,46,35,10,7,7,22,14,14,7,0,0,-11,-4,-11,11,,,,
395,2017,7,NCAAF_20171014_UCONN@TEMPLE,Temple,,UConn,,3-4,2-4,,7,14,24,28,7,0,7,10,0,14,14,0,1,-7,7,-7,-4,,,,
396,2017,7,NCAAF_20171014_BC@LVILLE,Louisville,,Boston College,,4-3,3-4,,21,14,42,45,14,7,0,21,7,7,14,17,1,7,7,7,-3,,,,
397,2017,7,NCAAF_20171014_UNLV@AF,Air Force,,UNLV,,2-4,2-4,,7,27,34,30,0,7,13,14,17,10,3,0,0,-20,-17,-20,4,,,,
398,2017,7,NCAAF_20171014_ODU@MRSHL,Marshall,,Old Dominion,,5-1,2-4,,7,3,35,3,0,7,7,21,0,3,0,0,3,4,0,4,32,,,,
399,2017,7,NCAAF_20171014_AUBURN@LSU,LSU,,Auburn,,5-2,5-2,,14,23,27,23,0,14,0,13,17,6,0,0,0,-9,-17,-9,4,,,,
400,2017,7,NCAAF_20171014_BAYLOR@OKLAST,Oklahoma State,,Baylor,,5-1,0-6,,35,10,59,16,7,28,10,14,7,3,6,0,5,25,0,25,43,,,,
401,2017,7,NCAAF_20171014_GATECH@MIAMI,Miami (Fla.),,Georgia Tech,,5-0,3-2,,13,14,25,24,3,10,3,9,7,7,10,0,2,-1,-4,-1,1,,,,
402,2017,7,NCAAF_20171014_MIAOH@KENTST,Kent St.,,Miami-OH,,2-5,2-5,,3,14,17,14,0,3,14,0,0,14,0,0,0,-11,0,-11,3,,,,
403,2017,7,NCAAF_20171014_NILL@BUFF,Buffalo,,N. Illinois,,3-4,4-2,,13,14,13,14,3,10,0,0,0,14,0,0,-1,-1,3,-1,-1,,,,
404,2017,7,NCAAF_20171014_NWEST@MD,Maryland,,Northwestern,,3-3,3-3,,14,24,21,37,7,7,7,0,3,21,3,10,0,-10,4,-10,-16,,,,
405,2017,7,NCAAF_20171014_OHIO@BGREEN,Bowling Green,,Ohio,,1-6,5-2,,16,21,30,48,6,10,7,7,0,21,6,21,-4,-5,6,-5,-18,,,,
406,2017,7,NCAAF_20171014_OKLA@TEXAS,Texas,,Oklahoma,,3-3,5-1,,10,20,24,29,0,10,7,7,10,10,3,6,-2,-10,-10,-10,-5,,,,
407,2017,7,NCAAF_20171014_PURDUE@WISC,Wisconsin,,Purdue,,6-0,3-3,,17,6,17,9,14,3,0,0,3,3,3,0,3,11,11,11,8,,,,
408,2017,7,NCAAF_20171014_TOLEDO@CMICH,C. Michigan,,Toledo,,3-4,5-1,,0,17,10,30,0,0,3,7,7,10,0,13,-2,-17,-7,-17,-20,,,,
409,2017,7,NCAAF_20171014_UVA@UNC,North Carolina,,Virginia,,1-6,5-1,,0,10,14,20,0,0,14,0,0,10,7,3,-4,-10,0,-10,-6,,,,
410,2017,7,NCAAF_20171014_VANDY@MISS,Ole Miss,,Vanderbilt,,3-3,3-4,,35,21,57,35,7,28,12,10,0,21,0,14,0,14,7,14,22,,,,
411,2017,7,NCAAF_20171014_NAVY@MEMP,Memphis,,Navy,,5-1,5-1,,10,10,30,27,7,3,10,10,10,0,9,8,0,0,-3,0,3,,,,
412,2017,7,NCAAF_20171014_COLO@OREGST,Oregon State,,Colorado,,1-6,4-3,,19,14,33,36,10,9,7,7,7,7,7,15,-3,5,3,5,-3,,,,
413,2017,7,NCAAF_20171014_HOU@TULSA,Tulsa,,Houston,,2-5,4-2,,7,10,45,17,0,7,17,21,3,7,0,7,-2,-3,-3,-3,28,,,,
414,2017,7,NCAAF_20171014_CHARLO@WKY,W. Kentucky,,Charlotte,,4-2,0-7,,38,14,45,14,14,24,0,7,7,7,0,0,4,24,7,24,31,,,,
415,2017,7,NCAAF_20171014_WYO@UTAHST,Utah St.,,Wyoming,,3-4,4-2,,16,9,23,28,6,10,0,7,3,6,7,12,-1,7,3,7,-5,,,,
416,2017,7,NCAAF_20171014_APLST@IDAHO,Idaho,,App. St.,,2-4,4-2,,17,0,20,23,0,17,3,0,0,0,7,16,-2,17,0,17,-3,,,,
417,2017,7,NCAAF_20171014_GAST@LAMON,UL-Monroe,,Georgia St.,,3-3,3-2,,10,26,37,47,10,0,14,13,13,13,14,7,0,-16,-3,-16,-10,,,,
418,2017,7,NCAAF_20171014_NMEXST@GAS,Ga. Southern,,New Mexico St.,,0-5,3-4,,24,21,27,35,14,10,3,0,14,7,0,14,-3,3,0,3,-8,,,,
419,2017,7,NCAAF_20171014_MTSU@UAB,UAB,,Middle Tenn.,,4-2,3-4,,22,20,25,23,9,13,0,3,10,10,3,0,1,2,-1,2,2,,,,
420,2017,7,NCAAF_20171014_CSTCAR@ARKST,Arkansas St.,,C. Carolina,,3-2,1-5,,17,7,51,17,7,10,17,17,0,7,0,10,2,10,7,10,34,,,,
421,2017,7,NCAAF_20171014_ECU@UCF,UCF,,East Carolina,,5-0,1-6,,42,14,63,21,21,21,7,14,7,7,0,7,4,28,14,28,42,,,,
422,2017,7,NCAAF_20171014_TULANE@FIU,FIU,,Tulane,,4-2,3-3,,10,3,23,10,7,3,3,10,0,3,7,0,1,7,7,7,13,,,,
423,2017,7,NCAAF_20171014_TXAM@FLA,Florida,,Texas A&M,,3-3,5-2,,10,3,17,19,3,7,0,7,3,0,7,9,-2,7,0,7,-2,,,,
424,2017,7,NCAAF_20171014_TXSA@NTEXAS,North Texas,,UTSA,,4-2,3-2,,16,17,29,26,16,0,0,13,7,10,3,6,1,-1,9,-1,3,,,,
425,2017,7,NCAAF_20171014_UTEP@USM,So. Miss,,UTEP,,4-2,0-7,,14,0,24,0,7,7,0,10,0,0,0,0,4,14,7,14,24,,,,
426,2017,7,NCAAF_20171014_ARK@BAMA,Alabama,,Arkansas,,7-0,2-4,,24,0,41,9,17,7,7,10,0,0,3,6,5,24,17,24,32,,,,
427,2017,7,NCAAF_20171014_CINCY@SFLA,South Florida,,Cincinnati,,6-0,2-5,,23,3,33,3,3,20,7,3,3,0,0,0,4,20,0,20,30,,,,
428,2017,7,NCAAF_20171014_MIZZOU@UGA,Georgia,,Missouri,,7-0,1-5,,34,21,53,28,14,20,13,6,14,7,0,7,6,13,0,13,25,,,,
429,2017,7,NCAAF_20171014_OHIOST@NEB,Nebraska,,Ohio State,,3-4,6-1,,0,35,14,56,0,0,14,0,14,21,14,7,-3,-35,-14,-35,-42,,,,
430,2017,7,NCAAF_20171014_MICHST@MINN,Minnesota,,Michigan St.,,3-3,5-1,,6,17,27,30,6,0,0,21,10,7,6,7,-2,-11,-4,-11,-3,,,,
431,2017,7,NCAAF_20171014_UTAH@USC,USC,,Utah,,6-1,4-2,,7,21,28,27,7,0,7,14,7,14,0,6,2,-14,0,-14,1,,,,
432,2017,7,NCAAF_20171014_UCLA@ARIZ,Arizona,,UCLA,,4-2,3-3,,30,14,47,30,17,13,10,7,7,7,16,0,1,16,10,16,17,,,,
433,2017,7,NCAAF_20171014_NMEX@FRESNO,Fresno St.,,New Mexico,,4-2,3-3,,21,0,38,0,14,7,10,7,0,0,0,0,1,21,14,21,38,,,,
434,2017,7,NCAAF_20171014_NEVADA@COLOST,Colorado St.,,Nevada,,5-2,1-6,,28,21,44,42,14,14,10,6,14,7,21,0,4,7,0,7,2,,,,
435,2017,7,NCAAF_20171014_BOISE@SDGST,San Diego St.,,Boise St.,,6-1,4-2,,0,21,14,31,0,0,7,7,14,7,0,10,2,-21,-14,-21,-17,,,,
436,2017,7,NCAAF_20171014_WASH@ARIZST,Arizona St.,,Washington,,1-2,6-1,,13,0,13,7,7,6,0,0,0,0,0,7,-5,13,7,13,6,,,,
437,2017,7,NCAAF_20171014_OREG@STNFRD,Stanford,,Oregon,,5-2,4-3,,28,7,49,7,21,7,7,14,7,0,0,0,1,21,14,21,42,,,,
438,2017,7,NCAAF_20171013_CLEM@CUSE,Syracuse,,Clemson,,4-3,6-1,,17,14,27,24,14,3,7,3,7,7,10,0,-2,3,7,3,3,,,,
439,2017,7,NCAAF_20171013_WASHST@CAL,California,,Washington St.,,4-3,6-1,,17,3,37,3,10,7,3,17,0,3,0,0,-2,14,10,14,34,,,,
440,2017,7,NCAAF_20171012_TXSTSM@LALAF,Louisiana,,Texas St.,,3-3,1-6,,14,0,24,7,14,0,3,7,0,0,7,0,2,14,14,14,17,,,,
441,2017,7,NCAAF_20171011_SALA@TROY,Troy,,South Alabama,,4-2,2-4,,0,9,8,19,0,0,0,8,7,2,7,3,2,-9,-7,-9,-11,,,,
442,2017,8,NCAAF_20171021_AKRON@TOLEDO,Toledo,,Akron,,6-1,4-4,,24,7,48,21,21,3,14,10,0,7,0,14,2,17,21,17,27,,,,
443,2017,8,NCAAF_20171021_IDAHO@MIZZOU,Missouri,,Idaho,,2-5,2-5,,51,14,68,21,34,17,14,3,7,7,0,7,0,37,27,37,47,,,,
444,2017,8,NCAAF_20171021_IOWAST@TXTECH,Texas Tech,,Iowa St.,,4-3,5-2,,6,24,13,31,6,0,7,0,7,17,0,7,-1,-18,-1,-18,-18,,,,
445,2017,8,NCAAF_20171021_LVILLE@FSU,Florida State,,Louisville,,2-4,5-3,,14,14,28,31,7,7,0,14,7,7,14,3,-3,0,0,0,-3,,,,
446,2017,8,NCAAF_20171021_MD@WISC,Wisconsin,,Maryland,,7-0,3-4,,21,3,38,13,7,14,7,10,0,3,10,0,4,18,7,18,25,,,,
447,2017,8,NCAAF_20171021_PURDUE@RUT,Rutgers,,Purdue,,3-4,3-4,,7,3,14,12,7,0,7,0,0,3,3,6,0,4,7,4,2,,,,
448,2017,8,NCAAF_20171021_TULSA@UCONN,UConn,,Tulsa,,3-4,2-6,,3,0,20,14,3,0,14,3,0,0,0,14,1,3,3,3,6,,,,
449,2017,8,NCAAF_20171021_PITT@DUKE,Duke,,Pittsburgh,,4-4,3-5,,3,7,17,24,0,3,14,0,7,0,7,10,1,-4,-7,-4,-7,,,,
450,2017,8,NCAAF_20171021_BC@UVA,Virginia,,Boston College,,5-2,4-4,,7,24,10,41,0,7,0,3,17,7,10,7,1,-17,-17,-17,-31,,,,
451,2017,8,NCAAF_20171021_KENTST@OHIO,Ohio,,Kent St.,,6-2,2-6,,13,3,48,3,0,13,28,7,3,0,0,0,4,10,-3,10,45,,,,
452,2017,8,NCAAF_20171021_NILL@BGREEN,Bowling Green,,N. Illinois,,1-7,5-2,,7,31,17,48,7,0,3,7,14,17,10,7,-4,-24,-7,-24,-31,,,,
453,2017,8,NCAAF_20171021_TROY@GAST,Georgia St.,,Troy,,3-3,5-2,,3,21,10,34,3,0,0,7,7,14,10,3,-2,-18,-4,-18,-24,,,,
454,2017,8,NCAAF_20171021_BUFF@MIAOH,Miami-OH,,Buffalo,,3-5,3-5,,10,7,24,14,10,0,14,0,0,7,0,7,0,3,10,3,10,,,,
455,2017,8,NCAAF_20171021_CMICH@BALLST,Ball St.,,C. Michigan,,2-5,4-4,,6,28,9,56,3,3,3,0,7,21,7,21,-2,-22,-4,-22,-47,,,,
456,2017,8,NCAAF_20171021_ARIZST@UTAH,Utah,,Arizona St.,,4-3,4-3,,0,16,10,30,0,0,3,7,9,7,7,7,0,-16,-9,-16,-20,,,,
457,2017,8,NCAAF_20171021_CSTCAR@APLST,App. St.,,C. Carolina,,5-2,1-6,,17,19,37,29,14,3,6,14,3,16,3,7,4,-2,11,-2,8,,,,
458,2017,8,NCAAF_20171021_CUSE@MIAMI,Miami (Fla.),,Syracuse,,6-0,4-4,,13,3,27,19,3,10,7,7,0,3,10,6,2,10,3,10,8,,,,
459,2017,8,NCAAF_20171021_GAS@MA,UMass,,Ga. Southern,,1-6,0-6,,48,17,55,20,28,20,0,7,7,10,3,0,1,31,21,31,35,,,,
460,2017,8,NCAAF_20171021_ILL@MINN,Minnesota,,Illinois,,4-3,2-5,,7,7,24,17,7,0,3,14,7,0,0,10,2,0,0,0,7,,,,
461,2017,8,NCAAF_20171021_IND@MICHST,Michigan St.,,Indiana,,6-1,3-4,,3,3,17,9,0,3,0,14,3,0,3,3,3,0,-3,0,8,,,,
462,2017,8,NCAAF_20171021_TENN@BAMA,Alabama,,Tennessee,,8-0,3-4,,21,0,45,7,7,14,10,14,0,0,7,0,5,21,7,21,38,,,,
463,2017,8,NCAAF_20171021_UCF@NAVY,Navy,,UCF,,5-2,6-0,,7,14,21,31,0,7,7,7,7,7,10,7,-1,-7,-7,-7,-10,,,,
464,2017,8,NCAAF_20171021_UNC@VATECH,Virginia Tech,,North Carolina,,6-1,1-7,,35,0,59,7,14,21,17,7,0,0,0,7,5,35,14,35,52,,,,
465,2017,8,NCAAF_20171021_OKLA@KSTATE,Kansas State,,Oklahoma,,3-4,6-1,,21,10,35,42,14,7,0,14,7,3,10,22,-3,11,7,11,-7,,,,
466,2017,8,NCAAF_20171021_OREG@UCLA,UCLA,,Oregon,,4-3,4-4,,14,14,31,14,14,0,10,7,0,14,0,0,0,0,14,0,17,,,,
467,2017,8,NCAAF_20171021_UK@MISSST,Miss. State,,Kentucky,,5-2,5-2,,17,7,45,7,7,10,7,21,0,7,0,0,0,10,7,10,38,,,,
468,2017,8,NCAAF_20171021_LAMON@SALA,South Alabama,,UL-Monroe,,3-4,3-4,,24,20,33,23,14,10,6,3,7,13,3,0,0,4,7,4,10,,,,
469,2017,8,NCAAF_20171021_NTEXAS@FAU,FAU,,North Texas,,4-3,4-3,,41,7,69,31,24,17,21,7,0,7,10,14,0,34,24,34,38,,,,
470,2017,8,NCAAF_20171021_UTAHST@UNLV,UNLV,,Utah St.,,2-5,4-4,,28,28,28,52,14,14,0,0,7,21,7,17,-2,0,7,0,-24,,,,
471,2017,8,NCAAF_20171021_BYU@ECU,East Carolina,,BYU,,2-6,1-7,,10,10,33,17,7,3,9,14,7,3,0,7,1,0,0,0,16,,,,
472,2017,8,NCAAF_20171021_RICE@TXSA,UTSA,,Rice,,4-2,1-6,,10,7,20,7,10,0,10,0,0,7,0,0,3,3,10,3,13,,,,
473,2017,8,NCAAF_20171021_SFLA@TULANE,Tulane,,South Florida,,3-4,7-0,,7,20,28,34,0,7,7,14,7,13,14,0,-4,-13,-7,-13,-6,,,,
474,2017,8,NCAAF_20171021_LSU@MISS,Ole Miss,,LSU,,3-4,6-2,,6,13,24,40,3,3,10,8,10,3,17,10,-3,-7,-7,-7,-16,,,,
475,2017,8,NCAAF_20171021_AUBURN@ARK,Arkansas,,Auburn,,2-5,6-2,,6,17,20,52,3,3,7,7,10,7,28,7,-4,-11,-7,-11,-32,,,,
476,2017,8,NCAAF_20171021_MICH@PSU,Penn State,,Michigan,,7-0,5-2,,21,13,42,13,14,7,7,14,0,13,0,0,2,8,14,8,29,,,,
477,2017,8,NCAAF_20171021_USC@ND,Notre Dame,,USC,,6-1,6-2,,28,0,49,14,14,14,14,7,0,0,14,0,0,28,14,28,35,,,,
478,2017,8,NCAAF_20171021_WAKE@GATECH,Georgia Tech,,Wake Forest,,4-2,4-3,,13,21,38,24,3,10,12,13,7,14,3,0,0,-8,-4,-8,14,,,,
479,2017,8,NCAAF_20171021_KANSAS@TCU,TCU,,Kansas,,7-0,1-6,,24,0,43,0,10,14,19,0,0,0,0,0,6,24,10,24,43,,,,
480,2017,8,NCAAF_20171021_WVU@BAYLOR,Baylor,,West Virginia,,0-7,5-2,,6,17,36,38,0,6,7,23,10,7,21,0,-5,-11,-10,-11,-2,,,,
481,2017,8,NCAAF_20171021_WYO@BOISE,Boise St.,,Wyoming,,5-2,4-3,,3,7,24,14,0,3,7,14,7,0,7,0,1,-4,-7,-4,10,,,,
482,2017,8,NCAAF_20171021_FRESNO@SDGST,San Diego St.,,Fresno St.,,6-2,5-2,,3,17,3,27,0,3,0,0,7,10,10,0,1,-14,-7,-14,-24,,,,
483,2017,8,NCAAF_20171021_COLO@WASHST,Washington St.,,Colorado,,7-1,4-4,,14,0,28,0,0,14,7,7,0,0,0,0,3,14,0,14,28,,,,
484,2017,8,NCAAF_20171020_WKY@ODU,Old Dominion,,W. Kentucky,,2-5,5-2,,14,21,31,35,7,7,17,0,7,14,0,14,-3,-7,0,-7,-4,,,,
485,2017,8,NCAAF_20171020_MRSHL@MTSU,Middle Tenn.,,Marshall,,3-5,6-1,,10,31,10,38,3,7,0,0,7,24,0,7,-3,-21,-4,-21,-28,,,,
486,2017,8,NCAAF_20171020_AF@NEVADA,Nevada,,Air Force,,1-7,3-4,,20,28,42,45,14,6,8,14,7,21,7,10,-2,-8,7,-8,-3,,,,
487,2017,8,NCAAF_20171020_COLOST@NMEX,New Mexico,,Colorado St.,,3-4,6-2,,10,21,24,27,7,3,7,7,0,21,0,6,-3,-11,7,-11,-3,,,,
488,2017,8,NCAAF_20171019_LALAF@ARKST,Arkansas St.,,Louisiana,,4-2,3-4,,34,3,47,3,14,20,3,10,3,0,0,0,1,31,11,31,44,,,,
489,2017,8,NCAAF_20171019_MEMP@HOU,Houston,,Memphis,,4-3,6-1,,17,0,38,42,7,10,14,7,0,0,21,21,-2,17,7,17,-4,,,,
490,2017,9,NCAAF_20171028_BUFF@AKRON,Akron,,Buffalo,,5-4,3-6,,14,13,21,20,7,7,0,7,7,6,0,7,2,1,0,1,1,,,,
491,2017,9,NCAAF_20171028_ARK@MISS,Ole Miss,,Arkansas,,3-5,3-5,,31,21,37,38,21,10,0,6,7,14,7,10,0,10,14,10,-1,,,,
492,2017,9,NCAAF_20171028_MIAMI@UNC,North Carolina,,Miami (Fla.),,1-8,7-0,,6,7,19,24,3,3,7,6,0,7,10,7,-6,-1,3,-1,-5,,,,
493,2017,9,NCAAF_20171028_OKLAST@WVU,West Virginia,,Oklahoma State,,5-3,7-1,,10,23,39,50,0,10,14,15,13,10,7,20,-2,-13,-13,-13,-11,,,,
494,2017,9,NCAAF_20171028_RUT@MICH,Michigan,,Rutgers,,6-2,3-5,,21,7,35,14,0,21,7,7,0,7,7,0,3,14,0,14,21,,,,
495,2017,9,NCAAF_20171028_TEXAS@BAYLOR,Baylor,,Texas,,0-8,4-4,,7,21,7,38,0,7,0,0,7,14,3,14,-4,-14,-7,-14,-31,,,,
496,2017,9,NCAAF_20171028_WISC@ILL,Illinois,,Wisconsin,,2-6,8-0,,3,17,10,24,0,3,0,7,7,10,0,7,-6,-14,-7,-14,-14,,,,
497,2017,9,NCAAF_20171028_LVILLE@WAKE,Wake Forest,,Louisville,,5-3,5-4,,28,10,42,32,14,14,7,7,3,7,7,15,0,18,11,18,10,,,,
498,2017,9,NCAAF_20171028_UVA@PITT,Pittsburgh,,Virginia,,4-5,5-3,,21,7,31,14,7,14,7,3,0,7,0,7,-1,14,7,14,17,,,,
499,2017,9,NCAAF_20171028_CAL@COLO,Colorado,,California,,5-4,4-5,,27,14,44,28,14,13,0,17,7,7,0,14,1,13,7,13,16,,,,
500,2017,9,NCAAF_20171028_FIU@MRSHL,Marshall,,FIU,,6-2,5-2,,7,28,30,41,0,7,7,16,14,14,7,6,1,-21,-14,-21,-11,,,,
501,2017,9,NCAAF_20171028_AF@COLOST,Colorado St.,,Air Force,,6-3,4-4,,21,28,28,45,14,7,7,0,7,21,3,14,2,-7,7,-7,-17,,,,
502,2017,9,NCAAF_20171028_KSTATE@KANSAS,Kansas,,Kansas State,,1-7,4-4,,6,10,20,30,6,0,0,14,7,3,10,10,-3,-4,-1,-4,-10,,,,
503,2017,9,NCAAF_20171028_SJST@BYU,BYU,,San Jose St.,,2-7,1-8,,24,6,41,20,14,10,7,10,3,3,0,14,1,18,11,18,21,,,,
504,2017,9,NCAAF_20171028_GAS@TROY,Troy,,Ga. Southern,,6-2,0-7,,28,10,38,16,14,14,3,7,7,3,0,6,6,18,7,18,22,,,,
505,2017,9,NCAAF_20171028_IND@MD,Maryland,,Indiana,,4-4,3-5,,28,23,42,39,7,21,0,14,16,7,10,6,1,5,-9,5,3,,,,
506,2017,9,NCAAF_20171028_LATECH@RICE,Rice,,Louisiana Tech,,1-7,4-4,,7,21,28,42,0,7,7,14,7,14,7,14,-3,-14,-7,-14,-14,,,,
507,2017,9,NCAAF_20171028_NCST@ND,Notre Dame,,NC State,,7-1,6-2,,21,14,35,14,7,14,14,0,7,7,0,0,1,7,0,7,21,,,,
508,2017,9,NCAAF_20171028_PSU@OHIOST,Ohio State,,Penn State,,7-1,7-1,,17,28,39,38,3,14,3,19,14,14,7,3,0,-11,-11,-11,1,,,,
509,2017,9,NCAAF_20171028_TCU@IOWAST,Iowa St.,,TCU,,6-2,7-1,,14,0,14,7,7,7,0,0,0,0,7,0,-1,14,7,14,7,,,,
510,2017,9,NCAAF_20171028_UCLA@WASH,Washington,,UCLA,,7-1,4-4,,20,9,44,23,3,17,17,7,3,6,0,14,3,11,0,11,21,,,,
511,2017,9,NCAAF_20171028_UGA@FLA,Florida,,Georgia,,3-4,8-0,,0,21,7,42,0,0,0,7,21,0,14,7,-5,-21,-21,-21,-35,,,,
512,2017,9,NCAAF_20171028_HOU@SFLA,South Florida,,Houston,,7-1,5-3,,7,0,24,28,0,7,7,10,0,0,14,14,2,7,0,7,-4,,,,
513,2017,9,NCAAF_20171028_VANDY@SC,South Carolina,,Vanderbilt,,6-2,3-5,,24,13,34,27,14,10,7,3,7,6,7,7,3,11,7,11,7,,,,
514,2017,9,NCAAF_20171028_FAU@WKY,W. Kentucky,,FAU,,5-3,5-3,,21,20,28,42,7,14,7,0,10,10,0,22,0,1,-3,1,-14,,,,
515,2017,9,NCAAF_20171028_AP@UCF,UCF,,Austin Peay,,7-0,5-4,,45,26,73,33,14,31,14,14,7,19,7,0,2,19,7,19,40,,,,
516,2017,9,NCAAF_20171028_LAMON@IDAHO,Idaho,,UL-Monroe,,3-5,3-5,,28,7,31,23,14,14,3,0,0,7,6,10,0,21,14,21,8,,,,
517,2017,9,NCAAF_20171028_UTAH@OREG,Oregon,,Utah,,5-4,4-4,,17,6,41,20,7,10,10,14,0,6,7,7,1,11,7,11,21,,,,
518,2017,9,NCAAF_20171028_TXSTSM@CSTCAR,C. Carolina,,Texas St.,,1-7,2-6,,7,17,7,27,7,0,0,0,7,10,3,7,-1,-10,0,-10,-20,,,,
519,2017,9,NCAAF_20171028_MINN@IOWA,Iowa,,Minnesota,,5-3,4-4,,7,0,17,10,7,0,7,3,0,0,0,10,1,7,7,7,7,,,,
520,2017,9,NCAAF_20171028_MIZZOU@UCONN,UConn,,Missouri,,3-5,3-5,,5,31,12,52,2,3,7,0,21,10,14,7,0,-26,-19,-26,-40,,,,
521,2017,9,NCAAF_20171028_ODU@NTEXAS,North Texas,,Old Dominion,,5-3,2-6,,35,23,45,38,14,21,0,10,10,13,15,0,3,12,4,12,7,,,,
522,2017,9,NCAAF_20171028_UAB@USM,So. Miss,,UAB,,5-3,5-3,,12,7,12,30,9,3,0,0,7,0,6,17,0,5,2,5,-18,,,,
523,2017,9,NCAAF_20171028_MISSST@TXAM,Texas A&M,,Miss. State,,5-3,6-2,,0,14,14,35,0,0,7,7,7,7,14,7,-1,-14,-7,-14,-21,,,,
524,2017,9,NCAAF_20171028_DUKE@VATECH,Virginia Tech,,Duke,,7-1,4-5,,17,3,24,3,7,10,7,0,0,3,0,0,3,14,7,14,21,,,,
525,2017,9,NCAAF_20171028_NEB@PURDUE,Purdue,,Nebraska,,3-5,4-4,,14,6,24,25,0,14,3,7,3,3,6,13,-1,8,-3,8,-1,,,,
526,2017,9,NCAAF_20171028_NMEX@WYO,Wyoming,,New Mexico,,5-3,3-5,,42,0,42,3,7,35,0,0,0,0,0,3,2,42,7,42,39,,,,
527,2017,9,NCAAF_20171028_TENN@UK,Kentucky,,Tennessee,,6-2,3-5,,21,20,29,26,7,14,0,8,6,14,3,3,3,1,1,1,3,,,,
528,2017,9,NCAAF_20171028_ARKST@NMEXST,New Mexico St.,,Arkansas St.,,3-5,5-2,,14,7,21,37,0,14,0,7,7,0,10,20,-2,7,-7,7,-16,,,,
529,2017,9,NCAAF_20171028_GATECH@CLEM,Clemson,,Georgia Tech,,7-1,4-3,,21,3,24,10,14,7,3,0,3,0,0,7,3,18,11,18,14,,,,
530,2017,9,NCAAF_20171028_TXSA@UTEP,UTEP,,UTSA,,0-8,5-2,,14,17,14,31,0,14,0,0,3,14,7,7,-5,-3,-3,-3,-17,,,,
531,2017,9,NCAAF_20171028_TXTECH@OKLA,Oklahoma,,Texas Tech,,7-1,4-4,,28,20,49,27,14,14,21,0,20,0,7,0,3,8,-6,8,22,,,,
532,2017,9,NCAAF_20171028_WASHST@ARIZ,Arizona,,Washington St.,,6-2,7-2,,23,14,58,37,10,13,14,21,7,7,13,10,-1,9,3,9,21,,,,
533,2017,9,NCAAF_20171028_BOISE@UTAHST,Utah St.,,Boise St.,,4-5,6-2,,7,28,14,41,7,0,7,0,14,14,7,6,-2,-21,-7,-21,-27,,,,
534,2017,9,NCAAF_20171028_UNLV@FRESNO,Fresno St.,,UNLV,,5-3,3-5,,9,9,16,26,9,0,7,0,3,6,7,10,2,0,6,0,-10,,,,
535,2017,9,NCAAF_20171028_USC@ARIZST,Arizona St.,,USC,,0-5,7-2,,10,31,17,48,3,7,7,0,14,17,7,10,-7,-21,-11,-21,-31,,,,
536,2017,9,NCAAF_20171028_SDGST@HAWAII,Hawaii,,San Diego St.,,3-5,7-2,,7,14,7,28,0,7,0,0,7,7,7,7,-4,-7,-7,-7,-21,,,,
537,2017,9,NCAAF_20171027_FSU@BC,Boston College,,Florida State,,5-4,2-5,,21,3,35,3,7,14,14,0,0,3,0,0,3,18,7,18,32,,,,
538,2017,9,NCAAF_20171027_TULANE@MEMP,Memphis,,Tulane,,7-1,3-5,,35,12,56,26,14,21,0,21,0,12,7,7,4,23,14,23,30,,,,
539,2017,9,NCAAF_20171027_TULSA@SMU,SMU,,Tulsa,,6-2,2-7,,21,28,38,34,7,14,7,10,14,14,6,0,4,-7,-7,-7,4,,,,
540,2017,9,NCAAF_20171026_TOLEDO@BALLST,Ball St.,,Toledo,,2-6,7-1,,10,24,17,58,7,3,7,0,3,21,27,7,-5,-14,4,-14,-41,,,,
541,2017,9,NCAAF_20171026_SALA@GAST,Georgia St.,,South Alabama,,4-3,3-5,,14,3,21,13,7,7,0,7,0,3,3,7,1,11,7,11,8,,,,
542,2017,9,NCAAF_20171026_STNFRD@OREGST,Oregon State,,Stanford,,1-7,6-2,,7,6,14,15,0,7,7,0,0,6,3,6,-5,1,0,1,-1,,,,
543,2017,10,NCAAF_20171104_AUBURN@TXAM,Texas A&M,,Auburn,,5-4,7-2,,13,21,27,42,3,10,7,7,0,21,14,7,-2,-8,3,-8,-15,,,,
544,2017,10,NCAAF_20171104_BAYLOR@KANSAS,Kansas,,Baylor,,1-8,1-8,,6,21,9,38,0,6,3,0,0,21,7,10,0,-15,0,-15,-29,,,,
545,2017,10,NCAAF_20171104_ECU@HOU,Houston,,East Carolina,,6-3,2-7,,28,10,52,27,21,7,17,7,0,10,7,10,4,18,21,18,25,,,,
546,2017,10,NCAAF_20171104_FLA@MIZZOU,Missouri,,Florida,,4-5,3-5,,28,6,45,16,7,21,7,10,0,6,3,7,1,22,7,22,29,,,,
547,2017,10,NCAAF_20171104_ILL@PURDUE,Purdue,,Illinois,,4-5,2-7,,13,10,29,10,7,6,3,13,7,3,0,0,2,3,0,3,19,,,,
548,2017,10,NCAAF_20171104_MA@MISSST,Miss. State,,UMass,,7-2,2-7,,13,20,34,23,10,3,14,7,3,17,0,3,5,-7,7,-7,11,,,,
549,2017,10,NCAAF_20171104_PSU@MICHST,Michigan St.,,Penn State,,7-2,7-2,,14,14,27,24,7,7,7,6,14,0,10,0,0,0,-7,0,3,,,,
550,2017,10,NCAAF_20171104_WISC@IND,Indiana,,Wisconsin,,3-6,9-0,,10,14,17,45,7,3,7,0,0,14,10,21,-6,-4,7,-4,-28,,,,
551,2017,10,NCAAF_20171104_WKY@VANDY,Vanderbilt,,W. Kentucky,,4-5,5-4,,21,14,31,17,14,7,7,3,7,7,3,0,-1,7,7,7,14,,,,
552,2017,10,NCAAF_20171104_CUSE@FSU,Florida State,,Syracuse,,3-5,4-5,,21,14,27,24,7,14,3,3,0,14,3,7,-1,7,7,7,3,,,,
553,2017,10,NCAAF_20171104_APLST@LAMON,UL-Monroe,,App. St.,,4-5,5-4,,28,24,52,45,14,14,7,17,0,24,14,7,-1,4,14,4,7,,,,
554,2017,10,NCAAF_20171104_GAST@GAS,Ga. Southern,,Georgia St.,,0-8,5-3,,10,7,17,21,7,3,7,0,7,0,7,7,-5,3,0,3,-4,,,,
555,2017,10,NCAAF_20171104_GATECH@UVA,Virginia,,Georgia Tech,,6-3,4-4,,13,14,40,36,3,10,15,12,7,7,14,8,2,-1,-4,-1,4,,,,
556,2017,10,NCAAF_20171104_NMEXST@TXSTSM,Texas St.,,New Mexico St.,,2-7,4-5,,21,17,35,45,14,7,7,7,7,10,14,14,-2,4,7,4,-10,,,,
557,2017,10,NCAAF_20171104_RICE@UAB,UAB,,Rice,,6-3,1-8,,42,7,52,21,21,21,7,3,0,7,0,14,5,35,21,35,31,,,,
558,2017,10,NCAAF_20171104_ARMY@AF,Air Force,,Army,,4-5,7-2,,0,14,0,21,0,0,0,0,7,7,0,7,-3,-14,-7,-14,-21,,,,
559,2017,10,NCAAF_20171104_CHARLO@ODU,Old Dominion,,Charlotte,,3-6,1-8,,3,0,6,0,3,0,3,0,0,0,0,0,2,3,3,3,6,,,,
560,2017,10,NCAAF_20171104_CLEM@NCST,NC State,,Clemson,,6-3,8-1,,21,17,31,38,14,7,0,10,7,10,14,7,-2,4,7,4,-7,,,,
561,2017,10,NCAAF_20171104_IOWAST@WVU,West Virginia,,Iowa St.,,6-3,6-3,,20,3,20,16,10,10,0,0,0,3,10,3,0,17,10,17,4,,,,
562,2017,10,NCAAF_20171104_MD@RUT,Rutgers,,Maryland,,4-5,4-5,,17,14,31,24,0,17,0,14,7,7,10,0,0,3,-7,3,7,,,,
563,2017,10,NCAAF_20171104_NTEXAS@LATECH,Louisiana Tech,,North Texas,,4-5,6-3,,17,10,23,24,3,14,3,3,7,3,7,7,-2,7,-4,7,-1,,,,
564,2017,10,NCAAF_20171104_OHIOST@IOWA,Iowa,,Ohio State,,6-3,7-2,,31,17,55,24,10,21,7,17,10,7,0,7,-1,14,0,14,31,,,,
565,2017,10,NCAAF_20171104_SC@UGA,Georgia,,South Carolina,,9-0,6-3,,14,7,24,10,7,7,7,3,0,7,3,0,3,7,7,7,14,,,,
566,2017,10,NCAAF_20171104_SFLA@UCONN,UConn,,South Florida,,3-6,8-1,,7,17,20,37,0,7,0,13,7,10,17,3,-5,-10,-7,-10,-17,,,,
567,2017,10,NCAAF_20171104_STNFRD@WASHST,Washington St.,,Stanford,,8-2,6-3,,14,7,24,21,0,14,3,7,0,7,14,0,2,7,0,7,3,,,,
568,2017,10,NCAAF_20171104_WAKE@ND,Notre Dame,,Wake Forest,,8-1,5-4,,31,10,48,37,7,24,10,7,3,7,13,14,3,21,4,21,11,,,,
569,2017,10,NCAAF_20171104_CINCY@TULANE,Tulane,,Cincinnati,,3-6,3-6,,13,10,16,17,7,6,0,3,3,7,7,0,0,3,4,3,-1,,,,
570,2017,10,NCAAF_20171104_CSTCAR@ARK,Arkansas,,C. Carolina,,4-5,1-8,,17,14,39,38,7,10,8,14,7,7,17,7,3,3,0,3,1,,,,
571,2017,10,NCAAF_20171104_LALAF@SALA,South Alabama,,Louisiana,,3-6,4-4,,7,19,14,19,0,7,0,7,3,16,0,0,-1,-12,-3,-12,-5,,,,
572,2017,10,NCAAF_20171104_MISS@UK,Kentucky,,Ole Miss,,6-3,4-5,,20,17,34,37,3,17,7,7,7,10,10,10,2,3,-4,3,-3,,,,
573,2017,10,NCAAF_20171104_OKLA@OKLAST,Oklahoma State,,Oklahoma,,7-2,8-1,,38,38,52,62,10,28,0,14,14,24,10,14,-1,0,-4,0,-10,,,,
574,2017,10,NCAAF_20171104_OREGST@CAL,California,,Oregon State,,5-5,1-8,,20,13,37,23,14,6,10,7,7,6,7,3,4,7,7,7,14,,,,
575,2017,10,NCAAF_20171104_UTAHST@NMEX,New Mexico,,Utah St.,,3-6,5-5,,3,14,10,24,0,3,0,7,7,7,3,7,-2,-11,-7,-11,-14,,,,
576,2017,10,NCAAF_20171104_HAWAII@UNLV,UNLV,,Hawaii,,4-5,3-6,,7,6,31,23,7,0,21,3,0,6,7,10,1,1,7,1,8,,,,
577,2017,10,NCAAF_20171104_COLOST@WYO,Wyoming,,Colorado St.,,6-3,6-4,,6,10,16,13,0,6,3,7,3,7,0,3,0,-4,-3,-4,3,,,,
578,2017,10,NCAAF_20171104_NEVADA@BOISE,Boise St.,,Nevada,,7-2,1-8,,31,14,41,14,10,21,7,3,7,7,0,0,6,17,3,17,27,,,,
579,2017,10,NCAAF_20171104_TXSA@FIU,FIU,,UTSA,,6-2,5-3,,0,0,14,7,0,0,14,0,0,0,0,7,1,0,0,0,7,,,,
580,2017,10,NCAAF_20171104_TEXAS@TCU,TCU,,Texas,,8-1,4-5,,17,7,24,7,7,10,0,7,0,7,0,0,4,10,7,10,17,,,,
581,2017,10,NCAAF_20171104_UCF@SMU,SMU,,UCF,,6-3,8-0,,14,21,24,31,7,7,10,0,7,14,7,3,-2,-7,0,-7,-7,,,,
582,2017,10,NCAAF_20171104_MINN@MICH,Michigan,,Minnesota,,7-2,4-5,,20,7,33,10,13,7,13,0,7,0,0,3,3,13,6,13,23,,,,
583,2017,10,NCAAF_20171104_USM@TENN,Tennessee,,So. Miss,,4-5,5-4,,10,3,24,10,7,3,14,0,0,3,0,7,-1,7,7,7,14,,,,
584,2017,10,NCAAF_20171104_UTEP@MTSU,Middle Tenn.,,UTEP,,4-5,0-9,,17,0,30,3,10,7,7,6,0,0,3,0,4,17,10,17,27,,,,
585,2017,10,NCAAF_20171104_LSU@BAMA,Alabama,,LSU,,9-0,6-3,,14,3,24,10,7,7,7,3,0,3,7,0,3,11,7,11,14,,,,
586,2017,10,NCAAF_20171104_VATECH@MIAMI,Miami (Fla.),,Virginia Tech,,8-0,7-2,,14,3,28,10,0,14,7,7,0,3,7,0,1,11,0,11,18,,,,
587,2017,10,NCAAF_20171104_COLO@ARIZST,Arizona St.,,Colorado,,1-4,5-5,,14,17,41,30,0,14,3,24,3,14,10,3,-4,-3,-3,-3,11,,,,
588,2017,10,NCAAF_20171104_OREG@WASH,Washington,,Oregon,,8-1,5-5,,17,3,38,3,0,17,21,0,3,0,0,0,3,14,-3,14,35,,,,
589,2017,10,NCAAF_20171104_SDGST@SJST,San Jose St.,,San Diego St.,,1-9,8-2,,0,35,7,52,0,0,7,0,21,14,14,3,-7,-35,-21,-35,-45,,,,
590,2017,10,NCAAF_20171104_ARIZ@USC,USC,,Arizona,,8-2,6-3,,21,6,49,35,7,14,7,21,0,6,14,15,2,15,7,15,14,,,,
591,2017,10,NCAAF_20171104_BYU@FRESNO,Fresno St.,,BYU,,6-3,2-8,,10,6,20,13,10,0,3,7,0,6,7,0,4,4,10,4,7,,,,
592,2017,10,NCAAF_20171103_MRSHL@FAU,FAU,,Marshall,,6-3,6-3,,16,3,30,25,13,3,7,7,0,3,13,9,0,13,13,13,5,,,,
593,2017,10,NCAAF_20171103_MEMP@TULSA,Tulsa,,Memphis,,2-8,8-1,,14,21,14,41,7,7,0,0,14,7,10,10,-6,-7,-7,-7,-27,,,,
594,2017,10,NCAAF_20171103_UCLA@UTAH,Utah,,UCLA,,4-4,4-4,,17,10,48,17,7,10,21,10,0,10,0,7,0,7,7,7,31,,,,
595,2017,10,NCAAF_20171102_BALLST@EMICH,E. Michigan,,Ball St.,,3-6,2-7,,35,14,56,14,14,21,14,7,7,7,0,0,1,21,7,21,42,,,,
596,2017,10,NCAAF_20171102_NILL@TOLEDO,Toledo,,N. Illinois,,8-1,6-3,,10,7,27,17,7,3,14,3,7,0,7,3,2,3,0,3,10,,,,
597,2017,10,NCAAF_20171102_NAVY@TEMPLE,Temple,,Navy,,4-5,5-3,,17,6,34,26,10,7,14,3,3,3,7,13,-1,11,7,11,8,,,,
598,2017,10,NCAAF_20171102_IDAHO@TROY,Troy,,Idaho,,7-2,3-6,,10,7,24,21,0,10,7,7,7,0,0,14,4,3,-7,3,3,,,,
599,2017,10,NCAAF_20171101_CMICH@WMICH,W. Michigan,,C. Michigan,,5-4,5-4,,21,7,28,35,14,7,7,0,7,0,7,21,0,14,7,14,-7,,,,
600,2017,10,NCAAF_20171031_BGREEN@KENTST,Kent St.,,Bowling Green,,2-7,2-7,,9,20,16,44,0,9,0,7,17,3,14,10,0,-11,-17,-11,-28,,,,
601,2017,10,NCAAF_20171031_MIAOH@OHIO,Ohio,,Miami-OH,,7-2,3-6,,28,21,45,28,14,14,7,10,14,7,7,0,4,7,0,7,17,,,,
602,2017,11,NCAAF_20171111_ARK@LSU,LSU,,Arkansas,,7-3,4-6,,7,7,33,10,7,0,12,14,0,7,3,0,3,0,7,0,23,,,,
603,2017,11,NCAAF_20171111_DUKE@ARMY,Army,,Duke,,8-2,4-6,,21,10,21,16,7,14,0,0,3,7,0,6,4,11,4,11,5,,,,
604,2017,11,NCAAF_20171111_FLA@SC,South Carolina,,Florida,,7-3,3-6,,21,13,28,20,14,7,7,0,0,13,0,7,4,8,14,8,8,,,,
605,2017,11,NCAAF_20171111_IND@ILL,Illinois,,Indiana,,2-8,4-6,,0,14,14,24,0,0,7,7,0,14,3,7,-2,-14,0,-14,-10,,,,
606,2017,11,NCAAF_20171111_LALAF@MISS,Ole Miss,,Louisiana,,5-5,4-5,,35,10,50,22,21,14,7,8,0,10,0,12,1,25,21,25,28,,,,
607,2017,11,NCAAF_20171111_MICHST@OHIOST,Ohio State,,Michigan St.,,8-2,7-3,,35,3,48,3,14,21,13,0,0,3,0,0,1,32,14,32,45,,,,
608,2017,11,NCAAF_20171111_NCST@BC,Boston College,,NC State,,5-5,7-3,,7,10,14,17,0,7,7,0,0,10,0,7,-2,-3,0,-3,-3,,,,
609,2017,11,NCAAF_20171111_NEB@MINN,Minnesota,,Nebraska,,5-5,4-6,,30,14,54,21,14,16,10,14,7,7,0,7,1,16,7,16,33,,,,
610,2017,11,NCAAF_20171111_OKLAST@IOWAST,Iowa St.,,Oklahoma State,,6-4,8-2,,21,21,42,49,14,7,7,14,7,14,10,18,-2,0,7,0,-7,,,,
611,2017,11,NCAAF_20171111_RUT@PSU,Penn State,,Rutgers,,8-2,4-6,,14,6,35,6,0,14,14,7,3,3,0,0,4,8,-3,8,29,,,,
612,2017,11,NCAAF_20171111_TXTECH@BAYLOR,Baylor,,Texas Tech,,1-9,5-5,,7,21,24,38,7,0,7,10,14,7,10,7,-4,-14,-7,-14,-14,,,,
613,2017,11,NCAAF_20171111_UCONN@UCF,UCF,,UConn,,9-0,3-7,,28,10,49,24,21,7,0,21,3,7,7,7,6,18,18,18,25,,,,
614,2017,11,NCAAF_20171111_VATECH@GATECH,Georgia Tech,,Virginia Tech,,5-4,7-3,,14,9,28,22,7,7,7,7,3,6,7,6,-2,5,4,5,6,,,,
615,2017,11,NCAAF_20171111_MTSU@CHARLO,Charlotte,,Middle Tenn.,,1-9,5-5,,7,28,21,35,7,0,7,7,14,14,0,7,-4,-21,-7,-21,-14,,,,
616,2017,11,NCAAF_20171111_WAKE@CUSE,Syracuse,,Wake Forest,,4-6,6-4,,38,24,43,64,14,24,5,0,21,3,16,24,-2,14,-7,14,-21,,,,
617,2017,11,NCAAF_20171111_FAU@LATECH,Louisiana Tech,,FAU,,4-6,7-3,,9,20,23,48,3,6,7,7,6,14,22,6,-3,-11,-3,-11,-25,,,,
618,2017,11,NCAAF_20171111_FSU@CLEM,Clemson,,Florida State,,9-1,3-6,,17,0,31,14,7,10,0,14,0,0,7,7,6,17,7,17,17,,,,
619,2017,11,NCAAF_20171111_IOWA@WISC,Wisconsin,,Iowa,,10-0,6-4,,17,7,38,14,3,14,7,14,7,0,7,0,4,10,-4,10,24,,,,
620,2017,11,NCAAF_20171111_MICH@MD,Maryland,,Michigan,,4-6,8-2,,0,28,10,35,0,0,3,7,7,21,0,7,-4,-28,-7,-28,-25,,,,
621,2017,11,NCAAF_20171111_SMU@NAVY,Navy,,SMU,,6-3,6-4,,34,11,43,40,13,21,6,3,5,6,21,8,0,23,8,23,3,,,,
622,2017,11,NCAAF_20171111_UGA@AUBURN,Auburn,,Georgia,,7-2,9-0,,16,7,40,17,6,10,14,10,7,0,3,7,-2,9,-1,9,23,,,,
623,2017,11,NCAAF_20171111_USM@RICE,Rice,,So. Miss,,1-9,6-4,,14,22,34,43,0,14,13,7,10,12,14,7,-5,-8,-10,-8,-9,,,,
624,2017,11,NCAAF_20171111_UVA@LVILLE,Louisville,,Virginia,,6-4,6-4,,17,14,38,21,7,10,14,7,7,7,0,7,0,3,0,3,17,,,,
625,2017,11,NCAAF_20171111_WVU@KSTATE,Kansas State,,West Virginia,,5-5,7-3,,20,28,23,28,6,14,0,3,7,21,0,0,-2,-8,-1,-8,-5,,,,
626,2017,11,NCAAF_20171111_GAST@TXSTSM,Texas St.,,Georgia St.,,2-8,6-3,,14,13,30,33,7,7,3,13,10,3,10,10,-4,1,-3,1,-3,,,,
627,2017,11,NCAAF_20171111_ME@MA,UMass,,Maine,,3-7,4-5,,24,16,44,31,21,3,13,7,7,9,8,7,-1,8,14,8,13,,,,
628,2017,11,NCAAF_20171111_SJST@NEVADA,Nevada,,San Jose St.,,2-8,1-10,,38,7,59,14,14,24,14,7,7,0,0,7,1,31,7,31,45,,,,
629,2017,11,NCAAF_20171111_UK@VANDY,Vanderbilt,,Kentucky,,4-6,7-3,,7,20,21,44,7,0,14,0,7,13,21,3,-3,-13,0,-13,-23,,,,
630,2017,11,NCAAF_20171111_USC@COLO,Colorado,,USC,,5-6,9-2,,0,20,24,38,0,0,14,10,0,20,10,8,-4,-20,0,-20,-14,,,,
631,2017,11,NCAAF_20171111_TROY@CSTCAR,C. Carolina,,Troy,,1-9,8-2,,10,28,17,42,10,0,7,0,14,14,7,7,-7,-18,-4,-18,-25,,,,
632,2017,11,NCAAF_20171111_ARKST@SALA,South Alabama,,Arkansas St.,,4-6,5-3,,10,6,24,19,10,0,7,7,0,6,6,7,-1,4,10,4,5,,,,
633,2017,11,NCAAF_20171111_UTEP@NTEXAS,North Texas,,UTEP,,7-3,0-10,,14,7,45,10,7,7,14,17,7,0,3,0,7,7,0,7,35,,,,
634,2017,11,NCAAF_20171111_WASHST@UTAH,Utah,,Washington St.,,5-4,8-2,,10,20,25,33,0,10,0,15,13,7,6,7,-3,-10,-13,-10,-8,,,,
635,2017,11,NCAAF_20171111_KANSAS@TEXAS,Texas,,Kansas,,5-5,1-9,,35,17,42,27,28,7,0,7,7,10,3,7,4,18,21,18,15,,,,
636,2017,11,NCAAF_20171111_WKY@MRSHL,Marshall,,W. Kentucky,,7-3,5-5,,13,7,30,23,0,13,17,0,7,0,3,13,2,6,-7,6,7,,,,
637,2017,11,NCAAF_20171111_BAMA@MISSST,Miss. State,,Alabama,,7-3,10-0,,14,14,24,31,7,7,7,3,7,7,3,14,-3,0,0,0,-7,,,,
638,2017,11,NCAAF_20171111_NMEX@TXAM,Texas A&M,,New Mexico,,6-4,3-7,,48,7,55,14,13,35,0,7,0,7,7,0,3,41,13,41,41,,,,
639,2017,11,NCAAF_20171111_ODU@FIU,FIU,,Old Dominion,,6-3,4-6,,14,24,30,37,7,7,9,7,7,17,7,6,2,-10,0,-10,-7,,,,
640,2017,11,NCAAF_20171111_PURDUE@NWEST,Northwestern,,Purdue,,7-3,4-6,,14,0,23,13,0,14,6,3,0,0,7,6,3,14,0,14,10,,,,
641,2017,11,NCAAF_20171111_UAB@TXSA,UTSA,,UAB,,5-4,7-3,,6,21,19,24,3,3,0,13,14,7,0,3,-2,-15,-11,-15,-5,,,,
642,2017,11,NCAAF_20171111_TENN@MIZZOU,Missouri,,Tennessee,,5-5,4-6,,24,17,50,17,14,10,17,9,10,7,0,0,1,7,4,7,33,,,,
643,2017,11,NCAAF_20171111_ND@MIAMI,Miami (Fla.),,Notre Dame,,9-0,8-2,,27,0,41,8,14,13,7,7,0,0,8,0,1,27,14,27,33,,,,
644,2017,11,NCAAF_20171111_TCU@OKLA,Oklahoma,,TCU,,9-1,8-2,,38,14,38,20,17,21,0,0,7,7,0,6,1,24,10,24,18,,,,
645,2017,11,NCAAF_20171111_ARIZST@UCLA,UCLA,,Arizona St.,,5-5,5-5,,20,21,44,37,7,13,14,10,14,7,13,3,0,-1,-7,-1,7,,,,
646,2017,11,NCAAF_20171111_OREGST@ARIZ,Arizona,,Oregon State,,7-3,1-9,,28,0,49,28,14,14,14,7,0,0,14,14,6,28,14,28,21,,,,
647,2017,11,NCAAF_20171111_WYO@AF,Air Force,,Wyoming,,4-6,7-3,,7,21,14,28,0,7,7,0,7,14,0,7,-3,-14,-7,-14,-14,,,,
648,2017,11,NCAAF_20171111_FRESNO@HAWAII,Hawaii,,Fresno St.,,3-7,7-3,,7,21,21,31,7,0,0,14,0,21,10,0,-4,-14,7,-14,-10,,,,
649,2017,11,NCAAF_20171110_TEMPLE@CINCY,Cincinnati,,Temple,,3-7,5-5,,0,13,24,35,0,0,14,10,3,10,15,7,-2,-13,-3,-13,-11,,,,
650,2017,11,NCAAF_20171110_BYU@UNLV,UNLV,,BYU,,4-6,3-8,,7,14,21,31,0,7,7,7,0,14,14,3,1,-7,0,-7,-10,,,,
651,2017,11,NCAAF_20171110_WASH@STNFRD,Stanford,,Washington,,7-3,8-2,,10,14,30,22,0,10,10,10,7,7,0,8,-1,-4,-7,-4,8,,,,
652,2017,11,NCAAF_20171109_BALLST@NILL,N. Illinois,,Ball St.,,7-3,2-8,,35,7,63,17,21,14,14,14,7,0,10,0,5,28,14,28,46,,,,
653,2017,11,NCAAF_20171109_GAS@APLST,App. St.,,Ga. Southern,,6-4,0-9,,10,3,27,6,0,10,3,14,3,0,3,0,6,7,-3,7,21,,,,
654,2017,11,NCAAF_20171109_UNC@PITT,Pittsburgh,,North Carolina,,4-6,2-8,,17,24,31,34,3,14,7,7,14,10,3,7,2,-7,-11,-7,-3,,,,
655,2017,11,NCAAF_20171108_KENTST@WMICH,W. Michigan,,Kent St.,,6-4,2-8,,31,14,48,20,21,10,3,14,14,0,0,6,4,17,7,17,28,,,,
656,2017,11,NCAAF_20171108_TOLEDO@OHIO,Ohio,,Toledo,,8-2,8-2,,10,7,38,10,7,3,14,14,0,7,3,0,0,3,7,3,28,,,,
657,2017,11,NCAAF_20171108_EMICH@CMICH,C. Michigan,,E. Michigan,,6-4,3-7,,28,17,42,30,14,14,7,7,7,10,0,13,3,11,7,11,12,,,,
658,2017,11,NCAAF_20171107_AKRON@MIAOH,Miami-OH,,Akron,,4-6,5-5,,10,7,24,14,7,3,14,0,7,0,0,7,-1,3,0,3,10,,,,
659,2017,11,NCAAF_20171107_BGREEN@BUFF,Buffalo,,Bowling Green,,4-6,2-8,,21,14,38,28,21,0,7,10,7,7,7,7,2,7,14,7,10,,,,
660,2017,12,NCAAF_20171118_CINCY@ECU,East Carolina,,Cincinnati,,3-8,3-8,,24,13,48,20,14,10,14,10,0,13,7,0,0,11,14,11,28,,,,
661,2017,12,NCAAF_20171118_DEST@FSU,Florida State,,Delaware St.,,4-6,2-9,,56,6,77,6,21,35,7,14,6,0,0,0,2,50,15,50,71,,,,
662,2017,12,NCAAF_20171118_LAMON@AUBURN,Auburn,,UL-Monroe,,8-2,4-5,,14,7,42,14,7,7,14,14,7,0,0,7,4,7,0,7,28,,,,
663,2017,12,NCAAF_20171118_MERCER@BAMA,Alabama,,Mercer,,10-0,5-5,,35,0,56,0,14,21,14,7,0,0,0,0,5,35,14,35,56,,,,
664,2017,12,NCAAF_20171118_MICH@WISC,Wisconsin,,Michigan,,11-0,8-3,,7,7,24,10,7,0,14,3,0,7,3,0,3,0,7,0,14,,,,
665,2017,12,NCAAF_20171118_MINN@NWEST,Northwestern,,Minnesota,,8-3,5-6,,25,0,39,0,0,25,7,7,0,0,0,0,3,25,0,25,39,,,,
666,2017,12,NCAAF_20171118_MISSST@ARK,Arkansas,,Miss. State,,4-6,7-3,,14,14,21,28,14,0,7,0,0,14,0,14,-3,0,14,0,-7,,,,
667,2017,12,NCAAF_20171118_RUT@IND,Indiana,,Rutgers,,5-6,4-7,,20,0,41,0,17,3,14,7,0,0,0,0,1,20,17,20,41,,,,
668,2017,12,NCAAF_20171118_SMU@MEMP,Memphis,,SMU,,9-1,6-5,,31,24,66,45,10,21,14,21,10,14,14,7,3,7,0,7,21,,,,
669,2017,12,NCAAF_20171118_TCU@TXTECH,Texas Tech,,TCU,,5-6,9-2,,3,10,3,27,3,0,0,0,0,10,7,10,-4,-7,3,-7,-24,,,,
670,2017,12,NCAAF_20171118_TEXAS@WVU,West Virginia,,Texas,,7-4,6-5,,0,14,14,28,0,0,7,7,0,14,7,7,1,-14,0,-14,-14,,,,
671,2017,12,NCAAF_20171118_UCF@TEMPLE,Temple,,UCF,,5-6,10-0,,13,31,19,45,3,10,0,6,7,24,14,0,-5,-18,-4,-18,-26,,,,
672,2017,12,NCAAF_20171118_UVA@MIAMI,Miami (Fla.),,Virginia,,10-0,6-5,,14,21,44,28,7,7,17,13,14,7,7,0,4,-7,-7,-7,16,,,,
673,2017,12,NCAAF_20171118_CIT@CLEM,Clemson,,The Citadel,,10-1,5-6,,38,0,61,3,21,17,20,3,0,0,0,3,5,38,21,38,58,,,,
674,2017,12,NCAAF_20171118_PITT@VATECH,Virginia Tech,,Pittsburgh,,8-3,4-7,,10,7,20,14,7,3,0,10,7,0,0,7,4,3,0,3,6,,,,
675,2017,12,NCAAF_20171118_FRESNO@WYO,Wyoming,,Fresno St.,,7-4,8-3,,0,10,7,13,0,0,0,7,3,7,3,0,-1,-10,-3,-10,-6,,,,
676,2017,12,NCAAF_20171118_RICE@ODU,Old Dominion,,Rice,,5-6,1-10,,10,7,24,21,7,3,7,7,7,0,0,14,4,3,0,3,3,,,,
677,2017,12,NCAAF_20171118_IOWAST@BAYLOR,Baylor,,Iowa St.,,1-10,7-4,,10,17,13,23,7,3,3,0,7,10,3,3,-6,-7,0,-7,-10,,,,
678,2017,12,NCAAF_20171118_ARIZST@OREGST,Oregon State,,Arizona St.,,1-10,6-5,,7,30,24,40,0,7,3,14,16,14,3,7,-5,-23,-16,-23,-16,,,,
679,2017,12,NCAAF_20171118_CHARLO@USM,So. Miss,,Charlotte,,7-4,1-10,,38,7,66,21,13,25,14,14,0,7,7,7,6,31,13,31,45,,,,
680,2017,12,NCAAF_20171118_HAWAII@UTAHST,Utah St.,,Hawaii,,6-5,3-8,,21,0,38,0,14,7,14,3,0,0,0,0,3,21,14,21,38,,,,
681,2017,12,NCAAF_20171118_LATECH@UTEP,UTEP,,Louisiana Tech,,0-11,5-6,,0,28,21,42,0,0,14,7,7,21,0,14,-5,-28,-7,-28,-21,,,,
682,2017,12,NCAAF_20171118_MA@BYU,BYU,,UMass,,3-9,4-7,,0,3,10,16,0,0,3,7,0,3,13,0,-1,-3,0,-3,-6,,,,
683,2017,12,NCAAF_20171118_SALA@GAS,Ga. Southern,,South Alabama,,1-9,4-7,,31,0,52,0,21,10,14,7,0,0,0,0,-3,31,21,31,52,,,,
684,2017,12,NCAAF_20171118_TXSTSM@ARKST,Arkansas St.,,Texas St.,,6-3,2-9,,16,6,30,12,16,0,14,0,6,0,6,0,4,10,10,10,18,,,,
685,2017,12,NCAAF_20171118_WCAR@UNC,North Carolina,,W. Carolina,,3-8,7-5,,42,7,65,10,7,35,10,13,7,0,0,3,-4,35,0,35,55,,,,
686,2017,12,NCAAF_20171118_CUSE@LVILLE,Louisville,,Syracuse,,7-4,4-7,,35,3,56,10,7,28,14,7,3,0,0,7,3,32,4,32,46,,,,
687,2017,12,NCAAF_20171118_GATECH@DUKE,Duke,,Georgia Tech,,5-6,5-5,,20,20,43,20,3,17,10,13,7,13,0,0,0,0,-4,0,23,,,,
688,2017,12,NCAAF_20171118_ILL@OHIOST,Ohio State,,Illinois,,9-2,2-9,,38,0,52,14,28,10,7,7,0,0,7,7,7,38,28,38,38,,,,
689,2017,12,NCAAF_20171118_KSTATE@OKLAST,Oklahoma State,,Kansas State,,8-3,6-5,,13,28,40,45,10,3,7,20,7,21,14,3,2,-15,3,-15,-5,,,,
690,2017,12,NCAAF_20171118_NAVY@ND,Notre Dame,,Navy,,9-2,6-4,,10,10,24,17,3,7,7,7,0,10,7,0,3,0,3,0,7,,,,
691,2017,12,NCAAF_20171118_OKLA@KANSAS,Kansas,,Oklahoma,,1-10,10-1,,3,21,3,41,0,3,0,0,7,14,7,13,-9,-18,-7,-18,-38,,,,
692,2017,12,NCAAF_20171118_PURDUE@IOWA,Iowa,,Purdue,,6-5,5-6,,9,7,15,24,0,9,0,6,7,0,14,3,1,2,-7,2,-9,,,,
693,2017,12,NCAAF_20171118_SJST@COLOST,Colorado St.,,San Jose St.,,7-5,1-11,,28,7,42,14,14,14,7,7,7,0,0,7,6,21,7,21,28,,,,
694,2017,12,NCAAF_20171118_UK@UGA,Georgia,,Kentucky,,10-1,7-4,,21,6,42,13,7,14,7,14,6,0,7,0,3,15,1,15,29,,,,
695,2017,12,NCAAF_20171118_HOU@TULANE,Tulane,,Houston,,5-6,6-4,,13,3,20,17,3,10,0,7,3,0,7,7,-1,10,0,10,3,,,,
696,2017,12,NCAAF_20171118_MD@MICHST,Michigan St.,,Maryland,,8-3,4-7,,14,0,17,7,7,7,3,0,0,0,0,7,4,14,7,14,10,,,,
697,2017,12,NCAAF_20171118_NEB@PSU,Penn State,,Nebraska,,9-2,4-7,,42,10,56,44,14,28,0,14,10,0,14,20,5,32,4,32,12,,,,
698,2017,12,NCAAF_20171118_UAB@FLA,Florida,,UAB,,4-6,7-4,,19,0,36,7,6,13,14,3,0,0,0,7,-3,19,6,19,29,,,,
699,2017,12,NCAAF_20171118_WOFF@SC,South Carolina,,Wofford,,8-3,9-2,,14,3,31,10,0,14,7,10,3,0,7,0,-1,11,-3,11,21,,,,
700,2017,12,NCAAF_20171118_CSTCAR@IDAHO,Idaho,,C. Carolina,,3-7,2-9,,7,10,7,13,7,0,0,0,0,10,0,3,1,-3,7,-3,-6,,,,
701,2017,12,NCAAF_20171118_NMEXST@LALAF,Louisiana,,New Mexico St.,,5-5,4-6,,31,17,47,34,14,17,3,13,7,10,14,3,1,14,7,14,13,,,,
702,2017,12,NCAAF_20171118_ARMY@NTEXAS,North Texas,,Army,,8-3,8-3,,28,20,52,49,14,14,7,17,7,13,8,21,0,8,7,8,3,,,,
703,2017,12,NCAAF_20171118_ARIZ@OREG,Oregon,,Arizona,,6-5,7-4,,28,21,48,28,14,14,7,13,7,14,7,0,-1,7,7,7,20,,,,
704,2017,12,NCAAF_20171118_BC@UCONN,UConn,,Boston College,,3-8,6-5,,3,14,16,39,3,0,0,13,0,14,19,6,-3,-11,3,-11,-23,,,,
705,2017,12,NCAAF_20171118_FIU@FAU,FAU,,FIU,,8-3,6-4,,21,10,52,24,14,7,16,15,0,10,7,7,2,11,14,11,28,,,,
706,2017,12,NCAAF_20171118_LSU@TENN,Tennessee,,LSU,,4-7,8-3,,10,17,10,30,0,10,0,0,3,14,13,0,-4,-7,-3,-7,-20,,,,
707,2017,12,NCAAF_20171118_MRSHL@TXSA,UTSA,,Marshall,,6-4,7-4,,6,0,9,7,3,3,0,3,0,0,0,7,-1,6,3,6,2,,,,
708,2017,12,NCAAF_20171118_TXAM@MISS,Ole Miss,,Texas A&M,,5-6,7-4,,24,21,24,31,14,10,0,0,14,7,7,3,-2,3,0,3,-7,,,,
709,2017,12,NCAAF_20171118_MIZZOU@VANDY,Vanderbilt,,Missouri,,4-7,6-5,,0,35,17,45,0,0,17,0,7,28,3,7,-2,-35,-7,-35,-28,,,,
710,2017,12,NCAAF_20171118_NCST@WAKE,Wake Forest,,NC State,,7-4,7-4,,21,14,30,24,14,7,3,6,7,7,7,3,0,7,7,7,6,,,,
711,2017,12,NCAAF_20171118_CAL@STNFRD,Stanford,,California,,8-3,5-6,,10,6,17,14,3,7,7,0,3,3,8,0,3,4,0,4,3,,,,
712,2017,12,NCAAF_20171118_UCLA@USC,USC,,UCLA,,10-2,5-6,,14,7,28,23,14,0,7,7,7,0,7,9,5,7,7,7,5,,,,
713,2017,12,NCAAF_20171118_AF@BOISE,Boise St.,,Air Force,,9-2,4-7,,27,10,44,19,17,10,10,7,7,3,0,9,5,17,10,17,25,,,,
714,2017,12,NCAAF_20171118_NEVADA@SDGST,San Diego St.,,Nevada,,9-2,2-9,,21,17,42,23,14,7,7,14,10,7,0,6,7,4,4,4,19,,,,
715,2017,12,NCAAF_20171118_UTAH@WASH,Washington,,Utah,,9-2,5-6,,16,13,33,30,6,10,7,10,7,6,10,7,4,3,-1,3,3,,,,
716,2017,12,NCAAF_20171117_UNLV@NMEX,New Mexico,,UNLV,,3-7,4-6,,14,24,35,38,0,14,7,14,10,14,3,11,-1,-10,-10,-10,-3,,,,
717,2017,12,NCAAF_20171116_BUFF@BALLST,Ball St.,,Buffalo,,2-9,5-6,,10,23,24,40,0,10,7,7,10,13,14,3,-3,-13,-10,-13,-16,,,,
718,2017,12,NCAAF_20171116_TULSA@SFLA,South Florida,,Tulsa,,9-1,2-9,,24,17,27,20,21,3,3,0,7,10,0,3,7,7,14,7,7,,,,
719,2017,12,NCAAF_20171115_EMICH@MIAOH,Miami-OH,,E. Michigan,,4-7,4-7,,17,13,24,27,0,17,0,7,7,6,14,0,0,4,-7,4,-3,,,,
720,2017,12,NCAAF_20171115_WMICH@NILL,N. Illinois,,W. Michigan,,8-3,6-5,,21,14,35,31,14,7,0,14,7,7,14,3,2,7,7,7,4,,,,
721,2017,12,NCAAF_20171115_TOLEDO@BGREEN,Bowling Green,,Toledo,,2-9,9-2,,21,24,37,66,7,14,7,9,14,10,28,14,-7,-3,-7,-3,-29,,,,
722,2017,12,NCAAF_20171114_CMICH@KENTST,Kent St.,,C. Michigan,,2-9,7-4,,17,28,23,42,3,14,0,6,7,21,0,14,-5,-11,-4,-11,-19,,,,
723,2017,12,NCAAF_20171114_OHIO@AKRON,Akron,,Ohio,,6-5,8-3,,30,24,37,34,10,20,0,7,14,10,3,7,-2,6,-4,6,3,,,,
724,2017,13,NCAAF_20171125_FSU@FLA,Florida,,Florida State,,4-7,5-6,,13,24,22,38,7,6,3,6,7,17,0,14,-1,-11,0,-11,-16,,,,
725,2017,13,NCAAF_20171125_IND@PURDUE,Purdue,,Indiana,,6-6,5-7,,21,10,31,24,7,14,3,7,7,3,0,14,1,11,0,11,7,,,,
726,2017,13,NCAAF_20171125_LVILLE@UK,Kentucky,,Louisville,,7-5,8-4,,10,31,17,44,7,3,0,7,17,14,3,10,-1,-21,-10,-21,-27,,,,
727,2017,13,NCAAF_20171125_UCONN@CINCY,Cincinnati,,UConn,,4-8,3-9,,7,6,22,21,0,7,0,15,3,3,9,6,1,1,-3,1,1,,,,
728,2017,13,NCAAF_20171125_UGA@GATECH,Georgia Tech,,Georgia,,5-6,11-1,,7,17,7,38,0,7,0,0,7,10,14,7,-6,-10,-7,-10,-31,,,,
729,2017,13,NCAAF_20171125_ECU@MEMP,Memphis,,East Carolina,,10-1,3-9,,49,0,70,13,28,21,14,7,0,0,13,0,7,49,28,49,57,,,,
730,2017,13,NCAAF_20171125_KANSAS@OKLAST,Oklahoma State,,Kansas,,9-3,1-11,,34,10,58,17,10,24,14,10,3,7,7,0,8,24,7,24,41,,,,
731,2017,13,NCAAF_20171125_OHIOST@MICH,Michigan,,Ohio State,,8-4,10-2,,14,14,20,31,7,7,6,0,0,14,7,10,-2,0,7,0,-11,,,,
732,2017,13,NCAAF_20171125_TULANE@SMU,SMU,,Tulane,,7-5,5-7,,27,21,41,38,14,13,7,7,7,14,17,0,2,6,7,6,3,,,,
733,2017,13,NCAAF_20171125_BC@CUSE,Syracuse,,Boston College,,4-8,7-5,,14,28,14,42,7,7,0,0,14,14,7,7,-3,-14,-7,-14,-28,,,,
734,2017,13,NCAAF_20171125_DUKE@WAKE,Wake Forest,,Duke,,7-5,6-6,,17,10,23,31,10,7,6,0,3,7,7,14,1,7,7,7,-8,,,,
735,2017,13,NCAAF_20171125_NTEXAS@RICE,Rice,,North Texas,,1-11,9-3,,14,24,14,30,7,7,0,0,7,17,3,3,-8,-10,0,-10,-16,,,,
736,2017,13,NCAAF_20171125_UTEP@UAB,UAB,,UTEP,,8-4,0-12,,14,7,28,7,3,11,14,0,7,0,0,0,8,7,-4,7,21,,,,
737,2017,13,NCAAF_20171125_APLST@GAST,Georgia St.,,App. St.,,6-4,7-4,,7,10,10,31,0,7,0,3,0,10,14,7,-1,-3,0,-3,-21,,,,
738,2017,13,NCAAF_20171125_FAU@CHARLO,Charlotte,,FAU,,1-11,9-3,,6,24,12,31,0,6,6,0,10,14,7,0,-8,-18,-10,-18,-19,,,,
739,2017,13,NCAAF_20171125_USM@MRSHL,Marshall,,So. Miss,,7-5,8-4,,14,14,27,28,0,14,7,6,0,14,7,7,-1,0,0,0,-1,,,,
740,2017,13,NCAAF_20171125_ARKST@LAMON,UL-Monroe,,Arkansas St.,,4-7,7-3,,21,28,50,67,14,7,14,15,7,21,21,18,-3,-7,7,-7,-17,,,,
741,2017,13,NCAAF_20171125_ODU@MTSU,Middle Tenn.,,Old Dominion,,6-6,5-7,,24,3,41,10,3,21,7,10,3,0,0,7,1,21,0,21,31,,,,
742,2017,13,NCAAF_20171125_UNLV@NEVADA,Nevada,,UNLV,,3-9,5-7,,9,13,23,16,6,3,7,7,0,13,3,0,-2,-4,6,-4,7,,,,
743,2017,13,NCAAF_20171125_BAMA@AUBURN,Auburn,,Alabama,,10-2,11-1,,10,7,26,14,7,3,10,6,0,7,7,0,-1,3,7,3,12,,,,
744,2017,13,NCAAF_20171125_IOWAST@KSTATE,Kansas State,,Iowa St.,,7-5,7-5,,7,6,20,19,0,7,0,13,3,3,6,7,0,1,-3,1,1,,,,
745,2017,13,NCAAF_20171125_PSU@MD,Maryland,,Penn State,,4-8,10-2,,0,31,3,66,0,0,3,0,14,17,21,14,-6,-31,-14,-31,-63,,,,
746,2017,13,NCAAF_20171125_UNC@NCST,NC State,,North Carolina,,8-4,3-9,,12,14,33,21,6,6,7,14,7,7,0,7,5,-2,-1,-2,12,,,,
747,2017,13,NCAAF_20171125_BOISE@FRESNO,Fresno St.,,Boise St.,,9-3,9-3,,10,7,28,17,7,3,6,12,7,0,3,7,0,3,0,3,11,,,,
748,2017,13,NCAAF_20171125_WISC@MINN,Minnesota,,Wisconsin,,5-7,12-0,,0,17,0,31,0,0,0,0,7,10,7,7,-7,-17,-7,-17,-31,,,,
749,2017,13,NCAAF_20171125_WVU@OKLA,Oklahoma,,West Virginia,,11-1,7-5,,45,10,59,31,14,31,14,0,3,7,14,7,4,35,11,35,28,,,,
750,2017,13,NCAAF_20171125_MICHST@RUT,Rutgers,,Michigan St.,,4-8,9-3,,7,16,7,40,0,7,0,0,13,3,3,21,-5,-9,-13,-9,-33,,,,
751,2017,13,NCAAF_20171125_NWEST@ILL,Illinois,,Northwestern,,2-10,9-3,,7,14,7,42,7,0,0,0,0,14,14,14,-7,-7,7,-7,-35,,,,
752,2017,13,NCAAF_20171125_VANDY@TENN,Tennessee,,Vanderbilt,,4-8,5-7,,14,21,24,42,14,0,3,7,7,14,0,21,-1,-7,7,-7,-18,,,,
753,2017,13,NCAAF_20171125_IDAHO@NMEXST,New Mexico St.,,Idaho,,5-6,3-8,,14,7,17,10,14,0,0,3,0,7,3,0,2,7,14,7,7,,,,
754,2017,13,NCAAF_20171125_TEMPLE@TULSA,Tulsa,,Temple,,2-10,6-6,,13,31,22,43,7,6,7,2,10,21,6,6,-4,-18,-3,-18,-21,,,,
755,2017,13,NCAAF_20171125_ARIZ@ARIZST,Arizona St.,,Arizona,,7-5,7-5,,14,24,42,30,7,7,21,7,14,10,0,6,0,-10,-7,-10,12,,,,
756,2017,13,NCAAF_20171125_GAS@LALAF,Louisiana,,Ga. Southern,,5-6,2-9,,7,17,24,34,0,7,3,14,14,3,10,7,3,-10,-14,-10,-10,,,,
757,2017,13,NCAAF_20171125_WYO@SJST,San Jose St.,,Wyoming,,2-11,7-5,,13,7,20,17,7,6,0,7,0,7,3,7,-5,6,7,6,3,,,,
758,2017,13,NCAAF_20171125_OREGST@OREG,Oregon,,Oregon State,,7-5,1-11,,52,7,69,10,17,35,10,7,7,0,3,0,6,45,10,45,59,,,,
759,2017,13,NCAAF_20171125_CLEM@SC,South Carolina,,Clemson,,8-4,11-1,,0,20,10,34,0,0,0,10,7,13,14,0,-3,-20,-7,-20,-24,,,,
760,2017,13,NCAAF_20171125_TXAM@LSU,LSU,,Texas A&M,,9-3,7-5,,20,7,45,21,13,7,14,11,0,7,14,0,2,13,13,13,24,,,,
761,2017,13,NCAAF_20171125_TXSA@LATECH,Louisiana Tech,,UTSA,,6-6,6-5,,10,0,20,6,7,3,3,7,0,0,3,3,0,10,7,10,14,,,,
762,2017,13,NCAAF_20171125_ND@STNFRD,Stanford,,Notre Dame,,9-3,9-3,,14,10,38,20,7,7,3,21,7,3,10,0,0,4,0,4,18,,,,
763,2017,13,NCAAF_20171125_WASHST@WASH,Washington,,Washington St.,,10-2,9-3,,24,0,41,14,7,17,10,7,0,0,0,14,1,24,7,24,27,,,,
764,2017,13,NCAAF_20171125_BYU@HAWAII,Hawaii,,BYU,,3-9,4-9,,7,13,20,30,7,0,0,13,7,6,7,10,-1,-6,0,-6,-10,,,,
765,2017,13,NCAAF_20171125_COLO@UTAH,Utah,,Colorado,,6-6,5-7,,28,0,34,13,14,14,3,3,0,0,7,6,1,28,14,28,21,,,,
766,2017,13,NCAAF_20171125_UTAHST@AF,Air Force,,Utah St.,,5-7,6-6,,17,21,38,35,10,7,7,14,14,7,0,14,-1,-4,-4,-4,3,,,,
767,2017,13,NCAAF_20171124_WMICH@TOLEDO,Toledo,,W. Michigan,,10-2,6-6,,17,3,37,10,3,14,14,6,0,3,7,0,4,14,3,14,27,,,,
768,2017,13,NCAAF_20171124_BAYLOR@TCU,TCU,,Baylor,,10-2,1-11,,21,19,45,22,14,7,14,10,9,10,3,0,9,2,5,2,23,,,,
769,2017,13,NCAAF_20171124_MIAMI@PITT,Pittsburgh,,Miami (Fla.),,5-7,10-1,,10,7,24,14,3,7,7,7,0,7,0,7,-5,3,3,3,10,,,,
770,2017,13,NCAAF_20171124_NAVY@HOU,Houston,,Navy,,7-4,6-5,,7,14,24,14,7,0,7,10,0,14,0,0,1,-7,7,-7,10,,,,
771,2017,13,NCAAF_20171124_NILL@CMICH,C. Michigan,,N. Illinois,,8-4,8-4,,0,17,31,24,0,0,17,14,14,3,0,7,0,-17,-14,-17,7,,,,
772,2017,13,NCAAF_20171124_OHIO@BUFF,Buffalo,,Ohio,,6-6,8-4,,24,10,31,24,24,0,0,7,7,3,14,0,-2,14,17,14,7,,,,
773,2017,13,NCAAF_20171124_MIZZOU@ARK,Arkansas,,Missouri,,4-8,7-5,,28,31,45,48,21,7,7,10,7,24,0,17,-3,-3,14,-3,-3,,,,
774,2017,13,NCAAF_20171124_NMEX@SDGST,San Diego St.,,New Mexico,,10-2,3-9,,14,0,35,10,7,7,7,14,0,0,10,0,7,14,7,14,25,,,,
775,2017,13,NCAAF_20171124_SFLA@UCF,UCF,,South Florida,,11-0,9-2,,21,20,49,42,21,0,7,21,7,13,14,8,2,1,14,1,7,,,,
776,2017,13,NCAAF_20171124_IOWA@NEB,Nebraska,,Iowa,,4-8,7-5,,14,14,14,56,7,7,0,0,7,7,28,14,-3,0,0,0,-42,,,,
777,2017,13,NCAAF_20171124_TXSTSM@TROY,Troy,,Texas St.,,9-2,2-10,,41,0,62,9,17,24,14,7,0,0,6,3,7,41,17,41,53,,,,
778,2017,13,NCAAF_20171124_WKY@FIU,FIU,,W. Kentucky,,7-4,6-6,,13,10,41,17,3,10,21,7,3,7,7,0,1,3,0,3,24,,,,
779,2017,13,NCAAF_20171124_TXTECH@TEXAS,Texas,,Texas Tech,,6-6,6-6,,20,10,23,27,7,13,0,3,7,3,3,14,0,10,0,10,-4,,,,
780,2017,13,NCAAF_20171124_VATECH@UVA,Virginia,,Virginia Tech,,6-6,9-3,,0,3,0,10,0,0,0,0,0,3,7,0,-3,-3,0,-3,-10,,,,
781,2017,13,NCAAF_20171124_CAL@UCLA,UCLA,,California,,6-6,5-7,,17,9,30,27,7,10,7,6,3,6,8,10,1,8,4,8,3,,,,
782,2017,13,NCAAF_20171123_MISS@MISSST,Miss. State,,Ole Miss,,8-4,6-6,,6,10,28,31,0,6,0,22,7,3,14,7,2,-4,-7,-4,-3,,,,
783,2017,13,NCAAF_20171121_BGREEN@EMICH,E. Michigan,,Bowling Green,,5-7,2-10,,20,17,34,31,13,7,14,0,10,7,14,0,3,3,3,3,3,,,,
784,2017,13,NCAAF_20171121_KENTST@AKRON,Akron,,Kent St.,,7-5,2-10,,24,7,24,14,10,14,0,0,0,7,7,0,5,17,10,17,10,,,,
785,2017,13,NCAAF_20171121_MIAOH@BALLST,Ball St.,,Miami-OH,,2-10,5-7,,0,28,7,28,0,0,0,7,14,14,0,0,-3,-28,-14,-28,-21,,,,
786,2017,14,NCAAF_20171202_AKRON@TOLEDO,Toledo,,Akron,,11-2,7-6,,28,0,45,28,7,21,10,7,0,0,7,21,4,28,7,28,17,,,,
787,2017,14,NCAAF_20171202_LAMON@FSU,Florida State,,UL-Monroe,,6-6,4-8,,14,0,42,10,7,7,14,14,0,0,10,0,2,14,7,14,32,,,,
788,2017,14,NCAAF_20171202_MA@FIU,FIU,,UMass,,8-4,4-8,,35,21,63,45,14,21,7,21,14,7,10,14,4,14,0,14,18,,,,
789,2017,14,NCAAF_20171202_NTEXAS@FAU,FAU,,North Texas,,10-3,9-4,,27,0,41,17,10,17,7,7,0,0,9,8,1,27,10,27,24,,,,
790,2017,14,NCAAF_20171202_TCU@OKLA,Oklahoma,,TCU,,12-1,10-3,,24,17,41,17,17,7,17,0,0,17,0,0,2,7,17,7,24,,,,
791,2017,14,NCAAF_20171202_GAS@CSTCAR,C. Carolina,,Ga. Southern,,3-9,2-10,,14,10,28,17,7,7,14,0,3,7,7,0,1,4,4,4,11,,,,
792,2017,14,NCAAF_20171202_IDAHO@GAST,Georgia St.,,Idaho,,6-5,4-8,,10,14,10,24,7,3,0,0,7,7,3,7,2,-4,0,-4,-14,,,,
793,2017,14,NCAAF_20171202_LALAF@APLST,App. St.,,Louisiana,,8-4,5-7,,35,7,63,14,14,21,14,14,7,0,0,7,3,28,7,28,49,,,,
794,2017,14,NCAAF_20171202_UGA@AUBURN,Auburn,,Georgia,,10-3,12-1,,7,10,7,28,7,0,0,0,0,10,3,15,-2,-3,7,-3,-21,,,,
795,2017,14,NCAAF_20171202_SALA@NMEXST,New Mexico St.,,South Alabama,,6-6,4-8,,13,7,22,17,0,13,0,9,0,7,0,10,2,6,0,6,5,,,,
796,2017,14,NCAAF_20171202_TROY@ARKST,Arkansas St.,,Troy,,7-4,10-2,,10,7,25,32,0,10,3,12,0,7,10,15,-3,3,0,3,-7,,,,
797,2017,14,NCAAF_20171202_FRESNO@BOISE,Boise St.,,Fresno St.,,10-3,9-4,,10,14,17,14,3,7,0,7,0,14,0,0,1,-4,3,-4,3,,,,
798,2017,14,NCAAF_20171202_MIAMI@CLEM,Clemson,,Miami (Fla.),,12-1,10-2,,21,0,38,3,14,7,17,0,0,0,0,3,2,21,14,21,35,,,,
799,2017,14,NCAAF_20171202_OHIOST@WISC,Wisconsin,,Ohio State,,12-1,11-2,,10,21,21,27,7,3,3,8,14,7,3,3,1,-11,-7,-11,-6,,,,
800,2017,14,NCAAF_20171201_STNFRD@USC,USC,,Stanford,,11-2,9-4,,17,14,31,28,7,10,7,7,0,14,7,7,2,3,7,3,3,,,,
801,2017,15,NCAAF_20171209_ARMY@NAVY,Navy,,Army,,6-6,9-3,,10,7,13,14,3,7,3,0,7,0,0,7,-3,3,-4,3,-1,,,,
802,2018,2,NCAAF_20180909_RICE@HAWAII,Hawaii,,Rice,,3-0,1-2,,21,10,43,29,14,7,7,15,7,3,3,16,2,11,7,11,14,0.6214011248977447,4.526030135483985,,
803,2018,2,NCAAF_20180908_ARIZ@HOU,Houston,,Arizona,,2-0,0-2,,31,0,45,18,21,10,7,7,0,0,10,8,2,31,21,31,27,0.4437655892212051,-2.070466823076117,,
804,2018,2,NCAAF_20180908_DUKE@NWEST,Northwestern,,Duke,,1-1,2-0,,7,21,7,21,7,0,0,0,0,21,0,0,-1,-14,7,-14,-14,0.6523886294854404,5.735478175035766,,
805,2018,2,NCAAF_20180908_EMICH@PURDUE,Purdue,,E. Michigan,,0-2,2-0,,12,10,19,20,6,6,0,7,7,3,0,10,-2,2,-1,2,-1,0.8956219609292133,18.401925487510514,,
806,2018,2,NCAAF_20180908_GATECH@SFLA,South Florida,,Georgia Tech,,2-0,1-1,,21,17,49,38,14,7,7,21,17,0,14,7,1,4,-3,4,11,0.32701547114493024,-6.56103757337943,,
807,2018,2,NCAAF_20180908_LIB@ARMY,Army,Black Knights,Liberty,Flames,1-1,1-1,1,17,0,38,14,14,3,7,14,0,0,14,0,0,17,14,17,24,0.4827509424853992,-0.6331709876398772,,
808,2018,2,NCAAF_20180908_MISSST@KSTATE,Kansas State,Wildcats,Miss. State,Bulldogs,1-1,2-0,1,3,17,10,31,3,0,7,0,3,14,7,7,-1,-14,0,-14,-21,0.3338190159551815,-6.286142040568288,,
809,2018,2,NCAAF_20180908_NEVADA@VANDY,Vanderbilt,,Nevada,,2-0,1-1,,17,10,41,10,0,17,17,7,0,10,0,0,1,7,0,7,31,0.5878221467036504,3.2492129915292303,0.5817789424626094,3.0544439708154414
810,2018,2,NCAAF_20180908_NMEX@WISC,Wisconsin,Badgers,New Mexico,Lobos,2-0,1-1,1,10,7,45,14,3,7,14,21,7,0,0,7,1,3,-4,3,31,0.9987598408940946,44.295623321185815,0.9984459501697988,43.747402957186864
811,2018,2,NCAAF_20180908_TWST@WAKE,Wake Forest,,Towson,,2-0,1-1,,38,20,51,20,14,24,3,10,14,6,0,0,1,18,0,18,31,0.9999952508740085,64.82858048851347,,
812,2018,2,NCAAF_20180908_WMICH@MICH,Michigan,Wolverines,W. Michigan,Broncos,1-1,0-2,1,35,0,49,3,21,14,7,7,0,0,0,3,1,35,21,35,46,0.9072212373041821,19.38047868281062,,
813,2018,2,NCAAF_20180908_GAST@NCST,NC State,,Georgia St.,,2-0,1-1,,20,7,41,7,10,10,7,14,7,0,0,0,1,13,3,13,34,0.987297765090184,32.72246216362099,,
814,2018,2,NCAAF_20180908_HOLY@BC,Boston College,,Holy Cross,,2-0,0-2,,34,0,62,14,21,13,14,14,0,0,7,7,2,34,21,34,48,0.9920706179911651,35.31299855313609,,
815,2018,2,NCAAF_20180908_UCLA@OKLA,Oklahoma,Sooners,UCLA,Bruins,2-0,0-2,1,21,7,49,21,14,7,14,14,7,0,0,14,2,14,7,14,28,0.9454858996961023,23.46113789611907,0.9576206434195029,25.50297403084025
816,2018,2,NCAAF_20180908_AF@FAU,FAU,,Air Force,,1-1,1-1,,19,7,33,27,6,13,6,8,0,7,13,7,0,12,6,12,6,0.8366600831166829,14.358899038732956,0.8667409570178333,16.43933506954903
817,2018,2,NCAAF_20180908_PORTST@OREG,Oregon,Ducks,Portland St.,Vikings,2-0,0-2,1,35,7,62,14,14,21,14,13,0,7,0,7,2,28,14,28,48,0.9856924330532506,32.04248260391387,,
818,2018,2,NCAAF_20180908_WMMARY@VATECH,Virginia Tech,Hokies,William & Mary,Tribe,1-0,1-0,1,38,7,62,17,17,21,17,7,0,7,7,3,0,31,17,31,45,0.9896559351139294,33.870676819752276,,
819,2018,2,NCAAF_20180908_KANSAS@CMICH,C. Michigan,Chippewas,Kansas,Jayhawks,0-2,1-1,1,0,7,7,31,0,0,7,0,0,7,14,10,-1,-7,0,-7,-24,0.8425435908636737,14.712350130229568,0.8108573277049154,13.035570024560144
820,2018,2,NCAAF_20180908_ARKST@BAMA,Alabama,Crimson Tide,Arkansas St.,Red Wolves,2-0,1-1,1,40,0,57,7,19,21,10,7,0,0,7,0,1,40,19,40,50,0.9915865737396667,34.99560488616369,,
821,2018,2,NCAAF_20180908_BALLST@ND,Notre Dame,Fighting Irish,Ball St.,Cardinals,2-0,1-1,1,14,6,24,16,7,7,10,0,3,3,0,10,1,8,4,8,8,0.9999463775200705,56.70791375681411,0.9999691974376504,59.27860880428395
822,2018,2,NCAAF_20180908_BUFF@TEMPLE,Temple,,Buffalo,,0-2,2-0,,7,12,29,36,0,7,7,15,6,6,10,14,-2,-5,-6,-5,-7,0.524520420436125,0.9003718065928421,,
823,2018,2,NCAAF_20180908_COLO@NEB,Nebraska,,Colorado,,0-1,2-0,,21,17,28,33,7,14,7,0,14,3,10,6,-2,4,-7,4,-5,0.5366509130926602,1.34684416952169,,
824,2018,2,NCAAF_20180908_HOW@KENTST,Kent St.,,Howard,,1-1,0-2,,26,0,54,14,16,10,21,7,0,0,14,0,1,26,16,26,40,0.39261989550871557,-3.98925930930546,,
825,2018,2,NCAAF_20180908_MEMP@NAVY,Navy,Midshipmen,Memphis,Tigers,1-1,1-1,1,9,7,22,21,3,6,0,13,0,7,14,0,0,2,3,2,1,0.23649357945220506,-10.50580255409877,,
826,2018,2,NCAAF_20180908_MRGNST@AKRON,Akron,,Morgan St.,,1-0,0-2,,27,0,41,7,17,10,14,0,0,0,0,7,1,27,17,27,34,0.9999900562264418,62.45488298406357,,
827,2018,2,NCAAF_20180908_RUT@OHIOST,Ohio State,Buckeyes,Rutgers,Scarlet Knights,2-0,1-1,1,35,0,52,3,14,21,10,7,0,0,3,0,1,35,14,35,49,0.9949583515675835,37.6671960716196,0.9954451200364087,38.58484008660818
828,2018,2,NCAAF_20180908_UGA@SC,South Carolina,Gamecocks,Georgia,Bulldogs,1-0,1-0,1,10,20,17,41,7,3,0,7,17,3,21,0,0,-10,-10,-10,-24,0.06109944332171169,-22.62716381465558,0.04499304300881257,-25.085047939536878
829,2018,2,NCAAF_20180908_UNC@ECU,East Carolina,,North Carolina,,1-1,0-2,,21,19,41,19,7,14,7,13,6,13,0,0,1,2,1,2,22,0.10704972688260606,-18.187871164686626,,
830,2018,2,NCAAF_20180908_WAG@CUSE,Syracuse,,Wagner,,2-0,1-1,,45,7,62,10,21,24,14,3,7,0,0,3,1,38,14,38,52,0.9976687228333576,41.4223774871253,,
831,2018,2,NCAAF_20180908_ETNST@TENN,Tennessee,Volunteers,ETSU,Buccaneers,1-1,1-1,1,38,0,59,3,10,28,7,14,0,0,3,0,0,38,10,38,56,,,,
832,2018,2,NCAAF_20180908_LAMAR@TXTECH,Texas Tech,,Lamar,,1-1,1-1,,42,0,77,0,14,28,14,21,0,0,0,0,0,42,14,42,77,0.999992957545255,63.57311376516806,,
833,2018,2,NCAAF_20180908_SIL@MISS,Ole Miss,,S. Illinois,,2-0,1-1,,35,38,76,41,14,21,14,27,21,17,3,0,1,-3,-7,-3,35,0.4537091399555424,-1.7025252833453166,,
834,2018,2,NCAAF_20180908_IOWAST@IOWA,Iowa,Hawkeyes,Iowa St.,Cyclones,2-0,0-1,1,3,3,13,3,0,3,3,7,3,0,0,0,2,0,-3,0,10,0.5832649533882611,3.078029987593709,,
835,2018,2,NCAAF_20180908_NDK@WASH,Washington,Huskies,North Dakota,Fighting Hawks,1-1,1-1,1,17,0,45,3,10,7,7,21,0,0,3,0,0,17,10,17,42,0.9921929500293799,35.39590526861373,,
836,2018,2,NCAAF_20180908_APLST@CHARLO,Charlotte,,App. St.,,1-1,1-1,,9,24,9,45,0,9,0,0,10,14,7,14,0,-15,-10,-15,-36,0.024244524402033618,-28.884841633007394,,
837,2018,2,NCAAF_20180908_MA@GAS,Ga. Southern,,UMass,,2-0,1-2,,17,10,34,13,0,17,10,7,3,7,3,0,1,7,-3,7,21,0.3588551558517875,-5.292530436467295,,
838,2018,2,NCAAF_20180908_MD@BGREEN,Bowling Green,,Maryland,,0-2,2-0,,14,10,14,45,7,7,0,0,0,10,7,28,-2,4,7,4,-31,0.1888588698478586,-12.913759336969346,0.24830808358965806,-10.058211705068999
839,2018,2,NCAAF_20180908_SAV@MIAMI,Miami (Fla.),Hurricanes,Savannah St.,Tigers,1-1,0-2,1,28,0,77,0,7,21,21,28,0,0,0,0,1,28,7,28,77,0.9999980244048304,67.5463124224349,,
840,2018,2,NCAAF_20180908_SCST@UCF,UCF,Knights,SC State,Bulldogs,2-0,0-2,1,24,0,38,0,14,10,14,0,0,0,0,0,2,24,14,24,38,,,,
841,2018,2,NCAAF_20180908_YST@WVU,West Virginia,Mountaineers,Youngstown St.,Penguins,2-0,0-2,1,21,7,52,17,7,14,21,10,0,7,10,0,2,14,7,14,35,,,,
842,2018,2,NCAAF_20180908_EKY@MRSHL,Marshall,,E. Kentucky,,2-0,1-1,,20,6,32,16,13,7,7,5,0,6,7,3,1,14,13,14,16,0.8739866043565931,16.768831425218078,,
843,2018,2,NCAAF_20180908_BAYLOR@TXSA,UTSA,,Baylor,,0-2,2-0,,13,20,20,37,3,10,0,7,10,10,7,10,-2,-7,-7,-7,-17,0.25520688992800455,-9.635714674439658,0.22835036349664195,-11.012021139491651
844,2018,2,NCAAF_20180908_CLEM@TXAM,Texas A&M,Aggies,Clemson,Tigers,1-1,2-0,1,3,14,26,28,3,0,10,13,7,7,14,0,-1,-11,-4,-11,-2,0.04437453528800994,-24.91715472179182,,
845,2018,2,NCAAF_20180908_FAMU@TROY,Troy,,Florida A&M,,1-1,1-1,,38,7,59,7,21,17,14,7,0,7,0,0,0,31,21,31,52,0.9989679593632722,45.10257926212603,,
846,2018,2,NCAAF_20180908_INST@LVILLE,Louisville,,Indiana St.,,1-1,1-1,,7,7,31,7,7,0,7,17,7,0,0,0,0,0,0,0,24,0.9999845751632235,61.00485963544192,,
847,2018,2,NCAAF_20180908_LAMON@USM,So. Miss,,UL-Monroe,,1-1,2-0,,17,14,20,21,10,7,3,0,14,0,7,0,-1,3,-4,3,-1,0.5848472207139515,3.137416222642768,,
848,2018,2,NCAAF_20180908_SELOU@LSU,LSU,Tigers,SE Louisiana,Lions,2-0,0-2,1,24,0,31,0,14,10,0,7,0,0,0,0,2,24,14,24,31,0.9967275107379212,39.807380065082555,,
849,2018,2,NCAAF_20180908_SO@LATECH,Louisiana Tech,,Southern U.,,2-0,0-2,,31,14,54,17,21,10,14,9,7,7,3,0,2,17,14,17,37,0.9975374412138788,41.16506609016327,,
850,2018,2,NCAAF_20180908_TNMART@MTSU,Middle Tenn.,,UT Martin,,1-1,0-2,,26,17,61,37,14,12,21,14,7,10,7,13,1,9,7,9,24,0.7884490712170049,11.72710287130948,,
851,2018,2,NCAAF_20180908_TXSO@TXSTSM,Texas St.,,Texas Southern,,1-1,1-1,,16,0,36,20,3,13,10,10,0,0,7,13,0,16,3,16,16,,,,
852,2018,2,NCAAF_20180908_UAB@CSTCAR,C. Carolina,,UAB,,1-1,1-1,,20,24,47,24,7,13,7,20,14,10,0,0,0,-4,-7,-4,23,0.3452737214555255,-5.828219033050713,,
853,2018,2,NCAAF_20180908_WYO@MIZZOU,Missouri,,Wyoming,,2-0,1-2,,16,0,40,13,3,13,14,10,0,0,10,3,1,16,3,16,27,0.776572541630639,11.135915380452353,,
854,2018,2,NCAAF_20180908_SAMF@FSU,Florida State,Seminoles,Samford,Bulldogs,1-1,1-1,1,21,23,36,26,7,14,0,15,16,7,0,3,0,-2,-9,-2,10,0.7787588922586115,11.243363993508531,,
855,2018,2,NCAAF_20180908_ALST@AUBURN,Auburn,Tigers,Alabama St.,Hornets,2-0,1-1,1,42,2,63,9,21,21,7,14,0,2,7,0,1,40,21,40,54,0.999887873785508,54.020289034018546,,
856,2018,2,NCAAF_20180908_ARK@COLOST,Colorado St.,Rams,Arkansas,Razorbacks,1-2,1-1,1,9,13,34,27,3,6,8,17,7,6,14,0,0,-4,-4,-4,7,0.5113829515380874,0.4177669530747412,,
857,2018,2,NCAAF_20180908_FIU@ODU,Old Dominion,,FIU,,0-2,1-1,,20,14,20,28,7,13,0,0,0,14,14,0,-1,6,7,6,-8,0.2444109443282263,-10.133320378457025,0.22688623683917153,-11.083779278431507
858,2018,2,NCAAF_20180908_FRESNO@MINN,Minnesota,,Fresno St.,,2-0,1-1,,10,0,21,14,7,3,0,11,0,0,7,7,1,10,7,10,7,0.5741422034790542,2.7365860063265277,0.5956912704511514,3.583575694627001
859,2018,2,NCAAF_20180908_ME@WKY,W. Kentucky,,Maine,,0-2,2-0,,21,14,28,31,21,0,0,7,0,14,14,3,-2,7,21,7,-3,0.7401001206174759,9.422862682829308,,
860,2018,2,NCAAF_20180908_UIW@NTEXAS,North Texas,,Incarnate Word,,2-0,0-2,,41,6,58,16,10,31,14,3,6,0,10,0,2,35,4,35,42,0.9999132564941225,54.96876125991141,,
861,2018,2,NCAAF_20180908_UK@FLA,Florida,Gators,Kentucky,Wildcats,1-1,2-0,1,10,7,16,27,0,10,0,6,7,0,14,6,-1,3,-7,3,-11,0.5363752762981044,1.3366867931065975,,
862,2018,2,NCAAF_20180908_UTAH@NILL,N. Illinois,,Utah,,0-2,2-0,,3,0,6,17,3,0,0,3,0,0,7,10,-2,3,3,3,-11,0.34494982962224996,-5.841087081603224,,
863,2018,2,NCAAF_20180908_UVA@IND,Indiana,,Virginia,,2-0,1-1,,20,9,20,16,13,7,0,0,9,0,7,0,1,11,4,11,4,0.5792599944426651,2.9279381538823817,,
864,2018,2,NCAAF_20180908_WIL@ILL,Illinois,,W. Illinois,,2-0,0-2,,14,7,34,14,0,14,10,10,7,0,7,0,2,7,-7,7,20,0.014055721042397051,-32.144656828902704,,
865,2018,2,NCAAF_20180908_CINCY@MIAOH,Miami-OH,,Cincinnati,,0-2,2-0,,0,7,0,21,0,0,0,0,7,0,0,14,-2,-7,-7,-7,-21,0.6597615888980877,6.0287864130163396,,
866,2018,2,NCAAF_20180908_NICHST@TULANE,Tulane,,Nicholls St.,,1-1,1-1,,21,10,42,17,7,14,7,14,3,7,0,7,0,11,4,11,25,0.5091796744850074,0.336888251006064,,
867,2018,2,NCAAF_20180908_NMEXST@UTAHST,Utah St.,,New Mexico St.,,1-1,0-3,,33,10,60,13,16,17,14,13,7,3,3,0,1,23,9,23,47,0.7851550831640428,11.561251426530267,0.8554269344557391,15.682995824875974
868,2018,2,NCAAF_20180908_PSU@PITT,Pittsburgh,Panthers,Penn State,Nittany Lions,1-1,2-0,1,6,14,6,51,6,0,0,0,7,7,16,21,-1,-8,-1,-8,-45,0.0396807297380114,-25.68382536377707,0.0612232756449228,-22.85264639391295
869,2018,2,NCAAF_20180908_SALA@OKLAST,Oklahoma State,,South Alabama,,2-0,0-2,,31,13,55,13,14,17,10,14,7,6,0,0,2,18,7,18,42,0.9975601156729924,41.20860700179723,,
870,2018,2,NCAAF_20180908_SUT@OREGST,Oregon State,,So. Utah,,1-1,0-2,,41,7,48,25,17,24,0,7,0,7,9,9,1,34,17,34,23,0.9794530893641884,29.902661830599953,,
871,2018,2,NCAAF_20180908_TULSA@TEXAS,Texas,Longhorns,Tulsa,Golden Hurricane,1-1,1-1,1,21,0,28,21,14,7,0,7,0,0,7,14,0,21,14,21,7,0.929832000082469,21.586744907525514,,
872,2018,2,NCAAF_20180908_USC@STNFRD,Stanford,Cardinal,USC,Trojans,2-0,1-1,1,14,0,17,3,7,7,3,0,0,0,3,0,1,14,7,14,14,0.5476824967268826,1.753950077710602,0.5269980726836541,1.0020263429056229
873,2018,2,NCAAF_20180908_SACST@SDGST,San Diego St.,,Sacramento St.,,1-1,1-1,,13,7,28,14,7,6,0,15,0,7,7,0,0,6,7,6,14,0.9990861558904167,45.63016150245386,,
874,2018,2,NCAAF_20180908_UTEP@UNLV,UNLV,,UTEP,,1-1,0-2,,38,10,52,24,14,24,7,7,10,0,7,7,1,28,4,28,28,0.9242141120934112,20.99326504615211,0.9305040895003585,21.890510982251158
875,2018,2,NCAAF_20180908_CAL@BYU,BYU,,California,,1-1,2-0,,3,7,18,21,0,3,7,8,7,0,7,7,-1,-4,-7,-4,-3,0.14314835274088,-15.609964969405267,,
876,2018,2,NCAAF_20180908_UCONN@BOISE,Boise St.,Broncos,UConn,Huskies,2-0,0-2,1,41,0,62,7,24,17,14,7,0,0,7,0,2,41,24,41,55,0.9237072759328812,20.94139482623258,,
877,2018,2,NCAAF_20180908_MICHST@ARIZST,Arizona St.,Sun Devils,Michigan St.,Spartans,2-0,1-1,1,0,3,16,13,0,0,3,13,0,3,10,0,1,-3,0,-3,3,0.2956080708594315,-7.862576210846893,,
878,2018,2,NCAAF_20180908_SJST@WASHST,Washington St.,,San Jose St.,,2-0,0-2,,24,0,31,0,14,10,0,7,0,0,0,0,2,24,14,24,31,0.9981881425569054,42.589424551969024,,
879,2018,2,NCAAF_20180907_TCU@SMU,SMU,Mustangs,TCU,Horned Frogs,0-2,2-0,1,12,14,12,42,9,3,0,0,0,14,14,14,-2,-2,9,-2,-30,0.11433587698218961,-17.623011331349694,,
880,2018,3,NCAAF_20180915_BALLST@IND,Indiana,Hoosiers,Ball St.,Cardinals,3-0,1-2,1,24,3,38,10,3,21,7,7,3,0,7,0,2,21,0,21,28,0.9948394607844198,38.220630843487754,,
881,2018,3,NCAAF_20180915_FSU@CUSE,Syracuse,,Florida State,,3-0,1-2,,6,0,30,7,3,3,14,10,0,0,0,7,2,6,3,6,23,0.24179986721211433,-10.438877477230335,0.2887695795506988,-8.459793856772137
882,2018,3,NCAAF_20180915_GAS@CLEM,Clemson,Tigers,Ga. Southern,Eagles,3-0,2-1,1,21,0,38,7,0,21,3,14,0,0,0,7,1,21,0,21,31,0.9988253397668402,45.331929922191364,0.9989413930674463,46.678809570512385
883,2018,3,NCAAF_20180915_HAWAII@ARMY,Army,Black Knights,Hawaii,Rainbow Warriors,2-1,3-1,1,21,14,28,21,7,14,0,7,7,7,0,7,-1,7,0,7,7,0.9436705943874315,23.639090711893857,,
884,2018,3,NCAAF_20180915_KENTST@PSU,Penn State,Nittany Lions,Kent St.,Golden Flashes,3-0,1-2,1,28,10,63,10,21,7,21,14,7,3,0,0,2,18,14,18,53,0.9999575686873714,58.56646269961078,0.9999868559805276,63.84451283802895
885,2018,3,NCAAF_20180915_MIAMI@TOLEDO,Toledo,Rockets,Miami (Fla.),Hurricanes,1-1,2-1,1,7,21,24,49,0,7,14,3,7,14,14,14,-1,-14,-7,-14,-25,0.2059474474393369,-12.227639833139392,0.1711181584537964,-14.425469446934073
886,2018,3,NCAAF_20180915_MTSU@UGA,Georgia,Bulldogs,Middle Tenn.,Blue Raiders,3-0,1-2,1,42,7,49,7,14,28,7,0,0,7,0,0,2,35,14,35,42,0.9969688521716826,40.8956073604877,,
887,2018,3,NCAAF_20180915_MURYST@UK,Kentucky,Wildcats,Murray St.,Racers,3-0,0-3,1,17,3,48,10,7,10,17,14,0,3,0,7,3,14,7,14,38,0.9841770820514574,32.021204222111464,,
888,2018,3,NCAAF_20180915_OKLA@IOWAST,Iowa St.,Cyclones,Oklahoma,Sooners,0-1,2-0,1,10,24,27,37,0,10,14,3,10,14,10,3,-2,-14,-10,-14,-10,0.22962754281250342,-11.02822330190628,0.24271965237968074,-10.595283396719879
889,2018,3,NCAAF_20180915_RI@UCONN,UConn,Huskies,Rhode Island,Rams,1-2,2-1,1,42,28,56,49,14,28,7,7,7,21,14,7,-1,14,7,14,7,,,,
890,2018,3,NCAAF_20180915_RUT@KANSAS,Kansas,,Rutgers,,2-1,1-2,,31,14,55,14,17,14,10,14,7,7,0,0,1,17,10,17,41,0.25489230257269435,-9.822677514649286,0.2958015077016172,-8.148908431994641
891,2018,3,NCAAF_20180915_TEMPLE@MD,Maryland,Terrapins,Temple,Owls,2-1,1-2,1,7,21,14,35,0,7,0,7,7,14,7,7,1,-14,-7,-14,-21,0.6375881760437168,5.245623331080537,,
892,2018,3,NCAAF_20180915_TROY@NEB,Nebraska,,Troy,,0-2,2-1,,7,17,19,24,0,7,6,6,3,14,0,7,-2,-10,-3,-10,-5,0.5075133396760375,0.28065903622660926,,
893,2018,3,NCAAF_20180915_UTEP@TENN,Tennessee,Volunteers,UTEP,Miners,1-1,0-2,1,10,0,24,0,3,7,7,7,0,0,0,0,1,10,3,10,24,0.9671313529817105,27.421927161235033,0.9654009772053849,27.599592235266073
894,2018,3,NCAAF_20180915_GATECH@PITT,Pittsburgh,,Georgia Tech,,2-1,1-2,,21,0,24,19,14,7,3,0,0,0,6,13,1,21,14,21,5,0.31578054132136546,-7.145734520320616,,
895,2018,3,NCAAF_20180915_TULANE@UAB,UAB,,Tulane,,2-1,1-2,,21,7,31,24,7,14,3,7,0,7,14,3,1,14,7,14,7,0.14009911291144406,-16.091759803354364,,
896,2018,3,NCAAF_20180915_DAVIS@STNFRD,Stanford,Cardinal,UC-Davis,Aggies,3-0,2-1,1,17,3,30,10,0,17,10,3,3,0,0,7,1,14,-3,14,20,0.9859623079143512,32.72717319654646,,
897,2018,3,NCAAF_20180915_VANDY@ND,Notre Dame,Fighting Irish,Vanderbilt,Commodores,2-0,2-0,1,16,3,22,17,10,6,0,6,0,3,7,7,0,13,10,13,5,0.9461664360760565,23.973075703995733,0.9256154547996522,21.93072389014037
898,2018,3,NCAAF_20180915_BOISE@OKLAST,Oklahoma State,Cowboys,Boise St.,Broncos,3-0,2-1,1,17,7,44,21,0,17,17,10,0,7,14,0,1,10,0,10,23,0.7946591351090206,12.259394005040235,,
899,2018,3,NCAAF_20180915_BYU@WISC,Wisconsin,Badgers,BYU,Cougars,2-1,2-1,1,14,14,21,24,7,7,0,7,7,7,7,3,0,0,0,0,-3,0.994553173307169,37.94062279906717,0.9920764434526598,36.64126717233057
900,2018,3,NCAAF_20180915_CMICH@NILL,N. Illinois,,C. Michigan,,1-2,0-3,,14,3,24,16,0,14,7,3,0,3,7,6,1,11,0,11,8,0.6887980115715617,7.338193308268217,,
901,2018,3,NCAAF_20180915_DUKE@BAYLOR,Baylor,,Duke,,2-1,3-0,,0,23,27,40,0,0,13,14,7,16,7,10,-1,-23,-7,-23,-13,0.1957209863986311,-12.770676040310434,0.30284409364677956,-7.840936702463296
902,2018,3,NCAAF_20180915_LEH@NAVY,Navy,Midshipmen,Lehigh,Mountain Hawks,2-1,1-2,1,34,7,51,21,21,13,14,3,7,0,0,14,1,27,14,27,30,,,,
903,2018,3,NCAAF_20180915_LSU@AUBURN,Auburn,Tigers,LSU,Tigers,2-1,3-0,1,14,10,21,22,0,14,7,0,7,3,3,9,-1,4,-7,4,-1,0.8330544086804765,14.399419500531621,0.8568957627069386,16.198287429247785
904,2018,3,NCAAF_20180915_MIAOH@MINN,Minnesota,,Miami-OH,,3-0,0-3,,19,3,26,3,7,12,7,0,0,3,0,0,3,16,7,16,23,0.869431729187968,16.744963870240667,0.9017155510253458,19.61439792087299
905,2018,3,NCAAF_20180915_SFLA@ILL,Illinois,,South Florida,,2-1,3-0,,16,7,19,25,10,6,3,0,7,0,0,18,-1,9,3,9,-6,0.11659319777610477,-17.765449626572718,,
906,2018,3,NCAAF_20180915_SMU@MICH,Michigan,Wolverines,SMU,Mustangs,2-1,0-3,1,21,7,45,20,0,21,14,10,0,7,6,7,2,14,0,14,25,0.8602059353437446,16.112188090338634,,
907,2018,3,NCAAF_20180915_COLOST@FLA,Florida,,Colorado St.,,2-1,1-3,,27,3,48,10,6,21,0,21,0,3,7,0,1,24,6,24,38,0.5605137292903772,2.269080826711786,,
908,2018,3,NCAAF_20180915_EKY@BGREEN,Bowling Green,,E. Kentucky,,1-2,1-2,,28,21,42,35,0,28,6,8,14,7,14,0,0,7,-14,7,7,0.6083196055841509,4.097052264564411,,
909,2018,3,NCAAF_20180915_NTEXAS@ARK,Arkansas,,North Texas,,1-2,3-0,,10,34,17,44,0,10,0,7,17,17,3,7,-2,-24,-17,-24,-27,0.6872588958865746,7.273361735864341,,
910,2018,3,NCAAF_20180915_TXSA@KSTATE,Kansas State,,UTSA,,2-1,0-3,,27,7,41,17,10,17,14,0,7,0,0,10,2,20,3,20,24,0.9281457525615137,21.78779267911119,,
911,2018,3,NCAAF_20180915_WOFF@WYO,Wyoming,,Wofford,,2-2,2-1,,10,7,17,14,0,10,0,7,0,7,0,7,0,3,0,3,3,0.7570540769812641,10.38423494122327,,
912,2018,3,NCAAF_20180915_HOU@TXTECH,Texas Tech,,Houston,,2-1,2-1,,35,28,63,49,14,21,14,14,21,7,14,7,0,7,-7,7,14,0.6106279311488092,4.186669975710743,0.6092205212109436,4.2116190215875235
913,2018,3,NCAAF_20180915_OHIO@UVA,Virginia,,Ohio,,2-1,1-1,,38,21,45,31,21,17,0,7,7,14,7,3,1,17,14,17,14,0.5609555827510141,2.285779065370832,,
914,2018,3,NCAAF_20180915_NH@COLO,Colorado,,New Hamp.,,3-0,0-3,,28,0,45,14,7,21,10,7,0,0,14,0,3,28,7,28,31,0.635022008472239,5.1437654788810505,,
915,2018,3,NCAAF_20180915_SJST@OREG,Oregon,Ducks,San Jose St.,Spartans,3-0,0-3,1,21,6,35,22,14,7,7,7,0,6,6,10,3,15,14,15,13,0.9966828683702799,40.45263420858538,0.9970270191596854,41.780011797194675
916,2018,3,NCAAF_20180915_BTHN@FAU,FAU,,Bethune-Cook.,,2-1,1-2,,36,14,49,28,29,7,7,6,0,14,7,7,1,22,29,22,21,0.9796265733955105,30.4899393590199,,
917,2018,3,NCAAF_20180915_EMICH@BUFF,Buffalo,,E. Michigan,,3-0,2-1,,28,21,35,28,14,14,0,7,0,21,0,7,1,7,14,7,7,0.46419602270654037,-1.3391704842769627,,
918,2018,3,NCAAF_20180915_IDST@CAL,California,,Idaho State,,3-0,1-1,,28,3,45,23,7,21,3,14,0,3,6,14,2,25,7,25,22,0.957900490382654,25.732313439736004,,
919,2018,3,NCAAF_20180915_ALAM@CINCY,Cincinnati,,Alabama A&M,,3-0,1-2,,42,0,63,7,28,14,14,7,0,0,7,0,2,42,28,42,56,0.9968117796902813,40.64787551283405,,
920,2018,3,NCAAF_20180915_ARKST@TULSA,Tulsa,Golden Hurricane,Arkansas St.,Red Wolves,1-2,2-1,1,7,13,20,29,7,0,3,10,3,10,14,2,-1,-6,4,-6,-9,0.4524345918331666,-1.7809200886638905,0.4797892689150992,-0.7697963139494277
921,2018,3,NCAAF_20180915_BAMA@MISS,Ole Miss,Rebels,Alabama,Crimson Tide,2-1,3-0,1,7,49,7,62,7,0,0,0,28,21,10,3,-1,-42,-21,-42,-55,0.015896306159556173,-31.993675910570346,0.019292860876723328,-31.418817367567897
922,2018,3,NCAAF_20180915_DEST@WMICH,W. Michigan,,Delaware St.,,1-2,0-3,,28,0,68,0,14,14,16,24,0,0,0,0,1,28,14,28,68,0.9955863035240692,39.02211124802744,,
923,2018,3,NCAAF_20180915_OREGST@NEVADA,Nevada,,Oregon State,,2-1,1-2,,30,21,37,35,16,14,0,7,7,14,0,14,1,9,9,9,2,0.6597977436909497,6.13810050138386,,
924,2018,3,NCAAF_20180915_TXSTSM@SALA,South Alabama,,Texas St.,,1-2,1-2,,16,24,41,31,3,13,7,18,17,7,7,0,0,-8,-14,-8,10,0.7573631223495951,10.39895607086055,,
925,2018,3,NCAAF_20180915_AKRON@NWEST,Northwestern,,Akron,,1-2,2-0,,21,3,34,39,7,14,7,6,0,3,23,13,-1,18,7,18,-5,0.9541493132693268,25.131261072113432,,
926,2018,3,NCAAF_20180915_LALAF@MISSST,Miss. State,Bulldogs,Louisiana,Ragin' Cajuns,3-0,1-1,1,35,3,56,10,14,21,14,7,3,0,0,7,2,32,11,32,46,0.9967368326269711,40.533519932410854,,
927,2018,3,NCAAF_20180915_LAMON@TXAM,Texas A&M,,UL-Monroe,,2-1,2-1,,24,10,48,10,7,17,10,14,3,7,0,0,0,14,4,14,38,0.9352991845063015,22.597635270270757,,
928,2018,3,NCAAF_20180915_MA@FIU,FIU,,UMass,,2-1,1-3,,42,10,63,24,14,28,14,7,7,3,14,0,1,32,7,32,39,0.5471250980866925,1.764356601445968,,
929,2018,3,NCAAF_20180915_MIZZOU@PURDUE,Purdue,,Missouri,,0-3,3-0,,24,27,37,40,7,17,3,10,13,14,10,3,-3,-3,-6,-3,-3,0.5770229286268895,2.8951137689953157,0.5135969613536324,0.517766414191783
930,2018,3,NCAAF_20180915_NOIOWA@IOWA,Iowa,,Northern Iowa,,3-0,0-2,,21,0,38,14,7,14,17,0,0,0,0,14,3,21,7,21,24,0.931046252982298,22.108311486163075,,
931,2018,3,NCAAF_20180915_WKY@LVILLE,Louisville,,W. Kentucky,,2-1,0-3,,3,14,20,17,0,3,3,14,7,7,0,3,2,-11,-7,-11,3,0.9820082253223527,31.250162859754596,,
932,2018,3,NCAAF_20180915_EWASH@WASHST,Washington St.,,E. Washington,,3-0,2-1,,28,10,59,24,14,14,7,24,0,10,14,0,1,18,14,18,35,0.998269617932703,43.56516354226943,,
933,2018,3,NCAAF_20180915_NMEX@NMEXST,New Mexico St.,,New Mexico,,0-4,2-1,,17,21,25,42,17,0,0,8,7,14,7,14,-2,-4,10,-4,-17,0.44721362949091525,-1.9774946696459779,0.3642909604373141,-5.270636952349264
934,2018,3,NCAAF_20180915_OHIOST@TCU,TCU,Horned Frogs,Ohio State,Buckeyes,2-1,3-0,1,14,13,28,40,7,7,14,0,10,3,20,7,-1,1,-3,1,-12,0.23148150886432184,-10.937362166317769,0.2236609160211731,-11.541633358293382
935,2018,3,NCAAF_20180915_USC@TEXAS,Texas,Longhorns,USC,Trojans,2-1,1-2,1,16,14,37,14,3,13,21,0,14,0,0,0,1,2,-11,2,23,0.5253772800921868,0.9485464629864282,,
936,2018,3,NCAAF_20180915_PRARIE@UNLV,UNLV,,Prairie View,,2-1,1-3,,34,0,46,17,20,14,0,12,0,0,14,3,1,34,20,34,29,,,,
937,2018,3,NCAAF_20180915_WASH@UTAH,Utah,Utes,Washington,Huskies,2-0,1-1,1,7,14,7,21,7,0,0,0,7,7,7,0,1,-7,0,-7,-14,0.16160388791608105,-14.72101859784948,0.15906926448630077,-15.162642500059576
938,2018,3,NCAAF_20180915_ARIZST@SDGST,San Diego St.,Aztecs,Arizona St.,Sun Devils,1-1,2-0,1,14,14,28,21,0,14,3,11,7,7,0,7,-1,0,-7,0,7,0.4556031881101389,-1.6617723174203434,0.3618001951927542,-5.371467562914802
939,2018,3,NCAAF_20180915_FRESNO@UCLA,UCLA,,Fresno St.,,0-3,2-1,,7,16,14,38,0,7,7,0,13,3,15,7,-2,-9,-13,-9,-24,0.507137964678194,0.26663545556573354,0.5128127034916048,0.4878916251669807
940,2018,3,NCAAF_20180915_SUT@ARIZ,Arizona,,So. Utah,,1-2,0-3,,24,17,62,31,7,17,24,14,0,17,0,14,1,7,7,7,31,0.9991513189752357,46.77042697834651,,
941,2018,3,NCAAF_20180914_GAST@MEMP,Memphis,Tigers,Georgia St.,Panthers,2-1,1-2,1,38,10,59,22,21,17,7,14,3,7,6,6,1,28,18,28,37,0.9786211084932157,30.19148564690613,0.985735848160608,33.26219969659951
942,2018,3,NCAAF_20180913_ODU@CHARLO,Charlotte,49ers,Old Dominion,Monarchs,2-1,0-3,1,13,12,28,25,7,6,8,7,6,6,6,7,2,1,1,1,3,0.2894463891654313,-8.270381292876777,,
943,2018,3,NCAAF_20180913_BC@WAKE,Wake Forest,Demon Deacons,Boston College,Eagles,2-1,3-0,1,21,21,34,41,7,14,3,10,7,14,7,13,-1,0,0,0,-7,0.5274182621682311,1.024949768160809,0.42620488538225587,-2.825758783491665
944,2018,3,NCAAF_20180913_TNTECH@UTAHST,Utah St.,Aggies,Tenn. Tech,Golden Eagles,2-1,0-3,1,45,6,73,12,17,28,7,21,3,3,3,3,2,39,14,39,61,0.9987564588252287,45.075718674777534,,
945,2018,3,NCAAF_20180912_CSTCAR@CAMP,Campbell,,C. Carolina,,2-1,2-1,,21,24,21,58,14,7,0,0,7,17,21,13,0,-3,7,-3,-37,,,,
946,2018,4,NCAAF_20180923_DUQ@HAWAII,Hawaii,,Duquesne,,4-1,3-2,,21,14,42,21,7,14,7,14,14,0,0,7,1,7,-7,7,21,,,,
947,2018,4,NCAAF_20180922_AKRON@IOWAST,Iowa St.,,Akron,,1-2,2-1,,17,10,26,13,7,10,0,9,7,3,3,0,-1,7,0,7,13,0.9670124290464165,27.605221222451632,0.9735295904001078,29.55440470014878
948,2018,4,NCAAF_20180922_BC@PURDUE,Purdue,Boilermakers,Boston College,Eagles,1-3,3-1,1,23,7,30,13,7,16,7,0,7,0,0,6,-2,16,0,16,17,0.445158794344953,-2.0705104512744583,0.21209681450156948,-12.203607437060782
949,2018,4,NCAAF_20180922_BUFF@RUT,Rutgers,,Buffalo,,1-3,4-0,,6,35,13,42,3,3,0,7,14,21,0,7,-3,-29,-11,-29,-29,0.3552917678872429,-5.571402157359671,,
950,2018,4,NCAAF_20180922_KENTST@MISS,Ole Miss,,Kent St.,,3-1,1-3,,7,7,38,17,7,0,17,14,0,7,10,0,2,0,7,0,21,0.9432725262443967,23.76546723625563,0.9824193783740455,32.16706814375857
951,2018,4,NCAAF_20180922_MINN@MD,Maryland,Terrapins,Minnesota,Golden Gophers,3-1,3-1,1,21,10,42,13,14,7,14,7,0,10,3,0,0,11,14,11,29,0.32162778465958075,-6.953910386286793,0.3075024295984322,-7.680135259133294
952,2018,4,NCAAF_20180922_NAVY@SMU,SMU,,Navy,,1-3,2-2,,10,7,31,30,7,3,7,14,0,7,7,16,-1,3,7,3,1,0.4308032369701825,-2.6174401617696503,,
953,2018,4,NCAAF_20180922_ND@WAKE,Wake Forest,Demon Deacons,Notre Dame,Fighting Irish,2-2,4-0,1,13,28,27,56,3,10,7,7,7,21,21,7,-2,-15,-4,-15,-29,0.35314634241483,-5.657993842107317,0.4392874553795184,-2.332952595753113
954,2018,4,NCAAF_20180922_NEB@MICH,Michigan,Wolverines,Nebraska,Cornhuskers,3-1,0-3,1,39,0,56,10,20,19,10,7,0,0,3,7,3,39,20,39,46,0.9110381052133036,20.226924122861305,,
955,2018,4,NCAAF_20180922_NEVADA@TOLEDO,Toledo,Rockets,Nevada,Wolf Pack,2-1,2-2,1,35,24,63,44,14,21,14,14,7,17,14,6,0,11,7,11,19,0.8624133225624757,16.384022415379263,0.8641286530021525,16.783070065409447
956,2018,4,NCAAF_20180922_OHIO@CINCY,Cincinnati,,Ohio,,4-0,1-2,,7,24,34,30,0,7,14,13,14,10,3,3,3,-17,-14,-17,4,0.2328780300045491,-10.951470403828694,,
957,2018,4,NCAAF_20180922_UGA@MIZZOU,Missouri,Tigers,Georgia,Bulldogs,3-1,4-0,1,7,20,29,43,7,0,15,7,7,13,13,10,-1,-13,0,-13,-14,0.08732382606232114,-20.3807485996349,0.11260545485460116,-18.519770319927602
958,2018,4,NCAAF_20180922_PITT@UNC,North Carolina,Tar Heels,Pittsburgh,Panthers,1-2,2-2,1,21,28,38,35,7,14,17,0,7,21,0,7,-1,-7,0,-7,3,0.2519474753750536,-10.035181355281566,,
959,2018,4,NCAAF_20180922_LVILLE@UVA,Virginia,,Louisville,,3-1,2-2,,6,0,27,3,0,6,7,14,0,0,3,0,1,6,0,6,24,0.29748594583303145,-7.982289523862619,0.2679223765700055,-9.454044340640166
960,2018,4,NCAAF_20180922_WMICH@GAST,Georgia St.,,W. Michigan,,1-3,2-2,,9,20,15,34,0,9,6,0,3,17,14,0,-1,-11,-3,-11,-19,0.1903492977818395,-13.161702832269157,,
961,2018,4,NCAAF_20180922_ILST@COLOST,Colorado St.,,Illinois St.,,1-4,3-0,,6,14,19,35,6,0,7,6,0,14,7,14,-2,-8,6,-8,-16,,,,
962,2018,4,NCAAF_20180922_ME@CMICH,C. Michigan,,Maine,,1-3,2-1,,10,0,17,5,0,10,0,7,0,0,3,2,-1,10,0,10,12,0.843593284055791,15.154499070072234,,
963,2018,4,NCAAF_20180922_MIAOH@BGREEN,Bowling Green,,Miami-OH,,1-3,1-3,,3,24,23,38,0,3,0,20,7,17,7,7,0,-21,-7,-21,-15,0.35076394419574697,-5.75437116647845,0.41724858675245935,-3.1905586982575187
964,2018,4,NCAAF_20180922_WKY@BALLST,Ball St.,,W. Kentucky,,1-3,1-3,,10,7,20,28,7,3,3,7,0,7,7,14,0,3,7,3,-8,0.1681003054651029,-14.439265399799524,,
965,2018,4,NCAAF_20180922_CHARLO@MA,UMass,,Charlotte,,2-3,2-2,,35,10,49,31,28,7,7,7,0,10,7,14,0,25,28,25,18,0.8100723179590104,13.185019899203326,,
966,2018,4,NCAAF_20180922_CLEM@GATECH,Georgia Tech,Yellow Jackets,Clemson,Tigers,1-3,4-0,1,7,28,21,49,0,7,7,7,7,21,14,7,-3,-21,-7,-21,-28,0.12699996940564962,-17.126651936269923,0.13889519977157216,-16.572922193647173
967,2018,4,NCAAF_20180922_FIU@MIAMI,Miami (Fla.),Hurricanes,FIU,Panthers,3-1,2-2,1,24,0,31,17,7,17,7,0,0,0,0,17,1,24,7,24,14,0.9658816603072162,27.377726013701817,0.9312157860655402,22.675142259038694
968,2018,4,NCAAF_20180922_GRDWB@APLST,App. St.,,Gardner-Webb,,2-1,1-3,,52,7,72,7,28,24,14,6,7,0,0,0,1,45,21,45,65,0.9702829213745134,28.30151771369526,,
969,2018,4,NCAAF_20180922_KANSAS@BAYLOR,Baylor,,Kansas,,3-1,2-2,,23,0,26,7,7,16,3,0,0,0,7,0,1,23,7,23,19,0.7232222628780223,8.895096781497728,0.7616717140650232,10.867803542292904
970,2018,4,NCAAF_20180922_KSTATE@WVU,West Virginia,Mountaineers,Kansas State,Wildcats,3-0,2-2,1,21,0,35,6,7,14,14,0,0,0,3,3,1,21,7,21,29,0.5226354204908592,0.8523490113012713,,
971,2018,4,NCAAF_20180922_NCCEN@DUKE,Duke,,NC Central,,4-0,1-2,,27,13,55,13,20,7,21,7,7,6,0,0,3,14,13,14,42,0.9997921909412033,52.99999999999807,,
972,2018,4,NCAAF_20180922_NILL@FSU,Florida State,,N. Illinois,,2-2,1-3,,20,7,37,19,14,6,3,14,0,7,6,6,1,13,14,13,18,0.6874242733928427,7.335435274473184,,
973,2018,4,NCAAF_20180922_TULANE@OHIOST,Ohio State,Buckeyes,Tulane,Green Wave,4-0,1-3,1,42,6,49,6,21,21,0,7,0,6,0,0,3,36,21,36,43,0.9893501634705982,34.57242871070957,,
974,2018,4,NCAAF_20180922_TXAM@BAMA,Alabama,Crimson Tide,Texas A&M,Aggies,4-0,2-2,1,31,13,45,23,14,17,14,0,7,6,3,7,2,18,7,18,22,0.95521168667633,25.488843169477832,,
975,2018,4,NCAAF_20180922_VATECH@ODU,Old Dominion,Monarchs,Virginia Tech,Hokies,1-3,2-1,1,14,14,49,35,7,7,7,28,7,7,14,7,-1,0,0,0,14,0.0023681787481270034,-42.407026866803335,,
976,2018,4,NCAAF_20180922_ARIZ@OREGST,Oregon State,,Arizona,,1-3,2-2,,7,14,14,35,7,0,0,7,7,7,7,14,-1,-7,0,-7,-21,0.09411246705285303,-19.756572183557637,,
977,2018,4,NCAAF_20180922_SC@VANDY,Vanderbilt,Commodores,South Carolina,Gamecocks,2-2,2-1,1,14,20,14,37,0,14,0,0,10,10,10,7,0,-6,-10,-6,-23,0.238140149036714,-10.694671074543407,,
978,2018,4,NCAAF_20180922_UCONN@CUSE,Syracuse,,UConn,,4-0,1-3,,31,14,51,21,24,7,10,10,7,7,0,7,3,17,17,17,30,0.9031334570266734,19.51283314675311,0.8780260608949662,17.792711989006875
979,2018,4,NCAAF_20180922_TCU@TEXAS,Texas,Longhorns,TCU,Horned Frogs,3-1,2-2,1,10,13,31,16,7,3,14,7,6,7,3,0,1,-3,1,-3,15,0.3112277050676022,-7.392652841919357,,
980,2018,4,NCAAF_20180922_MCN@BYU,BYU,Cougars,McNeese St.,Cowboys,3-1,3-1,1,24,3,30,3,0,24,6,0,3,0,0,0,0,21,-3,21,27,,,,
981,2018,4,NCAAF_20180922_NTEXAS@LIB,Liberty,,North Texas,,1-2,4-0,,7,21,7,47,0,7,0,0,14,7,6,20,-3,-14,-14,-14,-40,0.4268878863443669,-2.767184462207524,,
982,2018,4,NCAAF_20180922_CSTCAR@LALAF,Louisiana,,C. Carolina,,1-2,3-1,,7,16,28,30,7,0,14,7,3,13,7,7,-2,-9,4,-9,-2,0.38702689593307915,-4.31025826555765,,
983,2018,4,NCAAF_20180922_FLA@TENN,Tennessee,Volunteers,Florida,Gators,2-2,3-1,1,3,26,21,47,0,3,10,8,14,12,7,14,-1,-23,-14,-23,-26,0.2576844161835342,-9.766827750102152,0.22458802392290933,-11.556485158009536
984,2018,4,NCAAF_20180922_LATECH@LSU,LSU,Tigers,Louisiana Tech,Bulldogs,4-0,2-1,1,24,7,38,21,7,17,0,14,0,7,7,7,2,17,7,17,17,0.9460915521366835,24.144284172261564,,
985,2018,4,NCAAF_20180922_MISSST@UK,Kentucky,Wildcats,Miss. State,Bulldogs,4-0,3-1,1,7,7,28,7,0,7,7,14,0,7,0,0,1,0,0,0,21,0.14239205993678872,-16.05982874740289,0.18987416136173452,-13.412920021290574
986,2018,4,NCAAF_20180922_NCST@MRSHL,Marshall,,NC State,,2-1,3-0,,7,23,20,37,0,7,13,0,3,20,14,0,-1,-16,-3,-16,-17,0.13079417037357088,-16.85575256977245,,
987,2018,4,NCAAF_20180922_RICE@USM,So. Miss,,Rice,,2-1,1-3,,24,15,40,22,10,14,10,6,8,7,0,7,1,9,2,9,18,0.8685143707869155,16.806971869735435,,
988,2018,4,NCAAF_20180922_TROY@LAMON,UL-Monroe,,Troy,,2-2,3-1,,7,35,27,35,7,0,7,13,7,28,0,0,-1,-28,0,-28,-8,0.14722164441772767,-15.741376524097745,0.12430589094903599,-17.617897824050488
989,2018,4,NCAAF_20180922_TXSTSM@TXSA,UTSA,,Texas St.,,1-3,1-3,,17,7,25,21,14,3,0,8,7,0,7,7,0,10,7,10,4,0.8774254967433497,17.44983899409351,0.9035871813347667,19.88612969977771
990,2018,4,NCAAF_20180922_TXTECH@OKLAST,Oklahoma State,Cowboys,Texas Tech,Red Raiders,3-1,3-1,1,17,24,17,41,10,7,0,0,7,17,10,7,0,-7,3,-7,-24,0.7822954856184482,11.710708552116557,,
991,2018,4,NCAAF_20180922_UNLV@ARKST,Arkansas St.,,UNLV,,3-1,2-2,,13,7,27,20,6,7,6,8,7,0,13,0,1,6,-1,6,7,0.6503691463333483,5.800292199423893,0.6521174634876689,5.971395192670798
992,2018,4,NCAAF_20180922_ARK@AUBURN,Auburn,Tigers,Arkansas,Razorbacks,3-1,1-3,1,17,0,34,3,10,7,7,10,0,0,3,0,2,17,10,17,31,0.9846148251063195,32.431386700484495,0.9930435012484127,37.55760454574238
993,2018,4,NCAAF_20180922_MICHST@IND,Indiana,Hoosiers,Michigan St.,Spartans,3-1,2-1,1,7,21,21,35,0,7,0,14,14,7,7,7,1,-14,-14,-14,-14,0.35625874791833323,-5.532434475536888,,
994,2018,4,NCAAF_20180922_NMEXST@UTEP,UTEP,,New Mexico St.,,0-4,1-4,,10,17,20,27,7,3,7,3,10,7,7,3,-1,-7,-3,-7,-7,0.15701209734321409,-15.116629262128072,0.2594731363751509,-9.848965390430749
995,2018,4,NCAAF_20180922_ECU@SFLA,South Florida,,East Carolina,,4-0,1-2,,13,10,20,13,6,7,0,7,7,3,3,0,3,3,-1,3,7,0.9428777953121825,23.713616362444554,,
996,2018,4,NCAAF_20180922_SALA@MEMP,Memphis,,South Alabama,,3-1,1-3,,21,21,52,35,7,14,10,21,7,14,6,8,2,0,0,0,17,0.9828431985664409,31.77581746154806,,
997,2018,4,NCAAF_20180922_TXSO@HOU,Houston,,Texas Southern,,3-1,1-3,,42,0,70,14,14,28,7,21,0,0,7,7,2,42,14,42,56,0.9996939980757359,51.44264270215956,,
998,2018,4,NCAAF_20180922_WISC@IOWA,Iowa,Hawkeyes,Wisconsin,Badgers,3-1,3-1,1,7,7,17,28,0,7,10,0,0,7,7,14,0,0,0,0,-11,0.41020445076194334,-3.4085377805104144,,
999,2018,4,NCAAF_20180922_AF@UTAHST,Utah St.,,Air Force,,3-1,1-2,,21,14,42,32,7,14,14,7,0,14,3,15,2,7,7,7,10,0.6919131660366485,7.526388388446776,0.764284584673049,10.997031554767318
1000,2018,4,NCAAF_20180922_ARIZST@WASH,Washington,Huskies,Arizona St.,Sun Devils,3-1,2-2,1,17,10,27,20,14,3,3,7,10,0,3,7,1,7,4,7,7,0.8663684371619467,16.656699238642318,0.8187107310627066,13.903139896283164
1001,2018,4,NCAAF_20180921_FAU@UCF,UCF,Knights,FAU,Owls,3-0,2-2,1,21,17,56,36,14,7,21,14,7,10,6,13,1,4,7,4,20,0.8517168454185324,15.672327004671502,,
1002,2018,4,NCAAF_20180921_PSU@ILL,Illinois,Fighting Illini,Penn State,Nittany Lions,2-2,4-0,1,17,21,24,63,7,10,7,0,7,14,7,35,-2,-4,0,-4,-39,0.003609460759596894,-40.33707063520035,0.006537042744794386,-37.89726403569966
1003,2018,4,NCAAF_20180921_WASHST@USC,USC,Trojans,Washington St.,Cougars,2-2,3-1,1,17,24,39,36,7,10,7,15,3,21,6,6,-1,-7,4,-7,3,0.5750455919722466,2.8412319059666515,0.5409029199668007,1.5684042350958407
1004,2018,4,NCAAF_20180920_TULSA@TEMPLE,Temple,Owls,Tulsa,Golden Hurricane,2-2,1-3,1,21,10,31,17,7,14,7,3,7,3,0,7,1,11,0,11,14,0.6161010397591811,4.433076794767203,,
1005,2018,5,NCAAF_20180929_ARK@TXAM,Texas A&M,,Arkansas,,3-2,1-4,,17,7,24,17,14,3,0,7,0,7,3,7,2,10,14,10,7,0.8543280926136538,15.915194523038167,0.8815131716975164,18.153801127412862
1006,2018,5,NCAAF_20180929_ARMY@BUFF,Buffalo,Bulls,Army,Black Knights,4-1,3-2,1,7,21,13,42,7,0,6,0,7,14,7,14,1,-14,0,-14,-29,0.45291487628964455,-1.7843162011385516,,
1007,2018,5,NCAAF_20180929_BGREEN@GATECH,Georgia Tech,,Bowling Green,,2-3,1-4,,28,10,63,17,14,14,21,14,3,7,7,0,1,18,11,18,46,0.9530301427191543,25.26351009775459,0.9176021377137702,21.32433624769442
1008,2018,5,NCAAF_20180929_CMICH@MICHST,Michigan St.,Spartans,C. Michigan,Chippewas,3-1,1-4,1,17,3,31,20,0,17,14,0,3,0,0,17,2,14,-3,14,11,0.892135728776,18.672177241342013,,
1009,2018,5,NCAAF_20180929_CUSE@CLEM,Clemson,Tigers,Syracuse,Orange,5-0,4-1,1,7,16,27,23,7,0,6,14,6,10,0,7,1,-9,1,-9,4,0.9389124521146587,23.313828088751563,0.9120299018932754,20.775380953910144
1010,2018,5,NCAAF_20180929_IND@RUT,Rutgers,,Indiana,,1-4,4-1,,7,24,17,24,7,0,0,10,7,17,0,0,-3,-17,0,-17,-7,0.13074091142651068,-16.93657219091125,0.13897989327913995,-16.654457154476177
1011,2018,5,NCAAF_20180929_LALAF@BAMA,Alabama,Crimson Tide,Louisiana,Ragin' Cajuns,5-0,1-3,1,49,0,56,14,28,21,7,0,0,0,0,14,4,49,28,49,42,0.9999470894514436,58.474189246062,,
1012,2018,5,NCAAF_20180929_OKLAST@KANSAS,Kansas,Jayhawks,Oklahoma State,Cowboys,2-3,4-1,1,7,24,28,48,0,7,7,14,14,10,10,14,-2,-17,-14,-17,-20,0.01420134479678492,-33.05697285682214,,
1013,2018,5,NCAAF_20180929_TEMPLE@BC,Boston College,,Temple,,4-1,2-3,,31,21,45,35,13,18,7,7,14,7,7,7,2,10,-1,10,10,0.7854194293226863,11.924997026258552,,
1014,2018,5,NCAAF_20180929_WVU@TXTECH,Texas Tech,Red Raiders,West Virginia,Mountaineers,3-2,4-0,1,10,35,34,42,7,3,7,17,28,7,0,7,-1,-25,-21,-25,-8,0.5848762675978327,3.2335448740830657,,
1015,2018,5,NCAAF_20180929_UVA@NCST,NC State,,Virginia,,4-0,3-2,,20,7,35,21,3,17,7,8,7,0,7,7,1,13,-4,13,14,0.7072627652106386,8.22632488286331,,
1016,2018,5,NCAAF_20180929_LAMON@GAST,Georgia St.,,UL-Monroe,,2-3,2-3,,30,14,46,14,14,16,6,10,7,7,0,0,0,16,7,16,32,0.4068539085531667,-3.554226894148826,0.3941250214859904,-4.123014726953443
1017,2018,5,NCAAF_20180929_MA@OHIO,Ohio,,UMass,,2-2,2-4,,35,28,58,42,14,21,17,6,21,7,7,7,0,7,-7,7,16,0.8392836053316794,14.95500816347834,,
1018,2018,5,NCAAF_20180929_KENTST@BALLST,Ball St.,,Kent St.,,2-3,1-4,,35,17,52,24,21,14,7,10,7,10,7,0,1,18,14,18,28,0.37890959154112414,-4.6507632210320935,0.30209375433884944,-7.957748987532796
1019,2018,5,NCAAF_20180929_BAYLOR@OKLA,Oklahoma,Sooners,Baylor,Bears,5-0,3-2,1,28,9,66,33,14,14,21,17,6,3,14,10,2,19,8,19,33,0.9792913743418187,30.7590782925227,0.9713571455827886,29.184063391827067
1020,2018,5,NCAAF_20180929_CINCY@UCONN,UConn,Huskies,Cincinnati,Bearcats,1-4,5-0,1,7,21,7,49,7,0,0,0,7,14,21,7,-4,-14,0,-14,-42,0.3119188239223226,-7.396957876884358,,
1021,2018,5,NCAAF_20180929_CSTCAR@TROY,Troy,,C. Carolina,,4-1,3-2,,24,14,45,21,21,3,14,7,0,14,7,0,1,10,21,10,24,0.8997012076633419,19.303919484206517,0.8940225128393554,19.16117293311595
1022,2018,5,NCAAF_20180929_FSU@LVILLE,Louisville,,Florida State,,2-3,3-2,,21,7,24,28,7,14,3,0,7,0,7,14,-1,14,0,14,-4,0.5030783478310028,0.11638528100513668,0.5817552975625734,3.1682207983037642
1023,2018,5,NCAAF_20180929_ODU@ECU,East Carolina,,Old Dominion,,2-2,1-4,,21,20,37,35,14,7,7,9,14,6,7,8,1,1,0,1,2,0.6480788333403747,5.7336133803952976,,
1024,2018,5,NCAAF_20180929_PITT@UCF,UCF,Knights,Pittsburgh,Panthers,4-0,2-3,1,31,7,45,14,14,17,7,7,7,0,0,7,2,24,7,24,31,0.9007904105395086,19.39769848348027,,
1025,2018,5,NCAAF_20180929_PURDUE@NEB,Nebraska,,Purdue,,0-4,2-3,,7,20,28,42,7,0,14,7,10,10,15,7,-2,-13,-3,-13,-14,0.15913689496613503,-15.052951552711363,,
1026,2018,5,NCAAF_20180929_RICE@WAKE,Wake Forest,,Rice,,3-2,1-4,,42,3,56,24,21,21,14,0,0,3,14,7,2,39,21,39,32,0.9936990303329688,37.62930082501964,,
1027,2018,5,NCAAF_20180929_SALA@APLST,App. St.,,South Alabama,,3-1,1-4,,42,7,52,7,21,21,3,7,7,0,0,0,2,35,14,35,45,0.8814999381561791,17.835856995481038,,
1028,2018,5,NCAAF_20180929_TENN@UGA,Georgia,Bulldogs,Tennessee,Volunteers,5-0,2-3,1,17,0,38,12,7,10,7,14,0,0,6,6,3,17,7,17,26,0.9934096224223893,37.38832250199124,0.9948854307239233,39.42101475975301
1029,2018,5,NCAAF_20180929_TEXAS@KSTATE,Kansas State,Wildcats,Texas,Longhorns,2-3,4-1,1,0,19,14,19,0,0,7,7,7,12,0,0,-2,-19,-7,-19,-5,0.23538192730526664,-10.87837391954946,,
1030,2018,5,NCAAF_20180929_WMICH@MIAOH,Miami-OH,,W. Michigan,,1-4,3-2,,27,14,39,40,17,10,6,6,14,0,13,13,-2,13,3,13,-1,0.34830373580688745,-5.880901598679316,,
1031,2018,5,NCAAF_20180929_NEVADA@AF,Air Force,,Nevada,,1-3,3-2,,7,21,25,28,0,7,10,8,7,14,7,0,-2,-14,-7,-14,-3,0.6473942872030255,5.705803072054323,0.585160287754901,3.3021844506624802
1032,2018,5,NCAAF_20180929_TNST@VANDY,Vanderbilt,,Tennessee St.,,3-2,2-1,,10,13,31,27,0,10,14,7,0,13,7,7,1,-3,0,-3,4,0.7109029646287126,8.386487307060008,,
1033,2018,5,NCAAF_20180929_USM@AUBURN,Auburn,Tigers,So. Miss,Golden Eagles,4-1,2-2,1,14,3,24,13,7,7,7,3,0,3,3,7,2,11,7,11,11,0.9915793314592469,36.05055036988574,,
1034,2018,5,NCAAF_20180929_MICH@NWEST,Northwestern,Wildcats,Michigan,Wolverines,1-3,4-1,1,17,7,17,20,10,7,0,0,0,7,6,7,-3,10,10,10,-3,0.2613340160241926,-9.641593026535645,,
1035,2018,5,NCAAF_20180929_ARKST@GAS,Ga. Southern,,Arkansas St.,,3-1,3-2,,7,3,28,21,0,7,7,14,0,3,11,7,0,4,0,4,7,0.1981102300237496,-12.796228532558303,0.1870907506878693,-13.641897294028468
1036,2018,5,NCAAF_20180929_FLA@MISSST,Miss. State,Bulldogs,Florida,Gators,3-2,4-1,1,6,3,6,13,3,3,0,0,0,3,7,3,-1,3,3,3,-7,0.7424959030177283,9.819891438790705,0.637794280564682,5.412271347369597
1037,2018,5,NCAAF_20180929_LIB@NMEX,New Mexico,,Liberty,,2-2,2-2,,10,42,43,52,7,3,13,20,21,21,0,10,0,-32,-14,-32,-9,0.7180136255832293,8.702115472295645,,
1038,2018,5,NCAAF_20180929_UTAH@WASHST,Washington St.,,Utah,,4-1,2-2,,21,21,28,24,7,14,0,7,14,7,3,0,2,0,-7,0,4,0.509090041232216,0.34369997191754464,,
1039,2018,5,NCAAF_20180929_BOISE@WYO,Wyoming,Cowboys,Boise St.,Broncos,2-3,3-1,1,0,24,14,34,0,0,7,7,7,17,3,7,-1,-24,-7,-24,-20,0.1575469390721791,-15.152188602489957,,
1040,2018,5,NCAAF_20180929_CHARLO@UAB,UAB,,Charlotte,,3-1,2-3,,21,0,28,7,14,7,0,7,0,0,0,7,1,21,14,21,21,0.8448102957316983,15.300534406001816,,
1041,2018,5,NCAAF_20180929_FAU@MTSU,Middle Tenn.,,FAU,,2-2,2-3,,10,21,25,24,0,10,7,8,14,7,3,0,0,-11,-14,-11,1,0.145936336465588,-15.897760706141526,,
1042,2018,5,NCAAF_20180929_HOUBP@SMU,SMU,,Houston Christian,,2-3,1-3,,35,10,63,27,21,14,14,14,3,7,10,7,1,25,18,25,36,0.9962089088734573,40.273426032308805,,
1043,2018,5,NCAAF_20180929_IOWAST@TCU,TCU,,Iowa St.,,3-2,1-3,,7,7,17,14,0,7,7,3,0,7,0,7,2,0,0,0,3,0.6088799000269064,4.168938683273609,0.5944447341549404,3.66877862790534
1044,2018,5,NCAAF_20180929_UTEP@TXSA,UTSA,,UTEP,,2-3,0-5,,24,7,30,21,7,17,0,6,7,0,7,7,2,17,0,17,9,0.9035800065314896,19.641364734450974,0.8480525189984439,15.7825652780175
1045,2018,5,NCAAF_20180929_VATECH@DUKE,Duke,Blue Devils,Virginia Tech,Hokies,4-1,3-1,1,7,17,14,31,7,0,0,7,3,14,7,7,1,-10,4,-10,-17,0.32894299760759327,-6.67923663621815,,
1046,2018,5,NCAAF_20180929_ARPB@FIU,FIU,,Ark.-Pine Bluff,,3-2,1-4,,38,3,55,9,17,21,17,0,3,0,3,3,2,35,14,35,46,0.9986982846152533,45.41555025887425,,
1047,2018,5,NCAAF_20180929_LATECH@NTEXAS,North Texas,,Louisiana Tech,,4-1,3-1,,21,26,27,29,21,0,6,0,6,20,3,0,1,-5,15,-5,-2,0.5803322095578485,3.05796774937329,,
1048,2018,5,NCAAF_20180929_MRSHL@WKY,W. Kentucky,,Marshall,,1-4,3-1,,10,10,17,20,3,7,0,7,7,3,0,10,-2,0,-4,0,-3,0.23852146652127493,-10.724978673950773,,
1049,2018,5,NCAAF_20180929_OHIOST@PSU,Penn State,Nittany Lions,Ohio State,Buckeyes,4-1,5-0,1,13,7,26,27,3,10,0,13,0,7,7,13,-1,6,3,6,-1,0.5038347038353922,0.14498216309476675,0.4508472632325953,-1.896164842767348
1050,2018,5,NCAAF_20180929_SC@UK,Kentucky,Wildcats,South Carolina,Gamecocks,5-0,2-2,1,24,3,24,10,3,21,0,0,3,0,7,0,3,21,0,21,14,0.35854971575002303,-5.46512451676881,,
1051,2018,5,NCAAF_20180929_STNFRD@ND,Notre Dame,Fighting Irish,Stanford,Cardinal,5-0,4-1,1,21,14,38,17,14,7,3,14,7,7,3,0,1,7,7,7,21,0.627189714102178,4.893198968111562,0.5060340730785653,0.23219467939270544
1052,2018,5,NCAAF_20180929_BYU@WASH,Washington,Huskies,BYU,Cougars,4-1,3-2,1,21,0,35,7,7,14,14,0,0,0,0,7,1,21,7,21,28,0.9675950761422258,27.851674653473196,0.9001849137279211,19.68921705490402
1053,2018,5,NCAAF_20180929_MISS@LSU,LSU,Tigers,Ole Miss,Rebels,5-0,3-2,1,28,6,45,16,14,14,7,10,3,3,7,3,2,22,11,22,29,0.8240793581245784,14.042579154478119,0.8851001938714735,18.434573034679033
1054,2018,5,NCAAF_20180929_OREGST@ARIZST,Arizona St.,,Oregon State,,1-2,1-4,,31,17,52,24,10,21,7,14,0,17,7,0,0,14,10,14,28,0.9457724406037915,24.210777258912685,0.9301274983702146,22.669378724929857
1055,2018,5,NCAAF_20180929_OREG@CAL,California,Golden Bears,Oregon,Ducks,3-1,4-1,1,10,28,24,42,3,7,7,7,7,21,7,7,-1,-18,-4,-18,-18,0.3453590712061748,-6.001212096724657,,
1056,2018,5,NCAAF_20180929_TOLEDO@FRESNO,Fresno St.,,Toledo,,3-1,2-2,,28,13,49,27,7,21,21,0,7,6,0,14,1,15,0,15,22,0.5057504483607105,0.21741665356643125,0.5301089305061188,1.1596672325363215
1057,2018,5,NCAAF_20180929_USC@ARIZ,Arizona,,USC,,2-3,3-2,,0,17,20,24,0,0,7,13,7,10,7,0,-1,-17,-7,-17,-4,0.27407891879471546,-9.05765264492203,,
1058,2018,5,NCAAF_20180928_MEMP@TULANE,Tulane,Green Wave,Memphis,Tigers,2-3,3-2,1,17,7,40,24,14,3,7,16,7,0,7,10,-1,10,7,10,16,0.16740082973806392,-14.547308548805518,,
1059,2018,5,NCAAF_20180928_UCLA@COLO,Colorado,Buffaloes,UCLA,Bruins,4-0,0-4,1,14,13,38,16,7,7,14,10,10,3,3,0,4,1,-3,1,22,0.4231557686718901,-2.9234781251698223,,
1060,2018,5,NCAAF_20180927_UNC@MIAMI,Miami (Fla.),Hurricanes,North Carolina,Tar Heels,4-1,1-3,1,33,10,47,10,14,19,0,14,10,0,0,0,3,23,4,23,37,0.921002848721507,21.294846102877557,,
1061,2018,6,NCAAF_20181007_WYO@HAWAII,Hawaii,,Wyoming,,6-1,2-4,,3,3,17,13,0,3,7,7,3,0,7,3,4,0,-3,0,4,0.15989312970526504,-14.93652553012788,,
1062,2018,6,NCAAF_20181006_BAMA@ARK,Arkansas,Razorbacks,Alabama,Crimson Tide,1-5,6-0,1,14,41,31,65,7,7,3,14,21,20,7,17,-5,-27,-14,-27,-34,0.004564856780690851,-39.14161827748342,0.011239082353363794,-35.48833573104457
1063,2018,6,NCAAF_20181006_BUFF@CMICH,C. Michigan,Chippewas,Buffalo,Bulls,1-5,5-1,1,3,17,24,34,3,0,14,7,7,10,7,10,-4,-14,-4,-14,-10,0.45988842809022623,-1.5120449448324962,,
1064,2018,6,NCAAF_20181006_ECU@TEMPLE,Temple,,East Carolina,,3-3,2-3,,35,3,49,6,14,21,7,7,0,3,0,3,1,32,14,32,43,0.7859300502054896,11.896087796144514,,
1065,2018,6,NCAAF_20181006_EMICH@WMICH,W. Michigan,,E. Michigan,,4-2,2-4,,14,10,27,24,7,7,0,13,0,10,7,7,2,4,7,4,3,0.4728920185398453,-1.0209232610496883,,
1066,2018,6,NCAAF_20181006_ILL@RUT,Rutgers,Scarlet Knights,Illinois,Fighting Illini,1-5,3-2,1,14,24,17,38,7,7,0,3,10,14,0,14,-2,-10,-3,-10,-21,0.43039891681688025,-2.632682900997793,0.37880160123511486,-4.7992317490675305
1067,2018,6,NCAAF_20181006_KANSAS@WVU,West Virginia,Mountaineers,Kansas,Jayhawks,5-0,2-4,1,21,7,38,22,14,7,7,10,7,0,7,8,3,14,7,14,16,0.9390942741794984,23.22854413109593,0.9446748698497475,24.806764419731053
1068,2018,6,NCAAF_20181006_MD@MICH,Michigan,Wolverines,Maryland,Terrapins,5-1,3-2,1,17,7,42,21,3,14,10,15,7,0,0,14,2,10,-4,10,21,0.9091735625344742,20.052789902415554,0.932647299789035,23.25990386744661
1069,2018,6,NCAAF_20181006_MIZZOU@SC,South Carolina,Gamecocks,Missouri,Tigers,3-2,3-2,1,14,23,37,35,7,7,17,6,14,9,0,12,0,-9,-7,-9,2,0.43301255916359305,-2.5328589232848913,,
1070,2018,6,NCAAF_20181006_NWEST@MICHST,Michigan St.,Spartans,Northwestern,Wildcats,3-2,2-3,1,6,14,19,29,3,3,13,0,7,7,8,7,1,-8,-4,-8,-10,0.5206745789208813,0.7783815157329741,,
1071,2018,6,NCAAF_20181006_TEXAS@OKLA,Oklahoma,Sooners,Texas,Longhorns,5-1,5-1,1,17,24,45,48,7,10,7,21,10,14,21,3,0,-7,-3,-7,-3,0.7853832464439638,11.867942269647699,,
1072,2018,6,NCAAF_20181006_TULANE@CINCY,Cincinnati,,Tulane,,6-0,2-4,,24,14,37,21,3,21,6,7,7,7,0,7,4,10,-4,10,16,0.337680110865199,-6.287543469348634,,
1073,2018,6,NCAAF_20181006_BC@NCST,NC State,Wolfpack,Boston College,Eagles,5-0,4-2,1,21,3,28,23,7,14,7,0,3,0,7,13,1,18,4,18,5,0.5561727386119367,2.1209458924575983,,
1074,2018,6,NCAAF_20181006_NILL@BALLST,Ball St.,,N. Illinois,,2-4,3-3,,6,14,16,24,0,6,3,7,7,7,7,3,-1,-8,-7,-8,-8,0.04046017520775258,-26.203485911361042,,
1075,2018,6,NCAAF_20181006_BGREEN@TOLEDO,Toledo,,Bowling Green,,3-2,1-5,,24,21,52,36,17,7,7,21,7,14,7,8,2,3,10,3,16,0.9282411992515851,21.961460444151896,0.9462343473602964,25.02620487479635
1076,2018,6,NCAAF_20181006_CLEM@WAKE,Wake Forest,Demon Deacons,Clemson,Tigers,3-3,6-0,1,0,28,3,63,0,0,3,0,7,21,21,14,-3,-28,-7,-28,-60,0.15167402862091883,-15.45272092456156,0.1574019908113249,-15.630877776147145
1077,2018,6,NCAAF_20181006_FSU@MIAMI,Miami (Fla.),Hurricanes,Florida State,Seminoles,5-1,3-3,1,7,20,28,27,0,7,14,7,7,13,7,0,2,-13,-7,-13,1,0.7157797642267165,8.562738167948964,0.6896666749554036,7.695847689095444
1078,2018,6,NCAAF_20181006_IOWA@MINN,Minnesota,Golden Gophers,Iowa,Hawkeyes,3-2,4-1,1,17,28,31,48,7,10,7,7,14,14,10,10,-1,-11,-7,-11,-17,0.12700312373302736,-17.125069065484638,,
1079,2018,6,NCAAF_20181006_IOWAST@OKLAST,Oklahoma State,Cowboys,Iowa St.,Cyclones,4-2,2-3,1,21,30,42,48,7,14,7,14,9,21,10,8,2,-9,-2,-9,-6,0.5809960886536933,3.069320777570624,,
1080,2018,6,NCAAF_20181006_KSTATE@BAYLOR,Baylor,,Kansas State,,4-2,2-4,,12,14,37,34,3,9,8,17,7,7,0,20,2,-2,-4,-2,3,0.27398669864570147,-9.019886785009021,,
1081,2018,6,NCAAF_20181006_LSU@FLA,Florida,Gators,LSU,Tigers,5-1,5-1,1,14,10,27,19,0,14,0,13,7,3,3,6,0,4,-7,4,8,0.2987148289122833,-7.928442174461736,0.23216733268847922,-11.378462308372264
1082,2018,6,NCAAF_20181006_MIAOH@AKRON,Akron,,Miami-OH,,2-2,2-4,,10,14,17,41,0,10,7,0,0,14,10,17,0,-4,0,-4,-24,0.5525204054319216,1.9822102078831563,0.68146439247396,7.33651403853446
1083,2018,6,NCAAF_20181006_NAVY@AF,Air Force,Falcons,Navy,Midshipmen,2-3,2-3,1,14,7,35,7,0,14,14,7,0,7,0,0,0,7,0,7,28,0.20717744655582648,-12.254530590681611,0.2964768553534476,-8.312486174857895
1084,2018,6,NCAAF_20181006_OHIO@KENTST,Kent St.,,Ohio,,1-5,3-2,,17,7,26,27,14,3,6,3,7,0,7,13,-2,10,7,10,-1,0.04665746817758909,-25.19451327922434,,
1085,2018,6,NCAAF_20181006_SALA@GAS,Ga. Southern,,South Alabama,,4-1,1-5,,17,6,48,13,7,10,10,21,0,6,0,7,3,11,7,11,35,0.6108868431665905,4.228167059683415,0.6649983083470693,6.626583772312415
1086,2018,6,NCAAF_20181006_SDGST@BOISE,Boise St.,,San Diego St.,,3-2,4-1,,7,13,13,19,7,0,0,6,3,10,0,6,-1,-6,4,-6,-6,0.6261426255675686,4.829036333170166,,
1087,2018,6,NCAAF_20181006_SFLA@MA,UMass,,South Florida,,2-5,5-0,,14,20,42,58,7,7,14,14,10,10,28,10,-3,-6,-3,-6,-16,0.052517008462383385,-24.335144384801765,,
1088,2018,6,NCAAF_20181006_ARIZST@COLO,Colorado,Buffaloes,Arizona St.,Sun Devils,5-0,3-3,1,14,14,28,21,7,7,14,0,7,7,7,0,2,0,0,0,7,0.34686807907765327,-5.912020762514771,,
1089,2018,6,NCAAF_20181006_IND@OHIOST,Ohio State,Buckeyes,Indiana,Hoosiers,6-0,4-2,1,28,20,49,26,7,21,7,14,3,17,6,0,2,8,4,8,23,0.9647894121027918,27.161643036245437,0.9762752606989896,30.824489417827408
1090,2018,6,NCAAF_20181006_LAMON@MISS,Ole Miss,,UL-Monroe,,4-2,2-4,,49,7,70,21,21,28,14,7,0,7,7,7,2,42,21,42,49,0.8421726864992212,15.064592343563447,0.9034234935455314,20.23550737405617
1091,2018,6,NCAAF_20181006_NMEX@UNLV,UNLV,,New Mexico,,2-3,3-2,,0,29,14,50,0,0,0,14,0,29,7,14,-1,-29,0,-29,-36,0.6170526708149945,4.470147394788341,,
1092,2018,6,NCAAF_20181006_ODU@FAU,FAU,,Old Dominion,,3-3,1-5,,26,7,52,33,6,20,6,20,0,7,14,12,2,19,6,19,19,0.9447191717754239,23.956064161545214,0.9448121447581301,24.825883238474944
1093,2018,6,NCAAF_20181006_LALAF@TXSTSM,Texas St.,,Louisiana,,1-4,2-3,,0,28,27,42,0,0,13,14,7,21,7,7,-1,-28,-7,-28,-15,0.3663592555099888,-5.12715880015611,,
1094,2018,6,NCAAF_20181006_SMU@UCF,UCF,Knights,SMU,Mustangs,5-0,2-4,1,27,10,48,20,21,6,7,14,3,7,3,7,3,17,18,17,28,0.9209786631922596,21.19381958757981,,
1095,2018,6,NCAAF_20181006_TXSA@RICE,Rice,,UTSA,,1-5,3-3,,0,13,3,20,0,0,3,0,3,10,0,7,-2,-13,-3,-13,-17,0.18203720780342836,-13.62635193361848,,
1096,2018,6,NCAAF_20181006_UAB@LATECH,Louisiana Tech,,UAB,,3-2,4-1,,7,7,7,28,7,0,0,0,0,7,7,14,-1,0,7,0,-21,0.6087984147382486,4.146457392202365,,
1097,2018,6,NCAAF_20181006_UCONN@MEMP,Memphis,Tigers,UConn,Huskies,4-2,1-5,1,41,14,55,14,13,28,7,7,7,7,0,0,3,27,6,27,41,0.9700597859826051,28.249809597167598,0.9786305918938664,31.508500472869855
1098,2018,6,NCAAF_20181006_AUBURN@MISSST,Miss. State,Bulldogs,Auburn,Tigers,4-2,4-2,1,13,3,23,9,3,10,3,7,3,0,3,3,0,10,0,10,14,0.2526065836364513,-10.003397057138727,0.29094537887337646,-8.562289332305
1099,2018,6,NCAAF_20181006_NEB@WISC,Wisconsin,Badgers,Nebraska,Cornhuskers,4-1,0-5,1,20,3,41,24,3,17,14,7,0,3,14,7,4,17,3,17,17,0.9706231311878418,28.375297990498723,,
1100,2018,6,NCAAF_20181006_NTEXAS@UTEP,UTEP,,North Texas,,0-6,5-1,,10,10,24,27,3,7,0,14,7,3,10,7,-5,0,-4,0,-3,0.043382721576620153,-25.71318302273994,0.04800312702841847,-25.88367810913678
1101,2018,6,NCAAF_20181006_VANDY@UGA,Georgia,Bulldogs,Vanderbilt,Commodores,6-0,3-3,1,21,6,41,13,7,14,17,3,3,3,0,7,3,15,4,15,28,0.9856809629445967,32.85523925429567,0.9836787150949944,33.22210535695376
1102,2018,6,NCAAF_20181006_WASH@UCLA,UCLA,Bruins,Washington,Huskies,0-5,5-1,1,7,24,24,31,0,7,3,14,7,17,0,7,-5,-17,-7,-17,-7,0.07832248279590515,-21.265294061407133,,
1103,2018,6,NCAAF_20181006_LIB@NMEXST,New Mexico St.,,Liberty,,2-4,2-3,,21,14,49,41,7,14,14,14,7,7,14,13,0,7,0,7,8,0.49380059403160204,-0.23330758770850935,,
1104,2018,6,NCAAF_20181006_ND@VATECH,Virginia Tech,Hokies,Notre Dame,Fighting Irish,3-2,6-0,1,16,17,23,45,3,13,0,7,10,7,14,14,-3,-1,-7,-1,-22,0.39561737048146506,-3.9740904085228976,,
1105,2018,6,NCAAF_20181006_WASHST@OREGST,Oregon State,,Washington St.,,1-5,5-1,,24,28,37,56,14,10,6,7,14,14,7,21,-4,-4,0,-4,-19,0.03919904705160526,-26.423976556676564,0.10183177036530355,-19.767058623848925
1106,2018,6,NCAAF_20181006_CAL@ARIZ,Arizona,,California,,3-3,3-2,,10,14,24,17,10,0,7,7,0,14,0,3,0,-4,10,-4,7,0.5571718362310376,2.158928180313012,,
1107,2018,6,NCAAF_20181006_COLOST@SJST,San Jose St.,Spartans,Colorado St.,Rams,0-5,2-4,1,0,28,30,42,0,0,30,0,14,14,0,14,-2,-28,-14,-28,-12,0.053619998278861436,-24.18200869025071,,
1108,2018,6,NCAAF_20181006_FRESNO@NEVADA,Nevada,,Fresno St.,,3-3,4-1,,3,7,3,21,0,3,0,0,0,7,7,7,-1,-4,0,-4,-18,0.1182960263102133,-17.76876450709858,0.1500909314554657,-16.11060835463877
1109,2018,6,NCAAF_20181006_UTAH@STNFRD,Stanford,Cardinal,Utah,Utes,4-2,3-2,1,7,24,21,40,0,7,14,0,7,17,3,13,1,-17,-7,-17,-19,0.6781904824208691,6.945747629215191,0.6727740738310071,6.960022866197278
1110,2018,6,NCAAF_20181005_GATECH@LVILLE,Louisville,Cardinals,Georgia Tech,Yellow Jackets,2-4,3-3,1,17,31,31,66,0,17,0,14,21,10,14,21,-1,-14,-21,-14,-35,0.4856886089510065,-0.5386868022961835,0.6119287562754041,4.421672440483462
1111,2018,6,NCAAF_20181005_MTSU@MRSHL,Marshall,Thundering Herd,Middle Tenn.,Blue Raiders,3-2,3-2,1,17,10,24,34,3,14,0,7,3,7,14,10,0,7,0,7,-10,0.6104638184310252,4.211606196295975,,
1112,2018,6,NCAAF_20181005_UTAHST@BYU,BYU,Cougars,Utah St.,Aggies,3-3,4-1,1,7,21,20,45,0,7,6,7,14,7,14,10,-1,-14,-14,-14,-25,0.28530291380282435,-8.514841649628636,,
1113,2018,6,NCAAF_20181004_GAST@TROY,Troy,Trojans,Georgia St.,Panthers,5-1,2-4,1,23,3,37,20,14,9,0,14,0,3,3,14,3,20,14,20,17,0.8536425352709165,15.796586641485192,0.857847963751952,16.649531165332974
1114,2018,6,NCAAF_20181004_TULSA@HOU,Houston,Cougars,Tulsa,Golden Hurricane,4-1,1-4,1,17,13,41,26,7,10,0,24,13,0,10,3,3,4,-6,4,15,0.8323857046637719,14.46719259655066,,
1115,2018,7,NCAAF_20181013_AKRON@BUFF,Buffalo,Bulls,Akron,Zips,6-1,2-3,1,10,6,24,6,7,3,7,7,3,3,0,0,4,4,4,4,18,0.6555733802871803,6.064990478777986,0.6390020060522053,5.69598476868498
1116,2018,7,NCAAF_20181013_FLA@VANDY,Vanderbilt,Commodores,Florida,Gators,3-4,6-1,1,21,13,27,37,7,14,0,6,0,13,7,17,-3,8,7,8,-10,0.2542650080644443,-10.01403334431319,0.2690600633927247,-9.856250620846254
1117,2018,7,NCAAF_20181013_IOWA@IND,Indiana,,Iowa,,4-3,5-1,,10,21,16,42,3,7,6,0,14,7,14,7,-1,-11,-11,-11,-26,0.17310194088590647,-14.26803094961457,,
1118,2018,7,NCAAF_20181013_MINN@OHIOST,Ohio State,Buckeyes,Minnesota,Golden Gophers,7-0,3-3,1,17,14,30,14,10,7,3,10,7,7,0,0,4,3,3,3,16,0.9708869583413157,28.688073405832824,0.9664424060698935,29.31143894525644
1119,2018,7,NCAAF_20181013_OKLAST@KSTATE,Kansas State,Wildcats,Oklahoma State,Cowboys,3-4,4-3,1,3,6,31,12,0,3,14,14,3,3,0,6,-1,-3,-3,-3,19,0.19270072969948626,-13.147297028211824,0.21898363511466457,-12.417291162763206
1120,2018,7,NCAAF_20181013_RUT@MD,Maryland,,Rutgers,,4-2,1-6,,24,0,34,7,10,14,10,0,0,0,0,7,3,24,10,24,27,0.7811944203207211,11.757517034468435,0.7593851394713307,11.275760500777665
1121,2018,7,NCAAF_20181013_TENN@AUBURN,Auburn,Tigers,Tennessee,Volunteers,4-3,3-3,1,17,13,24,30,10,7,0,7,3,10,14,3,1,4,7,4,-6,0.9693865169689699,28.352735415176767,0.9403208069126343,24.934025775384782
1122,2018,7,NCAAF_20181013_TOLEDO@EMICH,E. Michigan,,Toledo,,3-4,3-3,,28,3,28,26,21,7,0,0,3,0,3,20,0,25,18,25,2,0.3343213128144724,-6.483042542021451,,
1123,2018,7,NCAAF_20181013_DUKE@GATECH,Georgia Tech,,Duke,,3-4,5-1,,7,7,14,28,0,7,0,7,7,0,21,0,-2,0,-7,0,-14,0.5852814217170985,3.262994360303651,,
1124,2018,7,NCAAF_20181013_LVILLE@BC,Boston College,,Louisville,,5-2,2-5,,24,20,38,20,14,10,0,14,13,7,0,0,3,4,1,4,18,0.5822610340047361,3.1457221205514543,0.7089616741782628,8.81077529569842
1125,2018,7,NCAAF_20181013_UAB@RICE,Rice,,UAB,,1-6,5-1,,0,28,0,42,0,0,0,0,14,14,14,0,-4,-28,-14,-28,-42,0.14598099634885542,-15.962198520208858,,
1126,2018,7,NCAAF_20181013_TROY@LIB,Liberty,,Troy,,3-3,5-2,,14,10,22,16,0,14,0,8,7,3,3,3,-2,4,-7,4,6,0.1118159140624787,-18.432657079638602,,
1127,2018,7,NCAAF_20181013_USM@NTEXAS,North Texas,,So. Miss,,6-1,2-3,,10,7,30,7,0,10,6,14,0,7,0,0,4,3,0,3,23,0.5529286137950191,2.0155046768191482,,
1128,2018,7,NCAAF_20181013_KENTST@MIAOH,Miami-OH,,Kent St.,,3-4,1-6,,21,0,31,6,0,21,10,0,0,0,0,6,2,21,0,21,25,0.8607623881203006,16.415449057571266,0.8761239828623336,18.503965167655792
1129,2018,7,NCAAF_20181013_PITT@ND,Notre Dame,Fighting Irish,Pittsburgh,Panthers,7-0,3-4,1,6,7,19,14,0,6,6,7,7,0,7,0,4,-1,-7,-1,5,0.8845659507523289,18.147868958540187,,
1130,2018,7,NCAAF_20181013_BALLST@CMICH,C. Michigan,,Ball St.,,1-6,3-4,,20,7,23,24,3,17,0,3,0,7,0,17,-2,13,3,13,-1,0.8952566159026287,19.009003694961677,0.9052696063550754,21.00700441509025
1131,2018,7,NCAAF_20181013_WMICH@BGREEN,Bowling Green,,W. Michigan,,1-6,5-2,,21,7,35,42,7,14,7,7,0,7,21,14,-4,14,7,14,-7,0.18374787759255573,-13.649978538727623,,
1132,2018,7,NCAAF_20181013_ARMY@SJST,San Jose St.,,Army,,0-6,4-2,,3,14,3,52,3,0,0,0,0,14,24,14,-4,-11,3,-11,-49,0.0236010906026769,-30.058709555512507,,
1133,2018,7,NCAAF_20181013_BAYLOR@TEXAS,Texas,Longhorns,Baylor,Bears,6-1,4-3,1,23,10,23,17,3,20,0,0,7,3,7,0,2,13,-4,13,6,0.9012319711079657,19.518322111210352,0.8676097329208646,17.852969265417926
1134,2018,7,NCAAF_20181013_MICHST@PSU,Penn State,Nittany Lions,Michigan St.,Spartans,4-2,4-2,1,14,7,17,21,7,7,0,3,0,7,7,7,0,7,7,7,-4,0.9158383092381532,20.866514300404617,,
1135,2018,7,NCAAF_20181013_MRSHL@ODU,Old Dominion,,Marshall,,1-6,4-2,,3,14,20,42,0,3,7,10,0,14,7,21,-3,-11,0,-11,-22,0.17927395902469856,-13.906891140640766,0.2301120301470676,-11.822507529069014
1136,2018,7,NCAAF_20181013_OHIO@NILL,N. Illinois,,Ohio,,4-3,3-3,,9,7,24,21,3,6,0,15,0,7,14,0,1,2,3,2,3,0.5382021042525974,1.4526662126756946,,
1137,2018,7,NCAAF_20181013_PURDUE@ILL,Illinois,,Purdue,,3-3,3-3,,7,29,7,46,7,0,0,0,14,15,7,10,0,-22,-7,-22,-39,0.1214366008376686,-17.689064512017183,0.1605293154938192,-15.885774409383998
1138,2018,7,NCAAF_20181013_TEMPLE@NAVY,Navy,Midshipmen,Temple,Owls,2-4,4-3,1,10,7,17,24,0,10,7,0,0,7,10,7,-2,3,0,3,-7,0.5503953724502393,1.9185089717357755,,
1139,2018,7,NCAAF_20181013_TXAM@SC,South Carolina,Gamecocks,Texas A&M,Aggies,3-3,5-2,1,0,13,23,26,0,0,16,7,3,10,3,10,-2,-13,-3,-13,-3,0.49767792207241845,-0.0881642342850455,,
1140,2018,7,NCAAF_20181013_UCF@MEMP,Memphis,Tigers,UCF,Knights,4-3,6-0,1,30,17,30,31,17,13,0,0,7,10,7,7,-2,13,10,13,-1,0.17383051268241534,-14.224979845411838,0.3127838302407755,-7.812130661336369
1141,2018,7,NCAAF_20181013_UGA@LSU,LSU,Tigers,Georgia,Bulldogs,6-1,6-1,1,16,0,36,16,3,13,3,17,0,0,9,7,0,16,3,16,20,0.13951834004204233,-16.396286896122433,0.21671429245018548,-12.540686919219297
1142,2018,7,NCAAF_20181013_WKY@CHARLO,Charlotte,,W. Kentucky,,3-3,1-5,,9,7,40,14,6,3,21,10,7,0,0,7,2,2,-1,2,26,0.15444905922742025,-15.412511121456646,,
1143,2018,7,NCAAF_20181013_NMEX@COLOST,Colorado St.,,New Mexico,,3-4,3-3,,14,3,20,18,7,7,3,3,0,3,8,7,0,11,7,11,2,0.7038469784657599,8.111114393158857,,
1144,2018,7,NCAAF_20181013_UNLV@UTAHST,Utah St.,,UNLV,,5-1,2-4,,42,7,59,28,14,28,7,10,7,0,7,14,3,35,7,35,31,0.834949381675076,14.751700303505856,,
1145,2018,7,NCAAF_20181013_ALST@SALA,South Alabama,,Alabama St.,,2-5,2-4,,28,7,45,7,7,21,10,7,0,7,0,0,0,21,7,21,38,0.6801810224252858,7.091847115799737,,
1146,2018,7,NCAAF_20181013_NMEXST@LALAF,Louisiana,,New Mexico St.,,3-3,2-5,,45,21,66,38,28,17,7,14,14,7,10,7,1,24,14,24,28,0.35999560880166115,-5.429711093478261,,
1147,2018,7,NCAAF_20181013_LAMON@CSTCAR,C. Carolina,,UL-Monroe,,3-3,3-4,,13,24,20,45,3,10,7,0,14,10,7,14,0,-11,-11,-11,-25,0.499918171110052,-0.003106846955063247,0.6571504345413005,6.478935863173717
1148,2018,7,NCAAF_20181013_HOU@ECU,East Carolina,Pirates,Houston,Cougars,2-4,5-1,1,3,21,20,42,0,3,3,14,14,7,7,14,-3,-18,-14,-18,-22,0.08071121750065613,-21.21023382968218,,
1149,2018,7,NCAAF_20181013_LATECH@TXSA,UTSA,,Louisiana Tech,,3-4,4-2,,0,17,3,31,0,0,3,0,7,10,7,7,-1,-17,-7,-17,-28,0.43046659897486617,-2.6535273247733926,,
1150,2018,7,NCAAF_20181013_MIAMI@UVA,Virginia,Cavaliers,Miami (Fla.),Hurricanes,4-2,5-2,1,13,6,16,13,0,13,0,3,0,6,0,7,-1,7,0,7,3,0.1727823073366621,-14.286954422931672,0.19377162950058024,-13.83332710154167
1151,2018,7,NCAAF_20181013_MIZZOU@BAMA,Alabama,Crimson Tide,Missouri,Tigers,7-0,3-3,1,30,10,39,10,13,17,2,7,10,0,0,0,4,20,3,20,29,0.9314810657518666,22.52209236603261,0.758991361986173,11.255519080646707
1152,2018,7,NCAAF_20181013_UCLA@CAL,California,,UCLA,,3-3,1-5,,0,13,7,37,0,0,7,0,7,6,7,17,2,-13,-7,-13,-30,0.4821493354007691,-0.6779732872155932,,
1153,2018,7,NCAAF_20181013_VATECH@UNC,North Carolina,,Virginia Tech,,1-4,4-2,,9,7,19,22,6,3,7,3,7,0,7,8,-3,2,-1,2,-3,0.08556840312563896,-20.72942018272539,,
1154,2018,7,NCAAF_20181013_WVU@IOWAST,Iowa St.,Cyclones,West Virginia,Mountaineers,3-3,5-1,1,20,14,30,14,13,7,0,10,7,7,0,0,-2,6,6,6,16,0.6507253368315311,5.866076640555718,0.578742113343747,3.1806703667535317
1155,2018,7,NCAAF_20181013_MISS@ARK,Arkansas,Razorbacks,Ole Miss,Rebels,1-6,5-2,1,27,17,33,37,17,10,6,0,3,14,7,13,-4,10,14,10,-4,0.3425882840309087,-6.1406893524271595,0.2918847080162307,-8.771283604896553
1156,2018,7,NCAAF_20181013_MTSU@FIU,FIU,,Middle Tenn.,,4-2,3-3,,13,14,24,21,3,10,0,11,0,14,7,0,1,-1,3,-1,3,0.4832556701588735,-0.6359288661893174,,
1157,2018,7,NCAAF_20181013_WISC@MICH,Michigan,Wolverines,Wisconsin,Badgers,6-1,4-2,1,13,7,38,13,0,13,8,17,0,7,0,6,2,6,0,6,25,0.4022522630067925,-3.749181649475304,0.4533187832366492,-1.8775817654653224
1158,2018,7,NCAAF_20181013_HAWAII@BYU,BYU,,Hawaii,,4-3,6-2,,28,3,49,23,14,14,7,14,0,3,14,6,-2,25,14,25,26,0.7507092514378099,10.250249261622628,,
1159,2018,7,NCAAF_20181013_BOISE@NEVADA,Nevada,Wolf Pack,Boise St.,Broncos,3-4,4-2,1,17,17,27,31,10,7,10,0,7,10,14,0,-1,0,3,0,-4,0.08006935289403261,-21.275390442583557,0.05695969733646733,-25.307791852942728
1160,2018,7,NCAAF_20181013_COLO@USC,USC,Trojans,Colorado,Buffaloes,4-2,5-1,1,21,7,31,20,0,21,7,3,0,7,0,13,-1,14,0,14,11,0.7321326076487807,9.380095607777832,,
1161,2018,7,NCAAF_20181013_WYO@FRESNO,Fresno St.,,Wyoming,,5-1,2-5,,13,3,27,3,6,7,14,0,3,0,0,0,3,10,3,10,24,0.7875172848800875,12.084734516524406,0.7504437703620136,10.820469145295192
1162,2018,7,NCAAF_20181012_SFLA@TULSA,Tulsa,Golden Hurricane,South Florida,Bulls,1-5,6-0,1,10,3,24,25,7,3,14,0,3,0,7,15,-5,7,4,7,-1,0.13469773778851624,-16.729062184844963,,
1163,2018,7,NCAAF_20181012_AF@SDGST,San Diego St.,Aztecs,Air Force,Falcons,5-1,2-4,1,14,9,21,17,7,7,0,7,2,7,0,8,3,5,5,5,4,0.7650802431071189,10.947261034551957,,
1164,2018,7,NCAAF_20181012_ARIZ@UTAH,Utah,Utes,Arizona,Wildcats,4-2,3-4,1,28,0,42,10,14,14,7,7,0,0,3,7,1,28,14,28,32,0.6460351830130381,5.674599361947514,0.6388225593445972,5.6883138251236005
1165,2018,7,NCAAF_20181011_GAS@TXSTSM,Texas St.,Bobcats,Ga. Southern,Eagles,1-5,5-1,1,0,10,13,15,0,0,7,6,0,10,5,0,-4,-10,0,-10,-2,0.15616963119159222,-15.303285210604372,,
1166,2018,7,NCAAF_20181011_TXTECH@TCU,TCU,Horned Frogs,Texas Tech,Red Raiders,3-3,4-2,1,7,3,14,17,0,7,0,7,3,0,7,7,-1,4,-3,4,-3,0.6847344382673974,7.285338915949922,,
1167,2018,7,NCAAF_20181009_APLST@ARKST,Arkansas St.,Red Wolves,App. St.,Mountaineers,3-3,4-1,1,9,21,9,35,3,6,0,0,0,21,7,7,-1,-12,3,-12,-26,0.31078207736769903,-7.477027668236474,,
1168,2018,8,NCAAF_20181021_NEVADA@HAWAII,Hawaii,,Nevada,,6-3,4-4,,14,20,22,40,14,0,0,8,10,10,7,13,2,-6,4,-6,-18,0.28048340402321636,-8.897268687846804,,
1169,2018,8,NCAAF_20181020_AUBURN@MISS,Ole Miss,Rebels,Auburn,Tigers,5-3,5-3,1,6,10,16,31,3,3,3,7,7,3,21,0,0,-4,-4,-4,-15,0.0944405813728868,-20.106578651581913,0.17127661012484607,-15.169590849531573
1170,2018,8,NCAAF_20181020_BUFF@TOLEDO,Toledo,,Buffalo,,3-4,7-1,,17,7,17,31,7,10,0,0,0,7,10,14,-4,10,7,10,-14,0.6113280230070285,4.327418580669644,0.578676279394942,3.1726747184020496
1171,2018,8,NCAAF_20181020_ILL@WISC,Wisconsin,Badgers,Illinois,Fighting Illini,5-2,3-4,1,28,10,49,20,14,14,14,7,0,10,7,3,2,18,14,18,29,0.9800483295854125,31.443851312910283,0.9631267064327271,28.57977658041284
1172,2018,8,NCAAF_20181020_MD@IOWA,Iowa,Hawkeyes,Maryland,Terrapins,6-1,4-3,1,13,0,23,0,3,10,10,0,0,0,0,0,2,13,3,13,23,0.8971444608243635,19.36516318036638,,
1173,2018,8,NCAAF_20181020_MICH@MICHST,Michigan St.,Spartans,Michigan,Wolverines,4-3,7-1,1,0,7,7,21,0,0,7,0,0,7,7,7,-3,-7,0,-7,-14,0.2660322193450714,-9.562210287171752,,
1174,2018,8,NCAAF_20181020_NWEST@RUT,Rutgers,,Northwestern,,1-7,4-3,,12,7,15,18,0,12,3,0,7,0,3,8,-3,5,-7,5,-3,0.05231273102810685,-24.834220563011286,,
1175,2018,8,NCAAF_20181020_OKLA@TCU,TCU,Horned Frogs,Oklahoma,Sooners,3-4,6-1,1,24,28,27,52,7,17,3,0,14,14,10,14,-3,-4,-7,-4,-25,0.3099242959059155,-7.59129173795219,0.25587525260919386,-10.486404385713286
1176,2018,8,NCAAF_20181020_TULSA@ARK,Arkansas,,Tulsa,,2-6,1-6,,10,0,23,0,0,10,10,3,0,0,0,0,1,10,0,10,23,0.5304556684781109,1.169385526029032,,
1177,2018,8,NCAAF_20181020_UVA@DUKE,Duke,Blue Devils,Virginia,Cavaliers,5-2,5-2,1,0,14,14,28,0,0,7,7,7,7,6,8,0,-14,-7,-14,-14,0.6495305061978943,5.877174406077529,,
1178,2018,8,NCAAF_20181020_BGREEN@OHIO,Ohio,,Bowling Green,,4-3,1-7,,35,14,49,14,14,21,7,7,7,7,0,0,3,21,7,21,35,0.8417455146569406,15.328386914081022,,
1179,2018,8,NCAAF_20181020_IDST@LIB,Liberty,,Idaho State,,4-3,4-3,,20,17,48,41,7,13,14,14,0,17,14,10,0,3,7,3,7,0.702892722491498,8.152509149502805,,
1180,2018,8,NCAAF_20181020_FAU@MRSHL,Marshall,,FAU,,5-2,3-4,,10,7,31,7,0,10,14,7,0,7,0,0,2,3,0,3,24,0.26338522606158044,-9.685949074737152,0.18131181235345184,-14.550180565259211
1181,2018,8,NCAAF_20181020_UTAHST@WYO,Wyoming,,Utah St.,,2-6,6-1,,3,10,16,24,3,0,10,3,7,3,14,0,-4,-7,-4,-7,-8,0.25988570944279665,-9.850520241164077,,
1182,2018,8,NCAAF_20181020_CHARLO@MTSU,Middle Tenn.,,Charlotte,,4-3,3-4,,14,6,21,13,0,14,0,7,6,0,0,7,1,8,-6,8,8,0.896852179944652,19.340220112960253,,
1183,2018,8,NCAAF_20181020_EMICH@BALLST,Ball St.,,E. Michigan,,3-5,4-4,,6,21,20,42,0,6,7,7,7,14,14,7,-1,-15,-7,-15,-22,0.08232361342015881,-21.26523515774454,,
1184,2018,8,NCAAF_20181020_WMICH@CMICH,C. Michigan,,W. Michigan,,1-7,6-2,,0,21,10,35,0,0,10,0,7,14,0,14,-5,-21,-7,-21,-25,0.4477727086231854,-2.009142873210692,,
1185,2018,8,NCAAF_20181020_BAMA@TENN,Tennessee,Volunteers,Alabama,Crimson Tide,3-4,8-0,1,14,42,21,58,0,14,7,0,28,14,16,0,-5,-28,-28,-28,-37,0.007987253804704886,-36.87258763352577,0.014495222361154303,-34.89983482507159
1186,2018,8,NCAAF_20181020_COLO@WASH,Washington,Huskies,Colorado,Buffaloes,6-2,5-2,1,14,13,27,13,0,14,3,10,7,6,0,0,1,1,-7,1,14,0.8979966397162262,19.438182900542188,,
1187,2018,8,NCAAF_20181020_CSTCAR@MA,UMass,,C. Carolina,,2-6,4-3,,6,3,13,24,3,3,7,0,3,0,14,7,-2,3,0,3,-11,0.6629668690454704,6.436050662797925,,
1188,2018,8,NCAAF_20181020_HOU@NAVY,Navy,Midshipmen,Houston,Cougars,2-5,6-1,1,24,21,36,49,10,14,0,12,7,14,14,14,-4,3,3,3,-13,0.408769097606989,-3.530597339216058,,
1189,2018,8,NCAAF_20181020_KANSAS@TXTECH,Texas Tech,Red Raiders,Kansas,Jayhawks,5-2,2-5,1,24,3,48,16,3,21,3,21,3,0,6,7,3,21,0,21,32,0.9496924323648671,25.125703251270295,,
1190,2018,8,NCAAF_20181020_LALAF@APLST,App. St.,,Louisiana,,5-1,3-4,,17,10,27,17,7,10,7,3,7,3,0,7,2,7,0,7,10,0.9322785564105907,22.84707557941624,,
1191,2018,8,NCAAF_20181020_MINN@NEB,Nebraska,,Minnesota,,1-6,3-4,,28,8,53,28,14,14,8,17,0,8,14,6,-2,20,14,20,25,0.30513387577193374,-7.799816089007209,,
1192,2018,8,NCAAF_20181020_NCST@CLEM,Clemson,Tigers,NC State,Wolfpack,7-0,5-1,1,24,0,41,7,14,10,7,10,0,0,0,7,2,24,14,24,34,0.8391990875992132,15.167917878257697,,
1193,2018,8,NCAAF_20181020_PSU@IND,Indiana,Hoosiers,Penn State,Nittany Lions,4-4,5-2,1,14,17,28,33,14,0,7,7,7,10,9,7,-1,-3,7,-3,-5,0.04510523318016357,-25.927731432665496,0.052283546028067174,-25.94140346237691
1194,2018,8,NCAAF_20181020_SMU@TULANE,Tulane,,SMU,,2-5,3-4,,9,7,23,27,2,7,7,7,0,7,7,13,-1,2,2,2,-4,0.4248174727121887,-2.9012112642077454,,
1195,2018,8,NCAAF_20181020_UTEP@LATECH,Louisiana Tech,,UTEP,,5-2,0-7,,17,7,31,24,14,3,7,7,7,0,14,3,5,10,7,10,7,0.9225271052088441,21.765136688616053,,
1196,2018,8,NCAAF_20181020_WAKE@FSU,Florida State,,Wake Forest,,4-3,3-4,,21,10,38,17,7,14,10,7,10,0,0,7,1,11,-3,11,21,0.5346072258862449,1.3291673036440557,0.5844256733333513,3.4079443461232586
1197,2018,8,NCAAF_20181020_CAL@OREGST,Oregon State,,California,,1-6,4-3,,0,21,7,49,0,0,7,0,7,14,7,21,-3,-21,-7,-21,-42,0.14009787291275688,-16.52542090170664,,
1198,2018,8,NCAAF_20181020_MEMP@MIZZOU,Missouri,Tigers,Memphis,Tigers,4-3,4-4,1,48,20,65,33,21,27,14,3,3,17,7,6,0,28,18,28,32,0.489000755263176,-0.4219733056750101,0.6092512332357312,4.433057924448121
1199,2018,8,NCAAF_20181020_GAS@NMEXST,New Mexico St.,,Ga. Southern,,2-6,6-1,,17,24,31,48,14,3,7,7,10,14,21,3,-4,-7,4,-7,-17,0.4115538757764009,-3.4209846408710405,,
1200,2018,8,NCAAF_20181020_MISSST@LSU,LSU,Tigers,Miss. State,Bulldogs,7-1,4-3,1,10,3,19,3,7,3,6,3,3,0,0,0,3,7,4,7,16,0.5073451440210286,0.2817681715324625,0.6361397501701781,5.564486637246318
1201,2018,8,NCAAF_20181020_TXSA@USM,So. Miss,,UTSA,,3-3,3-5,,20,3,27,17,6,14,7,0,0,3,7,7,0,17,6,17,10,0.600326477717413,3.889908941274257,,
1202,2018,8,NCAAF_20181020_TXSTSM@LAMON,UL-Monroe,,Texas St.,,4-4,1-6,,17,7,20,14,7,10,3,0,7,0,0,7,3,10,0,10,6,0.7504005919793453,10.341029453397994,,
1203,2018,8,NCAAF_20181020_UCF@ECU,East Carolina,Pirates,UCF,Knights,2-5,7-0,1,3,20,10,37,3,0,7,0,0,20,3,14,-5,-17,3,-17,-27,0.006478740959813933,-38.02702138179478,,
1204,2018,8,NCAAF_20181020_UCONN@SFLA,South Florida,Bulls,UConn,Huskies,7-0,1-6,1,7,7,38,30,0,7,17,14,7,0,7,16,6,0,-7,0,8,0.9607557307109182,26.92603171844371,,
1205,2018,8,NCAAF_20181020_FRESNO@NMEX,New Mexico,,Fresno St.,,3-4,6-1,,7,24,7,38,0,7,0,0,10,14,14,0,-3,-17,-10,-17,-31,0.10980454141853968,-18.78550160244049,0.06750609606073588,-23.887979691467535
1206,2018,8,NCAAF_20181020_NTEXAS@UAB,UAB,,North Texas,,6-1,6-2,,10,21,29,21,3,7,9,10,7,14,0,0,0,-11,-4,-11,8,0.40043686110626253,-3.8596741942481003,,
1207,2018,8,NCAAF_20181020_ODU@WKY,W. Kentucky,,Old Dominion,,1-6,2-6,,24,17,34,37,7,17,3,7,14,3,2,18,-1,7,-7,7,-3,0.5733555054956723,2.8298889803323277,,
1208,2018,8,NCAAF_20181020_OHIOST@PURDUE,Purdue,Boilermakers,Ohio State,Buckeyes,4-3,7-1,1,14,3,49,20,7,7,7,28,0,3,3,14,-3,11,7,11,29,0.10576374747311856,-19.119229538578907,0.12664459054333044,-18.258451386798015
1209,2018,8,NCAAF_20181020_OREG@WASHST,Washington St.,Cougars,Oregon,Ducks,6-1,5-2,1,27,0,34,20,7,20,0,7,0,0,17,3,1,27,7,27,14,0.5008316142129525,0.03189989818736194,,
1210,2018,8,NCAAF_20181020_RICE@FIU,FIU,,Rice,,5-2,1-7,,16,10,36,17,0,16,10,10,7,3,7,0,4,6,-7,6,19,0.9145641945312134,20.956086009460137,0.9523714245704545,26.663668619897408
1211,2018,8,NCAAF_20181020_VANDY@UK,Kentucky,Wildcats,Vanderbilt,Commodores,6-1,3-5,1,7,7,14,7,0,7,0,7,7,0,0,0,3,0,-7,0,7,0.6906538688533976,7.616383501566304,,
1212,2018,8,NCAAF_20181020_USC@UTAH,Utah,Utes,USC,Trojans,5-2,4-3,1,20,14,41,28,7,13,14,7,14,0,0,14,1,6,-7,6,13,0.4914968006676581,-0.3261987756727649,0.603040883713174,4.175066615438482
1213,2018,8,NCAAF_20181020_ARIZ@UCLA,UCLA,,Arizona,,2-5,3-5,,17,7,31,30,7,10,7,7,0,7,13,10,-1,10,7,10,1,0.5249920497175469,0.9592975105936148,0.6299246571475651,5.300685068352095
1214,2018,8,NCAAF_20181020_SJST@SDGST,San Diego St.,Aztecs,San Jose St.,Spartans,6-1,0-7,1,10,6,16,13,0,10,3,3,6,0,7,0,6,4,-6,4,3,0.988202370079229,34.64077816241331,,
1215,2018,8,NCAAF_20181019_COLOST@BOISE,Boise St.,Broncos,Colorado St.,Rams,5-2,3-5,1,35,7,56,28,21,14,7,14,0,7,7,14,2,28,21,28,28,0.8114542815904109,13.516669323566703,,
1216,2018,8,NCAAF_20181019_AF@UNLV,UNLV,Rebels,Air Force,Falcons,2-5,3-4,1,21,20,35,41,7,14,7,7,3,17,21,0,-1,1,4,1,-6,0.2662124189534566,-9.553809287241506,0.21590497899930083,-12.563881146021913
1217,2018,8,NCAAF_20181018_GAST@ARKST,Arkansas St.,Red Wolves,Georgia St.,Panthers,4-3,2-5,1,34,7,51,35,20,14,7,10,7,0,14,14,2,27,13,27,16,0.7231431295569134,9.06251536175796,0.7219376204231874,9.407465515905756
1218,2018,8,NCAAF_20181018_STNFRD@ARIZST,Arizona St.,Sun Devils,Stanford,Cardinal,0-4,5-2,1,3,6,13,20,3,0,3,7,0,6,14,0,-5,-3,3,-3,-7,0.3185151715047324,-7.220805351627803,,
1219,2018,9,NCAAF_20181027_ARMY@EMICH,E. Michigan,Eagles,Army,Black Knights,4-5,6-2,1,0,16,22,37,0,0,14,8,3,13,7,14,-2,-16,-3,-16,-15,0.34160570136535306,-6.254911876772269,,
1220,2018,9,NCAAF_20181027_BTHN@NEB,Nebraska,,Bethune-Cook.,,2-6,4-5,,38,3,45,9,28,10,0,7,3,0,0,6,-2,35,25,35,36,0.9263236035024228,22.208683477178,,
1221,2018,9,NCAAF_20181027_CLEM@FSU,Florida State,Seminoles,Clemson,Tigers,4-4,8-0,1,0,28,10,59,0,0,3,7,0,28,24,7,-4,-28,0,-28,-49,0.11136578224149196,-18.688747033381105,0.07166068416727933,-22.8136393068213
1222,2018,9,NCAAF_20181027_CMICH@AKRON,Akron,,C. Michigan,,4-3,1-8,,17,0,17,10,7,10,0,0,0,0,10,0,3,17,7,17,7,0.44614800874450644,-2.0753331423597956,,
1223,2018,9,NCAAF_20181027_MA@UCONN,UConn,,UMass,,1-7,3-6,,7,3,17,22,7,0,7,3,3,0,6,13,-2,4,4,4,-5,0.4048274242235256,-3.691950350185266,,
1224,2018,9,NCAAF_20181027_PURDUE@MICHST,Michigan St.,Spartans,Purdue,Boilermakers,5-3,4-4,1,13,6,23,13,6,7,3,7,3,3,7,0,1,7,3,7,10,0.41713817938246267,-3.2068181055012133,,
1225,2018,9,NCAAF_20181027_TXTECH@IOWAST,Iowa St.,Cyclones,Texas Tech,Red Raiders,4-3,5-3,1,14,17,40,31,0,14,17,9,10,7,7,7,-1,-3,-10,-3,9,0.5864459657376141,3.347706469120567,,
1226,2018,9,NCAAF_20181027_VANDY@ARK,Arkansas,Razorbacks,Vanderbilt,Commodores,2-7,4-5,1,14,21,31,45,7,7,3,14,7,14,3,21,-2,-7,0,-7,-14,0.42858411539286234,-2.758640574573178,0.41630127316597276,-3.294766729729986
1227,2018,9,NCAAF_20181027_WAKE@LVILLE,Louisville,,Wake Forest,,2-6,4-4,,21,35,35,56,7,14,14,0,21,14,21,0,-2,-14,-14,-14,-21,0.49543014625779747,-0.17557896559367236,,
1228,2018,9,NCAAF_20181027_WISC@NWEST,Northwestern,Wildcats,Wisconsin,Badgers,5-3,5-3,1,14,10,31,17,7,7,10,7,7,3,0,7,0,4,0,4,14,0.21105097467257972,-12.304593050993958,,
1229,2018,9,NCAAF_20181027_UNC@UVA,Virginia,,North Carolina,,6-2,1-6,,17,14,31,21,14,3,7,7,7,7,0,7,5,3,7,3,10,0.743099144708526,10.007764194348454,,
1230,2018,9,NCAAF_20181027_CSTCAR@GAST,Georgia St.,,C. Carolina,,2-6,5-3,,13,20,34,37,7,6,21,0,17,3,7,10,-3,-7,-10,-7,-3,0.569991526596128,2.70304079920885,0.4031924862473497,-3.82051104927541
1231,2018,9,NCAAF_20181027_USM@CHARLO,Charlotte,,So. Miss,,4-4,3-4,,14,0,20,17,14,0,3,3,0,0,3,14,1,14,14,14,3,0.1473214533532483,-16.063055812056916,,
1232,2018,9,NCAAF_20181027_TCU@KANSAS,Kansas,,TCU,,3-5,3-5,,7,10,27,26,7,0,10,10,0,10,7,9,0,-3,7,-3,1,0.022037252500104132,-30.86006509727872,0.06887784067431679,-23.135795954015066
1233,2018,9,NCAAF_20181027_ARIZST@USC,USC,,Arizona St.,,4-4,4-4,,14,24,35,38,7,7,14,7,14,10,7,7,0,-10,-7,-10,-3,0.6226562925039925,4.789295806860423,0.6638163812747958,6.592207700742506
1234,2018,9,NCAAF_20181027_DUKE@PITT,Pittsburgh,,Duke,,4-4,5-3,,17,21,54,45,7,10,18,19,7,14,21,3,-1,-4,0,-4,9,0.36036015288837375,-5.479517117894147,,
1235,2018,9,NCAAF_20181027_FLA@UGA,Georgia,Bulldogs,Florida,Gators,7-1,6-2,1,13,7,36,17,10,3,10,13,0,7,7,3,1,6,10,6,19,0.9009228152620753,19.723824746825073,0.8752588832525694,17.95132235792289
1236,2018,9,NCAAF_20181027_ILL@MD,Maryland,,Illinois,,5-3,3-5,,28,9,63,33,14,14,21,14,3,6,10,14,2,19,11,19,30,0.712156248590763,8.578713609195802,0.6562120805341825,6.26868795786163
1237,2018,9,NCAAF_20181027_IOWA@PSU,Penn State,Nittany Lions,Iowa,Hawkeyes,6-2,6-2,1,17,17,30,24,7,10,10,3,12,5,0,7,0,0,-5,0,6,0.7164994630442443,8.774579643039488,0.5327339878345693,1.280468367851995
1238,2018,9,NCAAF_20181027_KSTATE@OKLA,Oklahoma,Sooners,Kansas State,Wildcats,7-1,3-5,1,34,7,51,14,17,17,14,3,0,7,0,7,4,27,17,27,37,0.9085586525062033,20.41515337699775,,
1239,2018,9,NCAAF_20181027_MTSU@ODU,Old Dominion,,Middle Tenn.,,2-7,5-3,,10,31,17,51,7,3,7,0,17,14,14,6,-3,-21,-10,-21,-34,0.23703031179428113,-10.972756025789295,,
1240,2018,9,NCAAF_20181027_NILL@BYU,BYU,,N. Illinois,,4-4,5-3,,3,0,6,7,3,0,3,0,0,0,7,0,-1,3,3,3,-1,0.3172328589540716,-7.287462016641541,,
1241,2018,9,NCAAF_20181027_SFLA@HOU,Houston,Cougars,South Florida,Bulls,7-1,7-1,1,28,21,57,36,14,14,15,14,0,21,15,0,0,7,14,7,21,0.5003028540862162,0.011635744242880719,,
1242,2018,9,NCAAF_20181027_NMEX@UTAHST,Utah St.,,New Mexico,,7-1,3-5,,52,5,61,19,28,24,9,0,3,2,14,0,4,47,25,47,42,0.8497248305134133,15.867833722066507,,
1243,2018,9,NCAAF_20181027_RICE@NTEXAS,North Texas,,Rice,,7-2,1-8,,17,10,41,17,10,7,3,21,7,3,7,0,6,7,3,7,24,0.9269301295866932,22.27546710572915,0.9548494792947271,26.403225041854284
1244,2018,9,NCAAF_20181027_UK@MIZZOU,Missouri,Tigers,Kentucky,Wildcats,4-4,7-1,1,14,3,14,15,0,14,0,0,3,0,0,12,-3,11,-3,11,-1,0.6665285813140911,6.596143504203553,,
1245,2018,9,NCAAF_20181027_UNLV@SJST,San Jose St.,,UNLV,,1-7,2-6,,24,21,50,37,7,17,17,9,7,14,7,9,-1,3,0,3,13,0.18433449511375577,-13.77893447100928,,
1246,2018,9,NCAAF_20181027_WASH@CAL,California,Golden Bears,Washington,Huskies,5-3,6-3,1,6,7,12,10,3,3,6,0,7,0,0,3,-1,-1,-4,-1,2,0.08777195330475085,-20.762658354248742,,
1247,2018,9,NCAAF_20181027_ARKST@LALAF,Louisiana,,Arkansas St.,,4-4,4-4,,31,21,47,43,21,10,3,13,14,7,7,15,0,10,7,10,4,0.20717827037000835,-12.511072141543991,0.34563096784463676,-6.1906868472782435
1248,2018,9,NCAAF_20181027_BOISE@AF,Air Force,Falcons,Boise St.,Broncos,3-5,6-2,1,28,28,38,48,7,21,3,7,14,14,10,10,-3,0,-7,0,-10,0.1762749537197973,-14.249263323437162,0.1799704952564467,-14.270510255224508
1249,2018,9,NCAAF_20181027_NCST@CUSE,Syracuse,Orange,NC State,Wolfpack,6-2,5-2,1,27,20,51,41,24,3,14,10,7,13,7,14,1,7,17,7,10,0.3248117912145072,-6.963046908920546,,
1250,2018,9,NCAAF_20181027_NMEXST@TXSTSM,Texas St.,,New Mexico St.,,2-6,2-7,,20,13,27,20,13,7,7,0,0,13,7,0,0,7,13,7,7,0.27603016883589304,-9.114878197816608,0.47850786287429037,-0.8401785387753762
1251,2018,9,NCAAF_20181027_TULANE@TULSA,Tulsa,,Tulane,,1-7,3-5,,10,7,17,24,3,7,7,0,0,7,7,10,-2,3,3,3,-7,0.34087757187401113,-6.2853282663061805,,
1252,2018,9,NCAAF_20181027_TXAM@MISSST,Miss. State,Bulldogs,Texas A&M,Aggies,5-3,5-3,1,7,10,28,13,7,0,7,14,0,10,3,0,0,-3,7,-3,15,0.6365235424109059,5.352075231588572,,
1253,2018,9,NCAAF_20181027_WASHST@STNFRD,Stanford,Cardinal,Washington St.,Cougars,5-3,7-1,1,28,17,38,41,14,14,3,7,14,3,7,17,-2,11,0,11,-3,0.6014304533512871,3.9399501680258027,,
1254,2018,9,NCAAF_20181027_FIU@WKY,W. Kentucky,,FIU,,1-7,6-2,,3,14,17,38,0,3,0,14,7,7,14,10,-5,-11,-7,-11,-21,0.3002872265185288,-8.025079091915359,,
1255,2018,9,NCAAF_20181027_TENN@SC,South Carolina,Gamecocks,Tennessee,Volunteers,4-3,3-5,1,9,14,27,24,3,6,15,3,7,7,10,0,1,-5,-4,-5,3,0.7824464773386623,11.962826619380053,,
1256,2018,9,NCAAF_20181027_UAB@UTEP,UTEP,,UAB,,0-8,7-1,,0,10,0,19,0,0,0,0,10,0,2,7,-7,-10,-10,-10,-19,0.08589539321451523,-20.94457577636615,0.06020738844960527,-24.20878810819363
1257,2018,9,NCAAF_20181027_ND@NAVY,Navy,Midshipmen,Notre Dame,Fighting Irish,2-6,8-0,1,0,27,22,44,0,0,14,8,13,14,10,7,-6,-27,-13,-27,-22,0.10735957320675116,-19.016698369904475,0.2836743028064941,-8.915752264867933
1258,2018,9,NCAAF_20181027_TEXAS@OKLAST,Oklahoma State,Cowboys,Texas,Longhorns,5-3,6-2,1,31,14,38,35,17,14,0,7,7,7,7,14,-1,17,10,17,3,0.5198680564844389,0.7636523924554695,0.41627758907934,-3.295713058951833
1259,2018,9,NCAAF_20181027_HAWAII@FRESNO,Fresno St.,,Hawaii,,7-1,6-4,,37,13,50,20,14,23,10,3,3,10,0,7,1,24,11,24,30,0.963155136553602,27.41373481535811,0.91926229031675,21.825244009597668
1260,2018,9,NCAAF_20181027_OREG@ARIZ,Arizona,Wildcats,Oregon,Ducks,4-5,5-3,1,23,8,44,15,10,13,14,7,0,8,0,7,-1,15,10,15,29,0.3524661314524874,-5.804070629502462,,
1261,2018,9,NCAAF_20181027_SDGST@NEVADA,Nevada,,San Diego St.,,5-4,6-2,,15,24,28,24,9,6,10,3,14,10,0,0,-1,-9,-5,-9,4,0.17407871654338936,-14.379770407381045,,
1262,2018,9,NCAAF_20181026_LATECH@FAU,FAU,Owls,Louisiana Tech,Bulldogs,3-5,6-2,1,10,14,13,21,10,0,3,0,0,14,0,7,-3,-4,10,-4,-8,0.7968218263709237,12.726754699066305,0.7173168111559419,8.961398707810758
1263,2018,9,NCAAF_20181026_MIAMI@BC,Boston College,Eagles,Miami (Fla.),Hurricanes,6-2,5-3,1,17,14,27,14,14,3,10,0,7,7,0,0,1,3,7,3,13,0.36048658319168925,-5.47433940637643,,
1264,2018,9,NCAAF_20181026_IND@MINN,Minnesota,Golden Gophers,Indiana,Hoosiers,4-4,4-5,1,21,9,38,31,7,14,10,7,6,3,0,22,0,12,1,12,7,0.4110153304384643,-3.447670517823326,0.4184130250857352,-3.2104372312774103
1265,2018,9,NCAAF_20181026_WYO@COLOST,Colorado St.,Rams,Wyoming,Cowboys,3-6,3-6,1,0,3,21,34,0,0,7,14,0,3,21,10,0,-3,0,-3,-13,0.5272100219860589,1.0462289181087385,,
1266,2018,9,NCAAF_20181026_UTAH@UCLA,UCLA,Bruins,Utah,Utes,2-6,6-2,1,7,17,10,41,7,0,3,0,3,14,21,3,-4,-10,4,-10,-31,0.2890077597089554,-8.526458782719146,0.19600123799091151,-13.343239060778728
1267,2018,9,NCAAF_20181025_BALLST@OHIO,Ohio,Bobcats,Ball St.,Cardinals,5-3,3-6,1,31,7,52,14,0,31,21,0,7,0,0,7,2,24,-7,24,38,0.9325259479597219,22.9126055631981,,
1268,2018,9,NCAAF_20181025_BAYLOR@WVU,West Virginia,Mountaineers,Baylor,Bears,6-1,4-4,1,41,0,58,14,10,31,10,7,0,0,14,0,2,41,10,41,44,0.7797400831002477,11.822325698349061,,
1269,2018,9,NCAAF_20181025_TOLEDO@WMICH,W. Michigan,Broncos,Toledo,Rockets,6-3,4-4,1,17,23,24,51,7,10,7,0,14,9,21,7,2,-6,-7,-6,-27,0.37760411258400994,-4.778791565889037,0.32490616135649164,-7.07733246623161
1270,2018,9,NCAAF_20181025_APLST@GAS,Ga. Southern,Eagles,App. St.,Mountaineers,7-1,5-2,1,17,7,34,14,0,17,10,7,0,7,0,7,2,10,0,10,20,0.14577441270918,-16.16635285398172,,
1271,2018,9,NCAAF_20181025_GATECH@VATECH,Virginia Tech,Hokies,Georgia Tech,Yellow Jackets,4-3,4-4,1,21,28,28,49,14,7,0,7,14,14,14,7,0,-7,0,-7,-21,0.5966427814624772,3.7501254313592653,,
1272,2018,9,NCAAF_20181023_TROY@SALA,South Alabama,Jaguars,Troy,Trojans,2-6,6-2,1,17,31,17,38,7,10,0,0,16,15,0,7,-4,-14,-9,-14,-21,0.10773946056444528,-18.98522657712715,0.04125969877740909,-27.064774433138155
1273,2018,10,NCAAF_20181104_UTAHST@HAWAII,Hawaii,,Utah St.,,6-5,8-1,,3,28,17,56,3,0,14,0,28,0,28,0,-2,-25,-25,-25,-39,0.05834983906280078,-24.130211524161552,,
1274,2018,10,NCAAF_20181103_AF@ARMY,Army,Black Knights,Air Force,Falcons,7-2,3-6,1,14,0,17,14,7,7,0,3,0,0,6,8,4,14,7,14,3,0.7264119935018897,9.259639933932533,,
1275,2018,10,NCAAF_20181103_CMICH@EMICH,E. Michigan,,C. Michigan,,5-5,1-9,,7,7,17,7,7,0,0,10,0,7,0,0,4,0,7,0,10,0.6311617102390138,5.151763817556969,,
1276,2018,10,NCAAF_20181103_CUSE@WAKE,Wake Forest,Demon Deacons,Syracuse,Orange,4-5,7-2,1,10,21,24,41,10,0,14,0,14,7,14,6,-3,-11,-4,-11,-17,0.5474271634331426,1.832920304702668,,
1277,2018,10,NCAAF_20181103_IOWAST@KANSAS,Kansas,,Iowa St.,,3-6,5-3,,3,20,3,27,0,3,0,0,14,6,7,0,-2,-17,-14,-17,-24,0.03448940671733991,-27.972218879788272,0.10469645765764235,-19.35685081329939
1278,2018,10,NCAAF_20181103_LVILLE@CLEM,Clemson,Tigers,Louisville,Cardinals,9-0,2-7,1,35,3,77,16,14,21,28,14,3,0,6,7,7,32,11,32,61,0.9490697548680619,25.1626529832634,,
1279,2018,10,NCAAF_20181103_MEMP@ECU,East Carolina,,Memphis,,2-6,5-4,,17,24,41,59,14,3,17,7,10,14,14,21,-3,-7,4,-7,-18,0.06548636313779854,-23.230378452874106,,
1280,2018,10,NCAAF_20181103_MICHST@MD,Maryland,,Michigan St.,,5-4,6-3,,3,10,3,24,0,3,0,0,10,0,7,7,-1,-7,-10,-7,-21,0.23487246539379547,-11.119220391390968,0.23079883419686975,-11.35313838146135
1281,2018,10,NCAAF_20181103_NEB@OHIOST,Ohio State,Buckeyes,Nebraska,Cornhuskers,8-1,2-7,1,16,21,36,31,16,0,14,6,7,14,0,10,6,-5,9,-5,5,0.9742736759973281,29.958384736725975,,
1282,2018,10,NCAAF_20181103_OKLAST@BAYLOR,Baylor,,Oklahoma State,,5-4,5-4,,14,10,35,31,0,14,7,14,7,3,14,7,0,4,-7,4,4,0.09229276817304188,-20.407722148897278,0.21866917197814484,-11.977330190895373
1283,2018,10,NCAAF_20181103_RUT@WISC,Wisconsin,,Rutgers,,6-3,1-8,,10,0,31,17,7,3,14,7,0,0,3,14,5,10,7,10,14,0.9836409889115526,32.847673869319124,0.9944983130049642,39.20899913948165
1284,2018,10,NCAAF_20181103_SC@MISS,Ole Miss,Rebels,South Carolina,Gamecocks,5-4,5-3,1,27,27,44,48,3,24,10,7,17,10,7,14,0,0,-14,0,-4,0.31488658066094644,-7.414609117132329,,
1285,2018,10,NCAAF_20181103_TXAM@AUBURN,Auburn,Tigers,Texas A&M,Aggies,6-3,5-4,1,14,17,28,24,7,7,0,14,3,14,7,0,1,-3,4,-3,4,0.7807668845777067,11.91739415260406,,
1286,2018,10,NCAAF_20181103_GATECH@UNC,North Carolina,,Georgia Tech,,1-7,5-4,,10,21,28,38,7,3,10,8,7,14,7,10,-4,-11,0,-11,-10,0.13458379873537152,-16.99631043897506,,
1287,2018,10,NCAAF_20181103_SJST@WYO,Wyoming,,San Jose St.,,4-6,1-8,,10,0,24,9,3,7,7,7,0,0,3,6,3,10,3,10,15,0.9048964196240189,20.14929419765059,,
1288,2018,10,NCAAF_20181103_TXSTSM@GAST,Georgia St.,,Texas St.,,2-7,3-6,,10,13,31,40,7,3,0,21,13,0,20,7,-1,-3,-6,-3,-9,0.7431284115751027,10.044454087493932,0.7256135118919173,9.246356288717152
1289,2018,10,NCAAF_20181103_GAS@LAMON,UL-Monroe,,Ga. Southern,,5-4,7-2,,27,10,44,25,13,14,14,3,0,10,8,7,-2,17,13,17,19,0.3436989193689063,-6.189358397037381,0.1653376361701968,-15.000731636788714
1290,2018,10,NCAAF_20181103_MRSHL@USM,So. Miss,,Marshall,,4-4,5-3,,17,10,26,24,3,14,3,6,3,7,7,7,-1,7,0,7,2,0.311331212103777,-7.568953057051033,,
1291,2018,10,NCAAF_20181103_SALA@ARKST,Arkansas St.,,South Alabama,,5-4,2-7,,14,7,38,14,0,14,14,10,0,7,0,7,3,7,0,7,24,0.8074385263344933,13.358798050156679,0.8057905861038883,13.300329185085047
1292,2018,10,NCAAF_20181103_FSU@NCST,NC State,,Florida State,,6-2,4-5,,27,14,47,28,10,17,10,10,0,14,7,7,2,13,10,13,19,0.5641680987147444,2.484817071108978,,
1293,2018,10,NCAAF_20181103_IOWA@PURDUE,Purdue,Boilermakers,Iowa,Hawkeyes,5-4,6-3,1,21,17,38,36,14,7,14,3,7,10,6,13,-1,4,7,4,2,0.33916460858738495,-6.379400929939436,0.38030202092351095,-4.698551795386038
1294,2018,10,NCAAF_20181103_KSTATE@TCU,TCU,,Kansas State,,4-5,3-6,,7,7,14,13,7,0,7,0,7,0,0,6,1,0,0,0,1,0.7534785422942469,10.543688878769103,,
1295,2018,10,NCAAF_20181103_LALAF@TROY,Troy,,Louisiana,,7-2,4-5,,23,3,26,16,10,13,3,0,3,0,13,0,3,20,7,20,10,0.8603340101573547,16.64006939098988,0.8356030030141087,15.059197139893286
1296,2018,10,NCAAF_20181103_MINN@ILL,Illinois,,Minnesota,,4-5,4-5,,24,17,55,31,14,10,21,10,7,10,0,14,0,7,7,7,24,0.2013251740564077,-12.872762638917038,0.20878907980046202,-12.500628085753306
1297,2018,10,NCAAF_20181103_NAVY@CINCY,Cincinnati,,Navy,,8-1,2-7,,28,0,42,0,7,21,7,7,0,0,0,0,6,28,7,28,42,0.3407699825626678,-6.312006406801515,,
1298,2018,10,NCAAF_20181103_TULANE@SFLA,South Florida,Bulls,Tulane,Green Wave,7-2,4-5,1,3,27,15,41,3,0,6,6,7,20,7,7,3,-24,-4,-24,-26,0.6832464126813733,7.333858477418005,,
1299,2018,10,NCAAF_20181103_UGA@UK,Kentucky,Wildcats,Georgia,Bulldogs,7-2,8-1,1,3,14,17,34,0,3,7,7,7,7,14,6,-1,-11,-7,-11,-17,0.07127030552499913,-22.555409539084962,,
1300,2018,10,NCAAF_20181103_UTEP@RICE,Rice,,UTEP,,1-9,1-8,,3,27,26,34,0,3,7,16,7,20,7,0,0,-24,-7,-24,-8,0.5233277759393156,0.8999339321759408,0.43024479288393713,-2.710234595855809
1301,2018,10,NCAAF_20181103_WVU@TEXAS,Texas,Longhorns,West Virginia,Mountaineers,6-3,7-1,1,28,27,41,42,14,14,3,10,10,17,0,15,-1,1,4,1,-1,0.6080068420231717,4.216507880672509,,
1302,2018,10,NCAAF_20181103_BC@VATECH,Virginia Tech,Hokies,Boston College,Eagles,4-4,7-2,1,14,7,21,31,7,7,0,7,7,0,14,10,-3,7,0,7,-10,0.5222928488014122,0.8599661410632393,,
1303,2018,10,NCAAF_20181103_PSU@MICH,Michigan,Wolverines,Penn State,Nittany Lions,8-1,6-3,1,14,0,42,7,7,7,14,14,0,0,0,7,2,14,7,14,35,0.32291441735817894,-7.068807059852304,0.5685770245387964,2.6639959383667247
1304,2018,10,NCAAF_20181103_ALCORN@NMEXST,New Mexico St.,,Alcorn St.,,3-7,7-3,,35,14,52,42,14,21,3,14,7,7,7,21,-4,21,7,21,10,0.35264088709554375,-5.817301240376935,,
1305,2018,10,NCAAF_20181103_CHARLO@TENN,Tennessee,,Charlotte,,4-5,4-5,,14,3,14,3,14,0,0,0,0,3,0,0,0,11,14,11,11,0.9261871436748838,22.271984374610156,0.8993623915786135,19.706755936906347
1306,2018,10,NCAAF_20181103_MIZZOU@FLA,Florida,Gators,Missouri,Tigers,6-3,5-4,1,10,21,17,38,3,7,7,0,7,14,14,3,1,-11,-4,-11,-21,0.42374222704474496,-2.958315965182976,0.31523990661349743,-7.418238971195933
1307,2018,10,NCAAF_20181103_UTAH@ARIZST,Arizona St.,Sun Devils,Utah,Utes,5-4,6-3,1,21,17,38,20,14,7,0,17,7,10,3,0,-1,4,7,4,18,0.3287791207086187,-6.818432137517789,0.1826417177976165,-13.961192975922586
1308,2018,10,NCAAF_20181103_APLST@CSTCAR,C. Carolina,,App. St.,,5-4,6-2,,7,14,7,23,7,0,0,0,7,7,0,9,-1,-7,0,-7,-16,0.10376594316936383,-19.386595617643025,,
1309,2018,10,NCAAF_20181103_DUKE@MIAMI,Miami (Fla.),Hurricanes,Duke,Blue Devils,5-4,6-3,1,12,7,12,20,0,12,0,0,7,0,10,3,-1,5,-7,5,-8,0.694694332220348,7.83229247689701,,
1310,2018,10,NCAAF_20181103_HOU@SMU,SMU,Mustangs,Houston,Cougars,4-5,7-2,1,31,14,45,31,10,21,7,7,0,14,3,14,-3,17,10,17,14,0.3242192001044766,-7.012943623255694,,
1311,2018,10,NCAAF_20181103_UCONN@TULSA,Tulsa,Golden Hurricane,UConn,Huskies,2-7,1-8,1,28,13,49,19,0,28,21,0,10,3,0,6,1,15,-10,15,30,0.7425985211685776,10.019181941303827,,
1312,2018,10,NCAAF_20181103_ND@NWEST,Northwestern,Wildcats,Notre Dame,Fighting Irish,5-4,9-0,1,7,7,21,31,0,7,0,14,7,0,14,10,-4,0,-7,0,-10,0.3127375129908673,-7.507813131798855,,
1313,2018,10,NCAAF_20181103_FAU@FIU,FIU,,FAU,,6-3,4-5,,7,14,14,49,0,7,7,0,7,7,7,28,2,-7,-7,-7,-35,0.2715459691792623,-9.354188197525787,0.3617153206848843,-5.457103237159799
1314,2018,10,NCAAF_20181103_LATECH@MISSST,Miss. State,Bulldogs,Louisiana Tech,Bulldogs,6-3,6-3,1,31,3,45,3,21,10,7,7,3,0,0,0,0,28,18,28,42,0.9381432895400699,23.67790760313693,0.8743191128145095,17.688489181958175
1315,2018,10,NCAAF_20181103_TXSA@UAB,UAB,,UTSA,,8-1,3-6,,38,3,52,3,21,17,7,7,3,0,0,0,5,35,18,35,49,0.6464772488076639,5.780795893165816,0.8084030518331129,13.447416165834511
1316,2018,10,NCAAF_20181103_UCLA@OREG,Oregon,,UCLA,,6-3,2-7,,21,7,42,21,14,7,7,14,0,7,7,7,4,14,14,14,21,0.6061173526213992,4.140918463941659,,
1317,2018,10,NCAAF_20181103_BAMA@LSU,LSU,Tigers,Alabama,Crimson Tide,7-2,9-0,1,0,16,0,29,0,0,0,0,6,10,6,7,-2,-16,-6,-16,-29,0.13979458731268746,-16.63117079289907,0.2653050424263854,-9.670047673906538
1318,2018,10,NCAAF_20181103_OKLA@TXTECH,Texas Tech,Red Raiders,Oklahoma,Sooners,5-4,8-1,1,31,28,46,51,14,17,0,15,7,21,7,16,-3,3,7,3,-5,0.16881057982556213,-14.748985226406376,,
1319,2018,10,NCAAF_20181103_STNFRD@WASH,Washington,Huskies,Stanford,Cardinal,7-3,5-4,1,21,0,27,23,14,7,3,3,0,0,14,9,2,21,14,21,4,0.6810089577002957,7.237350753730993,0.7323186970045422,9.558490169332572
1320,2018,10,NCAAF_20181103_USC@OREGST,Oregon State,,USC,,2-7,5-4,,14,21,21,38,0,14,7,0,7,14,7,10,-3,-7,-7,-7,-17,0.028584576921726113,-29.255912459712704,,
1321,2018,10,NCAAF_20181103_BYU@BOISE,Boise St.,,BYU,,7-2,4-5,,14,6,21,16,14,0,7,0,0,6,7,3,3,8,14,8,5,0.8571523807777781,16.421521178912144,0.8193957736266628,14.080262411943977
1322,2018,10,NCAAF_20181103_SDGST@NMEX,New Mexico,,San Diego St.,,3-6,7-2,,10,7,23,31,7,3,6,7,7,0,7,17,-4,3,0,3,-8,0.12392306004909304,-17.774851002021308,,
1323,2018,10,NCAAF_20181103_FRESNO@UNLV,UNLV,Rebels,Fresno St.,Bulldogs,2-7,8-1,1,0,17,3,48,0,0,0,3,7,10,17,14,-6,-17,-7,-17,-45,0.07393053292909757,-22.259048693150362,0.03815839103369911,-27.333026438766865
1324,2018,10,NCAAF_20181103_CAL@WASHST,Washington St.,Cougars,California,Golden Bears,8-1,5-4,1,13,10,19,13,3,10,0,6,0,10,3,0,3,3,3,3,6,0.7066456834808803,8.361583319877639,,
1325,2018,10,NCAAF_20181102_PITT@UVA,Virginia,Cavaliers,Pittsburgh,Panthers,6-3,5-4,1,10,7,13,23,7,3,0,3,7,0,7,9,1,3,0,3,-10,0.5294574003412373,1.1367872855321934,,
1326,2018,10,NCAAF_20181102_WKY@MTSU,Middle Tenn.,Blue Raiders,W. Kentucky,Hilltoppers,6-3,1-8,1,20,3,29,10,10,10,3,6,3,0,7,0,5,17,7,17,19,0.7583084414880465,10.78048091951382,,
1327,2018,10,NCAAF_20181102_COLO@ARIZ,Arizona,,Colorado,,5-5,5-4,,26,24,42,34,0,26,9,7,10,14,10,0,0,2,-10,2,8,0.5442689469350754,1.7103420789516122,,
1328,2018,10,NCAAF_20181101_NILL@AKRON,Akron,,N. Illinois,,4-4,6-3,,10,24,26,36,7,3,16,0,7,17,5,7,-2,-14,0,-14,-10,0.2959232044573654,-8.24699797075084,,
1329,2018,10,NCAAF_20181101_OHIO@WMICH,W. Michigan,,Ohio,,6-4,6-3,,0,45,14,59,0,0,7,7,21,24,7,7,0,-45,-21,-45,-45,0.3793984439455932,-4.723070208119509,0.2792436535703622,-9.022599913784461
1330,2018,10,NCAAF_20181101_TEMPLE@UCF,UCF,Knights,Temple,Owls,8-0,5-4,1,28,34,52,40,14,14,14,10,17,17,0,6,3,-6,-3,-6,12,0.9052848428025888,20.184667567658607,,
1331,2018,10,NCAAF_20181031_BALLST@TOLEDO,Toledo,Rockets,Ball St.,Cardinals,5-4,3-7,1,28,7,45,13,21,7,3,14,0,7,0,6,2,21,21,21,32,0.9619472685407496,27.28290696890292,0.9315075741023591,22.932597013840905
1332,2018,10,NCAAF_20181030_KENTST@BGREEN,Bowling Green,,Kent St.,,1-8,2-7,,13,14,28,35,3,10,0,15,7,7,7,14,-1,-1,-4,-1,-7,0.6659622926794578,6.595461399820351,,
1333,2018,10,NCAAF_20181030_MIAOH@BUFF,Buffalo,,Miami-OH,,8-1,3-6,,28,21,51,42,14,14,14,9,14,7,21,0,5,7,0,7,9,0.6606906562170091,6.373319856951639,,
1334,2018,11,NCAAF_20181110_AKRON@EMICH,E. Michigan,,Akron,,6-5,4-5,,10,7,27,7,7,3,0,17,0,7,0,0,2,3,7,3,20,0.6649292553675887,6.607870005462644,,
1335,2018,11,NCAAF_20181110_BYU@MA,UMass,,BYU,,4-7,5-5,,10,14,16,35,10,0,0,6,7,7,14,7,-1,-4,3,-4,-19,0.30057222924810745,-8.109564208483846,,
1336,2018,11,NCAAF_20181110_ILL@NEB,Nebraska,,Illinois,,3-7,4-6,,38,21,54,35,21,17,7,9,14,7,0,14,-1,17,7,17,19,0.6989909640883243,8.090098225054277,0.717810946395212,9.058700928260805
1337,2018,11,NCAAF_20181110_KANSAS@KSTATE,Kansas State,Wildcats,Kansas,Jayhawks,4-6,3-7,1,0,3,21,17,0,0,14,7,0,3,7,7,1,-3,0,-3,4,0.8675279340022364,17.293729279497654,0.7649753400786006,11.354187406420806
1338,2018,11,NCAAF_20181110_LAF@ARMY,Army,Black Knights,Lafayette,Leopards,8-2,3-7,1,17,6,31,13,3,14,14,0,3,3,0,7,5,11,0,11,18,,,,
1339,2018,11,NCAAF_20181110_MD@IND,Indiana,,Maryland,,5-5,5-5,,21,15,34,32,0,21,10,3,6,9,8,9,0,6,-6,6,2,0.6011731490419725,3.977326874458896,0.5659237847111693,2.6091686442073296
1340,2018,11,NCAAF_20181110_MISS@TXAM,Texas A&M,Aggies,Ole Miss,Rebels,6-4,5-5,1,14,14,38,24,7,7,7,17,0,14,7,3,1,0,7,0,14,0.7023405175461594,8.239697715231557,,
1341,2018,11,NCAAF_20181110_NAVY@UCF,UCF,Knights,Navy,Midshipmen,9-0,2-8,1,21,3,35,24,14,7,7,7,0,3,7,14,7,18,14,18,11,0.91785659721206,21.575600968023934,,
1342,2018,11,NCAAF_20181110_OHIOST@MICHST,Michigan St.,Spartans,Ohio State,Buckeyes,6-4,9-1,1,3,7,6,26,0,3,3,0,0,7,2,17,-3,-4,0,-4,-20,0.1746708810651787,-14.518207982011205,0.17444826507555034,-14.722931970616173
1343,2018,11,NCAAF_20181110_SC@FLA,Florida,Gators,South Carolina,Gamecocks,7-3,5-4,1,14,21,35,31,0,14,7,14,14,7,10,0,2,-7,-14,-7,4,0.48747516845158523,-0.4871157293902968,,
1344,2018,11,NCAAF_20181110_SMU@UCONN,UConn,,SMU,,1-9,5-5,,10,31,50,62,7,3,14,26,17,14,14,17,-4,-21,-10,-21,-12,0.08624520311735795,-21.163690320926975,,
1345,2018,11,NCAAF_20181110_TCU@WVU,West Virginia,Mountaineers,TCU,Horned Frogs,8-1,4-6,1,24,3,47,10,0,24,16,7,3,0,7,0,4,21,-3,21,37,0.38361960482446433,-4.591696097597293,,
1346,2018,11,NCAAF_20181110_TULSA@MEMP,Memphis,,Tulsa,,6-4,2-8,,27,0,47,21,17,10,7,13,0,0,14,7,4,27,17,27,26,0.8450414020143628,15.751949991863228,,
1347,2018,11,NCAAF_20181110_VANDY@MIZZOU,Missouri,,Vanderbilt,,6-4,4-6,,13,21,33,28,7,6,13,7,14,7,7,0,2,-8,-7,-8,5,0.8171920901088088,14.034963022950706,0.8514557389999119,16.388427146809818
1348,2018,11,NCAAF_20181110_WISC@PSU,Penn State,Nittany Lions,Wisconsin,Badgers,7-3,6-4,1,16,7,22,10,10,6,3,3,7,0,3,0,1,9,3,9,12,0.6603332652188861,6.412699702940387,0.6251887676256278,5.015987991033171
1349,2018,11,NCAAF_20181110_UNC@DUKE,Duke,,North Carolina,,7-3,1-8,,35,28,42,35,14,21,7,0,14,14,0,7,6,7,0,7,7,0.8027881367788195,13.211314086442428,,
1350,2018,11,NCAAF_20181110_TROY@GAS,Ga. Southern,,Troy,,7-3,8-2,,14,17,21,35,14,0,0,7,3,14,11,7,-1,-3,11,-3,-14,0.23536509355463575,-11.189476691595445,0.4128794518023393,-3.460080126407547
1351,2018,11,NCAAF_20181110_UCLA@ARIZST,Arizona St.,,UCLA,,6-4,2-8,,17,14,31,28,3,14,7,7,7,7,7,7,4,3,-4,3,3,0.6455205003667874,5.790340120208242,0.6363818135648744,5.482272761197464
1352,2018,11,NCAAF_20181110_CHARLO@MRSHL,Marshall,,Charlotte,,6-3,4-6,,13,10,30,13,10,3,17,0,7,3,3,0,2,3,3,3,17,0.9126927270815197,21.059434656481784,,
1353,2018,11,NCAAF_20181110_BGREEN@CMICH,C. Michigan,,Bowling Green,,1-10,2-8,,13,0,13,24,7,6,0,0,0,0,17,7,-1,13,7,13,-11,0.7484247521693628,10.386663908243918,0.7727381529636917,11.754914501623261
1354,2018,11,NCAAF_20181110_LIB@UVA,Virginia,Cavaliers,Liberty,Flames,7-3,4-5,1,24,17,45,24,14,10,14,7,7,10,7,0,3,7,7,7,21,0.89074706244055,19.08905382294114,,
1355,2018,11,NCAAF_20181110_MTSU@UTEP,UTEP,,Middle Tenn.,,1-9,7-3,,10,27,32,48,0,10,0,22,14,13,7,14,-6,-17,-14,-17,-16,0.0669709970693374,-23.250069641183728,,
1356,2018,11,NCAAF_20181110_BAYLOR@IOWAST,Iowa St.,Cyclones,Baylor,Bears,6-3,5-5,1,17,0,28,14,7,10,11,0,0,0,7,7,1,17,7,17,14,0.8929294841661699,19.27130395995647,0.7992916998886241,13.18832433081775
1357,2018,11,NCAAF_20181110_MICH@RUT,Rutgers,Scarlet Knights,Michigan,Wolverines,1-9,9-1,1,7,21,7,42,7,0,0,0,7,14,14,7,-8,-14,0,-14,-35,0.012686345970813417,-34.68236842743309,0.0014304946738030733,-46.87369702697697
1358,2018,11,NCAAF_20181110_MISSST@BAMA,Alabama,Crimson Tide,Miss. State,Bulldogs,10-0,6-4,1,21,0,24,0,14,7,0,3,0,0,0,0,4,21,14,21,24,0.8787363299610721,18.13006699325757,0.8764687867437158,18.193040522128967
1359,2018,11,NCAAF_20181110_NMEX@AF,Air Force,Falcons,New Mexico,Lobos,4-6,3-7,1,21,17,42,24,7,14,14,7,0,17,7,0,1,4,7,4,18,0.7335262413913369,9.672626484551586,0.8115215593267258,13.886540257781462
1360,2018,11,NCAAF_20181110_NTEXAS@ODU,Old Dominion,,North Texas,,3-7,7-3,,10,28,34,31,0,10,14,10,14,14,3,0,-4,-18,-14,-18,3,0.18495052133391265,-13.909968612697725,0.11045483106655829,-19.23979728582026
1361,2018,11,NCAAF_20181110_NWEST@IOWA,Iowa,Hawkeyes,Northwestern,Wildcats,6-4,6-4,1,3,0,10,14,0,3,7,0,0,0,7,7,0,3,0,3,-4,0.6931897302849559,7.832759380127328,,
1362,2018,11,NCAAF_20181110_OKLAST@OKLA,Oklahoma,Sooners,Oklahoma State,Cowboys,9-1,5-5,1,34,28,48,47,14,20,7,7,14,14,7,12,4,6,0,6,1,0.7790792569321181,11.930938410647371,0.8970907376107145,19.884750017080933
1363,2018,11,NCAAF_20181110_PURDUE@MINN,Minnesota,,Purdue,,5-5,5-5,,13,3,41,10,3,10,21,7,3,0,0,7,0,10,0,10,31,0.19391449449589282,-13.396522621904836,0.08159354191978774,-21.916766889860355
1364,2018,11,NCAAF_20181110_UK@TENN,Tennessee,Volunteers,Kentucky,Wildcats,5-5,7-3,1,17,0,24,7,3,14,7,0,0,0,7,0,-2,17,3,17,17,0.2730096563540936,-9.365821746177744,,
1365,2018,11,NCAAF_20181110_VATECH@PITT,Pittsburgh,,Virginia Tech,,6-4,4-5,,31,7,52,22,10,21,7,14,0,7,8,7,2,24,10,24,30,0.2974665836768219,-8.248336305866985,,
1366,2018,11,NCAAF_20181110_WASHST@COLO,Colorado,Buffaloes,Washington St.,Cougars,5-5,9-1,1,7,10,7,31,7,0,0,0,0,10,7,14,-4,-3,7,-3,-24,0.3103983546562724,-7.674670957406647,,
1367,2018,11,NCAAF_20181110_APLST@TXSTSM,Texas St.,,App. St.,,3-7,7-2,,0,21,7,38,0,0,7,0,7,14,7,10,-4,-21,-7,-21,-31,0.0447580300014897,-26.340584277468736,,
1368,2018,11,NCAAF_20181110_ECU@TULANE,Tulane,,East Carolina,,5-5,2-7,,14,10,24,18,7,7,7,3,3,7,0,8,3,4,4,4,6,0.8280559462260372,14.68332950741518,,
1369,2018,11,NCAAF_20181110_SJST@UTAHST,Utah St.,,San Jose St.,,9-1,1-9,,38,10,62,24,10,28,21,3,7,3,7,7,8,28,3,28,38,0.9753767423733233,30.505780025018396,,
1370,2018,11,NCAAF_20181110_ARKST@CSTCAR,C. Carolina,,Arkansas St.,,5-5,6-4,,6,27,16,44,0,6,7,3,14,13,14,3,-1,-21,-14,-21,-28,0.22287871435318163,-11.828858442933097,0.46567616200262796,-1.353947044187862
1371,2018,11,NCAAF_20181110_GAST@LALAF,Louisiana,,Georgia St.,,5-5,2-8,,13,7,36,22,7,6,3,20,0,7,7,8,3,6,7,6,14,0.5087047201786052,0.33851520235626253,0.7048886377574288,8.463996456019686
1372,2018,11,NCAAF_20181110_LAMON@SALA,South Alabama,,UL-Monroe,,2-8,6-4,,10,24,10,38,7,3,0,0,10,14,14,0,-4,-14,-3,-14,-28,0.3870720554035385,-4.451619423031104,0.2830060506754346,-9.020724031212922
1373,2018,11,NCAAF_20181110_WKY@FAU,FAU,,W. Kentucky,,5-5,1-9,,10,9,34,15,10,0,7,17,0,9,0,6,4,1,10,1,19,0.9061849709840479,20.440426687847236,,
1374,2018,11,NCAAF_20181110_OREG@UTAH,Utah,Utes,Oregon,Ducks,7-3,6-4,1,19,7,32,25,10,9,3,10,0,7,10,8,1,12,10,12,7,0.6070321165713117,4.213237143650247,,
1375,2018,11,NCAAF_20181110_AUBURN@UGA,Georgia,Bulldogs,Auburn,Tigers,9-1,6-4,1,20,10,27,10,3,17,0,7,7,3,0,0,3,10,-4,10,17,0.6815143148054409,7.321220539036318,0.7573545512764024,10.967845604073318
1376,2018,11,NCAAF_20181110_FIU@TXSA,UTSA,,FIU,,3-7,7-3,,0,17,7,45,0,0,0,7,0,17,7,21,-4,-17,0,-17,-38,0.32265461247144067,-7.140506109475837,0.23499211232587114,-11.35585206419887
1377,2018,11,NCAAF_20181110_MIAMI@GATECH,Georgia Tech,,Miami (Fla.),,6-4,5-5,,17,14,27,21,14,3,10,0,7,7,0,7,1,3,7,3,6,0.4170644386666288,-3.2485873265253247,0.34275727459829863,-6.364730591356647
1378,2018,11,NCAAF_20181110_RICE@LATECH,Louisiana Tech,,Rice,,7-3,1-10,,7,3,28,13,0,7,14,7,0,3,7,3,6,4,0,4,15,0.9010387351628244,19.973023755605,0.9138925985687485,21.456081389770816
1379,2018,11,NCAAF_20181110_SFLA@CINCY,Cincinnati,,South Florida,,9-1,7-3,,14,16,35,23,7,7,21,0,9,7,7,0,2,-2,-2,-2,12,0.36201438905653216,-5.477363574158716,,
1380,2018,11,NCAAF_20181110_TEMPLE@HOU,Houston,Cougars,Temple,Owls,7-3,6-4,1,14,28,49,59,7,7,21,14,14,14,21,10,1,-14,-7,-14,-10,0.6250694202478226,4.945928649521591,,
1381,2018,11,NCAAF_20181110_FSU@ND,Notre Dame,Fighting Irish,Florida State,Seminoles,10-0,4-6,1,32,6,42,13,17,15,3,7,0,6,7,0,6,26,17,26,29,0.7787051803308409,11.911395883548266,0.5010548880352148,0.04156002924878521
1382,2018,11,NCAAF_20181110_LSU@ARK,Arkansas,Razorbacks,LSU,Tigers,2-8,8-2,1,3,14,17,24,0,3,0,14,7,7,10,0,-6,-11,-7,-11,-7,0.07895215014829682,-21.906921869212397,0.053639396324350774,-25.31349263678908
1383,2018,11,NCAAF_20181110_TEXAS@TXTECH,Texas Tech,Red Raiders,Texas,Longhorns,5-5,7-3,1,10,17,34,41,7,3,0,24,0,17,10,14,-2,-7,7,-7,-7,0.45306560568787113,-1.8293030793743696,0.4969411356043033,-0.12051287625831719
1384,2018,11,NCAAF_20181110_CLEM@BC,Boston College,Eagles,Clemson,Tigers,7-3,10-0,1,7,13,7,27,7,0,0,0,10,3,7,7,-3,-6,-3,-6,-20,0.0959988330431023,-20.239838430720795,0.04569506855219829,-26.53259640887177
1385,2018,11,NCAAF_20181110_OREGST@STNFRD,Stanford,Cardinal,Oregon State,Beavers,6-4,2-8,1,34,17,48,17,13,21,7,7,7,10,0,0,4,17,6,17,31,0.9764436642798248,30.797965073568207,,
1386,2018,11,NCAAF_20181110_CAL@USC,USC,,California,,5-5,6-4,,14,0,14,15,0,14,0,0,0,0,15,0,-1,14,0,14,-1,0.6972156836208616,8.011114601925215,,
1387,2018,11,NCAAF_20181110_COLOST@NEVADA,Nevada,,Colorado St.,,6-4,3-7,,28,0,49,10,7,21,21,0,0,0,0,10,3,28,7,28,39,0.41508574703910384,-3.327277752206072,,
1388,2018,11,NCAAF_20181110_UNLV@SDGST,San Diego St.,,UNLV,,7-3,3-7,,14,13,24,27,0,14,10,0,6,7,0,14,4,1,-6,1,-3,0.8825355293712669,18.425817467645373,,
1389,2018,11,NCAAF_20181109_LVILLE@CUSE,Syracuse,Orange,Louisville,Cardinals,8-2,2-8,1,37,7,54,23,7,30,7,10,0,7,7,9,6,30,7,30,31,0.5873552232611607,3.4244708186648722,,
1390,2018,11,NCAAF_20181109_FRESNO@BOISE,Boise St.,Broncos,Fresno St.,Bulldogs,8-2,8-2,1,3,10,24,17,3,0,7,14,0,10,7,0,0,-7,3,-7,7,0.5159986803093698,0.6222852616071464,0.43094858238511224,-2.734183071395819
1391,2018,11,NCAAF_20181108_WAKE@NCST,NC State,Wolfpack,Wake Forest,Demon Deacons,6-3,5-5,1,13,3,23,27,6,7,3,7,0,3,10,14,1,10,6,10,-4,0.6307016655395523,5.176916667704177,,
1392,2018,11,NCAAF_20181107_OHIO@MIAOH,Miami-OH,RedHawks,Ohio,Bobcats,4-6,6-4,1,28,7,30,28,7,21,0,2,7,0,7,14,-2,21,0,21,2,0.2668885815312272,-9.653042511584715,,
1393,2018,11,NCAAF_20181107_TOLEDO@NILL,N. Illinois,,Toledo,,7-3,5-5,,17,9,38,15,7,10,14,7,3,6,0,6,2,8,4,8,23,0.41633034692176707,-3.277771501204711,,
1394,2018,11,NCAAF_20181106_KENTST@BUFF,Buffalo,Bulls,Kent St.,Golden Flashes,9-1,2-8,1,34,0,48,14,21,13,14,0,0,0,0,14,7,34,21,34,34,0.9328514185970155,23.228861273358746,,
1395,2018,12,NCAAF_20181117_ARK@MISSST,Miss. State,Bulldogs,Arkansas,Razorbacks,7-4,2-9,1,17,3,52,6,3,14,21,14,0,3,3,0,5,14,3,14,46,0.9113080324710119,20.92633366979271,0.8636058511058715,17.02913757352519
1396,2018,12,NCAAF_20181117_CIT@BAMA,Alabama,Crimson Tide,The Citadel,Bulldogs,11-0,4-6,1,10,10,50,17,7,3,27,13,0,10,0,7,7,0,7,0,33,0.9999588758743267,61.09092813762561,,
1397,2018,12,NCAAF_20181117_COLG@ARMY,Army,Black Knights,Colgate,Raiders,9-2,9-1,1,14,0,28,14,7,7,0,14,0,0,7,7,0,14,7,14,14,0.9598161917132401,27.12739409838798,,
1398,2018,12,NCAAF_20181117_IDAHO@FLA,Florida,Gators,Idaho,Vandals,8-3,4-7,1,49,0,63,10,28,21,7,7,0,0,3,7,4,49,28,49,53,0.9521132037581315,25.84190464767687,,
1399,2018,12,NCAAF_20181117_MICHST@NEB,Nebraska,Cornhuskers,Michigan St.,Spartans,4-7,6-5,1,0,3,9,6,0,0,0,9,3,0,0,3,-2,-3,-3,-3,3,0.2120973313272232,-12.398375983895335,0.25027605009543175,-10.460077074577498
1400,2018,12,NCAAF_20181117_MTSU@UK,Kentucky,Wildcats,Middle Tenn.,Blue Raiders,8-3,7-4,1,24,10,34,23,17,7,7,3,0,10,6,7,1,14,17,14,11,0.7458942673599918,10.2645590379542,,
1401,2018,12,NCAAF_20181117_NWEST@MINN,Minnesota,,Northwestern,,5-6,7-4,,7,13,14,24,0,7,0,7,7,6,0,11,-2,-6,-7,-6,-10,0.2764393915113913,-9.206907397711461,,
1402,2018,12,NCAAF_20181117_PITT@WAKE,Wake Forest,,Pittsburgh,,5-6,7-4,,10,6,13,34,3,7,0,3,0,6,14,14,-2,4,3,4,-21,0.5426775544922722,1.6628329286709231,,
1403,2018,12,NCAAF_20181117_PSU@RUT,Rutgers,Scarlet Knights,Penn State,Nittany Lions,1-10,8-3,1,0,13,7,20,0,0,0,7,3,10,0,7,-7,-13,-3,-13,-13,0.00701824049861155,-38.10787268269155,0.002648316635642245,-43.29889101682238
1404,2018,12,NCAAF_20181117_SFLA@TEMPLE,Temple,,South Florida,,7-4,7-4,,0,17,27,17,0,0,10,17,7,10,0,0,0,-17,-7,-17,10,0.49054085192377306,-0.36788402389595376,,
1405,2018,12,NCAAF_20181117_TCU@BAYLOR,Baylor,,TCU,,5-6,5-6,,6,9,9,16,6,0,3,0,3,6,7,0,0,-3,3,-3,-7,0.13827259770104128,-16.88116042600052,0.2576252392188727,-10.103903952886412
1406,2018,12,NCAAF_20181117_NCST@LVILLE,Louisville,Cardinals,NC State,Wolfpack,2-9,7-3,1,3,17,10,52,3,0,0,7,7,10,21,14,-5,-14,-4,-14,-42,0.26860990938385065,-9.572587456012798,,
1407,2018,12,NCAAF_20181117_UTAH@COLO,Colorado,,Utah,,5-6,8-3,,7,7,7,30,7,0,0,0,0,7,17,6,-3,0,7,0,-23,0.24643311315159888,-10.63894713233276,,
1408,2018,12,NCAAF_20181117_FIU@CHARLO,Charlotte,,FIU,,4-7,8-3,,14,20,35,42,7,7,7,14,10,10,7,15,-4,-6,-3,-6,-7,0.14860801180478245,-16.17230346773829,0.17510775147348312,-14.505931339844437
1409,2018,12,NCAAF_20181117_UTAHST@COLOST,Colorado St.,,Utah St.,,3-8,10-1,,7,10,24,29,0,7,3,14,3,7,10,9,-7,-3,-3,-3,-5,0.19250755280188625,-13.477041370088045,,
1410,2018,12,NCAAF_20181117_VMI@ODU,Old Dominion,,VMI,,4-7,1-10,,49,0,77,14,21,28,14,14,0,0,14,0,3,49,21,49,63,0.9988508887981058,47.298255997617275,,
1411,2018,12,NCAAF_20181117_CUSE@ND,Notre Dame,Fighting Irish,Syracuse,Orange,11-0,8-3,1,20,0,36,3,13,7,9,7,0,0,0,3,3,20,13,20,33,0.7902207154489431,12.522833398306034,,
1412,2018,12,NCAAF_20181117_GAST@APLST,App. St.,,Georgia St.,,8-2,2-9,,17,7,45,17,14,3,14,14,7,0,3,7,6,10,7,10,28,0.89014563261699,19.040575067119562,,
1413,2018,12,NCAAF_20181117_TXSA@MRSHL,Marshall,,UTSA,,7-3,3-8,,20,0,23,0,10,10,3,0,0,0,0,0,4,20,10,20,23,0.830822934833013,14.853603438117375,,
1414,2018,12,NCAAF_20181117_LAMON@ARKST,Arkansas St.,,UL-Monroe,,7-4,6-5,,17,7,31,17,7,10,14,0,0,7,10,0,1,10,7,10,14,0.7426813287597556,10.109553440564696,0.7455108351926685,10.255230931384176
1415,2018,12,NCAAF_20181117_NEVADA@SJST,San Jose St.,,Nevada,,1-10,7-4,,6,7,12,21,6,0,6,0,0,7,7,7,-6,-1,6,-1,-9,0.11291321201630744,-18.79044060677211,,
1416,2018,12,NCAAF_20181117_WCAR@UNC,North Carolina,,W. Carolina,,2-8,3-8,,35,16,49,26,14,21,14,0,7,9,3,7,-1,19,7,19,23,0.9987923755004755,47.06626937676697,,
1417,2018,12,NCAAF_20181117_BC@FSU,Florida State,Seminoles,Boston College,Eagles,5-6,7-4,1,6,7,22,21,0,6,7,9,0,7,7,7,-2,-1,0,-1,1,0.38595303304363726,-4.497284834503944,0.2875909299092392,-8.702526270466478
1418,2018,12,NCAAF_20181117_BGREEN@AKRON,Akron,,Bowling Green,,4-6,3-8,,6,7,6,21,3,3,0,0,0,7,7,7,1,-1,3,-1,-15,0.6910146537174158,7.73735320426681,0.8061614993908938,13.413782751716212
1419,2018,12,NCAAF_20181117_IOWA@ILL,Illinois,Fighting Illini,Iowa,Hawkeyes,4-7,7-4,1,0,35,0,63,0,0,0,0,7,28,14,14,-3,-35,-7,-35,-63,0.03605224146858066,-27.901563101043052,0.02195562335953205,-31.288197576045263
1420,2018,12,NCAAF_20181117_LATECH@USM,So. Miss,,Louisiana Tech,,5-5,7-4,,14,17,21,20,7,7,0,7,7,10,0,3,-2,-3,0,-3,1,0.4907191964511497,-0.36094660681158075,,
1421,2018,12,NCAAF_20181117_MIAMI@VATECH,Virginia Tech,,Miami (Fla.),,4-6,6-5,,14,17,14,38,7,7,0,0,3,14,21,0,-2,-3,4,-3,-24,0.40868426829335647,-3.5826979367466265,,
1422,2018,12,NCAAF_20181117_MIZZOU@TENN,Tennessee,Volunteers,Missouri,Tigers,5-6,7-4,1,10,26,17,50,0,10,7,0,6,20,14,10,-2,-16,-6,-16,-33,0.18396459004149035,-13.968315266274772,0.1690206007771864,-14.876609212731296
1423,2018,12,NCAAF_20181117_TULSA@NAVY,Navy,Midshipmen,Tulsa,Golden Hurricane,3-8,2-9,1,27,16,37,29,7,20,3,7,7,9,0,13,1,11,0,11,8,0.7021061111030633,8.229759080237727,0.5775067895719981,3.0360486424532382
1424,2018,12,NCAAF_20181117_TXSTSM@TROY,Troy,,Texas St.,,9-2,3-8,,9,0,12,7,3,6,0,3,0,0,0,7,6,9,3,9,5,0.943130163158598,24.53727997464148,0.9541447100416816,26.187294523556716
1425,2018,12,NCAAF_20181117_TXTECH@KSTATE,Kansas State,,Texas Tech,,5-6,5-6,,10,6,21,6,0,10,5,6,6,0,0,0,0,4,-6,4,15,0.3174314834686569,-7.367572034623663,0.26145694299050604,-9.920302015496418
1426,2018,12,NCAAF_20181117_USC@UCLA,UCLA,,USC,,3-8,5-6,,21,24,34,27,14,7,0,13,10,14,3,0,-2,-3,4,-3,7,0.30119540186133653,-8.082342242972686,0.39587368040386284,-4.100081549995707
1427,2018,12,NCAAF_20181117_WVU@OKLAST,Oklahoma State,Cowboys,West Virginia,Mountaineers,6-5,8-2,1,14,31,45,41,7,7,10,21,14,17,0,10,-2,-17,-7,-17,4,0.5616920434467645,2.408737078191052,,
1428,2018,12,NCAAF_20181117_AF@WYO,Wyoming,,Air Force,,5-6,4-7,,14,17,35,27,14,0,0,21,7,10,7,3,1,-3,7,-3,8,0.44190387447316226,-2.2673007045519853,,
1429,2018,12,NCAAF_20181117_IND@MICH,Michigan,Wolverines,Indiana,Hoosiers,10-1,5-6,1,15,17,31,20,3,12,10,6,7,10,0,3,5,-2,-4,-2,11,0.8974818615172095,19.661605796862887,0.9328550079269441,23.251770576270133
1430,2018,12,NCAAF_20181117_LIB@AUBURN,Auburn,Tigers,Liberty,Flames,7-4,4-6,1,32,0,53,0,15,17,21,0,0,0,0,0,3,32,15,32,53,0.9902242830505972,36.223184707305904,,
1431,2018,12,NCAAF_20181117_MA@UGA,Georgia,Bulldogs,UMass,Minutemen,10-1,4-8,1,42,13,66,27,14,28,17,7,7,6,7,7,6,29,7,29,39,0.9977642513664208,44.10411347078434,,
1432,2018,12,NCAAF_20181117_OREGST@WASH,Washington,Huskies,Oregon State,Beavers,8-3,2-9,1,35,16,42,23,28,7,7,0,3,13,0,7,6,19,25,19,19,0.9926954171030593,37.88442153514427,,
1433,2018,12,NCAAF_20181117_GAS@CSTCAR,C. Carolina,,Ga. Southern,,5-6,8-3,,10,13,17,41,7,3,0,7,3,10,21,7,-3,-3,4,-3,-24,0.35248390898103144,-5.874018330546505,0.28249643603639274,-8.935525574708663
1434,2018,12,NCAAF_20181117_SALA@LALAF,Louisiana,,South Alabama,,6-5,2-9,,24,17,48,38,10,14,17,7,0,17,7,14,4,7,10,7,10,0.6354426223377335,5.372605557649308,0.8747205137519867,17.841704900089553
1435,2018,12,NCAAF_20181117_DUKE@CLEM,Clemson,Tigers,Duke,Blue Devils,11-0,7-4,1,14,6,35,6,0,14,14,7,6,0,0,0,4,8,-6,8,29,0.9404614289594866,24.18128332759386,0.9746039841894675,30.330044342401038
1436,2018,12,NCAAF_20181117_UAB@TXAM,Texas A&M,,UAB,,7-4,9-2,,24,7,41,20,14,10,10,7,7,0,0,13,-2,17,7,17,21,0.8581568863790386,16.63234739871598,,
1437,2018,12,NCAAF_20181117_UCONN@ECU,East Carolina,Pirates,UConn,Huskies,3-7,1-10,1,34,21,55,21,7,27,14,7,7,14,0,0,2,13,0,13,34,0.6191864472066464,4.706139866414105,,
1438,2018,12,NCAAF_20181117_KANSAS@OKLA,Oklahoma,Sooners,Kansas,Jayhawks,10-1,3-8,1,21,10,55,40,7,14,14,20,7,3,7,23,7,11,0,11,15,0.9914428406671691,36.989520669959575,0.9850946073378545,33.73633601572135
1439,2018,12,NCAAF_20181117_RICE@LSU,LSU,Tigers,Rice,Owls,9-2,1-11,1,28,3,42,10,14,14,7,7,0,3,0,7,8,25,14,25,32,0.9980859346817061,44.8667587499217,0.9994860677827921,50.97552621043292
1440,2018,12,NCAAF_20181117_TNCHAT@SC,South Carolina,,Chattanooga,,6-4,6-5,,28,3,49,9,14,14,7,14,0,3,0,6,0,25,14,25,40,0.9605703893994951,27.263713665745968,,
1441,2018,12,NCAAF_20181117_UTEP@WKY,W. Kentucky,,UTEP,,2-9,1-10,,40,0,40,16,27,13,0,0,0,0,8,8,1,40,27,40,24,0.7731927374491843,11.626353498440494,,
1442,2018,12,NCAAF_20181117_CINCY@UCF,UCF,Knights,Cincinnati,Bearcats,10-0,9-2,1,21,6,38,13,7,14,7,10,6,0,0,7,1,15,1,15,25,0.9136610939217031,21.155881341302234,,
1443,2018,12,NCAAF_20181117_IOWAST@TEXAS,Texas,Longhorns,Iowa St.,Cyclones,8-3,6-4,1,17,3,24,10,7,10,7,0,3,0,0,7,2,14,4,14,14,0.4818489139603813,-0.7061073628681243,0.5704113297159407,2.7550231356531185
1444,2018,12,NCAAF_20181117_NMEXST@BYU,BYU,,New Mexico St.,,6-5,3-8,,31,7,45,10,7,24,7,7,7,0,3,0,3,24,0,24,35,0.8027505254555614,13.210103824491853,0.9059287974680916,20.436478508248
1445,2018,12,NCAAF_20181117_ARIZ@WASHST,Washington St.,Cougars,Arizona,Wildcats,10-1,5-6,1,55,14,69,28,21,34,0,14,7,7,14,0,5,41,14,41,41,0.6624578902068514,6.503233475001025,,
1446,2018,12,NCAAF_20181117_ARIZST@OREG,Oregon,,Arizona St.,,7-4,6-5,,28,13,31,29,7,21,0,3,3,10,3,13,1,15,4,15,2,0.515043609791425,0.5851581096907239,,
1447,2018,12,NCAAF_20181117_SDGST@FRESNO,Fresno St.,Bulldogs,San Diego St.,Aztecs,9-2,7-4,1,10,14,23,14,7,3,7,6,7,7,0,0,2,-4,0,-4,9,0.6606808324801079,6.427857217297515,,
1448,2018,12,NCAAF_20181117_UNLV@HAWAII,Hawaii,,UNLV,,7-5,3-8,,6,21,35,28,3,3,7,22,7,14,0,7,4,-15,-4,-15,7,0.3494960240343732,-5.999038007411741,,
1449,2018,12,NCAAF_20181116_BOISE@NMEX,New Mexico,Lobos,Boise St.,Broncos,3-8,9-2,1,7,24,14,45,0,7,0,7,14,10,7,14,-6,-17,-14,-17,-31,0.060735939162696706,-24.02561722259793,0.05909836243341293,-24.260951377809874
1450,2018,12,NCAAF_20181116_MEMP@SMU,SMU,Mustangs,Memphis,Tigers,5-6,7-4,1,5,7,18,28,3,2,7,6,0,7,7,14,-2,-2,3,-2,-10,0.3150944563468072,-7.469462610662845,,
1451,2018,12,NCAAF_20181115_TOLEDO@KENTST,Kent St.,Golden Flashes,Toledo,Rockets,2-9,6-5,1,17,28,34,56,7,10,10,7,14,14,21,7,-4,-11,-7,-11,-22,0.0469587956401184,-25.987534174471875,,
1452,2018,12,NCAAF_20181115_TULANE@HOU,Houston,Cougars,Tulane,Green Wave,8-3,5-6,1,31,9,48,17,14,17,10,7,6,3,0,8,3,22,8,22,31,0.655659211605705,6.215669288410254,0.6505551722151981,6.006586069339733
1453,2018,12,NCAAF_20181115_FAU@NTEXAS,North Texas,Mean Green,FAU,Owls,8-3,5-6,1,20,21,41,38,17,3,14,7,7,14,10,7,3,-1,10,-1,3,0.2572789351678526,-10.111464292828487,0.39803629962137255,-4.012983419353645
1454,2018,12,NCAAF_20181114_BUFF@OHIO,Ohio,Bobcats,Buffalo,Bulls,7-4,9-2,1,31,10,52,17,14,17,14,7,7,3,0,7,-2,21,7,21,35,0.5479875451019746,1.8706739530279037,0.3906490803024757,-4.3110382114393815
1455,2018,12,NCAAF_20181114_MIAOH@NILL,N. Illinois,Huskies,Miami-OH,RedHawks,7-4,5-6,1,0,3,7,13,0,0,7,0,0,3,10,0,2,-3,0,-3,-6,0.6701445780771721,6.831077468679723,,
1456,2018,13,NCAAF_20181124_BAYLOR@TXTECH,Texas Tech,,Baylor,,5-7,6-6,,17,14,24,35,10,7,0,7,7,7,14,7,-1,3,3,3,-11,0.8245137855034297,14.483490673928372,0.8667240676520508,16.944467567989477
1457,2018,13,NCAAF_20181124_CUSE@BC,Boston College,Eagles,Syracuse,Orange,7-5,9-3,1,14,28,21,42,7,7,7,0,14,14,7,7,-2,-14,-7,-14,-21,0.6025433792716455,4.036409950037239,,
1458,2018,13,NCAAF_20181124_FLA@FSU,Florida State,Seminoles,Florida,Gators,5-7,9-3,1,7,13,14,41,0,7,7,0,3,10,14,14,-4,-6,-3,-6,-27,0.44612853858103185,-2.1033138199825316,0.21417496781833478,-12.079088958036891
1459,2018,13,NCAAF_20181124_GATECH@UGA,Georgia,Bulldogs,Georgia Tech,Yellow Jackets,11-1,7-5,1,38,7,45,21,14,24,7,0,7,0,0,14,4,31,7,31,24,0.8665368023795046,17.239234589503496,,
1460,2018,13,NCAAF_20181124_MICH@OHIOST,Ohio State,Buckeyes,Michigan,Wolverines,11-1,10-2,1,24,19,62,39,7,17,17,21,3,16,0,20,1,5,4,5,23,0.5860453730779518,3.3756408393192032,0.35442839351180333,-5.694607426079756
1461,2018,13,NCAAF_20181124_MRSHL@FIU,FIU,,Marshall,,8-4,8-3,,10,14,25,28,3,7,0,15,14,0,7,7,0,-4,-11,-4,-3,0.362035878381299,-5.481900354109143,,
1462,2018,13,NCAAF_20181124_NAVY@TULANE,Tulane,,Navy,,6-6,3-9,,21,3,29,28,0,21,0,8,0,3,18,7,3,18,0,18,1,0.45163468065065693,-1.8872137486618499,0.5172415643572335,0.6593268518308832
1463,2018,13,NCAAF_20181124_PURDUE@IND,Indiana,,Purdue,,5-7,6-6,,7,14,21,28,0,7,0,14,7,7,7,7,-1,-7,-7,-7,-7,0.30669845339716084,-7.845464597609066,,
1464,2018,13,NCAAF_20181124_WKY@LATECH,Louisiana Tech,Bulldogs,W. Kentucky,Hilltoppers,7-5,3-9,1,12,23,15,30,0,12,3,0,14,9,0,7,4,-11,-14,-11,-15,0.6689912517321537,6.787957022532169,0.7527892650262845,10.420921323284574
1465,2018,13,NCAAF_20181124_WAKE@DUKE,Duke,,Wake Forest,,7-5,6-6,,7,31,7,59,0,7,0,0,21,10,14,14,1,-24,-21,-24,-52,0.5323494556304469,1.2605577153201466,0.7224380229740968,8.999619188341512
1466,2018,13,NCAAF_20181124_ODU@RICE,Rice,,Old Dominion,,2-11,4-8,,13,6,27,13,6,7,7,7,3,3,7,0,-2,7,3,7,14,0.2622022909233064,-9.884976213410596,0.2088762612436611,-12.358306544714878
1467,2018,13,NCAAF_20181124_GAS@GAST,Georgia St.,,Ga. Southern,,2-10,9-3,,0,13,14,35,0,0,0,14,0,13,15,7,-7,-13,0,-13,-21,0.338803090721703,-6.455686373886067,0.13066452423963104,-17.130790526324972
1468,2018,13,NCAAF_20181124_NMEXST@LIB,Liberty,,New Mexico St.,,5-6,3-9,,28,14,28,21,17,11,0,0,14,0,0,7,2,14,3,14,7,0.5749264862083676,2.933809376265117,,
1469,2018,13,NCAAF_20181124_TROY@APLST,App. St.,,Troy,,9-2,9-3,,21,3,21,10,7,14,0,0,0,3,7,0,0,18,7,18,11,0.6033543667445063,4.069070544007559,0.7346533023189667,9.56159492276538
1470,2018,13,NCAAF_20181124_WYO@NMEX,New Mexico,,Wyoming,,3-9,6-6,,3,14,3,31,0,3,0,0,7,7,3,14,-3,-11,-7,-11,-28,0.25746931094025094,-10.111637846580493,,
1471,2018,13,NCAAF_20181124_LALAF@LAMON,UL-Monroe,,Louisiana,,6-6,7-5,,21,24,28,31,0,21,0,7,14,10,0,7,-1,-3,-14,-3,-3,0.5185673835387102,0.7229804853182031,0.3799350149807674,-4.661496699774489
1472,2018,13,NCAAF_20181124_STNFRD@UCLA,UCLA,Bruins,Stanford,Cardinal,3-9,7-4,1,20,27,42,49,6,14,16,6,10,17,14,8,-4,-7,-4,-7,-7,0.23255961183536789,-11.342677846832203,,
1473,2018,13,NCAAF_20181124_UAB@MTSU,Middle Tenn.,,UAB,,8-4,9-3,,13,3,27,3,0,13,7,7,3,0,0,0,-1,10,-3,10,24,0.5394934477981023,1.5397678646733652,,
1474,2018,13,NCAAF_20181124_USM@UTEP,UTEP,,So. Miss,,1-11,6-5,,0,19,7,39,0,0,0,7,16,3,7,13,-5,-19,-16,-19,-32,0.10299630566181528,-19.638279301775356,,
1475,2018,13,NCAAF_20181124_ARIZST@ARIZ,Arizona,,Arizona St.,,5-7,7-5,,22,14,40,41,10,12,18,0,7,7,7,20,-2,8,3,8,-1,0.40398107769404157,-3.7742883647275676,0.2691617275345618,-9.384718742342557
1476,2018,13,NCAAF_20181124_AUBURN@BAMA,Alabama,Crimson Tide,Auburn,Tigers,12-0,7-5,1,17,14,52,21,7,10,21,14,7,7,7,0,5,3,0,3,31,0.8024508530678178,13.20554673328536,0.9259745784992157,22.05984820181311
1477,2018,13,NCAAF_20181124_ILL@NWEST,Northwestern,Wildcats,Illinois,Fighting Illini,8-4,4-8,1,21,6,24,16,7,14,3,0,3,3,0,10,4,15,4,15,8,0.9313224561921348,23.07086806400025,,
1478,2018,13,NCAAF_20181124_MD@PSU,Penn State,Nittany Lions,Maryland,Terrapins,9-3,5-7,1,17,3,38,3,14,3,7,14,3,0,0,0,4,14,11,14,35,0.948373237463609,25.300265168556393,,
1479,2018,13,NCAAF_20181124_MINN@WISC,Wisconsin,Badgers,Minnesota,Golden Gophers,7-5,6-6,1,7,17,15,37,0,7,0,8,3,14,6,14,1,-10,-3,-10,-22,0.8664859035739891,17.235566009367574,0.7896991176432528,12.28283137665494
1480,2018,13,NCAAF_20181124_PITT@MIAMI,Miami (Fla.),,Pittsburgh,,7-5,7-5,,10,0,24,3,3,7,7,7,0,0,3,0,0,10,3,10,21,0.6987434654089976,8.087079093103853,,
1481,2018,13,NCAAF_20181124_SMU@TULSA,Tulsa,,SMU,,3-9,5-7,,21,7,27,24,7,14,3,3,0,7,7,10,-2,14,7,14,3,0.27903994699757306,-9.09496919261727,,
1482,2018,13,NCAAF_20181124_TEMPLE@UCONN,UConn,,Temple,,1-11,8-4,,7,40,7,57,7,0,0,0,13,27,7,10,-7,-33,-6,-33,-50,0.06594205896549987,-23.39697566233872,,
1483,2018,13,NCAAF_20181124_ARKST@TXSTSM,Texas St.,,Arkansas St.,,3-9,8-4,,0,7,7,33,0,0,7,0,7,0,21,5,-5,-7,-7,-7,-26,0.09967644954778632,-19.929215067983932,0.11870564078616841,-18.0188065962559
1484,2018,13,NCAAF_20181124_RUT@MICHST,Michigan St.,,Rutgers,,7-5,1-11,,7,7,14,10,0,7,0,7,7,0,0,3,6,0,-7,0,4,0.9185005200017081,21.663104131327714,0.9608296316636016,26.84783055762591
1485,2018,13,NCAAF_20181124_TENN@VANDY,Vanderbilt,,Tennessee,,6-6,5-7,,17,0,38,13,7,10,0,21,0,0,7,6,1,17,7,17,25,0.5513956791907925,2.0060986630882667,,
1486,2018,13,NCAAF_20181124_CHARLO@FAU,FAU,,Charlotte,,5-7,5-7,,21,10,24,27,7,14,0,3,10,0,7,10,0,11,-3,11,-3,0.952379780062055,25.90740208674913,0.843845420849879,15.409456640463077
1487,2018,13,NCAAF_20181124_COLO@CAL,California,,Colorado,,7-4,5-7,,24,7,33,21,21,3,3,6,0,7,14,0,2,17,21,17,12,0.5482793134633077,1.8838412737724752,,
1488,2018,13,NCAAF_20181124_KSTATE@IOWAST,Iowa St.,Cyclones,Kansas State,Wildcats,7-4,5-7,1,14,21,42,38,7,7,7,21,0,21,10,7,2,-7,7,-7,4,0.7079991869918674,8.50260555131399,0.6871993145029026,7.441388386667995
1489,2018,13,NCAAF_20181124_NTEXAS@TXSA,UTSA,,North Texas,,3-9,9-3,,14,17,21,24,0,14,0,7,10,7,7,0,-6,-3,-10,-3,-3,0.227354824534728,-11.608883844886691,0.08176751487168055,-21.248946843531712
1490,2018,13,NCAAF_20181124_SC@CLEM,Clemson,Tigers,South Carolina,Gamecocks,12-0,6-5,1,28,21,56,35,14,14,14,14,7,14,0,14,6,7,7,7,21,0.935719622251457,23.60022015575845,,
1491,2018,13,NCAAF_20181124_SJST@FRESNO,Fresno St.,,San Jose St.,,10-2,1-11,,3,0,31,13,0,3,14,14,0,0,0,13,9,3,0,3,18,0.9856896130373713,33.98673943895494,,
1492,2018,13,NCAAF_20181124_UK@LVILLE,Louisville,Cardinals,Kentucky,Wildcats,2-10,9-3,1,10,35,10,56,7,3,0,0,14,21,0,21,-7,-25,-7,-25,-46,0.38203667014392595,-4.660658639057203,,
1493,2018,13,NCAAF_20181124_ND@USC,USC,Trojans,Notre Dame,Fighting Irish,5-7,12-0,1,10,7,17,24,7,3,0,7,0,7,10,7,-7,3,7,3,-7,0.18143050871981303,-14.129786437149107,0.16321467444364013,-14.966304861304707
1494,2018,13,NCAAF_20181124_OKLAST@TCU,TCU,,Oklahoma State,,6-6,6-6,,7,3,31,24,0,7,17,7,3,0,7,14,0,4,-3,4,7,0.4411665110628442,-2.2984073696065934,0.3237715868253326,-6.972429577012917
1495,2018,13,NCAAF_20181124_NEVADA@UNLV,UNLV,Rebels,Nevada,Wolf Pack,4-8,7-5,1,21,26,34,29,0,21,7,6,20,6,0,3,-3,-5,-20,-5,5,0.3068170533805332,-7.840220205870821,0.18496911730860366,-13.673897990624937
1496,2018,13,NCAAF_20181124_BYU@UTAH,Utah,Utes,BYU,Cougars,9-3,6-6,1,0,20,35,27,0,0,14,21,13,7,7,0,3,-20,-13,-20,8,0.8492026694644013,16.04123028208022,0.8276702336849475,14.412194509009169
1497,2018,13,NCAAF_20181124_UTAHST@BOISE,Boise St.,Broncos,Utah St.,Aggies,10-2,10-2,1,17,14,33,24,7,10,3,13,7,7,0,10,0,3,0,3,9,0.6191007834326637,4.706993595179711,0.39706155356229733,-3.979911124239152
1498,2018,13,NCAAF_20181123_AKRON@OHIO,Ohio,,Akron,,8-4,4-7,,28,7,49,28,21,7,7,14,0,7,7,14,4,21,21,21,21,0.825547346863474,14.545759832124531,0.8905301848416002,18.748881522511056
1499,2018,13,NCAAF_20181123_BUFF@BGREEN,Bowling Green,,Buffalo,,3-9,10-2,,7,34,14,44,7,0,0,7,13,21,7,3,-7,-27,-6,-27,-30,0.1636421473892613,-15.211681029099964,0.07891041397740794,-21.54113120963484
1500,2018,13,NCAAF_20181123_CMICH@TOLEDO,Toledo,,C. Michigan,,7-5,1-11,,24,0,51,13,14,10,13,14,0,0,0,13,6,24,14,24,38,0.7493667046246171,10.442877273756096,0.8274347351588609,14.39813062652297
1501,2018,13,NCAAF_20181123_EMICH@KENTST,Kent St.,,E. Michigan,,2-10,7-5,,10,21,20,28,10,0,7,3,7,14,7,0,-5,-11,3,-11,-8,0.07839575248937514,-21.987484456674906,,
1502,2018,13,NCAAF_20181123_HOU@MEMP,Memphis,,Houston,,8-4,8-4,,17,21,52,31,3,14,14,21,7,14,10,0,0,-4,-4,-4,21,0.5460706943526134,1.7972665680631508,0.4475002377219769,-2.012822624598357
1503,2018,13,NCAAF_20181123_NEB@IOWA,Iowa,Hawkeyes,Nebraska,Cornhuskers,8-4,4-8,1,21,13,31,28,7,14,7,3,7,6,0,15,4,8,0,8,3,0.8989747636711467,19.810174897453294,0.915205890069019,20.9477054311717
1504,2018,13,NCAAF_20181123_TEXAS@KANSAS,Kansas,Jayhawks,Texas,Longhorns,3-9,9-3,1,0,7,17,24,0,0,0,17,7,0,14,3,-6,-7,-7,-7,-7,0.05172925879508228,-25.28523325564157,0.11187078598629929,-18.554987027036304
1505,2018,13,NCAAF_20181123_ARK@MIZZOU,Missouri,Tigers,Arkansas,Razorbacks,8-4,2-10,1,28,0,38,0,7,21,10,0,0,0,0,0,6,28,7,28,38,0.8909083941700138,19.121363097847166,0.9300903721201653,22.517588989533124
1506,2018,13,NCAAF_20181123_CSTCAR@SALA,South Alabama,,C. Carolina,,3-9,5-7,,24,7,31,28,10,14,7,0,0,7,7,14,-2,17,10,17,3,0.43982663145516476,-2.3511488049546756,0.21434358757275385,-12.070270090129497
1507,2018,13,NCAAF_20181123_ECU@CINCY,Cincinnati,Bearcats,East Carolina,Pirates,10-2,3-8,1,42,6,56,6,21,21,7,7,0,6,0,0,7,36,21,36,50,0.7781358714291899,11.893462726809332,,
1508,2018,13,NCAAF_20181123_OREG@OREGST,Oregon State,Beavers,Oregon,Ducks,2-10,8-4,1,3,21,15,55,0,3,6,6,14,7,13,21,-6,-18,-14,-18,-40,0.055716998611774926,-24.71794017363277,,
1509,2018,13,NCAAF_20181123_UCF@SFLA,South Florida,Bulls,UCF,Knights,7-5,11-0,1,3,17,10,38,0,3,7,0,7,10,7,14,-4,-14,-7,-14,-28,0.11396721328977444,-18.72264292402656,,
1510,2018,13,NCAAF_20181123_OKLA@WVU,West Virginia,Mountaineers,Oklahoma,Sooners,8-3,11-1,1,28,35,56,59,14,14,21,7,14,21,10,14,-3,-7,0,-7,-3,0.2168152614600254,-12.158712612964507,,
1511,2018,13,NCAAF_20181123_WASH@WASHST,Washington St.,Cougars,Washington,Huskies,10-2,9-3,1,7,14,15,28,0,7,8,0,7,7,6,8,1,-7,-7,-7,-13,0.324874094774667,-7.0516714166995484,,
1512,2018,13,NCAAF_20181122_COLOST@AF,Air Force,Falcons,Colorado St.,Rams,5-7,3-9,1,17,13,27,19,7,10,0,10,0,13,0,6,2,4,7,4,8,0.5763128640183385,2.9887631739712788,,
1513,2018,13,NCAAF_20181122_MISSST@MISS,Ole Miss,Rebels,Miss. State,Bulldogs,5-7,8-4,1,3,21,3,35,0,3,0,0,7,14,7,7,-3,-18,-7,-18,-32,0.15054823788652927,-16.057770574385188,,
1514,2018,13,NCAAF_20181120_BALLST@MIAOH,Miami-OH,RedHawks,Ball St.,Cardinals,6-6,4-8,1,21,21,42,21,7,14,14,7,14,7,0,0,2,0,-7,0,21,0.8930825614683833,19.303294204441443,,
1515,2018,13,NCAAF_20181120_NILL@WMICH,W. Michigan,Broncos,N. Illinois,Huskies,7-5,7-5,1,13,7,28,21,7,6,8,7,7,0,14,0,0,6,0,6,7,0.32751382007176044,-6.937950887764032,,
1516,2018,14,NCAAF_20181201_AKRON@SC,South Carolina,Gamecocks,Akron,Zips,7-5,4-8,1,28,3,28,3,14,14,0,0,3,0,0,0,3,25,11,25,25,0.9114148128127766,21.078404260098978,,
1517,2018,14,NCAAF_20181201_DRA@IOWAST,Iowa St.,Cyclones,Drake,Bulldogs,8-4,7-4,1,20,14,27,24,7,13,7,0,7,7,10,0,1,6,0,6,3,,,,
1518,2018,14,NCAAF_20181201_ECU@NCST,NC State,Wolfpack,East Carolina,Pirates,9-3,3-9,1,27,0,58,3,17,10,14,17,0,0,0,3,6,27,17,27,55,0.9630621366559157,27.917480557504973,,
1519,2018,14,NCAAF_20181201_LALAF@APLST,App. St.,Mountaineers,Louisiana,Ragin' Cajuns,10-2,7-6,1,14,6,30,19,7,7,6,10,3,3,10,3,3,8,4,8,11,0.8759310619741569,18.038366025748985,0.9249899934785043,21.104252062114256
1520,2018,14,NCAAF_20181201_MRSHL@VATECH,Virginia Tech,Hokies,Marshall,Thundering Herd,6-6,8-4,1,31,6,41,20,10,21,3,7,6,0,0,14,-2,25,4,25,21,0.7465328459366243,10.365194921186344,,
1521,2018,14,NCAAF_20181201_TEXAS@OKLA,Oklahoma,Sooners,Texas,Longhorns,12-1,9-4,1,20,14,39,27,3,17,7,12,7,7,13,0,3,6,-4,6,12,0.7417164802052386,10.131335687609408,0.7298551612224973,8.978164963122481
1522,2018,14,NCAAF_20181201_UAB@MTSU,Middle Tenn.,Blue Raiders,UAB,Blazers,8-5,10-3,1,16,24,25,27,13,3,6,3,3,21,0,3,-2,-8,10,-8,-2,0.592172709806086,3.641422305322749,,
1523,2018,14,NCAAF_20181201_NRFST@LIB,Liberty,Flames,Norfolk St.,Spartans,6-6,4-7,1,38,10,52,17,10,28,7,7,3,7,0,7,2,28,7,28,35,,,,
1524,2018,14,NCAAF_20181201_STNFRD@CAL,California,Golden Bears,Stanford,Cardinal,7-5,8-4,1,6,13,13,23,0,6,0,7,10,3,0,10,-1,-7,-10,-7,-10,0.25977394658538455,-10.059428013148136,,
1525,2018,14,NCAAF_20181201_MEMP@UCF,UCF,Knights,Memphis,Tigers,12-0,8-5,1,21,38,56,41,7,14,14,21,24,14,3,0,4,-17,-17,-17,15,0.7837179614411909,12.258128097847703,,
1526,2018,14,NCAAF_20181201_BAMA@UGA,Georgia,Bulldogs,Alabama,Crimson Tide,11-2,13-0,1,21,14,28,35,7,14,7,0,0,14,7,14,-2,7,7,7,-7,0.36485222667502115,-5.396725611968691,0.21957748260633658,-11.342227733425716
1527,2018,14,NCAAF_20181201_CLEM@PITT,Pittsburgh,Panthers,Clemson,Tigers,7-6,13-0,1,10,28,10,42,3,7,0,0,14,14,0,14,-6,-18,-11,-18,-32,0.04397253527248213,-26.65164214207664,,
1528,2018,14,NCAAF_20181201_NWEST@OHIOST,Ohio State,Buckeyes,Northwestern,Wildcats,12-1,8-5,1,24,7,45,24,14,10,7,14,7,0,14,3,4,17,7,17,21,0.856233166117451,16.611763202394627,,
1529,2018,14,NCAAF_20181130_NILL@BUFF,Buffalo,Bulls,N. Illinois,Huskies,10-3,8-5,1,22,10,29,30,7,15,7,0,0,10,7,13,2,12,7,12,-1,0.5085648361567034,0.3353521836018558,,
1530,2018,14,NCAAF_20181130_UTAH@WASH,Washington,Huskies,Utah,Utes,10-3,9-4,1,3,0,10,3,0,3,7,0,0,0,3,0,1,3,0,3,7,0.6870597807429079,7.614880255528192,,
1531,2018,15,NCAAF_20181208_NAVY@ARMY,Army,Black Knights,Navy,Midshipmen,10-2,3-10,1,7,0,17,10,7,0,3,7,0,0,0,10,7,7,7,7,7,0.6027371191549672,4.053334893915462,,
1532,2019,1,NCAAF_20190902_ND@LVILLE,Louisville,Cardinals,Notre Dame,Fighting Irish,0-1,1-0,0,14,21,17,35,14,0,0,3,14,7,7,7,-1,-7,0,-7,-18,0.07441691749975077,-22.460152396730905,0.004725084310978067,-37.92240052572484
1533,2019,1,NCAAF_20190901_HOU@OKLA,Oklahoma,Sooners,Houston,Cougars,1-0,0-1,0,21,10,49,31,7,14,21,7,0,10,7,14,1,11,7,11,18,0.9216055698036706,22.029070819880985,0.9204314064849679,20.57313418994144
1534,2019,1,NCAAF_20190831_AKRON@ILL,Illinois,Fighting Illini,Akron,Zips,1-0,0-1,1,28,3,42,3,14,14,14,0,3,0,0,0,1,25,11,25,39,0.5544926179060361,2.131727909077199,0.4793213311921277,-0.7577244471818005
1535,2019,1,NCAAF_20190831_BOISE@FSU,Florida State,Seminoles,Boise St.,Broncos,0-1,1-0,0,31,19,31,36,21,10,0,0,6,13,7,10,-1,12,15,12,-5,0.43237615554608766,-2.6499188705603274,0.21515162330976056,-11.523941907848695
1536,2019,1,NCAAF_20190831_ECU@NCST,NC State,Wolfpack,East Carolina,Pirates,1-0,0-1,0,17,3,34,6,7,10,7,10,3,0,0,3,1,14,4,14,28,0.976120473647409,30.796670221038426,,
1537,2019,1,NCAAF_20190831_FAU@OHIOST,Ohio State,Buckeyes,FAU,Owls,1-0,0-1,1,28,3,45,21,28,0,7,10,0,3,3,15,1,25,28,25,24,0.959683005264523,27.179697606018976,0.9586900098317481,25.361472979088376
1538,2019,1,NCAAF_20190831_HOW@MD,Maryland,Terrapins,Howard,Bison,1-0,0-1,1,56,0,79,0,28,28,16,7,0,0,0,0,1,56,28,56,79,0.9909267755344332,36.75700387189261,,
1539,2019,1,NCAAF_20190831_IND@BALLST,Ball St.,Cardinals,Indiana,Hoosiers,0-1,1-0,1,10,16,24,34,3,7,7,7,10,6,7,11,-1,-6,-7,-6,-10,0.024802824440116722,-30.545300114243787,,
1540,2019,1,NCAAF_20190831_INST@KANSAS,Kansas,Jayhawks,Indiana St.,Sycamores,1-0,0-1,1,10,3,24,17,7,3,6,8,0,3,0,14,1,7,7,7,7,0.9372112447564013,23.831008322722255,,
1541,2019,1,NCAAF_20190831_MISS@MEMP,Memphis,Tigers,Ole Miss,Rebels,1-0,0-1,0,13,0,15,10,7,6,0,2,0,0,3,7,1,13,7,13,5,0.670027420168739,6.845239049343377,,
1542,2019,1,NCAAF_20190831_MISSST@LALAF,Louisiana,Ragin' Cajuns,Miss. State,Bulldogs,0-1,1-0,0,14,21,28,38,7,7,0,14,7,14,7,10,-1,-7,0,-7,-10,0.011149872074114886,-35.55294155127001,0.012433498804166221,-32.78106161139954
1543,2019,1,NCAAF_20190831_SALA@NEB,Nebraska,Cornhuskers,South Alabama,Jaguars,1-0,0-1,1,14,7,35,21,7,7,14,7,7,0,14,0,1,7,0,7,14,0.9472151814665486,25.179160163870392,0.9663078148673809,26.726496726028813
1544,2019,1,NCAAF_20190831_TOLEDO@UK,Kentucky,Wildcats,Toledo,Rockets,1-0,0-1,0,14,14,38,24,0,14,10,14,7,7,3,7,1,0,-7,0,14,0.6403207874374577,5.590155993416602,,
1545,2019,1,NCAAF_20190831_JMAD@WVU,West Virginia,Mountaineers,James Madison,Dukes,1-0,0-1,0,3,7,20,13,0,3,7,10,7,0,3,3,1,-4,-7,-4,7,0.7710341849681981,11.547852482957751,,
1546,2019,1,NCAAF_20190831_RI@OHIO,Ohio,Bobcats,Rhode Island,Rams,1-0,0-1,0,17,6,41,20,7,10,17,7,0,6,7,7,1,11,7,11,21,0.9838561837191337,33.30653035135265,,
1547,2019,1,NCAAF_20190831_BUCK@TEMPLE,Temple,Owls,Bucknell,Bison,1-0,0-1,1,35,9,56,12,21,14,7,14,0,9,3,0,1,26,21,26,44,,,,
1548,2019,1,NCAAF_20190831_EWASH@WASH,Washington,Huskies,E. Washington,Eagles,1-0,0-1,0,28,7,47,14,21,7,14,5,0,7,0,7,1,21,21,21,33,0.998831784390915,47.35403762830367,,
1549,2019,1,NCAAF_20190831_COLG@AF,Air Force,Falcons,Colgate,Raiders,1-0,0-2,0,35,0,48,7,7,28,13,0,0,0,7,0,1,35,7,35,41,0.7779570059130815,11.906530840056803,,
1550,2019,1,NCAAF_20190831_DUKE@BAMA,Alabama,Crimson Tide,Duke,Blue Devils,1-0,0-1,1,14,3,42,3,0,14,21,7,0,3,0,0,1,11,0,11,39,0.9760295794909223,30.771565315420958,0.9994614378048366,47.774301132368834
1551,2019,1,NCAAF_20190831_EMICH@CSTCAR,C. Carolina,Chanticleers,E. Michigan,Eagles,0-1,1-0,1,13,7,23,30,10,3,0,10,0,7,16,7,-1,6,10,6,-7,0.1161256755144977,-18.58497515662077,,
1552,2019,1,NCAAF_20190831_ETNST@APLST,App. St.,Mountaineers,ETSU,Buccaneers,1-0,0-1,0,14,0,42,7,7,7,14,14,0,0,7,0,1,14,7,14,35,0.9999228896262623,58.87322928227309,,
1553,2019,1,NCAAF_20190831_GAST@TENN,Tennessee,Volunteers,Georgia St.,Panthers,0-1,1-0,1,17,14,30,38,14,3,3,10,7,7,7,17,-1,3,7,3,-8,0.873398086038909,17.77632326163257,0.9616566717534948,25.866464962203395
1554,2019,1,NCAAF_20190831_HOLY@NAVY,Navy,Midshipmen,Holy Cross,Crusaders,1-0,0-1,1,24,7,45,7,10,14,14,7,0,7,0,0,1,17,10,17,38,0.982049443256733,32.64087924308842,,
1555,2019,1,NCAAF_20190831_IDAHO@PSU,Penn State,Nittany Lions,Idaho,Vandals,1-0,0-1,0,44,0,79,7,20,24,14,21,0,0,0,7,1,44,20,44,72,0.9988182325205368,47.30002533035986,,
1556,2019,1,NCAAF_20190831_SC@UNC,North Carolina,Tar Heels,South Carolina,Gamecocks,1-0,0-1,0,6,13,24,20,3,3,3,15,10,3,7,0,1,-7,-7,-7,4,0.14871050406177355,-16.21086722740324,,
1557,2019,1,NCAAF_20190831_MTST@TXTECH,Texas Tech,Red Raiders,Montana St.,Bobcats,1-0,0-1,0,28,7,45,10,14,14,3,14,0,7,0,3,1,21,14,21,35,0.9812949431938526,32.37973242765736,,
1558,2019,1,NCAAF_20190831_NWEST@STNFRD,Stanford,Cardinal,Northwestern,Wildcats,1-0,0-1,1,10,0,17,7,0,10,0,7,0,0,0,7,1,10,0,10,10,0.496295343085682,-0.14447446239159945,,
1559,2019,1,NCAAF_20190831_PORTST@ARK,Arkansas,Razorbacks,Portland St.,Vikings,1-0,0-1,0,10,6,20,13,10,0,7,3,3,3,0,7,1,4,7,4,7,0.9089728374283292,20.761145252245115,,
1560,2019,1,NCAAF_20190831_VATECH@BC,Boston College,Eagles,Virginia Tech,Hokies,1-0,0-1,1,28,14,35,28,7,21,0,7,7,7,7,7,1,14,0,14,7,0.5270207526831816,1.054548973695887,,
1561,2019,1,NCAAF_20190831_CAMP@TROY,Troy,Trojans,Campbell,Fighting Camels,1-0,0-1,1,20,7,43,14,17,3,16,7,7,0,0,7,1,13,10,13,29,0.9997421204066427,54.02329724285687,,
1562,2019,1,NCAAF_20190831_CUSE@LIB,Liberty,Flames,Syracuse,Orange,0-1,1-0,0,0,10,0,24,0,0,0,0,3,7,7,7,-1,-10,-3,-10,-24,0.0460497660090563,-26.205873238563754,,
1563,2019,1,NCAAF_20190831_SAMST@NMEX,New Mexico,Lobos,Sam Houston,Bearkats,1-0,0-1,1,22,16,39,31,13,9,10,7,0,16,7,8,1,6,13,6,8,,,,
1564,2019,1,NCAAF_20190831_UIW@TXSA,UTSA,Roadrunners,Incarnate Word,Cardinals,1-0,0-1,1,21,7,35,7,7,14,7,7,0,7,0,0,1,14,7,14,28,0.9898528270822491,36.107386204304134,,
1565,2019,1,NCAAF_20190831_DAVIS@CAL,California,Golden Bears,UC-Davis,Aggies,1-0,0-1,1,13,10,27,13,0,13,7,7,10,0,3,0,1,3,-10,3,14,0.8443242756452489,15.750520669895195,,
1566,2019,1,NCAAF_20190831_VMI@MRSHL,Marshall,Thundering Herd,VMI,Keydets,1-0,0-1,0,35,7,56,17,14,21,14,7,0,7,0,10,1,28,14,28,39,0.9999983914929319,72.44397557078605,,
1567,2019,1,NCAAF_20190831_ALCORN@USM,So. Miss,Golden Eagles,Alcorn St.,Braves,1-0,0-1,1,13,0,38,10,10,3,15,10,0,0,10,0,1,13,10,13,28,0.8108186139596851,13.705089732592683,,
1568,2019,1,NCAAF_20190831_ILST@NILL,N. Illinois,,Illinois St.,,1-0,0-1,,3,3,24,10,3,0,7,14,0,3,0,7,1,0,3,0,14,0.2967395730291651,-8.30474666000407,,
1569,2019,1,NCAAF_20190831_MONNJ@WMICH,W. Michigan,,Monmouth,,1-0,0-1,,31,7,48,13,21,10,14,3,0,7,6,0,1,24,21,24,35,,,,
1570,2019,1,NCAAF_20190831_NICHST@KSTATE,Kansas State,Wildcats,Nicholls St.,Colonels,1-0,0-1,1,28,0,49,14,14,14,0,21,0,0,7,7,1,28,14,28,35,0.9223359174056588,22.106958900653808,,
1571,2019,1,NCAAF_20190831_NRFST@ODU,Old Dominion,Monarchs,Norfolk St.,Spartans,1-0,0-1,1,14,6,24,21,14,0,3,7,0,6,0,15,1,8,14,8,3,0.9841561081788813,33.42314498307485,,
1572,2019,1,NCAAF_20190831_SFA@BAYLOR,Baylor,Bears,S.F. Austin,Lumberjacks,1-0,0-1,0,35,7,56,17,14,21,14,7,7,0,0,10,1,28,7,28,39,0.9979680212641608,44.69982742109562,,
1573,2019,1,NCAAF_20190831_SMU@ARKST,Arkansas St.,Red Wolves,SMU,Mustangs,0-1,1-0,0,9,16,30,37,7,2,14,7,3,13,14,7,-1,-7,4,-7,-7,0.368127554345555,-5.240111032039863,,
1574,2019,1,NCAAF_20190831_ABIL@NTEXAS,North Texas,Mean Green,Abil Christian,Wildcats,1-0,0-1,1,38,10,51,31,17,21,10,3,0,10,7,14,1,28,17,28,20,0.977746327593665,31.259900239008743,,
1575,2019,1,NCAAF_20190831_GAS@LSU,LSU,Tigers,Ga. Southern,Eagles,1-0,0-1,1,42,3,55,3,21,21,10,3,0,3,0,0,1,39,21,39,52,0.9666273269768241,28.52335291565703,,
1576,2019,1,NCAAF_20190831_MIAOH@IOWA,Iowa,Hawkeyes,Miami-OH,RedHawks,1-0,0-1,1,10,7,38,14,3,7,14,14,0,7,0,7,1,3,3,3,24,0.9503857322417489,25.648595659439366,,
1577,2019,1,NCAAF_20190831_MIZZOU@WYO,Wyoming,Cowboys,Missouri,Tigers,1-0,0-1,1,27,17,37,31,0,27,7,3,14,3,0,14,1,10,-14,10,6,0.10599221415519788,-19.418058813506036,,
1578,2019,1,NCAAF_20190831_MTSU@MICH,Michigan,Wolverines,Middle Tenn.,Blue Raiders,1-0,0-1,1,27,14,40,21,10,17,6,7,7,7,0,7,1,13,3,13,19,0.9631103353561656,27.816944916691682,0.9333136272848461,21.93136414016405
1579,2019,1,NCAAF_20190831_OREG@AUBURN,Auburn,Tigers,Oregon,Ducks,1-0,0-1,0,6,14,27,21,3,3,7,14,14,0,7,0,1,-8,-11,-8,6,0.8115882464523161,13.749386783405043,,
1580,2019,1,NCAAF_20190831_UGA@VANDY,Vanderbilt,Commodores,Georgia,Bulldogs,0-1,1-0,0,6,21,6,30,0,6,0,0,14,7,3,6,-1,-15,-14,-15,-24,0.033752254512432245,-28.444245906337414,,
1581,2019,1,NCAAF_20190831_UVA@PITT,Pittsburgh,Panthers,Virginia,Cavaliers,0-1,1-0,1,14,13,14,30,0,14,0,0,10,3,10,7,-1,1,-10,1,-16,0.5639080557642624,2.5030110887065575,,
1582,2019,1,NCAAF_20190831_ARPB@TCU,TCU,Horned Frogs,Ark.-Pine Bluff,Golden Lions,1-0,0-1,0,16,0,39,7,10,6,13,10,0,0,7,0,1,16,10,16,32,0.9999967956586665,70.20339501148044,,
1583,2019,1,NCAAF_20190831_GRAM@LAMON,UL-Monroe,Warhawks,Grambling,Tigers,1-0,0-1,0,17,9,31,9,7,10,7,7,6,3,0,0,1,8,1,8,22,0.8263601286403125,14.622403412555741,,
1584,2019,1,NCAAF_20190831_HOUBP@UTEP,UTEP,Miners,Houston Christian,Huskies,1-0,0-1,0,20,17,36,34,3,17,13,3,0,17,11,6,1,3,3,3,2,0.6614260286380058,6.47759801443965,,
1585,2019,1,NCAAF_20190831_LATECH@TEXAS,Texas,Longhorns,Louisiana Tech,Bulldogs,1-0,0-1,1,24,0,45,14,7,17,14,7,0,0,0,14,1,24,7,24,31,0.9582451553548927,26.92542191383268,0.9629971685863706,26.10515304606696
1586,2019,1,NCAAF_20190831_WBRST@SDGST,San Diego St.,Aztecs,Weber St.,Wildcats,1-0,0-1,1,3,0,6,0,0,3,0,3,0,0,0,0,1,3,0,3,6,0.7880354703562323,12.440343717581413,,
1587,2019,1,NCAAF_20190831_NMEXST@WASHST,Washington St.,Cougars,New Mexico St.,Aggies,1-0,0-1,0,35,7,58,7,14,21,13,10,7,0,0,0,1,28,7,28,51,0.979419980929343,31.767600765886755,,
1588,2019,1,NCAAF_20190831_SUT@UNLV,UNLV,Rebels,So. Utah,Thunderbirds,1-0,0-1,0,35,7,56,23,7,28,21,0,0,7,0,16,1,28,7,28,33,0.9452905507826437,24.905016817529827,,
1589,2019,1,NCAAF_20190831_FRESNO@USC,USC,Trojans,Fresno St.,Bulldogs,1-0,0-1,1,17,10,31,23,14,3,14,0,3,7,3,10,1,7,11,7,8,0.503430651592204,0.13378851026868688,0.18311566823063952,-13.20258090949244
1590,2019,1,NCAAF_20190830_RICE@ARMY,Army,Black Knights,Rice,Owls,1-0,0-1,0,7,7,14,7,0,7,0,7,0,7,0,0,1,0,0,0,7,0.9758537858463154,30.723237340978017,,
1591,2019,1,NCAAF_20190830_TULSA@MICHST,Michigan St.,Spartans,Tulsa,Golden Hurricane,1-0,0-1,1,25,7,28,7,7,18,3,0,0,7,0,0,1,18,7,18,21,0.9083527615718028,20.702385771324657,0.8646952506169824,16.09725299283167
1592,2019,1,NCAAF_20190830_WISC@SFLA,South Florida,Bulls,Wisconsin,Badgers,0-1,1-0,0,0,28,0,49,0,0,0,0,7,21,14,7,-1,-28,-7,-28,-49,0.11531856309512523,-18.64938007474825,,
1593,2019,1,NCAAF_20190830_MA@RUT,Rutgers,Scarlet Knights,UMass,Minutemen,1-0,0-1,0,38,21,48,21,7,31,3,7,21,0,0,0,1,17,-14,17,27,0.6571119175076542,6.29457002503807,,
1594,2019,1,NCAAF_20190830_UTAHST@WAKE,Wake Forest,Demon Deacons,Utah St.,Aggies,1-0,0-1,1,17,21,38,35,10,7,14,7,7,14,7,7,1,-4,3,-4,3,0.6003961840559904,3.9574681975025214,0.1463454461040754,-15.375090715681324
1595,2019,1,NCAAF_20190830_PURDUE@NEVADA,Nevada,Wolf Pack,Purdue,Boilermakers,1-0,0-1,0,7,24,34,31,0,7,10,17,10,14,7,0,1,-17,-10,-17,3,0.07927697590235705,-21.93568218338021,,
1596,2019,1,NCAAF_20190830_COLOST@COLO,Colorado,Buffaloes,Colorado St.,Rams,1-0,0-1,1,24,21,52,31,7,17,14,14,7,14,3,7,1,3,0,3,21,0.6770420904452075,7.14790699605021,,
1597,2019,1,NCAAF_20190830_OKLAST@OREGST,Oregon State,Beavers,Oklahoma State,Cowboys,0-1,1-0,1,16,31,36,52,10,6,7,13,7,24,14,7,-1,-15,3,-15,-16,0.010688763239343646,-35.80227659865125,,
1598,2019,1,NCAAF_20190829_ALBANY@CMICH,C. Michigan,,Albany,,1-0,0-1,,24,7,38,21,7,17,7,7,0,7,7,7,1,17,7,17,17,0.9321730863355889,23.214859626844145,,
1599,2019,1,NCAAF_20190829_MRGNST@BGREEN,Bowling Green,,Morgan St.,,1-0,0-1,,30,3,46,3,13,17,7,9,0,3,0,0,1,27,13,27,43,0.9967824695259949,42.39095849227681,,
1600,2019,1,NCAAF_20190829_ROB@BUFF,Buffalo,,Robert Morris,,1-0,0-1,,28,10,38,10,21,7,10,0,7,3,0,0,1,18,14,18,28,,,,
1601,2019,1,NCAAF_20190829_UCLA@CINCY,Cincinnati,Bearcats,UCLA,Bruins,1-0,0-1,1,10,7,24,14,7,3,7,7,0,7,7,0,1,3,7,3,10,0.48556097510906004,-0.5632089743967299,,
1602,2019,1,NCAAF_20190829_WAG@UCONN,UConn,Huskies,Wagner,Seahawks,1-0,0-1,0,10,0,24,21,7,3,14,0,0,0,14,7,1,10,7,10,3,0.9034063460620518,20.243872902514454,,
1603,2019,1,NCAAF_20190829_CAR@WKY,W. Kentucky,,Cent. Ark.,,0-1,1-0,,21,14,28,35,14,7,7,0,0,14,0,21,-1,7,14,7,-7,0.7745763188585935,11.73059513602243,,
1604,2019,1,NCAAF_20190829_FAMU@UCF,UCF,Knights,Florida A&M,Rattlers,1-0,0-1,0,48,0,62,0,17,31,7,7,0,0,0,0,1,48,17,48,62,0.9999985504743044,72.77676900840504,,
1605,2019,1,NCAAF_20190829_GRDWB@CHARLO,Charlotte,,Gardner-Webb,,1-0,0-1,,35,14,49,28,7,28,7,7,0,14,7,7,1,21,7,21,21,0.9558720962835611,26.520852563623293,,
1606,2019,1,NCAAF_20190829_ALST@UAB,UAB,Blazers,Alabama St.,Hornets,1-0,0-1,0,24,13,24,19,14,10,0,0,13,0,6,0,1,11,1,11,5,0.9865759315876158,34.440492011805304,,
1607,2019,1,NCAAF_20190829_FIU@TULANE,Tulane,Green Wave,FIU,Panthers,1-0,0-1,1,28,7,42,14,7,21,14,0,0,7,7,0,1,21,7,21,28,0.6197528994517569,4.742499549214813,0.45971468798792114,-1.4780221466922967
1608,2019,1,NCAAF_20190829_GATECH@CLEM,Clemson,Tigers,Georgia Tech,Yellow Jackets,1-0,0-1,1,28,0,52,14,14,14,14,10,0,0,7,7,1,28,14,28,38,0.9218533336580148,22.055431718127693,,
1609,2019,1,NCAAF_20190829_TXSTSM@TXAM,Texas A&M,Aggies,Texas St.,Bobcats,1-0,0-1,1,28,0,41,7,14,14,3,10,0,0,0,7,1,28,14,28,34,0.9922084509222623,37.62699149256764,,
1610,2019,1,NCAAF_20190829_SDST@MINN,Minnesota,Golden Gophers,S. Dakota St.,Jackrabbits,1-0,0-1,1,13,7,28,21,0,13,7,8,0,7,14,0,1,6,0,6,7,,,,
1611,2019,1,NCAAF_20190829_KENTST@ARIZST,Arizona St.,Sun Devils,Kent St.,Golden Flashes,1-0,0-1,0,10,0,30,7,10,0,17,3,0,0,0,7,1,10,10,10,23,0.9662823229692369,28.451421658375693,,
1612,2019,1,NCAAF_20190829_NCO@SJST,San Jose St.,Spartans,N. Colorado,Bears,1-0,0-1,1,21,6,35,18,14,7,7,7,3,3,9,3,1,15,11,15,17,0.39839119422210234,-4.006331970551628,,
1613,2019,1,NCAAF_20190829_UTAH@BYU,BYU,Cougars,Utah,Utes,0-1,1-0,1,6,9,12,30,0,6,0,6,3,6,7,14,-1,-3,-3,-3,-18,0.15911090437763886,-15.528485608330811,0.2242176466802802,-11.07613899506731
1614,2019,1,NCAAF_20190824_MIAMI@FLA,Florida,Gators,Miami (Fla.),Hurricanes,1-0,0-1,0,7,13,24,20,7,0,10,7,3,10,0,7,1,-6,4,-6,4,0.4146321344337578,-3.3549561222658895,0.8382205512046781,14.42435795316078
1615,2019,1,NCAAF_20190824_ARIZ@HAWAII,Hawaii,Rainbow Warriors,Arizona,Wildcats,1-0,0-1,1,28,21,45,38,14,14,7,10,0,21,14,3,1,7,14,7,7,0.08797498269484283,-21.05478886910771,,
1616,2019,2,NCAAF_20190908_OREGST@HAWAII,Hawaii,,Oregon State,,2-0,0-2,,21,28,31,28,7,14,7,3,14,14,0,0,2,-7,-7,-7,3,0.49163741910762004,-0.32551092822586725,,
1617,2019,2,NCAAF_20190907_OHIO@PITT,Pittsburgh,Panthers,Ohio,Bobcats,1-1,1-1,1,17,3,20,10,3,14,3,0,0,3,7,0,0,14,3,14,10,0.5387010229037679,1.50868567365751,0.4050555878796718,-3.5422217540858014
1618,2019,2,NCAAF_20190907_BGREEN@KSTATE,Kansas State,Wildcats,Bowling Green,Falcons,2-0,1-1,1,38,0,52,0,17,21,7,7,0,0,0,0,1,38,17,38,52,0.9535443265265742,26.0899871401607,0.9683321828728128,27.373168668513415
1619,2019,2,NCAAF_20190907_CHARSO@SC,South Carolina,Gamecocks,Charleston So.,Buccaneers,1-1,0-2,1,44,3,72,10,21,23,7,21,3,0,0,7,1,41,18,41,62,0.9892433002839367,35.695570690529166,,
1620,2019,2,NCAAF_20190907_CINCY@OHIOST,Ohio State,Buckeyes,Cincinnati,Bearcats,2-0,1-1,1,28,0,42,0,7,21,7,7,0,0,0,0,1,28,7,28,42,0.9674533638800057,28.642419805208192,,
1621,2019,2,NCAAF_20190907_CUSE@MD,Maryland,Terrapins,Syracuse,Orange,2-0,1-1,0,42,13,63,20,21,21,7,14,7,6,7,0,1,29,14,29,43,0.36516164792841566,-5.352283661246474,,
1622,2019,2,NCAAF_20190907_ODU@VATECH,Virginia Tech,Hokies,Old Dominion,Monarchs,1-1,1-1,1,17,3,31,17,10,7,7,7,3,0,7,7,0,14,7,14,14,0.9661766606118756,28.37435517870972,0.7546377794822436,10.15948305162874
1623,2019,2,NCAAF_20190907_RUT@IOWA,Iowa,Hawkeyes,Rutgers,Scarlet Knights,2-0,1-1,1,20,0,30,0,7,13,7,3,0,0,0,0,1,20,7,20,30,0.9642817480840519,27.991435855268264,0.9825062704017065,31.083344018507375
1624,2019,2,NCAAF_20190907_SO@MEMP,Memphis,Tigers,Southern U.,Jaguars,2-0,0-2,0,27,17,55,24,17,10,21,7,7,10,7,0,2,10,10,10,31,0.9999357251434959,59.45849207668607,,
1625,2019,2,NCAAF_20190907_UAB@AKRON,Akron,Zips,UAB,Blazers,0-2,2-0,1,6,17,20,31,6,0,0,14,7,10,14,0,-2,-11,-1,-11,-11,0.3901318371276401,-4.33181067596297,0.14178351209131212,-15.808337639879767
1626,2019,2,NCAAF_20190907_VANDY@PURDUE,Purdue,Boilermakers,Vanderbilt,Commodores,1-1,0-2,0,14,10,42,24,7,7,14,14,7,3,0,14,1,4,0,4,18,0.769679332907713,11.45610477850596,0.5287044698427745,1.0616176079449815
1627,2019,2,NCAAF_20190907_WVU@MIZZOU,Missouri,Tigers,West Virginia,Mountaineers,1-1,1-1,1,31,0,38,7,10,21,0,7,0,0,0,7,0,31,10,31,31,0.4789529266747373,-0.8195713352247367,0.46509421114425487,-1.291504897141749
1628,2019,2,NCAAF_20190907_WCAR@NCST,NC State,Wolfpack,W. Carolina,Catamounts,2-0,0-2,0,24,0,41,0,3,21,10,7,0,0,0,0,2,24,3,24,41,0.9998798300071463,57.022510915945986,,
1629,2019,2,NCAAF_20190907_NILL@UTAH,Utah,Utes,N. Illinois,Huskies,2-0,1-1,0,21,17,35,17,0,21,7,7,7,10,0,0,1,4,-7,4,18,0.7775168173369555,11.860480967488456,0.8755226453332791,16.995816673233094
1630,2019,2,NCAAF_20190907_FORD@BALLST,Ball St.,Cardinals,Fordham,Rams,1-1,0-2,1,28,14,57,29,14,14,22,7,14,0,15,0,1,14,0,14,28,0.9793303665180402,31.67796727875475,,
1631,2019,2,NCAAF_20190907_SFLA@GATECH,Georgia Tech,Yellow Jackets,South Florida,Bulls,1-1,0-2,1,14,3,14,10,0,14,0,0,3,0,0,7,1,11,-3,11,4,0.7395785449901461,9.969423991139138,0.8391989139644944,14.611739400467457
1632,2019,2,NCAAF_20190907_TNTECH@MIAOH,Miami-OH,RedHawks,Tenn. Tech,Golden Eagles,1-1,1-1,1,41,3,48,17,10,31,0,7,3,0,0,14,0,38,7,38,31,0.9964385617793334,41.785376962801365,,
1633,2019,2,NCAAF_20190907_CHARLO@APLST,App. St.,Mountaineers,Charlotte,49ers,2-0,1-1,1,28,13,56,41,14,14,14,14,6,7,15,13,1,15,8,15,15,0.927096749457567,22.584919802874538,0.9437021847445678,23.389992374167946
1634,2019,2,NCAAF_20190907_CMICH@WISC,Wisconsin,Badgers,C. Michigan,Chippewas,2-0,1-1,0,44,0,61,0,16,28,10,7,0,0,0,0,1,44,16,44,61,0.9806756291572938,32.10957545117117,0.9781791063317008,29.742002030861215
1635,2019,2,NCAAF_20190907_EIL@IND,Indiana,Hoosiers,E. Illinois,Panthers,2-0,0-2,1,35,0,52,0,21,14,7,10,0,0,0,0,2,35,21,35,52,0.9850247288097426,33.706376947533045,,
1636,2019,2,NCAAF_20190907_GRAM@LATECH,Louisiana Tech,Bulldogs,Grambling,Tigers,1-1,0-2,0,20,0,20,14,7,13,0,0,0,0,7,7,1,20,7,20,6,0.9371112122167381,23.77219574720766,,
1637,2019,2,NCAAF_20190907_ILL@UCONN,UConn,Huskies,Illinois,Fighting Illini,1-1,2-0,1,13,24,23,31,10,3,7,3,0,24,7,0,-1,-11,10,-11,-8,0.16041973173076052,-15.414751173928835,0.08280044199110326,-20.439322738814553
1638,2019,2,NCAAF_20190907_RICH@BC,Boston College,Eagles,Richmond,Spiders,2-0,1-1,1,35,10,45,13,21,14,10,0,0,10,0,3,1,25,21,25,32,,,,
1639,2019,2,NCAAF_20190907_SIL@MA,UMass,Minutemen,S. Illinois,Salukis,0-2,1-1,1,13,17,20,45,6,7,0,7,0,17,14,14,-1,-4,6,-4,-25,0.5894744558962177,3.512232189365477,,
1640,2019,2,NCAAF_20190907_TXAM@CLEM,Clemson,Tigers,Texas A&M,Aggies,2-0,1-1,0,17,3,24,10,0,17,7,0,0,3,0,7,1,14,0,14,14,0.9272635632212964,22.603635202327496,,
1641,2019,2,NCAAF_20190907_USM@MISSST,Miss. State,Bulldogs,So. Miss,Golden Eagles,2-0,1-1,0,21,0,38,15,7,14,7,10,0,0,7,8,1,21,7,21,23,0.9554385493500931,26.397531619616984,,
1642,2019,2,NCAAF_20190907_MURYST@UGA,Georgia,Bulldogs,Murray St.,Racers,2-0,1-1,1,42,7,63,17,7,35,7,14,7,0,10,0,1,35,0,35,46,0.9999922480232472,67.10090292351833,,
1643,2019,2,NCAAF_20190907_NMEXST@BAMA,Alabama,Crimson Tide,New Mexico St.,Aggies,2-0,0-2,1,38,0,62,10,21,17,24,0,0,0,7,3,2,38,21,38,52,0.9998887787842097,57.32876552343305,0.9999989008503654,69.7923299260662
1644,2019,2,NCAAF_20190907_TXSA@BAYLOR,Baylor,Bears,UTSA,Roadrunners,2-0,1-1,0,35,0,63,14,14,21,14,14,0,0,7,7,1,35,14,35,49,0.8673048926001447,17.2936950803728,0.9594286152795172,25.71125023391926
1645,2019,2,NCAAF_20190907_WIL@COLOST,Colorado St.,Rams,W. Illinois,Leathernecks,1-1,0-2,1,28,6,38,13,14,14,7,3,3,3,0,7,1,22,11,22,25,0.3632063339257444,-5.433119110479311,,
1646,2019,2,NCAAF_20190907_SDGST@UCLA,UCLA,Bruins,San Diego St.,Aztecs,0-2,2-0,0,7,10,14,23,7,0,7,0,10,0,10,3,-2,-3,-3,-3,-9,0.47213577314761057,-1.0854104488103076,,
1647,2019,2,NCAAF_20190907_NCO@WASHST,Washington St.,Cougars,N. Colorado,Bears,2-0,0-2,0,24,10,59,17,14,10,21,14,7,3,0,7,2,14,7,14,42,0.9973050492550852,43.209467846556436,,
1648,2019,2,NCAAF_20190907_GRDWB@ECU,East Carolina,Pirates,Gardner-Webb,Runnin' Bulldogs,1-1,0-2,1,31,7,48,9,17,14,7,10,0,7,2,0,1,24,17,24,39,0.9704369319389665,29.30447275715005,,
1649,2019,2,NCAAF_20190907_ME@GAS,Ga. Southern,Eagles,Maine,Black Bears,1-1,1-1,0,10,3,26,18,0,10,6,10,3,0,0,15,0,7,-3,7,8,0.7034926677933584,8.299059359176226,,
1650,2019,2,NCAAF_20190907_NCAT@DUKE,Duke,Blue Devils,NC A&T,Aggies,1-1,1-1,0,28,10,45,13,7,21,10,7,3,7,3,0,0,18,4,18,32,0.9253313307372136,22.388831748961366,,
1651,2019,2,NCAAF_20190907_CSTCAR@KANSAS,Kansas,Jayhawks,C. Carolina,Chanticleers,1-1,1-1,1,7,6,7,12,7,0,0,0,0,6,6,0,0,1,7,1,-5,0.7742274936687779,11.689803119439603,0.8331429097155982,14.250398803454345
1652,2019,2,NCAAF_20190907_EKY@LVILLE,Louisville,Cardinals,E. Kentucky,Colonels,1-1,1-1,0,14,0,42,0,14,0,14,14,0,0,0,0,0,14,14,14,42,0.888959614383137,18.959378357018522,,
1653,2019,2,NCAAF_20190907_FUR@GAST,Georgia St.,,Furman,,2-0,1-1,,17,20,48,42,3,14,21,10,13,7,8,14,1,-3,-10,-3,6,0.5011062865531033,0.04305877035130834,,
1654,2019,2,NCAAF_20190907_JACKST@SALA,South Alabama,,Jackson St.,,1-1,0-2,,19,7,37,14,13,6,8,10,7,0,0,7,1,12,6,12,23,0.9613639053769669,27.433141404484104,,
1655,2019,2,NCAAF_20190907_MCN@OKLAST,Oklahoma State,Cowboys,McNeese St.,Cowboys,2-0,1-1,1,28,0,56,14,14,14,28,0,0,0,7,7,1,28,14,28,42,0.9986690061397706,46.649371254955895,,
1656,2019,2,NCAAF_20190907_NTEXAS@SMU,SMU,Mustangs,North Texas,Mean Green,2-0,1-1,1,28,14,49,27,21,7,14,7,0,14,6,7,1,14,21,14,22,0.6688673068824059,6.782250219863727,0.48815454299506,-0.4377830978458519
1657,2019,2,NCAAF_20190907_SD@OKLA,Oklahoma,Sooners,South Dakota,Coyotes,2-0,0-2,1,28,0,70,14,14,14,28,14,0,0,14,0,2,28,14,28,56,0.9883875596797739,35.24315881754046,,
1658,2019,2,NCAAF_20190907_TNST@MTSU,Middle Tenn.,,Tennessee St.,,1-1,1-1,,10,6,45,26,0,10,14,21,6,0,13,7,0,4,-6,4,19,0.5731650724359398,2.86387410153975,,
1659,2019,2,NCAAF_20190907_UCF@FAU,FAU,Owls,UCF,Knights,0-2,2-0,0,6,28,14,48,0,6,0,8,14,14,13,7,-2,-22,-14,-22,-34,0.11556131814563009,-18.593830379864357,0.06289886916166587,-22.568155429698663
1660,2019,2,NCAAF_20190907_WKY@FIU,FIU,Panthers,W. Kentucky,Hilltoppers,0-2,1-1,0,7,14,14,20,7,0,7,0,7,7,3,3,-1,-7,0,-7,-6,0.6897358680175564,7.687727898199228,0.7999722513178782,12.405633401931823
1661,2019,2,NCAAF_20190907_WYO@TXSTSM,Texas St.,Bobcats,Wyoming,Cowboys,0-2,2-0,0,14,10,14,23,7,7,0,0,0,10,10,3,-2,4,7,4,-9,0.06519607202357092,-23.486339731748103,0.07753746905696757,-20.96050705475932
1662,2019,2,NCAAF_20190907_ARK@MISS,Ole Miss,Rebels,Arkansas,Razorbacks,1-1,1-1,1,10,3,31,17,7,3,7,14,0,3,0,14,0,7,7,7,14,0.7016588726013218,8.216842270598136,0.7162799895564814,8.429797168766243
1663,2019,2,NCAAF_20190907_BUFF@PSU,Penn State,Nittany Lions,Buffalo,Bulls,2-0,1-1,0,7,10,45,13,7,0,28,10,0,10,3,0,1,-3,7,-3,32,0.9734532686319698,30.032804505541662,0.9100247841432696,19.76752428375687
1664,2019,2,NCAAF_20190907_EMICH@UK,Kentucky,Wildcats,E. Michigan,Eagles,2-0,1-1,1,17,3,38,17,14,3,7,14,0,3,7,7,1,14,14,14,21,0.7689524491514208,11.418995978689509,,
1665,2019,2,NCAAF_20190907_LIB@LALAF,Louisiana,Ragin' Cajuns,Liberty,Flames,1-1,0-2,0,21,14,35,14,7,14,14,0,7,7,0,0,1,7,0,7,21,0.5127717368074267,0.4971845198274423,0.8036716101247121,12.60151027387036
1666,2019,2,NCAAF_20190907_LSU@TEXAS,Texas,Longhorns,LSU,Tigers,1-1,2-0,1,7,20,38,45,0,7,14,17,3,17,3,22,-1,-13,-3,-13,-7,0.4839109593150702,-0.6263850161540176,0.3369441664466063,-6.203649102298016
1667,2019,2,NCAAF_20190907_NEVADA@OREG,Oregon,Ducks,Nevada,Wolf Pack,1-1,1-1,1,35,6,77,6,7,28,28,14,3,3,0,0,0,29,4,29,71,0.8310167134327779,14.878374286786766,,
1668,2019,2,NCAAF_20190907_STONYBRK@UTAHST,Utah St.,Aggies,Stony Brook,Seawolves,1-1,1-1,0,34,0,62,7,17,17,14,14,0,0,7,0,0,34,17,34,55,0.8991246320766626,19.822178012090262,,
1669,2019,2,NCAAF_20190907_TNMART@FLA,Florida,Gators,UT Martin,Skyhawks,2-0,1-1,0,17,0,45,0,3,14,14,14,0,0,0,0,1,17,3,17,45,0.9895011282339398,35.83802071385753,,
1670,2019,2,NCAAF_20190907_TULANE@AUBURN,Auburn,Tigers,Tulane,Green Wave,2-0,1-1,1,14,6,24,6,0,14,7,3,3,3,0,0,1,8,-3,8,18,0.9310991448746355,23.043336077480035,0.876294250347333,17.051356647576256
1671,2019,2,NCAAF_20190907_WMICH@MICHST,Michigan St.,Spartans,W. Michigan,Broncos,2-0,1-1,1,31,7,51,17,21,10,6,14,0,7,0,10,1,24,21,24,34,0.8837588054221597,18.539743221263052,0.8917250913981087,18.21736757119379
1672,2019,2,NCAAF_20190907_MIAMI@UNC,North Carolina,Tar Heels,Miami (Fla.),Hurricanes,2-0,0-2,1,17,13,28,25,17,0,3,8,3,10,6,6,2,4,14,4,3,0.10647076197382921,-19.339862969147816,,
1673,2019,2,NCAAF_20190907_PRARIE@HOU,Houston,Cougars,Prairie View,Panthers,1-1,1-1,1,34,10,37,17,24,10,3,0,3,7,0,7,0,24,21,24,20,0.9990189582133383,48.071995926258296,,
1674,2019,2,NCAAF_20190907_UTEP@TXTECH,Texas Tech,Red Raiders,UTEP,Miners,2-0,1-1,0,21,0,38,3,7,14,10,7,0,0,0,3,1,21,7,21,35,0.9966948044498332,42.170702970213824,0.9962526943759212,39.42025375975169
1675,2019,2,NCAAF_20190907_TULSA@SJST,San Jose St.,Spartans,Tulsa,Golden Hurricane,1-1,1-1,0,10,17,16,34,3,7,0,6,7,10,3,14,0,-7,-4,-7,-18,0.1701503832300375,-14.806642846298928,0.3677613682297173,-4.97964053513914
1676,2019,2,NCAAF_20190907_ARKST@UNLV,UNLV,Rebels,Arkansas St.,Red Wolves,1-1,1-1,1,3,23,17,43,0,3,7,7,10,13,10,10,0,-20,-10,-20,-26,0.28242293909198246,-8.938581235998754,0.22227204056530547,-11.270806144103176
1677,2019,2,NCAAF_20190907_CAL@WASH,Washington,Huskies,California,Golden Bears,1-1,2-0,1,10,3,19,20,0,10,3,6,0,3,14,3,-1,7,0,7,-1,0.851192219751947,16.172901331438425,0.8199607111593339,13.492011750289919
1678,2019,2,NCAAF_20190907_STNFRD@USC,USC,Trojans,Stanford,Cardinal,2-0,1-1,1,24,20,45,20,3,21,7,14,7,13,0,0,1,4,-4,4,25,0.39492330122771935,-4.138249817032374,0.3605864045593694,-5.261262552838616
1679,2019,2,NCAAF_20190907_NAZ@ARIZ,Arizona,Wildcats,N. Arizona,Lumberjacks,1-1,1-1,1,51,13,65,41,21,30,7,7,7,6,14,14,0,38,14,38,24,0.9928026505419267,38.0,,
1680,2019,2,NCAAF_20190906_WAKE@RICE,Rice,Owls,Wake Forest,Demon Deacons,0-2,2-0,0,14,24,21,41,14,0,0,7,14,10,10,7,-2,-10,0,-10,-20,0.011820667919515304,-35.137469004368086,0.03709588102782835,-26.320612106880162
1681,2019,2,NCAAF_20190906_WMMARY@UVA,Virginia,Cavaliers,William & Mary,Tribe,2-0,1-1,0,35,3,52,17,21,14,7,10,0,3,7,7,1,32,21,32,35,0.9695977028483751,29.112854238801447,,
1682,2019,2,NCAAF_20190906_MRSHL@BOISE,Boise St.,Broncos,Marshall,Thundering Herd,2-0,1-1,0,7,7,14,7,0,7,7,0,7,0,0,0,1,0,-7,0,7,0.8143312557453711,13.881195033878612,0.8685250447394984,16.5027590926602
1683,2019,2,NCAAF_20190906_SACST@ARIZST,Arizona St.,Sun Devils,Sacramento St.,Hornets,2-0,1-1,1,3,0,19,7,0,3,6,10,0,0,0,7,1,3,0,3,12,0.9836035909598253,33.145318188867805,,
1684,2019,3,NCAAF_20190914_ARKST@UGA,Georgia,Bulldogs,Arkansas St.,Red Wolves,3-0,1-2,0,34,0,55,0,13,21,14,7,0,0,0,0,2,34,13,34,55,0.9835491246550524,33.22350801505712,0.9821269744863239,31.481288941251613
1685,2019,3,NCAAF_20190914_EMICH@ILL,Illinois,Fighting Illini,E. Michigan,Eagles,2-1,2-1,0,17,23,31,34,17,0,0,14,14,9,0,11,0,-6,3,-6,-3,0.4281021201916262,-2.8221181302071727,,
1686,2019,3,NCAAF_20190914_FUR@VATECH,Virginia Tech,Hokies,Furman,Paladins,2-1,1-2,1,3,14,24,17,3,0,14,7,0,14,0,3,1,-11,3,-11,7,0.9720303204763119,29.769645326409204,,
1687,2019,3,NCAAF_20190914_KSTATE@MISSST,Miss. State,Bulldogs,Kansas State,Wildcats,2-1,3-0,1,14,17,24,31,0,14,7,3,3,14,0,14,-1,-3,-3,-3,-7,0.6897920578842238,7.713149303021339,0.8223403831946461,13.85786942024989
1688,2019,3,NCAAF_20190914_MD@TEMPLE,Temple,Owls,Maryland,Terrapins,2-0,2-1,0,7,2,20,17,7,0,6,7,2,0,13,2,0,5,5,5,3,0.4357772161582013,-2.5180570598661802,,
1689,2019,3,NCAAF_20190914_MIAOH@CINCY,Cincinnati,Bearcats,Miami-OH,RedHawks,2-1,1-2,0,14,10,35,13,0,14,21,0,10,0,3,0,1,4,-10,4,22,0.664962917454319,6.635204486766838,,
1690,2019,3,NCAAF_20190914_NCST@WVU,West Virginia,Mountaineers,NC State,Wolfpack,2-1,2-1,0,21,21,44,27,14,7,10,13,7,14,6,0,0,0,7,0,17,0.49313047580501146,-0.2681857189250536,0.6400752569046827,5.377204560718731
1691,2019,3,NCAAF_20190914_OHIOST@IND,Indiana,Hoosiers,Ohio State,Buckeyes,2-1,3-0,1,10,30,10,51,3,7,0,0,7,23,21,0,-1,-20,-4,-20,-41,0.060827297878100706,-24.106319814527012,0.06745734891573218,-22.41375250022095
1692,2019,3,NCAAF_20190914_PITT@PSU,Penn State,Nittany Lions,Pittsburgh,Panthers,3-0,1-2,0,10,10,17,10,7,3,7,0,0,10,0,0,2,0,7,0,7,0.9425143976854463,24.548168637848903,0.8068108226319834,12.986550210311165
1693,2019,3,NCAAF_20190914_TNCHAT@TENN,Tennessee,Volunteers,Chattanooga,Mocs,1-2,1-2,1,38,0,45,0,21,17,7,0,0,0,0,0,0,38,21,38,45,0.9121974716627834,21.0934831104218,,
1694,2019,3,NCAAF_20190914_FAU@BALLST,Ball St.,Cardinals,FAU,Owls,1-2,1-2,0,17,21,31,41,14,3,7,7,7,14,13,7,0,-4,7,-4,-10,0.04802582682895362,-25.91971974528525,0.12048487528122176,-17.579685057469504
1695,2019,3,NCAAF_20190914_NRFST@CSTCAR,C. Carolina,Chanticleers,Norfolk St.,Spartans,2-1,1-2,1,19,7,46,7,12,7,14,13,0,7,0,0,1,12,12,12,39,0.878699302703581,18.198255644327503,,
1696,2019,3,NCAAF_20190914_NMEX@ND,Notre Dame,Fighting Irish,New Mexico,Lobos,2-0,1-1,1,38,7,66,14,7,31,14,14,0,7,0,7,1,31,7,31,52,0.9904949690232465,36.52600869116873,0.9917832183545399,35.96909621057456
1697,2019,3,NCAAF_20190914_AKRON@CMICH,C. Michigan,Chippewas,Akron,Zips,2-1,0-3,0,27,10,45,24,3,24,3,15,0,10,0,14,2,17,3,17,21,0.5229940477724873,0.8981391542144479,0.3561312586273808,-5.529516347790086
1698,2019,3,NCAAF_20190914_ARMY@TXSA,UTSA,Roadrunners,Army,Black Knights,1-2,2-1,0,0,10,13,31,0,0,7,6,10,0,7,14,-1,-10,-10,-10,-18,0.08938385154472628,-20.940036996689855,,
1699,2019,3,NCAAF_20190914_BAMA@SC,South Carolina,Gamecocks,Alabama,Crimson Tide,1-2,3-0,0,10,24,23,47,10,0,3,10,14,10,10,13,-2,-14,-4,-14,-24,0.04927301698853015,-25.727218049930286,0.021699675291830922,-30.282515651793496
1700,2019,3,NCAAF_20190914_ECU@NAVY,Navy,Midshipmen,East Carolina,Pirates,2-0,1-2,0,28,3,42,10,14,14,14,0,0,3,0,7,1,25,14,25,32,0.8434636530069406,15.710888693768652,0.7647126624543054,10.817743598782812
1701,2019,3,NCAAF_20190914_GAS@MINN,Minnesota,Golden Gophers,Ga. Southern,Eagles,3-0,1-2,0,21,20,35,32,14,7,0,14,10,10,0,12,2,1,4,1,3,0.8966807467469742,19.66770782642351,0.7122898113981695,8.397090582706497
1702,2019,3,NCAAF_20190914_MEMP@SALA,South Alabama,Jaguars,Memphis,Tigers,1-2,3-0,1,0,23,6,42,0,0,0,6,7,16,7,12,-2,-23,-7,-23,-36,0.02876409532051427,-29.579149566223066,0.039573688962027065,-26.32162995844726
1703,2019,3,NCAAF_20190914_OKLAST@TULSA,Tulsa,Golden Hurricane,Oklahoma State,Cowboys,1-2,3-0,0,21,20,21,40,7,14,0,0,17,3,13,7,-2,1,-10,1,-19,0.05938367216084339,-24.294803955001044,0.10591690987437419,-18.71870053923393
1704,2019,3,NCAAF_20190914_STNFRD@UCF,UCF,Knights,Stanford,Cardinal,3-0,1-2,0,38,7,45,27,28,10,0,7,7,0,3,17,2,31,21,31,18,0.7025785071853707,8.282688278750754,0.8198857440072045,13.71707181360349
1705,2019,3,NCAAF_20190914_UNLV@NWEST,Northwestern,Wildcats,UNLV,Rebels,1-1,1-2,1,16,14,30,14,10,6,7,7,7,7,0,0,0,2,3,2,16,0.9553015853819946,26.45365329841826,0.9492890305625049,24.557675130983817
1706,2019,3,NCAAF_20190914_ARIZST@MICHST,Michigan St.,Spartans,Arizona St.,Sun Devils,2-1,3-0,1,0,3,7,10,0,0,0,7,0,3,0,7,-1,-3,0,-3,-3,0.690491503152074,7.744032156390858,0.6205702048793529,4.602373884149237
1707,2019,3,NCAAF_20190914_BTHN@MIAMI,Miami (Fla.),Hurricanes,Bethune-Cook.,Wildcats,1-2,1-1,1,28,0,63,0,7,21,14,21,0,0,0,0,0,28,7,28,63,0.9958433280755854,41.10065600462116,,
1708,2019,3,NCAAF_20190914_COLOST@ARK,Arkansas,Razorbacks,Colorado St.,Rams,2-1,1-2,0,27,24,55,34,24,3,7,21,14,10,10,0,1,3,10,3,21,0.5121948858879739,0.47613808274786606,0.7565337084005146,10.422714085987735
1709,2019,3,NCAAF_20190914_IOWA@IOWAST,Iowa St.,Cyclones,Iowa,Hawkeyes,1-1,3-0,0,7,6,17,18,7,0,7,3,3,3,3,9,-2,1,4,1,-1,0.3539276025805478,-5.836137548076579,0.34729432194153087,-5.886583858267983
1710,2019,3,NCAAF_20190914_LVILLE@WKY,W. Kentucky,Hilltoppers,Louisville,Cardinals,1-2,2-1,1,7,31,21,38,0,7,7,7,7,24,7,0,-1,-24,-7,-24,-17,0.14916364268903126,-16.19728674827263,0.5436689038886848,1.6443942496906985
1711,2019,3,NCAAF_20190914_SELOU@MISS,Ole Miss,Rebels,SE Louisiana,Lions,2-1,1-1,1,27,17,40,29,13,14,7,6,3,14,12,0,1,10,10,10,11,0.8735144486476782,17.80350807339181,,
1712,2019,3,NCAAF_20190914_CPOLY@OREGST,Oregon State,Beavers,Cal-Poly,Mustangs,1-2,1-2,1,38,7,45,7,21,17,7,0,7,0,0,0,0,31,14,31,38,0.9635698686740596,27.934996261296874,,
1713,2019,3,NCAAF_20190914_IDST@UTAH,Utah,Utes,Idaho State,Bengals,3-0,1-1,1,24,0,31,0,17,7,7,0,0,0,0,0,2,24,17,24,31,0.9812250633937307,32.38959600340735,,
1714,2019,3,NCAAF_20190914_NTEXAS@CAL,California,Golden Bears,North Texas,Mean Green,3-0,1-2,1,20,3,23,17,20,0,3,0,0,3,7,7,2,17,20,17,6,0.7820799375468661,12.13576482698727,0.7180744786390778,8.652626935276366
1715,2019,3,NCAAF_20190914_IDAHO@WYO,Wyoming,Cowboys,Idaho,Vandals,3-0,1-2,1,14,10,21,16,0,14,0,7,3,7,3,3,2,4,-3,4,5,0.8734754388125066,17.80058131083001,,
1716,2019,3,NCAAF_20190914_LATECH@BGREEN,Bowling Green,Falcons,Louisiana Tech,Bulldogs,1-2,2-1,1,7,21,7,35,7,0,0,0,14,7,0,14,-1,-14,-7,-14,-28,0.2917452341405097,-8.539070503348455,0.13249189536185035,-16.711957089468783
1717,2019,3,NCAAF_20190914_BUFF@LIB,Liberty,Flames,Buffalo,Bulls,1-2,1-2,1,28,7,35,17,7,21,7,0,0,7,3,7,0,21,7,21,18,0.15846360546707716,-15.586247472216257,0.17067535723117544,-14.26534798802242
1718,2019,3,NCAAF_20190914_MA@CHARLO,Charlotte,49ers,UMass,Minutemen,2-1,0-3,1,31,10,52,17,21,10,14,7,0,10,0,7,2,21,21,21,35,0.36330647917510817,-5.445176575227833,,
1719,2019,3,NCAAF_20190914_SCST@SFLA,South Florida,Bulls,SC State,Bulldogs,1-2,2-1,1,24,3,55,16,7,17,17,14,3,0,6,7,-1,21,4,21,39,0.855896890792954,16.540500736854312,,
1720,2019,3,NCAAF_20190914_USM@TROY,Troy,,So. Miss,,1-1,2-1,,14,17,42,47,7,7,7,21,14,3,9,21,-1,-3,-7,-3,-5,0.6254634485790599,4.9814979820635585,,
1721,2019,3,NCAAF_20190914_OHIO@MRSHL,Marshall,Thundering Herd,Ohio,Bobcats,2-1,1-2,1,27,17,33,31,10,17,0,6,3,14,7,7,1,10,7,10,2,0.35654576154342954,-5.7266389476795325,0.31408799189317493,-7.260797619728294
1722,2019,3,NCAAF_20190914_DUKE@MTSU,Middle Tenn.,Blue Raiders,Duke,Blue Devils,1-2,2-1,1,3,31,18,41,3,0,8,7,14,17,10,0,-1,-28,-11,-28,-23,0.2966758375863461,-8.316238358189366,0.6039125097335946,3.950330357251694
1723,2019,3,NCAAF_20190914_FLA@UK,Kentucky,Wildcats,Florida,Gators,2-1,3-0,0,14,7,21,29,0,14,7,0,7,0,3,19,-1,7,-7,7,-8,0.4155050973129828,-3.323567439558701,0.4680753867500128,-1.2010291598037952
1724,2019,3,NCAAF_20190914_GAST@WMICH,W. Michigan,,Georgia St.,,2-1,2-1,,43,10,57,10,24,19,14,0,10,0,0,0,0,33,14,33,47,0.755130784902581,10.757285941739497,0.568480221919975,2.586297458161262
1725,2019,3,NCAAF_20190914_KENTST@AUBURN,Auburn,Tigers,Kent St.,Golden Flashes,3-0,1-2,0,24,10,55,16,14,10,14,17,3,7,0,6,2,14,11,14,39,0.9985074487830714,46.24310346834926,,
1726,2019,3,NCAAF_20190914_LAMAR@TXAM,Texas A&M,Aggies,Lamar,Cardinals,2-1,2-1,1,27,0,62,3,13,14,21,14,0,0,3,0,0,27,13,27,59,0.9999971035447521,70.60913993924038,,
1727,2019,3,NCAAF_20190914_MURYST@TOLEDO,Toledo,,Murray St.,,1-1,1-2,,17,0,45,0,3,14,21,7,0,0,0,0,0,17,3,17,45,0.9770070738453044,31.078092999597573,,
1728,2019,3,NCAAF_20190914_NH@FIU,FIU,,New Hamp.,,1-2,0-2,,13,10,30,17,7,6,7,10,10,0,7,0,1,3,-3,3,13,0.6871360201600281,7.596150798984922,,
1729,2019,3,NCAAF_20190914_TXSTSM@SMU,SMU,Mustangs,Texas St.,Bobcats,3-0,0-3,1,13,3,47,17,7,6,21,13,3,0,7,7,3,10,4,10,30,0.9472423250126145,25.20922927763735,0.8838395609466341,17.907051032134
1730,2019,3,NCAAF_20190914_WBRST@NEVADA,Nevada,Wolf Pack,Weber St.,Wildcats,2-1,1-2,1,9,10,19,13,3,6,7,3,0,10,3,0,1,-1,3,-1,6,0.4416706663782526,-2.285234540229794,,
1731,2019,3,NCAAF_20190914_CLEM@CUSE,Syracuse,Orange,Clemson,Tigers,1-2,3-0,0,6,17,6,41,0,6,0,0,14,3,10,14,-2,-11,-14,-11,-35,0.045410528195874655,-26.33676176225066,,
1732,2019,3,NCAAF_20190914_FSU@UVA,Virginia,Cavaliers,Florida State,Seminoles,3-0,1-2,1,10,14,31,24,3,7,0,21,0,14,3,7,2,-4,3,-4,7,0.44311352585905606,-2.2283136752960786,,
1733,2019,3,NCAAF_20190914_HAWAII@WASH,Washington,Huskies,Hawaii,Rainbow Warriors,2-1,2-1,1,38,7,52,20,21,17,0,14,0,7,13,0,0,31,21,31,32,0.9891424883358968,35.74703865339757,,
1734,2019,3,NCAAF_20190914_NWST@LSU,LSU,Tigers,Northwestern St.,Demons,3-0,0-3,0,24,14,65,14,3,21,27,14,7,7,0,0,3,10,-4,10,51,0.9998543605772939,56.4232574303789,,
1735,2019,3,NCAAF_20190914_SEMOST@MIZZOU,Missouri,Tigers,SE Missouri St.,Redhawks,2-1,1-2,1,37,0,50,0,27,10,10,3,0,0,0,0,1,37,27,37,50,0.9984919503947844,46.19364785611674,,
1736,2019,3,NCAAF_20190914_TCU@PURDUE,Purdue,Boilermakers,TCU,Horned Frogs,1-2,2-0,1,6,13,13,34,3,3,0,7,10,3,14,7,-1,-7,-7,-7,-21,0.4915090850132158,-0.3314933432986322,0.7651372366319079,10.838453893516991
1737,2019,3,NCAAF_20190914_TXSO@LALAF,Louisiana,,Texas Southern,,2-1,0-3,,56,6,77,6,28,28,7,14,3,3,0,0,2,50,25,50,71,0.9795592844769507,31.844444399849976,,
1738,2019,3,NCAAF_20190914_MOST@TULANE,Tulane,Green Wave,Missouri St.,Bears,2-1,0-2,1,38,6,58,6,10,28,13,7,0,6,0,0,2,32,10,32,52,0.7850048759876659,12.291057737364099,,
1739,2019,3,NCAAF_20190914_NILL@NEB,Nebraska,Cornhuskers,N. Illinois,Huskies,2-1,1-2,1,30,5,44,8,10,20,7,7,0,5,3,0,1,25,10,25,36,0.6178388427677399,4.669208582958788,0.7722479426140341,11.188448178323071
1740,2019,3,NCAAF_20190914_OKLA@UCLA,UCLA,Bruins,Oklahoma,Sooners,0-3,3-0,0,7,34,14,48,0,7,7,0,17,17,7,7,-3,-27,-17,-27,-34,0.05401976017849419,-25.028323619846446,0.05548070570746977,-23.896324858272898
1741,2019,3,NCAAF_20190914_SDGST@NMEXST,New Mexico St.,Aggies,San Diego St.,Aztecs,0-3,3-0,0,0,17,10,31,0,0,10,0,7,10,7,7,-3,-17,-7,-17,-21,0.06460839585738787,-23.62869580720468,,
1742,2019,3,NCAAF_20190914_TEXAS@RICE,Rice,Owls,Texas,Longhorns,0-3,2-1,0,0,31,13,48,0,0,0,13,14,17,7,10,-2,-31,-14,-31,-35,0.00339693120158302,-42.1551901497474,0.003139562822606301,-40.972032770630676
1743,2019,3,NCAAF_20190914_PORTST@BOISE,Boise St.,Broncos,Portland St.,Vikings,3-0,1-2,0,28,10,45,10,14,14,10,7,10,0,0,0,2,18,4,18,35,0.9797418116548761,31.902299324924,,
1744,2019,3,NCAAF_20190914_TXTECH@ARIZ,Arizona,Wildcats,Texas Tech,Red Raiders,2-1,2-1,1,13,7,28,14,0,13,0,15,7,0,7,0,0,6,-7,6,14,0.2644451251208364,-9.806904636926674,0.23029413112757913,-11.062633949376796
1745,2019,3,NCAAF_20190914_MT@OREG,Oregon,Ducks,Montana,Grizzlies,2-1,2-1,1,21,0,35,3,14,7,7,7,0,0,3,0,0,21,14,21,32,0.9990867407180928,48.54511936687351,,
1746,2019,3,NCAAF_20190913_UNC@WAKE,Wake Forest,Demon Deacons,North Carolina,Tar Heels,3-0,2-1,0,21,0,24,18,7,14,0,3,0,0,3,15,1,21,7,21,6,0.7675399314647172,11.38093202571963,,
1747,2019,3,NCAAF_20190913_KANSAS@BC,Boston College,Eagles,Kansas,Jayhawks,2-1,2-1,1,24,28,24,48,17,7,0,0,7,21,13,7,0,-4,10,-4,-24,0.8849105870774032,18.68710578060052,0.7000557469141637,7.864471467114676
1748,2019,3,NCAAF_20190913_WASHST@HOU,Houston,Cougars,Washington St.,Cougars,1-2,3-0,1,14,7,24,31,0,14,0,10,0,7,14,10,-2,7,0,7,-7,0.284867789226103,-8.852847098234918,0.15949035762287167,-14.94083243916495
1749,2019,4,NCAAF_20190922_CAR@HAWAII,Hawaii,,Cent. Ark.,,3-1,3-1,,28,9,35,16,14,14,0,7,0,9,0,7,0,19,14,19,19,0.49044775449482314,-0.3731040032262172,,
1750,2019,4,NCAAF_20190921_BC@RUT,Rutgers,Scarlet Knights,Boston College,Eagles,1-2,3-1,0,13,17,16,30,7,6,0,3,7,10,7,6,-2,-4,0,-4,-14,0.17045972026401568,-14.838487720063313,0.285880052145157,-8.548481052859543
1751,2019,4,NCAAF_20190921_CAL@MISS,Ole Miss,Rebels,California,Golden Bears,2-2,4-0,1,13,14,20,28,7,6,0,7,7,7,14,0,-2,-1,0,-1,-8,0.4579686780887804,-1.6446057968037167,0.4260580118394022,-2.818232494491724
1752,2019,4,NCAAF_20190921_ELON@WAKE,Wake Forest,Demon Deacons,Elon,Phoenix,4-0,2-2,1,28,7,49,7,14,14,14,7,7,0,0,0,2,21,7,21,42,0.9950556284653799,40.19402168603665,,
1753,2019,4,NCAAF_20190921_LAMON@IOWAST,Iowa St.,Cyclones,UL-Monroe,Warhawks,2-1,1-2,0,27,13,72,20,14,13,21,24,0,13,7,0,1,14,14,14,52,0.9808895966334807,32.29111949735568,,
1754,2019,4,NCAAF_20190921_LSU@VANDY,Vanderbilt,Commodores,LSU,Tigers,0-3,4-0,1,17,38,38,66,7,10,14,7,28,10,21,7,-4,-21,-21,-21,-28,0.15685746759118102,-15.697112165781164,,
1755,2019,4,NCAAF_20190921_MICH@WISC,Wisconsin,Badgers,Michigan,Wolverines,3-0,2-1,1,28,0,35,14,14,14,7,0,0,0,8,6,1,28,14,28,21,0.4538828423362482,-1.8051619653699618,,
1756,2019,4,NCAAF_20190921_MICHST@NWEST,Northwestern,Wildcats,Michigan St.,Spartans,1-2,3-1,0,3,14,10,31,0,3,0,7,7,7,10,7,-2,-11,-7,-11,-21,0.47141718821757495,-1.117274644053964,0.48558127260474604,-0.5465093394348628
1757,2019,4,NCAAF_20190921_MRGNST@ARMY,Army,Black Knights,Morgan St.,Bears,3-1,0-3,0,24,14,52,21,7,17,7,21,14,0,7,0,3,10,-7,10,31,0.9999779181985026,63.640926321571214,,
1758,2019,4,NCAAF_20190921_TENN@FLA,Florida,Gators,Tennessee,Volunteers,4-0,1-3,1,17,0,34,3,7,10,7,10,0,0,3,0,3,17,7,17,31,0.8165250944544967,14.057126857880803,0.8845723854644083,18.113421562919775
1759,2019,4,NCAAF_20190921_UCONN@IND,Indiana,Hoosiers,UConn,Huskies,3-1,1-2,1,17,3,38,3,7,10,14,7,3,0,0,0,2,14,4,14,35,0.9608845772956071,27.438689366812355,0.9829467500386696,32.03156951531372
1760,2019,4,NCAAF_20190921_USM@BAMA,Alabama,Crimson Tide,So. Miss,Golden Eagles,4-0,2-2,0,28,7,49,7,14,14,14,7,0,7,0,0,2,21,14,21,42,0.9972329056116134,43.22418955564308,0.9988672676732854,46.15477223813086
1761,2019,4,NCAAF_20190921_WMICH@CUSE,Syracuse,Orange,W. Michigan,Broncos,2-2,2-2,1,24,13,52,33,14,10,14,14,0,13,20,0,0,11,14,11,19,0.7761427698941656,11.829512707832237,,
1762,2019,4,NCAAF_20190921_CSTCAR@MA,UMass,Minutemen,C. Carolina,Chanticleers,0-4,3-1,0,14,42,28,62,7,7,7,7,14,28,14,6,-3,-28,-7,-28,-34,0.5153261573680923,0.598719052021238,,
1763,2019,4,NCAAF_20190921_LALAF@OHIO,Ohio,Bobcats,Louisiana,Ragin' Cajuns,1-3,3-1,1,6,10,25,45,0,6,6,13,7,3,14,21,-2,-4,-7,-4,-20,0.8244462702782349,14.528321525043793,0.6836535468999293,7.225360549291516
1764,2019,4,NCAAF_20190921_CCTST@EMICH,E. Michigan,Eagles,CCSU,Blue Devils,3-1,3-1,0,21,15,34,29,7,14,0,13,15,0,0,14,0,6,-8,6,5,0.9824115114683347,32.81832170497421,,
1765,2019,4,NCAAF_20190921_TROY@AKRON,Akron,Zips,Troy,Trojans,0-4,2-1,1,7,21,7,35,7,0,0,0,7,14,14,0,-2,-14,0,-14,-28,0.23648337751777704,-11.181805385699363,0.0910951934993327,-20.167652467629573
1766,2019,4,NCAAF_20190921_APLST@UNC,North Carolina,Tar Heels,App. St.,Mountaineers,2-2,3-0,1,17,27,31,34,7,10,7,7,13,14,7,0,-1,-10,-6,-10,-3,0.39254716953611646,-4.24870297955556,,
1767,2019,4,NCAAF_20190921_AUBURN@TXAM,Texas A&M,Aggies,Auburn,Tigers,2-2,4-0,0,3,14,20,28,0,3,0,17,14,0,7,7,-2,-11,-14,-11,-8,0.26135808780335235,-9.958762544961473,,
1768,2019,4,NCAAF_20190921_BGREEN@KENTST,Kent St.,Golden Flashes,Bowling Green,Falcons,2-2,1-3,1,24,7,62,20,21,3,17,21,7,0,0,13,1,17,14,17,42,0.38500022626207575,-4.55545956572189,,
1769,2019,4,NCAAF_20190921_LVILLE@FSU,Florida State,Seminoles,Louisville,Cardinals,2-2,2-2,1,21,7,35,24,21,0,0,14,0,7,10,7,0,14,21,14,11,0.638230150003575,5.51146948965561,0.8723529640741916,17.19767586185081
1770,2019,4,NCAAF_20190921_MIAOH@OHIOST,Ohio State,Buckeyes,Miami-OH,RedHawks,4-0,1-3,0,49,5,76,5,7,42,14,13,5,0,0,0,3,44,2,44,71,0.9928878628286415,38.19738274653571,0.9833296848017193,32.16984973331278
1771,2019,4,NCAAF_20190921_SALA@UAB,UAB,Blazers,South Alabama,Jaguars,3-0,1-3,0,28,3,35,3,14,14,7,0,3,0,0,0,2,25,11,25,32,0.8177158676531475,14.127134302540753,0.9153080803062803,20.77455678112394
1772,2019,4,NCAAF_20190921_SMU@TCU,TCU,Horned Frogs,SMU,Mustangs,2-1,4-0,0,17,31,38,41,7,10,7,14,18,13,0,10,-2,-14,-11,-14,-3,0.8262937222240947,14.640139308814355,0.6607807936254246,6.267728759045994
1773,2019,4,NCAAF_20190921_TEMPLE@BUFF,Buffalo,Bulls,Temple,Owls,2-2,2-1,1,24,7,38,22,0,24,7,7,7,0,3,12,0,17,-7,17,16,0.318243557703652,-7.363791431035793,,
1774,2019,4,NCAAF_20190921_UCF@PITT,Pittsburgh,Panthers,UCF,Knights,2-2,3-1,0,21,10,35,34,7,14,7,7,0,10,21,3,-1,11,7,11,1,0.16102721502035888,-15.428922945422869,0.1796754448134118,-13.856937316981544
1775,2019,4,NCAAF_20190921_WASH@BYU,BYU,Cougars,Washington,Huskies,2-2,3-1,0,12,24,19,45,3,9,7,0,21,3,21,0,-1,-12,-18,-12,-26,0.07281017361885023,-22.672986506904067,,
1776,2019,4,NCAAF_20190921_WYO@TULSA,Tulsa,Golden Hurricane,Wyoming,Cowboys,2-2,3-1,1,14,7,24,21,0,14,3,7,7,0,0,14,-1,7,-7,7,3,0.3893206023794522,-4.379643140624921,0.358301948695681,-5.487750329910774
1777,2019,4,NCAAF_20190921_CMICH@MIAMI,Miami (Fla.),Hurricanes,C. Michigan,Chippewas,2-2,2-2,0,7,2,17,12,7,0,7,3,0,2,3,7,0,5,7,5,5,0.9516466351436986,25.88042309956427,0.982243680624295,31.784452401288895
1778,2019,4,NCAAF_20190921_SC@MIZZOU,Missouri,Tigers,South Carolina,Gamecocks,3-1,1-3,1,17,7,34,14,7,10,14,3,0,7,7,0,2,10,7,10,20,0.6128642483112965,4.4684838883200655,0.7936635819982485,12.384417893331793
1779,2019,4,NCAAF_20190921_UK@MISSST,Miss. State,Bulldogs,Kentucky,Wildcats,3-1,2-2,0,21,3,28,13,7,14,0,7,3,0,7,3,1,18,4,18,15,0.7139418922655313,8.802245291028271,0.565640912265323,2.4987600429785246
1780,2019,4,NCAAF_20190921_NMEXST@NMEX,New Mexico,Lobos,New Mexico St.,Aggies,2-1,0-4,0,31,31,55,52,14,17,17,7,17,14,7,14,2,0,-3,0,3,0.6182266384933197,4.687154088055308,0.5998204754200843,3.823004725289536
1781,2019,4,NCAAF_20190921_WVU@KANSAS,Kansas,Jayhawks,West Virginia,Mountaineers,2-2,3-1,1,7,10,24,29,0,7,10,7,7,3,10,9,-1,-3,-7,-3,-5,0.08534804665453133,-21.34539656328832,0.07268316595482527,-22.012829980289688
1782,2019,4,NCAAF_20190921_HAMP@LIB,Liberty,Flames,Hampton,Pirates,2-2,2-2,1,41,12,62,27,27,14,7,14,12,0,8,7,0,29,15,29,35,0.9964896155811103,42.00393052743141,,
1783,2019,4,NCAAF_20190921_WAG@FAU,FAU,Owls,Wagner,Seahawks,2-2,0-4,1,28,7,42,7,14,14,7,7,0,7,0,0,2,21,14,21,35,0.9927640889565588,38.10053782429907,,
1784,2019,4,NCAAF_20190921_WMMARY@ECU,East Carolina,Pirates,William & Mary,Tribe,2-2,2-2,1,10,7,19,7,7,3,3,6,0,7,0,0,0,3,7,3,12,0.7582197325238988,10.915793869867116,,
1785,2019,4,NCAAF_20190921_BALLST@NCST,NC State,Wolfpack,Ball St.,Cardinals,3-1,1-3,0,20,7,34,23,6,14,7,7,7,0,6,10,2,13,-1,13,11,0.9916606486152565,37.29627315805908,0.982893939383691,32.01270806390144
1786,2019,4,NCAAF_20190921_BAYLOR@RICE,Rice,Owls,Baylor,Bears,0-4,3-0,0,3,21,13,21,0,3,3,7,7,14,0,0,-3,-18,-7,-18,-8,0.042856106929040405,-26.775226795925505,0.019670750159547334,-31.151517564374863
1787,2019,4,NCAAF_20190921_ODU@UVA,Virginia,Cavaliers,Old Dominion,Monarchs,4-0,1-2,0,7,17,28,17,0,7,7,14,10,7,0,0,3,-10,-10,-10,11,0.9352280275652964,23.619153876399537,,
1788,2019,4,NCAAF_20190921_OREG@STNFRD,Stanford,Cardinal,Oregon,Ducks,1-3,3-1,1,3,14,6,21,3,0,0,3,7,7,0,7,-2,-11,-4,-11,-15,0.5310956895232539,1.2156920930668775,,
1789,2019,4,NCAAF_20190921_SIL@ARKST,Arkansas St.,Red Wolves,S. Illinois,Salukis,2-2,2-2,1,31,14,41,28,14,17,7,3,14,0,14,0,0,17,0,17,13,0.6386123488873097,5.527363065337568,,
1790,2019,4,NCAAF_20190921_CHARLO@CLEM,Clemson,Tigers,Charlotte,49ers,4-0,2-2,0,38,3,52,10,17,21,7,7,0,3,7,0,2,35,17,35,42,0.999648956030835,52.80002479703728,0.9993169145158249,48.4024534619202
1791,2019,4,NCAAF_20190921_OKLAST@TEXAS,Texas,Longhorns,Oklahoma State,Cowboys,3-1,3-1,0,21,20,36,30,0,21,7,8,3,17,3,7,0,1,-3,1,6,0.5075429773741473,0.2946128005810351,0.7103476898792769,8.38127208502452
1792,2019,4,NCAAF_20190921_SJST@ARK,Arkansas,Razorbacks,San Jose St.,Spartans,2-2,2-1,0,7,24,24,31,7,0,3,14,7,17,0,7,0,-17,0,-17,-7,0.8782913061042741,18.174944565160217,,
1793,2019,4,NCAAF_20190921_TXSA@NTEXAS,North Texas,Mean Green,UTSA,Roadrunners,2-2,1-3,0,24,3,45,3,7,17,14,7,0,3,0,0,1,21,7,21,42,0.7585607828487716,10.932825199919307,0.8972326174916967,19.138110991508455
1794,2019,4,NCAAF_20190921_ND@UGA,Georgia,Bulldogs,Notre Dame,Fighting Irish,4-0,2-1,0,7,10,23,17,0,7,6,10,0,10,0,7,2,-3,0,-3,6,0.6926762823097143,7.844223179659139,0.663830445974879,6.393884705915497
1795,2019,4,NCAAF_20190921_NEB@ILL,Illinois,Fighting Illini,Nebraska,Cornhuskers,2-2,3-1,1,21,14,38,42,14,7,14,3,7,7,13,15,-1,7,7,7,-4,0.2311263812611679,-11.454192506570848,0.13372694265010998,-16.764714730324563
1796,2019,4,NCAAF_20190921_NEVADA@UTEP,UTEP,Miners,Nevada,Wolf Pack,1-2,3-1,0,14,21,21,37,7,7,7,0,0,21,3,13,-2,-7,7,-7,-16,0.09061253457967555,-20.83156900110305,0.10886435446611675,-18.633946153389907
1797,2019,4,NCAAF_20190921_COLO@ARIZST,Arizona St.,Sun Devils,Colorado,Buffaloes,3-1,3-1,0,21,24,31,34,0,21,3,7,14,10,7,3,0,-3,-14,-3,-3,0.6400137995609602,5.585691172677798,,
1798,2019,4,NCAAF_20190921_SACST@FRESNO,Fresno St.,Bulldogs,Sacramento St.,Hornets,1-2,2-2,1,14,12,34,20,7,7,0,20,6,6,0,8,-1,2,1,2,14,0.9644913329145439,28.12926589215988,,
1799,2019,4,NCAAF_20190921_TOLEDO@COLOST,Colorado St.,Rams,Toledo,Rockets,1-3,2-1,1,13,14,35,41,7,6,14,8,7,7,21,6,-1,-1,0,-1,-6,0.2774980628058741,-9.197261803562583,0.11682185553304825,-18.005578186129853
1800,2019,4,NCAAF_20190921_UCLA@WASHST,Washington St.,Cougars,UCLA,Bruins,3-1,1-3,1,35,17,63,67,7,28,14,14,10,7,21,29,2,18,-3,18,-4,0.7800319223677383,12.033157718967686,0.8546518596544459,15.973307582317638
1801,2019,4,NCAAF_20190921_UTAHST@SDGST,San Diego St.,Aztecs,Utah St.,Aggies,3-1,2-1,1,3,20,17,23,3,0,0,14,7,13,3,0,1,-17,-4,-17,-6,0.3969528886021134,-4.07039203764964,,
1802,2019,4,NCAAF_20190920_FIU@LATECH,Louisiana Tech,Bulldogs,FIU,Panthers,3-1,1-3,1,13,10,43,31,0,13,14,16,0,10,14,7,2,3,0,3,12,0.46986489903227446,-1.1780649024080958,0.4283557047388197,-2.729684293620373
1803,2019,4,NCAAF_20190920_AF@BOISE,Boise St.,Broncos,Air Force,Falcons,4-0,2-1,1,10,10,30,19,0,10,7,13,0,10,3,6,2,0,0,0,11,0.8007261714314616,13.153688350590528,0.7464294582313651,10.027517522487074
1804,2019,4,NCAAF_20190920_UTAH@USC,USC,Trojans,Utah,Utes,3-1,3-1,1,14,10,30,23,14,0,7,9,7,3,7,6,0,4,7,4,7,0.45655893191604,-1.6999823014126605,0.3297996643335368,-6.658845564062588
1805,2019,4,NCAAF_20190919_HOU@TULANE,Tulane,Green Wave,Houston,Cougars,3-1,1-3,0,14,28,38,31,7,7,7,17,14,14,0,3,2,-14,-7,-14,7,0.37821325626624047,-4.832838750327028,0.3746912555155286,-4.82940951658302
1806,2019,5,NCAAF_20190928_BUFF@MIAOH,Miami-OH,RedHawks,Buffalo,Bulls,2-3,2-3,0,13,14,34,20,0,13,21,0,7,7,0,6,0,-1,-7,-1,14,0.3613426336463603,-5.53668826056014,0.4979690791059388,-0.07727717835945214
1807,2019,5,NCAAF_20190928_BYU@TOLEDO,Toledo,Rockets,BYU,Cougars,3-1,2-3,1,3,7,28,21,0,3,11,14,0,7,14,0,1,-4,0,-4,7,0.6162790653295991,4.613841014665752,,
1808,2019,5,NCAAF_20190928_CMICH@WMICH,W. Michigan,Broncos,C. Michigan,Chippewas,3-2,2-3,0,17,0,31,15,10,7,7,7,0,0,0,15,1,17,10,17,16,0.6217169502085187,4.836488941487062,0.7916940126949756,12.330761992803104
1809,2019,5,NCAAF_20190928_HOLY@CUSE,Syracuse,Orange,Holy Cross,Crusaders,3-2,1-3,0,24,3,41,3,17,7,10,7,0,3,0,0,2,21,17,21,38,0.996644351143355,42.29430432060997,,
1810,2019,5,NCAAF_20190928_KANSAS@TCU,TCU,Horned Frogs,Kansas,Jayhawks,3-1,2-3,0,38,0,51,14,21,17,0,13,0,0,0,14,1,38,21,38,37,0.9124651963589794,21.15764992717476,0.6330187533857569,5.159000717258735
1811,2019,5,NCAAF_20190928_MTSU@IOWA,Iowa,Hawkeyes,Middle Tenn.,Blue Raiders,4-0,1-3,1,24,0,48,3,17,7,10,14,0,0,3,0,3,24,17,24,45,0.950817200213618,25.787307317952866,0.9336731495551869,22.826176122990063
1812,2019,5,NCAAF_20190928_NILL@VANDY,Vanderbilt,Commodores,N. Illinois,Huskies,1-3,1-3,1,14,0,24,18,14,0,7,3,0,0,10,8,0,14,14,14,6,0.5972854673994881,3.8431744804497043,,
1813,2019,5,NCAAF_20190928_NWEST@WISC,Wisconsin,Badgers,Northwestern,Wildcats,4-0,1-3,1,7,3,24,15,7,0,7,10,3,0,0,12,3,4,4,4,9,0.7947811448123934,12.842306575019222,,
1814,2019,5,NCAAF_20190928_RUT@MICH,Michigan,Wolverines,Rutgers,Scarlet Knights,3-1,1-3,1,24,0,52,0,14,10,14,14,0,0,0,0,2,24,14,24,52,0.9747058183785227,30.50104933457743,,
1815,2019,5,NCAAF_20190928_TXAM@ARK,Arkansas,Razorbacks,Texas A&M,Aggies,2-3,3-2,1,17,21,27,31,0,17,7,3,7,14,0,10,-1,-4,-7,-4,-4,0.12673200357823355,-17.817015052764077,,
1816,2019,5,NCAAF_20190928_TXTECH@OKLA,Oklahoma,Sooners,Texas Tech,Red Raiders,4-0,2-2,0,34,10,55,16,17,17,14,7,0,10,6,0,2,24,17,24,39,0.8472555081894729,15.987806595062523,0.8694967114613557,17.06234123543922
1817,2019,5,NCAAF_20190928_DE@PITT,Pittsburgh,Panthers,Delaware,Fightin' Blue Hens,3-2,3-2,0,10,7,17,14,0,10,0,7,0,7,7,0,0,3,0,3,3,0.9526190046372646,26.06762062265659,,
1818,2019,5,NCAAF_20190928_AKRON@MA,UMass,Minutemen,Akron,Zips,1-4,0-5,1,20,14,37,29,7,13,14,3,7,7,7,8,1,6,0,6,8,0.38220656205756964,-4.67574897865137,,
1819,2019,5,NCAAF_20190928_CLEM@UNC,North Carolina,Tar Heels,Clemson,Tigers,2-3,5-0,1,14,14,20,21,7,7,0,6,0,14,0,7,-3,0,7,0,-1,0.011228322218358122,-35.6122217950948,,
1820,2019,5,NCAAF_20190928_CSTCAR@APLST,App. St.,Mountaineers,C. Carolina,Chanticleers,4-0,3-2,0,35,21,56,37,14,21,7,14,14,7,9,7,1,14,0,14,19,0.8824944767585602,18.528045404591126,0.9406099927507564,23.679216017354577
1821,2019,5,NCAAF_20190928_FAU@CHARLO,Charlotte,49ers,FAU,Owls,2-3,3-2,1,14,24,27,45,7,7,7,6,14,10,14,7,-1,-10,-7,-10,-18,0.09328260928691812,-20.60714570391832,0.4093528901507427,-3.4793635170612447
1822,2019,5,NCAAF_20190928_GATECH@TEMPLE,Temple,Owls,Georgia Tech,Yellow Jackets,3-1,1-3,1,14,0,24,2,0,14,10,0,0,0,2,0,2,14,0,14,22,0.32940005236802716,-6.8893450631172755,,
1823,2019,5,NCAAF_20190928_IND@MICHST,Michigan St.,Spartans,Indiana,Hoosiers,4-1,3-2,1,21,14,40,31,7,14,0,19,7,7,3,14,1,7,0,7,9,0.6912868252752844,7.793176401078824,0.7361483963521018,9.586294781686945
1824,2019,5,NCAAF_20190928_IOWAST@BAYLOR,Baylor,Bears,Iowa St.,Cyclones,4-0,2-2,0,7,0,23,21,0,7,13,3,0,0,0,21,2,7,0,7,2,0.13851920544822738,-16.95922792850945,0.14746368348324967,-15.898933899041566
1825,2019,5,NCAAF_20190928_MINN@PURDUE,Purdue,Boilermakers,Minnesota,Golden Gophers,1-3,4-0,0,10,28,31,38,3,7,7,14,14,14,10,0,-3,-18,-11,-18,-7,0.6618357621252442,6.513464555452572,,
1826,2019,5,NCAAF_20190928_MISS@BAMA,Alabama,Crimson Tide,Ole Miss,Rebels,5-0,2-3,1,38,10,59,31,7,31,14,7,10,0,7,14,3,28,-3,28,28,0.9854301551295788,34.037011931477934,0.9909473902896738,35.87687031114572
1827,2019,5,NCAAF_20190928_USC@WASH,Washington,Huskies,USC,Trojans,4-1,3-2,0,17,7,28,14,14,3,11,0,0,7,7,0,1,10,14,10,14,0.7025925066610867,8.29821557444103,0.6128023589916112,4.350997089508368
1828,2019,5,NCAAF_20190928_UVA@ND,Notre Dame,Fighting Irish,Virginia,Cavaliers,3-1,4-1,0,14,17,35,20,14,0,14,7,7,10,0,3,-1,-3,7,-3,15,0.8814651159742535,18.446812664650906,,
1829,2019,5,NCAAF_20190928_WAKE@BC,Boston College,Eagles,Wake Forest,Demon Deacons,3-2,5-0,1,17,17,24,27,0,17,0,7,10,7,3,7,-2,0,-10,0,-3,0.50583889971369,0.22835705671366213,0.533402790893612,1.2724698806080426
1830,2019,5,NCAAF_20190928_SMU@SFLA,South Florida,,SMU,,1-3,5-0,,0,34,21,48,0,0,7,14,14,20,7,7,-4,-34,-14,-34,-27,0.4524603045459029,-1.8636144270731734,0.14744685547731473,-15.900042089070666
1831,2019,5,NCAAF_20190928_TWST@FLA,Florida,Gators,Towson,Tigers,5-0,3-2,1,17,0,38,0,7,10,14,7,0,0,0,0,2,17,7,17,38,0.9980365290972593,44.995487151907525,,
1832,2019,5,NCAAF_20190928_CINCY@MRSHL,Marshall,Thundering Herd,Cincinnati,Bearcats,2-2,3-1,0,0,28,14,52,0,0,0,14,14,14,17,7,-1,-28,-14,-28,-38,0.4020596647616401,-3.8695796010495087,,
1833,2019,5,NCAAF_20190928_ARKST@TROY,Troy,Trojans,Arkansas St.,Red Wolves,2-2,3-2,1,31,31,43,50,10,21,6,6,21,10,14,5,-1,0,-11,0,-7,0.5395126333172346,1.5478034011738941,0.5212443151475141,0.8087318006175792
1834,2019,5,NCAAF_20190928_ECU@ODU,Old Dominion,Monarchs,East Carolina,Pirates,1-3,3-2,0,3,17,21,24,3,0,10,8,10,7,0,7,-2,-14,-7,-14,-3,0.4520490362855195,-1.8798145506052606,0.4708239342773113,-1.1111451452935341
1835,2019,5,NCAAF_20190928_LALAF@GAS,Ga. Southern,Eagles,Louisiana,Ragin' Cajuns,1-3,4-1,1,13,17,24,37,3,10,8,3,7,10,7,13,-3,-4,-4,-4,-13,0.4868484685066554,-0.5144260218053773,0.42413181528484145,-2.9044201587608427
1836,2019,5,NCAAF_20190928_NMEX@LIB,Liberty,Flames,New Mexico,Lobos,3-2,2-2,1,14,3,17,10,7,7,3,0,0,3,0,7,1,11,7,11,7,0.49956209541814733,-0.01712566684511785,0.6374712176903683,5.338855720631528
1837,2019,5,NCAAF_20190928_KSTATE@OKLAST,Oklahoma State,Cowboys,Kansas State,Wildcats,4-1,3-1,1,16,3,26,13,10,6,7,3,0,3,0,10,1,13,10,13,13,0.6313833122583439,5.234744744940372,0.43583553226436844,-2.4520901317082604
1838,2019,5,NCAAF_20190928_MISSST@AUBURN,Auburn,Tigers,Miss. State,Bulldogs,5-0,3-2,0,42,9,56,23,21,21,7,7,6,3,7,7,2,33,15,33,33,0.5899139207349968,3.5466833735885075,0.32806561688138147,-6.758977188503593
1839,2019,5,NCAAF_20190928_NICHST@TXSTSM,Texas St.,Bobcats,Nicholls St.,Colonels,2-3,2-2,0,3,3,24,3,3,0,14,7,0,3,0,0,0,0,3,0,21,0.27589686380122125,-9.284302055416845,,
1840,2019,5,NCAAF_20190928_SALA@LAMON,UL-Monroe,Warhawks,South Alabama,Jaguars,2-2,1-4,0,17,7,30,17,7,10,0,13,7,0,3,7,1,10,0,10,13,0.6491038681972232,5.974008928830813,,
1841,2019,5,NCAAF_20190928_STNFRD@OREGST,Oregon State,Beavers,Stanford,Cardinal,1-3,2-3,0,0,14,28,31,0,0,7,21,7,7,7,10,-1,-14,-7,-14,-3,0.036169679773758956,-28.036278440586955,,
1842,2019,5,NCAAF_20190928_UAB@WKY,W. Kentucky,Hilltoppers,UAB,Blazers,2-2,3-1,1,13,10,20,13,3,10,0,7,3,7,3,0,-1,3,0,3,7,0.26981853410491274,-9.569621937166744,0.1191067944620594,-17.904038880712477
1843,2019,5,NCAAF_20190928_UCONN@UCF,UCF,Knights,UConn,Huskies,4-1,1-3,0,42,0,56,21,28,14,14,0,0,0,7,14,3,42,28,42,35,0.9971003779837159,43.04446803322486,0.9996825120407585,51.8575394434001
1844,2019,5,NCAAF_20190928_UTEP@USM,So. Miss,Golden Eagles,UTEP,Miners,3-2,1-3,0,24,6,31,13,14,10,7,0,0,6,7,0,2,18,14,18,18,0.9185691573452017,21.772653602943308,0.8878010805190494,18.442210022817193
1845,2019,5,NCAAF_20190928_COLOST@UTAHST,Utah St.,Aggies,Colorado St.,Rams,3-1,1-4,0,24,21,34,24,7,17,3,7,7,14,3,0,2,3,0,3,10,0.8236891659594355,14.502234144456509,0.9549253732352778,25.723877930470692
1846,2019,5,NCAAF_20190928_NCST@FSU,Florida State,Seminoles,NC State,Wolfpack,3-2,3-2,0,17,6,31,13,3,14,7,7,0,6,0,7,0,11,3,11,18,0.34654096592110717,-6.157704241521401,0.21784786703977688,-11.832394107347227
1847,2019,5,NCAAF_20190928_OHIOST@NEB,Nebraska,Cornhuskers,Ohio State,Buckeyes,3-2,5-0,1,0,38,7,48,0,0,7,0,14,24,10,0,-2,-38,-14,-38,-41,0.03574782625542716,-28.119590733718667,0.10127463597629338,-19.343972598257523
1848,2019,5,NCAAF_20190928_UK@SC,South Carolina,Gamecocks,Kentucky,Wildcats,2-3,2-3,1,10,0,24,7,7,3,7,7,0,0,0,7,0,10,7,10,17,0.5322122513327292,1.261135415182025,0.3675833496677299,-5.134735127061191
1849,2019,5,NCAAF_20190928_FRESNO@NMEXST,New Mexico St.,Aggies,Fresno St.,Bulldogs,0-5,2-2,1,3,24,17,30,0,3,7,7,7,17,6,0,-2,-21,-7,-21,-13,0.03421546488672522,-28.429167807945362,0.011068562910694024,-34.73151654393959
1850,2019,5,NCAAF_20190928_HOU@NTEXAS,North Texas,Mean Green,Houston,Cougars,2-3,2-3,1,6,17,25,46,0,6,12,7,14,3,14,15,0,-11,-14,-11,-21,0.26282515285718744,-9.901910198346116,0.22683544068116301,-11.374373542881528
1851,2019,5,NCAAF_20190928_UNLV@WYO,Wyoming,Cowboys,UNLV,Rebels,4-1,1-3,1,33,10,53,17,7,26,0,20,10,0,0,7,3,23,-3,23,36,0.7387487354130395,9.977310792274409,0.8573392019161803,16.21873638660874
1852,2019,5,NCAAF_20190928_WASHST@UTAH,Utah,Utes,Washington St.,Cougars,4-1,3-2,0,21,13,38,13,7,14,10,7,7,6,0,0,1,8,0,8,25,0.48082433706717453,-0.7502148124887071,0.4952620050524392,-0.18028565654445572
1853,2019,5,NCAAF_20190928_HAWAII@NEVADA,Nevada,Wolf Pack,Hawaii,Rainbow Warriors,3-2,4-1,0,3,31,3,54,0,3,0,0,7,24,14,9,-1,-28,-7,-28,-51,0.6943575997291597,7.929523987579273,,
1854,2019,5,NCAAF_20190928_UCLA@ARIZ,Arizona,Wildcats,UCLA,Bruins,3-1,1-4,1,6,7,20,17,0,6,7,7,7,0,10,0,2,-1,-7,-1,3,0.5292053715631214,1.1431918581750438,0.5532101836164726,2.030696145551019
1855,2019,5,NCAAF_20190927_DUKE@VATECH,Virginia Tech,Hokies,Duke,Blue Devils,2-2,3-1,1,3,21,10,45,3,0,7,0,0,21,10,14,-1,-18,3,-18,-35,0.5555923534392228,2.181201796546077,0.4091592820783806,-3.486926845384147
1856,2019,5,NCAAF_20190927_PSU@MD,Maryland,Terrapins,Penn State,Nittany Lions,2-2,4-0,1,0,38,0,59,0,0,0,0,14,24,7,14,-2,-38,-14,-38,-59,0.06406830782239792,-23.7381805116824,,
1857,2019,5,NCAAF_20190927_SJST@AF,Air Force,Falcons,San Jose St.,Spartans,3-1,2-2,0,21,10,41,24,7,14,13,7,7,3,0,14,1,11,0,11,17,0.8963606600683196,19.67532455603856,0.8453744767414599,15.434755841681323
1858,2019,5,NCAAF_20190927_ARIZST@CAL,California,Golden Bears,Arizona St.,Sun Devils,4-1,4-1,0,7,7,17,24,7,0,7,3,7,0,7,10,0,0,0,0,-7,0.45347737886337214,-1.8235597997175432,0.421867675047758,-2.9922115419283273
1859,2019,5,NCAAF_20190926_NAVY@MEMP,Memphis,Tigers,Navy,Midshipmen,4-0,2-1,0,14,20,35,23,7,7,14,7,13,7,0,3,2,-6,-6,-6,12,0.6992751942519951,8.149147326907382,0.8143568955082576,13.571765730808266
1860,2019,6,NCAAF_20191005_IOWA@MICH,Michigan,Wolverines,Iowa,Hawkeyes,4-1,4-1,1,10,3,10,3,10,0,0,0,0,3,0,0,0,7,10,7,7,0.5691874878325985,2.734984395072672,,
1861,2019,6,NCAAF_20191005_KENTST@WISC,Wisconsin,Badgers,Kent St.,Golden Flashes,5-0,2-3,0,28,0,48,0,7,21,13,7,0,0,0,0,3,28,7,28,48,0.9987739588013788,47.53018909444688,,
1862,2019,6,NCAAF_20191005_MD@RUT,Rutgers,Scarlet Knights,Maryland,Terrapins,1-4,3-2,1,7,27,7,48,0,7,0,0,7,20,21,0,-2,-20,-7,-20,-41,0.2341025027719772,-11.382084948786485,0.21863969725883536,-12.009861624078667
1863,2019,6,NCAAF_20191005_OKLA@KANSAS,Kansas,Jayhawks,Oklahoma,Sooners,2-4,5-0,1,7,21,20,45,7,0,0,13,7,14,14,10,-3,-14,0,-14,-25,0.012116743562780141,-35.3575624917645,0.04212335048876281,-26.693957310558545
1864,2019,6,NCAAF_20191005_OKLAST@TXTECH,Texas Tech,Red Raiders,Oklahoma State,Cowboys,3-2,4-2,0,20,7,45,35,13,7,14,11,0,7,14,14,-1,13,13,13,10,0.36167614160017514,-5.554231396960688,0.3708989251038416,-5.0939151313200455
1865,2019,6,NCAAF_20191005_PURDUE@PSU,Penn State,Nittany Lions,Purdue,Boilermakers,5-0,1-4,0,28,7,35,7,21,7,0,7,0,7,0,0,4,21,21,21,28,0.8771613324382409,18.215549156683096,,
1866,2019,6,NCAAF_20191005_SFLA@UCONN,UConn,Huskies,South Florida,Bulls,1-4,2-3,1,14,27,22,48,0,14,0,8,7,20,7,14,-1,-13,-7,-13,-26,0.08727303416361898,-21.303913426069755,0.15611574812865991,-15.623898074731443
1867,2019,6,NCAAF_20191005_TULANE@ARMY,Army,Black Knights,Tulane,Green Wave,3-2,4-1,0,14,21,33,42,7,7,7,12,14,7,7,14,-1,-7,-7,-7,-9,0.5275558095360728,1.0846547589798092,,
1868,2019,6,NCAAF_20191005_UTAHST@LSU,LSU,Tigers,Utah St.,Aggies,5-0,3-2,1,21,6,42,6,7,14,14,7,6,0,0,0,2,15,1,15,36,0.7558308197036897,10.872942932372041,,
1869,2019,6,NCAAF_20191005_BC@LVILLE,Louisville,Cardinals,Boston College,Eagles,3-2,3-3,0,28,22,41,39,14,14,3,10,7,15,7,10,0,6,7,6,2,0.3085302993551693,-7.845678506464026,0.09658887970452867,-20.118114035455193
1870,2019,6,NCAAF_20191005_TCU@IOWAST,Iowa St.,Cyclones,TCU,Horned Frogs,3-2,3-2,0,21,3,49,24,7,14,14,14,0,3,7,14,0,18,7,18,25,0.5297484631968802,1.1711167394701647,0.7428419382605382,10.082463858557745
1871,2019,6,NCAAF_20191005_EMICH@CMICH,C. Michigan,Chippewas,E. Michigan,Eagles,3-3,3-2,1,21,3,42,16,7,14,14,7,3,0,7,6,0,18,4,18,26,0.34016728670894525,-6.464677052927527,0.1334293939156601,-17.166493033082816
1872,2019,6,NCAAF_20191005_AF@NAVY,Navy,Midshipmen,Air Force,Falcons,3-1,3-2,1,14,6,34,25,0,14,7,13,3,3,3,16,0,8,-3,8,9,0.5989496616285577,3.9325531053359555,0.42527591371300855,-2.9130323930971755
1873,2019,6,NCAAF_20191005_ARKST@GAST,Georgia St.,Panthers,Arkansas St.,Red Wolves,3-2,3-3,1,31,21,52,38,7,24,7,14,0,21,7,10,0,10,7,10,14,0.16343788537052106,-15.38358523724628,,
1874,2019,6,NCAAF_20191005_AUBURN@FLA,Florida,Gators,Auburn,Tigers,6-0,5-1,0,17,13,24,13,7,10,0,7,6,7,0,0,1,4,1,4,11,0.27323355210247613,-9.462480024856973,0.4494311652940468,-1.9650434539227604
1875,2019,6,NCAAF_20191005_BALLST@NILL,N. Illinois,Huskies,Ball St.,Cardinals,1-4,2-3,0,17,3,20,27,14,3,0,3,0,3,14,10,-1,14,14,14,-7,0.9049705898519393,20.56118908450543,,
1876,2019,6,NCAAF_20191005_BAYLOR@KSTATE,Kansas State,Wildcats,Baylor,Bears,3-2,5-0,0,3,10,12,31,3,0,3,6,0,10,7,14,-2,-7,3,-7,-19,0.7190529577123038,9.101090563715275,0.6356835429671737,5.364033003042493
1877,2019,6,NCAAF_20191005_BGREEN@ND,Notre Dame,Fighting Irish,Bowling Green,Falcons,4-1,1-4,1,35,0,52,0,21,14,10,7,0,0,0,0,3,35,21,35,52,0.9975023905721119,44.04919293460841,0.9989770627499781,47.67315791753174
1878,2019,6,NCAAF_20191005_ILL@MINN,Minnesota,Golden Gophers,Illinois,Fighting Illini,5-0,2-3,0,16,10,40,17,3,13,14,10,7,3,7,0,3,6,-4,6,23,0.8090537934814126,13.720190191854442,0.8439620841854782,15.628925041870986
1879,2019,6,NCAAF_20191005_MRSHL@MTSU,Middle Tenn.,Blue Raiders,Marshall,Thundering Herd,2-3,2-3,0,17,13,24,13,10,7,0,7,7,6,0,0,0,4,3,4,11,0.4913981612895205,-0.3383432585969217,0.6291377264167728,5.095414788777717
1880,2019,6,NCAAF_20191005_TEXAS@WVU,West Virginia,Mountaineers,Texas,Longhorns,3-2,4-1,1,14,21,31,42,7,7,3,14,7,14,0,21,-1,-7,0,-7,-11,0.4154418510092276,-3.3510390304131192,0.5474579258361052,1.8435637015200825
1881,2019,6,NCAAF_20191005_VATECH@MIAMI,Miami (Fla.),Hurricanes,Virginia Tech,Hokies,2-3,3-2,1,7,28,35,42,0,7,7,21,21,7,0,14,-1,-21,-21,-21,-7,0.6722550048985408,7.000387299068393,0.8233143540845302,14.348680738577812
1882,2019,6,NCAAF_20191005_WMICH@TOLEDO,Toledo,Rockets,W. Michigan,Broncos,4-1,3-3,1,24,7,31,24,14,10,0,7,7,0,10,7,1,17,7,17,7,0.6634290499302343,6.618967834238219,0.7382626634323894,9.86395102210443
1883,2019,6,NCAAF_20191005_MEMP@LAMON,UL-Monroe,Warhawks,Memphis,Tigers,2-3,5-0,1,17,29,33,52,3,14,9,7,7,22,10,13,-3,-12,-4,-12,-19,0.06137181134534464,-24.216405884852293,,
1884,2019,6,NCAAF_20191005_NWEST@NEB,Nebraska,Cornhuskers,Northwestern,Wildcats,4-2,1-4,0,10,3,13,10,7,3,0,3,0,3,7,0,3,7,7,7,3,0.31574267339239914,-7.5258499896550575,0.532022571677828,1.2423517472402779
1885,2019,6,NCAAF_20191005_TROY@MIZZOU,Missouri,Tigers,Troy,Trojans,4-1,2-3,0,42,7,42,10,21,21,0,0,7,0,3,0,2,35,14,35,32,0.8686588406727839,17.57475495092524,0.962810370315914,27.586249159877198
1886,2019,6,NCAAF_20191005_UNC@GATECH,Georgia Tech,Yellow Jackets,North Carolina,Tar Heels,1-4,3-3,0,0,17,22,38,0,0,7,15,3,14,0,21,-2,-17,-3,-17,-16,0.7374227673572196,9.97019354216792,,
1887,2019,6,NCAAF_20191005_ARIZ@COLO,Colorado,Buffaloes,Arizona,Wildcats,3-2,4-1,1,20,14,30,35,3,17,7,3,7,7,14,7,-1,6,-4,6,-5,0.44101218747246773,-2.328555804296684,,
1888,2019,6,NCAAF_20191005_WKY@ODU,Old Dominion,Monarchs,W. Kentucky,Hilltoppers,1-4,3-2,0,3,10,3,20,0,3,0,0,0,10,3,7,-2,-7,0,-7,-17,0.40532168358879606,-3.7594337669282254,0.42224765288799193,-3.0325808154265133
1889,2019,6,NCAAF_20191005_MA@FIU,FIU,Panthers,UMass,Minutemen,2-3,1-5,0,34,0,44,0,17,17,10,0,0,0,0,0,1,34,17,34,44,0.7312125983539063,9.673080465897158,,
1890,2019,6,NCAAF_20191005_RICE@UAB,UAB,Blazers,Rice,Owls,4-1,0-6,0,21,20,35,20,0,21,14,0,7,13,0,0,4,1,-7,1,15,0.8673155223657578,17.476169980816906,0.8871145104899676,18.72801921633325
1891,2019,6,NCAAF_20191005_UGA@TENN,Tennessee,Volunteers,Georgia,Bulldogs,1-4,5-0,1,14,26,14,43,7,7,0,0,10,16,3,14,-4,-12,-3,-12,-29,0.020325825195681935,-32.11991519371014,,
1892,2019,6,NCAAF_20191005_MICHST@OHIOST,Ohio State,Buckeyes,Michigan St.,Spartans,6-0,4-2,1,27,10,34,10,3,24,0,7,0,10,0,0,2,17,3,17,24,0.8846613156846564,18.807135111310856,0.8871090343572395,18.727577229391727
1893,2019,6,NCAAF_20191005_VANDY@MISS,Ole Miss,Rebels,Vanderbilt,Commodores,3-3,1-4,1,10,6,31,6,10,0,14,7,0,6,0,0,2,4,10,4,25,0.5353218833147353,1.39105734486958,,
1894,2019,6,NCAAF_20191005_CAL@OREG,Oregon,Ducks,California,Golden Bears,4-1,4-2,0,0,7,17,7,0,0,10,7,7,0,0,0,0,-7,-7,-7,10,0.6904352002650966,7.799606589795701,,
1895,2019,6,NCAAF_20191005_LIB@NMEXST,New Mexico St.,Aggies,Liberty,Flames,0-6,4-2,0,0,10,13,20,0,0,6,7,3,7,3,7,-4,-10,-3,-10,-7,0.39132063388510385,-4.32873246789984,0.30415206466480804,-7.923580825020544
1896,2019,6,NCAAF_20191005_PITT@DUKE,Duke,Blue Devils,Pittsburgh,Panthers,3-2,4-2,0,3,19,30,33,3,0,7,20,10,9,7,7,-1,-16,-7,-16,-3,0.512683056289013,0.4989185771896132,0.31939120196441984,-7.2573169869204435
1897,2019,6,NCAAF_20191005_TXSA@UTEP,UTEP,Miners,UTSA,Roadrunners,1-4,2-3,1,3,10,16,26,0,3,7,6,7,3,6,10,-1,-7,-7,-7,-10,0.27016191820256874,-9.607789343455124,0.6856522301939334,7.476269733951327
1898,2019,6,NCAAF_20191005_OREGST@UCLA,UCLA,Bruins,Oregon State,Beavers,1-5,2-3,0,10,27,31,48,0,10,14,7,21,6,14,7,-1,-17,-21,-17,-17,0.8657451725117824,17.361790989279484,,
1899,2019,6,NCAAF_20191005_SDGST@COLOST,Colorado St.,Rams,San Diego St.,Aztecs,1-5,4-1,0,3,10,10,24,3,0,0,7,3,7,7,7,-3,-7,0,-7,-14,0.26395814842716414,-9.903820403180816,0.2305723259074819,-11.394024354057123
1900,2019,6,NCAAF_20191005_BOISE@UNLV,UNLV,Rebels,Boise St.,Broncos,1-4,5-0,1,0,17,13,38,0,0,7,6,7,10,7,14,-4,-17,-7,-17,-25,0.06204137142995125,-24.13012477014155,0.02988690285037332,-29.10426593202618
1901,2019,6,NCAAF_20191005_WASH@STNFRD,Stanford,Cardinal,Washington,Huskies,3-3,4-2,1,13,10,23,13,3,10,7,3,7,3,3,0,-1,3,-4,3,10,0.2941523155285155,-8.493295498092664,0.2703429050320183,-9.458534990555691
1902,2019,6,NCAAF_20191004_UCF@CINCY,Cincinnati,Bearcats,UCF,Knights,4-1,4-2,0,10,16,27,24,0,10,10,7,3,13,0,8,0,-6,-3,-6,3,0.12474434212143204,-18.069301384443918,,
1903,2019,6,NCAAF_20191004_NMEX@SJST,San Jose St.,Spartans,New Mexico,Lobos,3-2,2-3,1,26,7,32,21,6,20,0,6,0,7,7,7,1,19,6,19,11,0.33011138973733023,-6.897724843113451,0.520812189260701,0.8069304473929932
1904,2019,6,NCAAF_20191003_TEMPLE@ECU,East Carolina,Pirates,Temple,Owls,3-3,4-1,1,10,17,17,27,7,3,0,7,0,17,7,3,-1,-7,7,-7,-10,0.0998128831881433,-20.12519710159296,,
1905,2019,7,NCAAF_20191012_MD@PURDUE,Purdue,Boilermakers,Maryland,Terrapins,2-4,3-3,0,30,14,40,14,13,17,3,7,0,14,0,0,-1,16,13,16,26,0.6555485355185362,6.286392827112934,0.5505407103115328,1.9694056835812717
1906,2019,7,NCAAF_20191012_MEMP@TEMPLE,Temple,Owls,Memphis,Tigers,5-1,5-1,0,23,14,30,28,13,10,0,7,0,14,7,7,0,9,13,9,2,0.3579472752648182,-5.714929023352397,,
1907,2019,7,NCAAF_20191012_MIAOH@WMICH,W. Michigan,Broncos,Miami-OH,RedHawks,4-3,2-4,1,21,6,38,16,0,21,0,17,6,0,3,7,2,15,-6,15,22,0.5514419694920587,2.0304123333176562,,
1908,2019,7,NCAAF_20191012_MICH@ILL,Illinois,Fighting Illini,Michigan,Wolverines,2-4,5-1,1,7,28,25,42,0,7,10,8,14,14,0,14,-3,-21,-14,-21,-17,0.018332183430757598,-32.81001701686478,,
1909,2019,7,NCAAF_20191012_MISSST@TENN,Tennessee,Volunteers,Miss. State,Bulldogs,2-4,3-3,0,10,3,20,10,7,3,3,7,0,3,0,7,-1,7,7,7,10,0.11493703873552685,-18.85368785681112,0.108291668932052,-19.157451596940433
1910,2019,7,NCAAF_20191012_OKLA@TEXAS,Texas,Longhorns,Oklahoma,Sooners,4-2,6-0,0,3,10,27,34,0,3,14,10,7,3,10,14,-2,-7,-7,-7,-7,0.2481825270581437,-10.681133899520319,0.262038448885096,-9.877040151043218
1911,2019,7,NCAAF_20191012_RUT@IND,Indiana,Hoosiers,Rutgers,Scarlet Knights,4-2,1-5,0,21,0,35,0,21,0,14,0,0,0,0,0,3,21,21,21,35,0.8163613190369783,14.157107273607835,0.7761508624452336,11.77135735217226
1912,2019,7,NCAAF_20191012_TOLEDO@BGREEN,Bowling Green,Falcons,Toledo,Rockets,2-4,4-2,1,17,7,20,7,10,7,3,0,0,7,0,0,-2,10,10,10,13,0.06903073135049287,-23.287521463610574,0.0386509331610394,-27.388340097813384
1913,2019,7,NCAAF_20191012_GATECH@DUKE,Duke,Blue Devils,Georgia Tech,Yellow Jackets,4-2,1-5,0,38,14,41,23,10,28,3,0,7,7,3,6,3,24,3,24,18,0.48616577904061264,-0.5446274866382055,,
1914,2019,7,NCAAF_20191012_BALLST@EMICH,E. Michigan,Eagles,Ball St.,Cardinals,3-3,3-3,1,17,14,23,29,7,10,6,0,0,14,7,8,0,3,7,3,-6,0.8459138583366985,16.001827134591963,,
1915,2019,7,NCAAF_20191012_ODU@MRSHL,Marshall,Thundering Herd,Old Dominion,Monarchs,3-3,1-5,0,17,10,31,17,7,10,7,7,0,10,7,0,2,7,7,7,14,0.8198798125874275,14.366297906838952,0.8233072990660504,14.38815739955784
1916,2019,7,NCAAF_20191012_NMEXST@CMICH,C. Michigan,Chippewas,New Mexico St.,Aggies,4-3,0-7,0,28,21,42,28,14,14,6,8,7,14,0,7,4,7,7,7,14,0.7154490257093185,8.94058499733751,0.48104227915532893,-0.7370158217353122
1917,2019,7,NCAAF_20191012_BAMA@TXAM,Texas A&M,Aggies,Alabama,Crimson Tide,3-3,6-0,1,13,24,28,47,7,6,7,8,14,10,10,13,-3,-11,-7,-11,-19,0.052621731220063195,-25.437176335346408,,
1918,2019,7,NCAAF_20191012_BYU@SFLA,South Florida,Bulls,BYU,Cougars,3-3,2-4,0,7,16,27,23,0,7,7,13,3,13,7,0,1,-9,-3,-9,4,0.5782391205409622,3.0995215974102734,,
1919,2019,7,NCAAF_20191012_CINCY@HOU,Houston,Cougars,Cincinnati,Bearcats,2-4,5-1,0,10,21,23,38,3,7,7,6,14,7,0,17,-3,-11,-11,-11,-15,0.5483886935393838,1.909284986043474,,
1920,2019,7,NCAAF_20191012_FSU@CLEM,Clemson,Tigers,Florida State,Seminoles,6-0,3-3,1,28,0,45,14,14,14,14,3,0,0,7,7,3,28,14,28,31,0.9402741847961409,24.449985724342696,,
1921,2019,7,NCAAF_20191012_KENTST@AKRON,Akron,Zips,Kent St.,Golden Flashes,0-6,3-3,0,3,17,3,26,0,3,0,0,7,10,0,9,-3,-14,-7,-14,-23,0.6997982728709067,8.225271907392425,,
1922,2019,7,NCAAF_20191012_MICHST@WISC,Wisconsin,Badgers,Michigan St.,Spartans,6-0,4-3,1,17,0,38,0,7,10,0,21,0,0,0,0,2,17,7,17,38,0.7379269124234833,10.00195622961121,0.5260803392448489,1.014261803000295
1923,2019,7,NCAAF_20191012_NILL@OHIO,Ohio,Bobcats,N. Illinois,Huskies,2-4,2-4,1,21,10,36,39,7,14,0,15,10,0,12,17,0,11,-3,11,-3,0.6001772096794726,3.9853770314900885,0.7479297195908414,10.356346428651548
1924,2019,7,NCAAF_20191012_WASHST@ARIZST,Arizona St.,Sun Devils,Washington St.,Cougars,5-1,3-3,0,17,17,38,34,0,17,7,14,10,7,14,3,2,0,-10,0,4,0.35963641447490924,-5.643949869334051,0.38234678003970324,-4.640634700890388
1925,2019,7,NCAAF_20191012_UCONN@TULANE,Tulane,Green Wave,UConn,Huskies,5-1,1-5,1,28,0,49,7,14,14,14,7,0,0,0,7,4,28,14,28,42,0.9299122668256458,23.163302214775456,0.9792009502146617,31.589211615151385
1926,2019,7,NCAAF_20191012_IOWAST@WVU,West Virginia,Mountaineers,Iowa St.,Cyclones,3-3,4-2,0,14,14,14,38,7,7,0,0,0,14,7,17,-1,0,7,0,-24,0.39589411588232715,-4.145281462961407,0.3867922895772027,-4.460267625656002
1927,2019,7,NCAAF_20191012_MTSU@FAU,FAU,Owls,Middle Tenn.,Blue Raiders,4-2,2-4,1,12,13,28,13,2,10,10,6,6,7,0,0,2,-1,-4,-1,15,0.627241417086528,5.096328673871142,0.44352166658031456,-2.202254579458696
1928,2019,7,NCAAF_20191012_RI@VATECH,Virginia Tech,Hokies,Rhode Island,Rams,4-2,1-5,1,17,6,34,17,10,7,7,10,0,6,11,0,3,11,10,11,17,0.9775614252474077,31.49607000204884,,
1929,2019,7,NCAAF_20191012_SJST@NEVADA,Nevada,Wolf Pack,San Jose St.,Spartans,4-2,3-3,0,24,10,41,38,14,10,7,10,3,7,14,14,1,14,11,14,3,0.7745411100369779,11.837866159983207,0.6773465852204157,7.1362554132930995
1930,2019,7,NCAAF_20191012_UNLV@VANDY,Vanderbilt,Commodores,UNLV,Rebels,1-5,2-4,1,10,24,10,34,7,3,0,0,7,17,0,10,-1,-14,0,-14,-24,0.827079412534806,14.80250539097949,,
1931,2019,7,NCAAF_20191012_GAST@CSTCAR,C. Carolina,Chanticleers,Georgia St.,Panthers,3-3,4-2,0,6,17,21,31,3,3,7,8,3,14,14,0,-1,-11,0,-11,-10,0.5113997527906899,0.44875812824858485,,
1932,2019,7,NCAAF_20191012_UAB@TXSA,UTSA,Roadrunners,UAB,Blazers,2-4,5-1,1,7,16,14,33,0,7,7,0,3,13,7,10,-3,-9,-3,-9,-19,0.22171384558136742,-12.034650404035915,0.03857497576887092,-27.40240395222888
1933,2019,7,NCAAF_20191012_ARMY@WKY,W. Kentucky,Hilltoppers,Army,Black Knights,4-2,3-3,0,7,0,17,8,7,0,3,7,0,0,0,8,1,7,7,7,9,0.1605463314140566,-15.5802215133304,,
1934,2019,7,NCAAF_20191012_CHARLO@FIU,FIU,Panthers,Charlotte,49ers,3-3,2-4,0,28,17,48,23,7,21,13,7,10,7,6,0,1,11,-3,11,25,0.7771479725876753,11.974645622034814,0.5143786791769818,0.5589078268503442
1935,2019,7,NCAAF_20191012_FRESNO@AF,Air Force,Falcons,Fresno St.,Bulldogs,4-2,2-3,0,22,24,43,24,7,15,7,14,14,10,0,0,2,-2,-7,-2,19,0.23456039243176363,-11.367176981518242,,
1936,2019,7,NCAAF_20191012_MA@LATECH,Louisiana Tech,,UMass,,5-1,1-6,,52,14,69,21,28,24,10,7,0,14,7,0,4,38,28,38,48,0.7644844414771053,11.318374275077588,,
1937,2019,7,NCAAF_20191012_MISS@MIZZOU,Missouri,Tigers,Ole Miss,Rebels,5-1,3-4,0,12,7,38,27,3,9,23,3,7,0,7,13,2,5,-4,5,11,0.7867408721640534,12.486031261484754,0.8991463533943178,19.793697020210843
1938,2019,7,NCAAF_20191012_NTEXAS@USM,So. Miss,Golden Eagles,North Texas,Mean Green,4-2,2-4,1,28,20,45,27,13,15,10,7,7,13,0,7,2,8,6,8,18,0.4715277919478472,-1.1216261197477593,0.4511231897538731,-1.9042363030152814
1939,2019,7,NCAAF_20191012_ARK@UK,Kentucky,Wildcats,Arkansas,Razorbacks,3-3,2-4,0,7,13,24,20,0,7,10,7,7,6,0,7,1,-6,-7,-6,4,0.8000795851549701,13.219992595066799,0.7931771092493214,12.674246393963102
1940,2019,7,NCAAF_20191012_LVILLE@WAKE,Wake Forest,Demon Deacons,Louisville,Cardinals,5-1,4-2,1,21,31,59,62,7,14,10,28,21,10,14,17,1,-10,-14,-10,-3,0.6864382633821386,7.6279366145718654,0.9172511166275231,21.50087632504797
1941,2019,7,NCAAF_20191012_NAVY@TULSA,Tulsa,Golden Hurricane,Navy,Midshipmen,2-4,4-1,0,3,28,17,45,3,0,7,7,7,21,0,17,-2,-25,-4,-25,-28,0.30477794864826724,-8.019366645065872,0.37430958211457965,-4.968346744779012
1942,2019,7,NCAAF_20191012_NEB@MINN,Minnesota,Golden Gophers,Nebraska,Cornhuskers,6-0,4-3,0,14,0,34,7,7,7,20,0,0,0,0,7,2,14,7,14,27,0.5779527925008425,3.088030776281471,0.42685351285184236,-2.858749063322932
1943,2019,7,NCAAF_20191012_PSU@IOWA,Iowa,Hawkeyes,Penn State,Nittany Lions,4-2,6-0,1,6,7,12,17,3,3,0,6,0,7,3,7,-2,-1,3,-1,-5,0.29563027894727034,-8.432384323871872,0.45469113891398105,-1.764603559808208
1944,2019,7,NCAAF_20191012_USC@ND,Notre Dame,Fighting Irish,USC,Trojans,5-1,3-3,0,17,3,30,27,0,17,3,10,3,0,10,14,2,14,-3,14,3,0.761551549871293,11.169200422971983,0.7224095405204851,9.147446951040763
1945,2019,7,NCAAF_20191012_FLA@LSU,LSU,Tigers,Florida,Gators,6-0,6-1,1,21,21,42,28,7,14,14,7,7,14,7,0,0,0,0,0,14,0.6359771340998668,5.460160434115778,,
1946,2019,7,NCAAF_20191012_UTAH@OREGST,Oregon State,Beavers,Utah,Utes,2-4,5-1,1,0,35,7,52,0,0,0,7,21,14,14,3,-3,-35,-21,-35,-45,0.044164365763728286,-26.76140261280125,,
1947,2019,7,NCAAF_20191012_HAWAII@BOISE,Boise St.,Broncos,Hawaii,Rainbow Warriors,6-0,4-2,0,31,14,59,37,14,17,21,7,7,7,7,16,2,17,7,17,22,0.9336831180433943,23.6133130428874,,
1948,2019,7,NCAAF_20191012_WYO@SDGST,San Diego St.,Aztecs,Wyoming,Cowboys,5-1,4-2,1,6,14,26,22,3,3,13,7,0,14,0,8,1,-8,3,-8,4,0.6197025827260257,4.784537394766176,0.35509724569128176,-5.761120274747597
1949,2019,7,NCAAF_20191012_WASH@ARIZ,Arizona,Wildcats,Washington,Huskies,4-2,5-2,1,17,13,27,51,0,17,0,10,6,7,14,24,-1,4,-6,4,-24,0.16466404444694316,-15.317255004751757,0.21923179375948076,-12.012167349833135
1950,2019,7,NCAAF_20191011_COLOST@NMEX,New Mexico,Lobos,Colorado St.,Rams,2-4,2-5,0,14,21,21,35,6,8,0,7,7,14,7,7,0,-7,-1,-7,-14,0.28516396260919996,-8.912226493569051,0.3415770242828252,-6.328062824164235
1951,2019,7,NCAAF_20191011_UVA@MIAMI,Miami (Fla.),Hurricanes,Virginia,Cavaliers,3-3,4-2,1,7,3,17,9,7,0,0,10,0,3,0,6,-1,4,7,4,8,0.7125770458100377,8.807968931275468,,
1952,2019,7,NCAAF_20191011_COLO@OREG,Oregon,Ducks,Colorado,Buffaloes,5-1,3-3,1,24,3,45,3,7,17,14,7,3,0,0,0,2,21,4,21,42,0.7611726589543655,11.150002727495632,,
1953,2019,7,NCAAF_20191010_CUSE@NCST,NC State,Wolfpack,Syracuse,Orange,4-2,3-3,0,13,0,16,10,6,7,3,0,0,0,3,7,1,13,6,13,6,0.6189427717117509,4.753219536491258,,
1954,2019,7,NCAAF_20191010_LAMON@TXSTSM,Texas St.,Bobcats,UL-Monroe,Warhawks,2-4,3-3,0,7,17,14,24,0,7,7,0,7,10,0,7,-1,-10,-7,-10,-10,0.2859038392163207,-8.878036456084658,,
1955,2019,7,NCAAF_20191009_APLST@LALAF,Louisiana,Ragin' Cajuns,App. St.,Mountaineers,4-2,5-0,1,7,7,7,17,0,7,0,0,7,0,3,7,-1,0,-7,0,-10,0.20956856043720873,-12.68632265090497,0.3814521699631592,-4.677006849112814
1956,2019,8,NCAAF_20191019_AUBURN@ARK,Arkansas,Razorbacks,Auburn,Tigers,2-5,6-1,1,0,17,10,51,0,0,10,0,17,0,14,20,-4,-17,-17,-17,-41,0.0421192464379907,-27.175754224246248,0.046050911491338775,-26.322699064567217
1957,2019,8,NCAAF_20191019_CLEM@LVILLE,Louisville,Cardinals,Clemson,Tigers,4-3,7-0,1,3,17,10,45,0,3,0,7,3,14,7,21,-3,-14,-3,-14,-35,0.025930649745488754,-30.601869985530925,0.0013073637865733678,-47.03384811055544
1958,2019,8,NCAAF_20191019_FLA@SC,South Carolina,Gamecocks,Florida,Gators,3-4,7-1,1,10,10,27,38,7,3,10,7,3,7,7,21,-4,0,4,0,-11,0.4200288794292747,-3.17652123619348,0.26767458808788536,-9.686707956180626
1959,2019,8,NCAAF_20191019_HOU@UCONN,UConn,Huskies,Houston,Cougars,1-6,3-4,0,7,10,17,24,0,7,3,7,3,7,7,7,-2,-3,-3,-3,-7,0.042313590900653786,-27.1417765605986,0.010888940000757463,-35.8522792138514
1960,2019,8,NCAAF_20191019_IOWAST@TXTECH,Texas Tech,Red Raiders,Iowa St.,Cyclones,3-4,5-2,0,7,20,24,34,0,7,10,7,7,13,7,7,-2,-13,-7,-13,-10,0.3315811425389986,-6.855320658757137,0.1671951684655658,-15.085088731453666
1961,2019,8,NCAAF_20191019_KENTST@OHIO,Ohio,Bobcats,Kent St.,Golden Flashes,3-4,3-4,0,24,24,45,38,10,14,7,14,14,10,0,14,0,0,-4,0,7,0.9221729539078467,22.34745205617537,,
1962,2019,8,NCAAF_20191019_NCST@BC,Boston College,Eagles,NC State,Wolfpack,4-3,4-3,1,24,3,45,24,7,17,7,14,0,3,7,14,0,21,7,21,21,0.39914963488826016,-4.0221868568198715,0.25074524730944914,-10.503780557870911
1963,2019,8,NCAAF_20191019_PURDUE@IOWA,Iowa,Hawkeyes,Purdue,Boilermakers,5-2,2-5,1,9,7,26,20,6,3,7,10,0,7,0,13,3,2,6,2,6,0.7411400247330918,10.18125752519154,0.7913777255452237,12.676972619262443
1964,2019,8,NCAAF_20191019_WISC@ILL,Illinois,Fighting Illini,Wisconsin,Badgers,3-4,6-1,0,7,13,24,23,0,7,7,10,7,6,7,3,-3,-6,-7,-6,1,0.021816734029016516,-31.755751587339546,0.03227044343344565,-28.88574601831543
1965,2019,8,NCAAF_20191019_WVU@OKLA,Oklahoma,Sooners,West Virginia,Mountaineers,7-0,3-4,0,28,14,52,14,14,14,21,3,0,14,0,0,4,14,14,14,38,0.8335065061952074,15.23755651793681,0.7230826633800892,9.251686327395177
1966,2019,8,NCAAF_20191019_CMICH@BGREEN,Bowling Green,Falcons,C. Michigan,Chippewas,2-5,5-3,0,7,21,20,38,7,0,7,6,7,14,7,10,-3,-14,0,-14,-18,0.24363535824629756,-10.933479789474404,0.4114262827886763,-3.4985843692309544
1967,2019,8,NCAAF_20191019_TOLEDO@BALLST,Ball St.,Cardinals,Toledo,Rockets,4-3,4-3,1,38,0,52,14,17,21,14,0,0,0,7,7,0,38,17,38,38,0.08862102124175686,-21.237115240711262,,
1968,2019,8,NCAAF_20191019_NILL@MIAOH,Miami-OH,RedHawks,N. Illinois,Huskies,3-4,2-5,0,7,10,27,24,0,7,14,6,3,7,7,7,1,-3,-3,-3,3,0.38572640235633393,-4.571906279474888,,
1969,2019,8,NCAAF_20191019_OREGST@CAL,California,Golden Bears,Oregon State,Beavers,4-3,3-4,0,3,14,17,21,0,3,14,0,7,7,0,7,1,-11,-7,-11,-4,0.8817009315017917,18.62810367011207,0.9098571438346466,20.93853612740115
1970,2019,8,NCAAF_20191019_TCU@KSTATE,Kansas State,Wildcats,TCU,Horned Frogs,4-2,3-3,0,14,10,24,17,7,7,3,7,0,10,7,0,1,4,7,4,7,0.35924933671499093,-5.673521938856766,,
1971,2019,8,NCAAF_20191019_NMEX@WYO,Wyoming,Cowboys,New Mexico,Lobos,5-2,2-5,1,7,0,23,10,7,0,6,10,0,0,0,10,3,7,7,7,13,0.8208030699052584,14.455543407887603,0.9484896479754423,25.47834615676794
1972,2019,8,NCAAF_20191019_BUFF@AKRON,Akron,Zips,Buffalo,Bulls,0-7,3-4,0,0,7,0,21,0,0,0,0,7,0,7,7,-3,-7,-7,-7,-21,0.21461622269251768,-12.442093936654715,0.048107160048148745,-25.99573162543004
1973,2019,8,NCAAF_20191019_DUKE@UVA,Virginia,Cavaliers,Duke,Blue Devils,5-2,4-3,1,17,0,48,14,0,17,24,7,0,0,7,7,1,17,0,17,34,0.42893707319816565,-2.8186282035450176,,
1974,2019,8,NCAAF_20191019_IND@MD,Maryland,Terrapins,Indiana,Hoosiers,3-4,5-2,0,21,24,28,34,7,14,7,0,14,10,7,3,-2,-3,-7,-3,-6,0.44966690180206803,-1.991081889833481,0.4401297168410806,-2.354089986392495
1975,2019,8,NCAAF_20191019_LAMON@APLST,App. St.,Mountaineers,UL-Monroe,Warhawks,6-0,3-4,0,31,7,52,7,21,10,7,14,7,0,0,0,3,24,14,24,45,0.8523124642538435,16.469762742204807,,
1976,2019,8,NCAAF_20191019_LSU@MISSST,Miss. State,Bulldogs,LSU,Tigers,3-4,7-0,1,7,22,13,36,0,7,0,6,3,19,14,0,-4,-15,-3,-15,-23,0.41098563170990776,-3.5415291236961366,,
1977,2019,8,NCAAF_20191019_MINN@RUT,Rutgers,Scarlet Knights,Minnesota,Golden Gophers,1-6,7-0,1,0,14,7,42,0,0,0,7,7,7,7,21,-6,-14,-7,-14,-35,0.1427582635703487,-16.80982795229943,0.08760020350298525,-21.185540538445068
1978,2019,8,NCAAF_20191019_OREG@WASH,Washington,Huskies,Oregon,Ducks,5-3,6-1,0,21,14,31,35,7,14,10,0,7,7,14,7,-1,7,0,7,-4,0.6466638692228867,5.923197374112533,0.4487660262423221,-2.0124671975789425
1979,2019,8,NCAAF_20191019_SFLA@NAVY,Navy,Midshipmen,South Florida,Bulls,5-1,3-4,0,21,3,35,3,7,14,0,14,0,3,0,0,2,18,7,18,32,0.5568830647574939,2.2518577314299364,0.7782650983808348,11.97587551717615
1980,2019,8,NCAAF_20191019_TEMPLE@SMU,SMU,Mustangs,Temple,Owls,7-0,5-2,1,24,7,45,21,10,14,7,14,0,7,7,7,2,17,10,17,24,0.49277304094142216,-0.2851397126911479,,
1981,2019,8,NCAAF_20191019_TULSA@CINCY,Cincinnati,Bearcats,Tulsa,Golden Hurricane,6-1,2-5,0,10,7,24,13,10,0,7,7,0,7,3,3,4,3,10,3,11,0.7714057358542274,11.702003426215697,,
1982,2019,8,NCAAF_20191019_USM@LATECH,Louisiana Tech,Bulldogs,So. Miss,Golden Eagles,6-1,4-3,0,24,27,45,30,7,17,0,21,14,13,0,3,2,-3,-7,-3,15,0.47360744446703906,-1.0420221852447185,0.44400668904432317,-2.200600845302432
1983,2019,8,NCAAF_20191019_BAYLOR@OKLAST,Oklahoma State,Cowboys,Baylor,Bears,4-3,7-0,1,13,10,27,45,6,7,7,7,7,3,14,21,-3,3,-1,3,-18,0.8066439571143049,13.623959922315521,,
1984,2019,8,NCAAF_20191019_CHARLO@WKY,W. Kentucky,Hilltoppers,Charlotte,49ers,5-2,2-5,0,17,14,30,14,7,10,13,0,7,7,0,0,3,3,0,3,16,0.6687469901455823,6.86955729420913,0.5238264803830365,0.9338777270095733
1985,2019,8,NCAAF_20191019_MIZZOU@VANDY,Vanderbilt,Commodores,Missouri,Tigers,2-5,5-2,1,14,7,21,14,0,14,0,7,0,7,7,0,-3,7,0,7,7,0.1456259559336771,-16.61104567210384,,
1986,2019,8,NCAAF_20191019_MTSU@NTEXAS,North Texas,Mean Green,Middle Tenn.,Blue Raiders,3-4,2-5,1,17,16,33,30,7,10,3,13,3,13,0,14,1,1,4,1,3,0.4567416353653059,-1.710023904887521,0.33678340777933835,-6.583089358818327
1987,2019,8,NCAAF_20191019_ODU@UAB,UAB,Blazers,Old Dominion,Monarchs,6-1,1-6,0,28,3,38,14,14,14,7,3,0,3,11,0,5,25,14,25,24,0.7900154247597291,12.693436316287148,0.8151987950721084,14.021029726025489
1988,2019,8,NCAAF_20191019_ARIZST@UTAH,Utah,Utes,Arizona St.,Sun Devils,6-1,5-2,0,14,0,21,3,0,14,0,7,0,0,3,0,1,14,0,14,18,0.6660522581326801,6.752806483999734,0.6448784012377872,5.805973454646093
1989,2019,8,NCAAF_20191019_ME@LIB,Liberty,Flames,Maine,Black Bears,5-2,2-5,1,45,17,59,44,17,28,7,7,3,14,7,20,3,28,14,28,15,0.6693989462223947,6.897860298050773,,
1990,2019,8,NCAAF_20191019_RICE@TXSA,UTSA,,Rice,,3-4,0-7,,7,10,31,27,7,0,17,7,3,7,14,3,3,-3,4,-3,4,0.6270277289260158,5.099433251890105,0.18520167546254185,-13.997584534096532
1991,2019,8,NCAAF_20191019_UK@UGA,Georgia,Bulldogs,Kentucky,Wildcats,6-1,3-4,1,0,0,21,0,0,0,14,7,0,0,0,0,3,0,0,0,21,0.9213885151265161,22.26297455696431,0.9071074193705935,20.67717356158964
1992,2019,8,NCAAF_20191019_ARMY@GAST,Georgia St.,Panthers,Army,Black Knights,5-2,3-4,1,14,14,28,21,7,7,6,8,7,7,7,0,2,0,0,0,7,0.13283320464561732,-17.519502343107433,,
1993,2019,8,NCAAF_20191019_COLO@WASHST,Washington St.,Cougars,Colorado,Buffaloes,4-3,3-4,0,24,3,41,10,21,3,7,10,3,0,7,0,1,21,18,21,31,0.7768514428787182,11.987177748296745,,
1994,2019,8,NCAAF_20191019_ECU@UCF,UCF,Knights,East Carolina,Pirates,5-2,3-4,0,35,6,41,28,21,14,6,0,0,6,16,6,2,29,21,29,13,0.9888574893530675,35.972017787954314,0.9875670359233544,35.05934594853127
1995,2019,8,NCAAF_20191019_KANSAS@TEXAS,Texas,Longhorns,Kansas,Jayhawks,5-2,2-5,1,21,17,50,48,14,7,3,26,3,14,7,24,3,4,11,4,2,0.9377047953872715,24.172393988062026,0.8847950289865538,18.74178151442186
1996,2019,8,NCAAF_20191019_SDGST@SJST,San Jose St.,Spartans,San Diego St.,Aztecs,3-4,6-1,0,7,13,17,27,7,0,3,7,7,6,14,0,-3,-6,0,-6,-10,0.06069785792877902,-24.379428369139987,0.2980854292346695,-8.28109905074328
1997,2019,8,NCAAF_20191019_TULANE@MEMP,Memphis,Tigers,Tulane,Green Wave,6-1,5-2,0,34,10,47,17,13,21,6,7,3,7,0,7,1,24,10,24,30,0.6715150423591414,6.989879661896566,0.6915157747242175,7.815977097492095
1998,2019,8,NCAAF_20191019_UTEP@FIU,FIU,Panthers,UTEP,Miners,4-3,1-5,0,18,7,32,17,3,15,0,14,7,0,0,10,3,11,-4,11,15,0.9071369983666311,20.82841595446382,0.8833020422046858,18.622281463776503
1999,2019,8,NCAAF_20191019_WMICH@EMICH,E. Michigan,Eagles,W. Michigan,Broncos,4-3,4-4,0,10,14,34,27,3,7,10,14,7,7,7,6,0,-4,-4,-4,7,0.4388575233880794,-2.4217668289794574,0.3191290431595407,-7.346914185332409
2000,2019,8,NCAAF_20191019_FSU@WAKE,Wake Forest,Demon Deacons,Florida State,Seminoles,6-1,3-4,1,12,14,22,20,6,6,0,10,0,14,0,6,3,-2,6,-2,2,0.5272880830603792,1.0774334775909438,0.5593218439022969,2.3323638498879973
2001,2019,8,NCAAF_20191019_MICH@PSU,Penn State,Nittany Lions,Michigan,Wolverines,7-0,5-2,0,21,7,28,21,7,14,0,7,0,7,7,7,2,14,7,14,7,0.6431358901033273,5.7740589729776275,,
2002,2019,8,NCAAF_20191019_TXAM@MISS,Ole Miss,Rebels,Texas A&M,Aggies,3-5,4-3,0,7,10,17,24,7,0,7,3,3,7,7,7,-1,-3,4,-3,-7,0.3123139211185295,-7.701325753779997,,
2003,2019,8,NCAAF_20191019_TENN@BAMA,Alabama,Crimson Tide,Tennessee,Volunteers,7-0,2-5,0,21,10,35,13,14,7,7,7,7,3,3,0,5,11,7,11,22,0.9910007450793125,37.233913955766525,0.9945480592919878,39.783220208083506
2004,2019,8,NCAAF_20191019_ARIZ@USC,USC,Trojans,Arizona,Wildcats,4-3,4-3,1,17,0,41,14,10,7,10,14,0,0,0,14,0,17,10,17,27,0.6911061408341018,7.853778937802758,0.6875956739020611,7.64244054762294
2005,2019,8,NCAAF_20191019_BOISE@BYU,BYU,Cougars,Boise St.,Broncos,3-4,6-1,0,7,10,28,25,7,0,21,0,7,3,0,15,-3,-3,0,-3,3,0.19836333984452226,-13.33886127343817,,
2006,2019,8,NCAAF_20191019_NEVADA@UTAHST,Utah St.,Aggies,Nevada,Wolf Pack,4-2,4-3,0,22,3,36,10,9,13,0,14,3,0,0,7,0,19,6,19,26,0.8552605765963313,16.672214275463944,0.84745464234507,16.02692845044544
2007,2019,8,NCAAF_20191019_AF@HAWAII,Hawaii,Rainbow Warriors,Air Force,Falcons,4-3,5-2,1,20,28,26,56,3,17,0,6,7,21,7,21,-1,-8,-4,-8,-30,0.23138998508446407,-11.557085126740844,,
2008,2019,8,NCAAF_20191018_MRSHL@FAU,FAU,Owls,Marshall,Thundering Herd,4-3,4-3,0,17,17,31,36,14,3,0,14,10,7,5,14,0,0,4,0,-5,0.6431989497147796,5.776720109375901,0.6077241005064808,4.272359329921784
2009,2019,8,NCAAF_20191018_PITT@CUSE,Syracuse,Orange,Pittsburgh,Panthers,3-4,5-2,0,6,24,20,27,3,3,7,7,10,14,0,3,-2,-18,-7,-18,-7,0.5060816657529251,0.23994832791572662,0.3667388674435619,-5.321116282318002
2010,2019,8,NCAAF_20191018_OHIOST@NWEST,Northwestern,Wildcats,Ohio State,Buckeyes,1-5,7-0,0,3,31,3,52,3,0,0,0,7,24,7,14,-6,-28,-4,-28,-49,0.08220127358723239,-21.88432849573246,0.056958611904505685,-24.703958762160468
2011,2019,8,NCAAF_20191018_UNLV@FRESNO,Fresno St.,Bulldogs,UNLV,Rebels,3-3,2-5,0,28,17,56,27,7,21,7,21,3,14,3,7,1,11,4,11,29,0.8967832833187745,19.885696633617954,,
2012,2019,8,NCAAF_20191017_LALAF@ARKST,Arkansas St.,Red Wolves,Louisiana,Ragin' Cajuns,3-4,5-2,1,10,24,20,37,7,3,3,7,7,17,0,13,-2,-14,0,-14,-17,0.6613796380966317,6.551235447826684,0.46688804174981624,-1.2985423292821423
2013,2019,8,NCAAF_20191017_UCLA@STNFRD,Stanford,Cardinal,UCLA,Bruins,3-4,2-5,1,10,21,16,34,10,0,0,6,14,7,6,7,1,-11,-4,-11,-18,0.7541095793308803,10.820515436440473,0.752192510244855,10.648473547967
2014,2019,8,NCAAF_20191016_SALA@TROY,Troy,Trojans,South Alabama,Jaguars,3-3,1-6,1,16,10,37,13,3,13,7,14,3,7,3,0,2,6,0,6,24,0.8824678928561802,18.689200550273654,,
2015,2019,9,NCAAF_20191026_APLST@SALA,South Alabama,Jaguars,App. St.,Mountaineers,1-7,7-0,0,0,13,3,30,0,0,0,3,7,6,10,7,-6,-13,-7,-13,-27,0.05931635626812304,-24.694559410129045,0.02919916168141734,-29.786493022721373
2016,2019,9,NCAAF_20191026_BGREEN@WMICH,W. Michigan,Broncos,Bowling Green,Falcons,5-4,2-6,0,21,3,49,10,0,21,28,0,3,0,7,0,3,18,-3,18,39,0.8494933689035284,16.366574525207966,0.8465394109287491,16.07916470837712
2017,2019,9,NCAAF_20191026_ILL@PURDUE,Purdue,Boilermakers,Illinois,Fighting Illini,2-6,4-4,1,0,17,6,24,0,0,0,6,3,14,7,0,-2,-17,-3,-17,-18,0.8781058613525039,18.444430706836783,0.7209588591275774,9.217392467335088
2018,2019,9,NCAAF_20191026_IOWA@NWEST,Northwestern,Wildcats,Iowa,Hawkeyes,1-6,6-2,0,0,10,0,20,0,0,0,0,7,3,7,3,-5,-10,-7,-10,-20,0.21129858553024206,-12.689947109995842,0.24772956493502862,-10.727564713048821
2019,2019,9,NCAAF_20191026_LIB@RUT,Rutgers,Scarlet Knights,Liberty,Flames,2-6,5-3,0,21,21,44,34,7,14,17,6,14,7,3,10,-3,0,-7,0,10,0.6290887309999033,5.213197874730895,0.5691067959009062,2.739925673403903
2020,2019,9,NCAAF_20191026_MIAMI@PITT,Pittsburgh,Panthers,Miami (Fla.),Hurricanes,5-3,4-4,1,6,10,12,16,3,3,3,3,3,7,0,6,1,-4,0,-4,-4,0.3410957010784694,-6.479683638897313,0.6668495185280767,6.7865296346348885
2021,2019,9,NCAAF_20191026_MISSST@TXAM,Texas A&M,Aggies,Miss. State,Bulldogs,5-3,3-5,0,28,10,49,30,14,14,14,7,0,10,7,13,2,18,14,18,19,0.3893137836698565,-4.448361107888559,0.4262457864263052,-2.9262543921808657
2022,2019,9,NCAAF_20191026_OKLA@KSTATE,Kansas State,Wildcats,Oklahoma,Sooners,5-2,7-1,0,24,23,48,41,7,17,17,7,17,6,0,18,-2,1,-10,1,7,0.11385408310910461,-19.088695506498425,0.11135430497124688,-19.189758825359135
2023,2019,9,NCAAF_20191026_SJST@ARMY,Army,Black Knights,San Jose St.,Spartans,3-5,4-4,0,10,23,29,34,7,3,7,12,7,16,0,11,-1,-13,0,-13,-5,0.9067611359632629,20.905134053813526,0.6379446901256594,5.554907621710662
2024,2019,9,NCAAF_20191026_WISC@OHIOST,Ohio State,Buckeyes,Wisconsin,Badgers,8-0,6-2,0,10,0,38,7,0,10,14,14,0,0,7,0,2,10,0,10,31,0.7326666822292648,9.825331287294148,0.9160513847393181,21.702025583552228
2025,2019,9,NCAAF_20191026_USM@RICE,Rice,Owls,So. Miss,Golden Eagles,0-8,5-3,0,0,10,6,20,0,0,6,0,0,10,3,7,-5,-10,0,-10,-14,0.13988799843616917,-17.103353967334556,0.2018299755598072,-13.14251141515468
2026,2019,9,NCAAF_20191026_NEVADA@WYO,Wyoming,Cowboys,Nevada,Wolf Pack,6-2,4-4,0,24,3,31,3,14,10,7,0,3,0,0,0,2,21,11,21,28,0.7104050094611747,8.775702048504058,0.8186631294086769,14.325657075766081
2027,2019,9,NCAAF_20191026_OHIO@BALLST,Ball St.,Cardinals,Ohio,Bobcats,4-4,4-4,1,7,13,21,34,7,0,7,7,7,6,14,7,0,-6,0,-6,-13,0.11130193393533427,-19.2999486418243,,
2028,2019,9,NCAAF_20191026_WKY@MRSHL,Marshall,Thundering Herd,W. Kentucky,Hilltoppers,5-3,5-3,0,20,7,26,23,14,6,3,3,0,7,6,10,0,13,14,13,3,0.7062865214665933,8.585812125066013,0.5182905177409072,0.7217830860220076
2029,2019,9,NCAAF_20191026_NMEXST@GAS,Ga. Southern,Eagles,New Mexico St.,Aggies,4-3,0-8,1,28,7,41,7,7,21,13,0,7,0,0,0,4,21,0,21,34,0.6796989688834617,7.387727653381717,,
2030,2019,9,NCAAF_20191026_AKRON@NILL,N. Illinois,Huskies,Akron,Zips,3-5,0-8,0,21,0,49,0,7,14,14,14,0,0,0,0,3,21,7,21,49,0.793113150842857,12.9328073529461,0.9187108383622911,21.976809954728544
2031,2019,9,NCAAF_20191026_ARIZ@STNFRD,Stanford,Cardinal,Arizona,Wildcats,4-4,4-4,0,31,24,41,31,7,24,7,3,10,14,7,0,0,7,-3,7,10,0.7023602316588017,8.40592816825722,0.6451980308712058,5.860494853332085
2032,2019,9,NCAAF_20191026_AUBURN@LSU,LSU,Tigers,Auburn,Tigers,8-0,6-2,1,10,10,23,20,0,10,6,7,3,7,3,7,2,0,-3,0,3,0.4490476638426546,-2.0265939487323976,,
2033,2019,9,NCAAF_20191026_CMICH@BUFF,Buffalo,Bulls,C. Michigan,Chippewas,4-4,5-4,0,30,14,43,20,3,27,3,10,7,7,0,6,-1,16,-4,16,23,0.6618112230346946,6.6052778121668325,0.8170367409874495,14.228835981557637
2034,2019,9,NCAAF_20191026_CUSE@FSU,Florida State,Seminoles,Syracuse,Orange,4-4,3-5,0,21,3,35,17,13,8,14,0,0,3,0,14,1,18,13,18,18,0.5009091199627588,0.03606104750895156,0.3540813853289946,-5.890972558049825
2035,2019,9,NCAAF_20191026_FAU@ODU,Old Dominion,Monarchs,FAU,Owls,1-7,5-3,1,3,24,3,41,0,3,0,0,14,10,7,10,-4,-21,-14,-21,-38,0.09964819443836614,-20.311527595708014,0.07904986239431944,-22.213491086580184
2036,2019,9,NCAAF_20191026_FIU@MTSU,Middle Tenn.,Blue Raiders,FIU,Panthers,3-5,4-4,0,14,17,50,17,14,0,23,13,7,10,0,0,-1,-3,7,-3,33,0.5728328275442356,2.9052142004502457,0.5998807229522631,3.982217122155788
2037,2019,9,NCAAF_20191026_IND@NEB,Nebraska,Cornhuskers,Indiana,Hoosiers,4-4,6-2,1,21,16,31,38,14,7,3,7,9,7,15,7,-2,5,5,5,-7,0.4043220264078182,-3.8322808509694823,0.5577610842856189,2.286597368115622
2038,2019,9,NCAAF_20191026_MD@MINN,Minnesota,Golden Gophers,Maryland,Terrapins,8-0,3-5,0,28,3,52,10,14,14,10,14,0,3,0,7,5,25,14,25,42,0.6007917712684825,4.041501010486513,0.7693330982651696,11.59314055073311
2039,2019,9,NCAAF_20191026_MIAOH@KENTST,Kent St.,Golden Flashes,Miami-OH,RedHawks,3-5,4-4,1,6,9,16,23,0,6,0,10,6,3,7,7,-1,-3,-6,-3,-7,0.18605447947294818,-14.123736976798,,
2040,2019,9,NCAAF_20191026_NTEXAS@CHARLO,Charlotte,49ers,North Texas,Mean Green,3-5,3-5,1,7,21,39,38,0,7,14,18,14,7,14,3,0,-14,-14,-14,1,0.1851704489765138,-14.176037591823388,0.36784195745145654,-5.312611722340932
2041,2019,9,NCAAF_20191026_OKLAST@IOWAST,Iowa St.,Cyclones,Oklahoma State,Cowboys,5-3,5-3,1,13,21,27,34,0,13,7,7,7,14,3,10,0,-8,-7,-8,-7,0.5869925677269949,3.478444702030515,0.7588548987742431,11.05761373357987
2042,2019,9,NCAAF_20191026_PSU@MICHST,Michigan St.,Spartans,Penn State,Nittany Lions,4-4,8-0,0,0,21,7,28,0,0,7,0,7,14,7,0,-4,-21,-7,-21,-21,0.13073398810757653,-17.769648384635047,0.18713022256565814,-13.983192622462795
2043,2019,9,NCAAF_20191026_TEXAS@TCU,TCU,Horned Frogs,Texas,Longhorns,4-3,5-3,1,13,17,37,27,3,10,14,10,3,14,3,7,-1,-4,0,-4,10,0.4413666326484291,-2.3341792445413603,0.3138606683018036,-7.63173840934806
2044,2019,9,NCAAF_20191026_TULANE@NAVY,Navy,Midshipmen,Tulane,Green Wave,6-1,5-3,1,31,14,41,38,21,10,0,10,0,14,14,10,1,17,21,17,3,0.5419058626517816,1.6653003530676642,0.5677882698783434,2.6871330655428096
2045,2019,9,NCAAF_20191026_UCONN@MA,UMass,Minutemen,UConn,Huskies,1-7,2-6,1,21,35,35,56,7,14,7,7,14,21,7,14,-1,-14,-7,-14,-21,0.505988187218026,0.2375354574493258,,
2046,2019,9,NCAAF_20191026_UVA@LVILLE,Louisville,Cardinals,Virginia,Cavaliers,5-3,5-3,1,7,14,28,21,7,0,7,14,7,7,0,7,0,-7,0,-7,7,0.3790363445119628,-4.87411104901355,,
2047,2019,9,NCAAF_20191026_SFLA@ECU,East Carolina,Pirates,South Florida,Bulls,3-5,4-4,1,10,35,20,45,7,3,0,10,14,21,3,7,-1,-25,-7,-25,-25,0.1898536826201105,-13.900703111095368,0.4466736273305799,-2.109939536598006
2048,2019,9,NCAAF_20191026_DUKE@UNC,North Carolina,Tar Heels,Duke,Blue Devils,4-4,4-4,0,7,3,20,17,7,0,10,3,3,0,14,0,0,4,4,4,3,0.3339142157583279,-6.790722352263401,,
2049,2019,9,NCAAF_20191026_HAWAII@NMEX,New Mexico,Lobos,Hawaii,Rainbow Warriors,2-6,5-3,1,3,35,31,45,3,0,7,21,21,14,3,7,-3,-32,-18,-32,-14,0.4542337850999205,-1.8193560807761742,,
2050,2019,9,NCAAF_20191026_SC@TENN,Tennessee,Volunteers,South Carolina,Gamecocks,3-5,3-5,0,17,21,41,21,3,14,14,10,7,14,0,0,0,-4,-4,-4,20,0.25542506578623336,-10.404762896653665,0.32520465587706016,-7.132180753448168
2051,2019,9,NCAAF_20191026_ARK@BAMA,Alabama,Crimson Tide,Arkansas,Razorbacks,8-0,2-6,0,41,0,48,7,17,24,7,0,0,0,0,7,6,41,17,41,41,0.9955407919292943,41.38338920054582,0.9979518093518135,45.17703141995977
2052,2019,9,NCAAF_20191026_MEMP@TULSA,Tulsa,Golden Hurricane,Memphis,Tigers,2-6,7-1,0,17,28,41,42,0,17,14,10,14,14,7,7,-5,-11,-14,-11,-1,0.1361671279377118,-17.37047256664073,0.1334604946187845,-17.471587589233792
2053,2019,9,NCAAF_20191026_TROY@GAST,Georgia St.,Panthers,Troy,Trojans,6-2,3-4,1,28,14,52,33,7,21,7,17,0,14,0,19,3,14,7,14,19,0.19690396579706881,-13.493959524482307,0.22536478227938994,-11.869287601683908
2054,2019,9,NCAAF_20191026_TXSTSM@ARKST,Arkansas St.,Red Wolves,Texas St.,Bobcats,4-4,2-5,0,17,14,38,14,7,10,14,7,0,14,0,0,2,3,7,3,24,0.8822011875753758,18.76870907881039,,
2055,2019,9,NCAAF_20191026_TXTECH@KANSAS,Kansas,Jayhawks,Texas Tech,Red Raiders,3-5,3-5,1,14,17,37,34,0,14,6,17,7,10,10,7,0,-3,-7,-3,3,0.1398161036175145,-17.108469098661317,0.4541956315897494,-1.8108935059625253
2056,2019,9,NCAAF_20191026_UCF@TEMPLE,Temple,,UCF,,5-3,6-2,,21,28,21,63,7,14,0,0,14,14,28,7,-1,-7,-7,-7,-42,0.1463995469047623,-16.647268479656077,0.17549377261994137,-14.67807481813724
2057,2019,9,NCAAF_20191026_ARIZST@UCLA,UCLA,Bruins,Arizona St.,Sun Devils,3-5,5-3,0,28,7,42,32,14,14,14,0,7,0,3,22,-2,21,7,21,10,0.38790931697860076,-4.506345643356553,0.2783966126986226,-9.247592255096208
2058,2019,9,NCAAF_20191026_BC@CLEM,Clemson,Tigers,Boston College,Eagles,8-0,4-4,0,38,7,59,7,17,21,14,7,0,7,0,0,4,31,17,31,52,0.928249390983347,23.14911811367699,0.9741074632965804,30.608314333828446
2059,2019,9,NCAAF_20191026_COLOST@FRESNO,Fresno St.,Bulldogs,Colorado St.,Rams,3-4,3-5,0,14,21,31,41,7,7,14,3,14,7,3,17,0,-7,-7,-7,-10,0.8209153351389974,14.540378280596428,,
2060,2019,9,NCAAF_20191026_MIZZOU@UK,Kentucky,Wildcats,Missouri,Tigers,4-4,5-3,0,22,0,29,7,0,22,0,7,0,0,7,0,-1,22,0,22,22,0.30779407902582534,-7.945626558093295,0.19070660437788656,-13.775049542573576
2061,2019,9,NCAAF_20191026_ND@MICH,Michigan,Wolverines,Notre Dame,Fighting Irish,6-2,5-2,0,17,0,45,14,3,14,7,21,0,0,7,7,1,17,3,17,31,0.5699171598157764,2.787675270732848,,
2062,2019,9,NCAAF_20191026_LATECH@UTEP,UTEP,,Louisiana Tech,,1-6,7-1,,7,28,21,42,7,0,0,14,7,21,14,0,-6,-21,0,-21,-21,0.08991474093849572,-21.224934625809624,0.07387535871116935,-22.780527384647613
2063,2019,9,NCAAF_20191026_CAL@UTAH,Utah,Utes,California,Golden Bears,7-1,4-4,1,28,0,35,0,7,21,7,0,0,0,0,0,3,28,7,28,35,0.7457335347939793,10.461877205980045,0.7706015594434805,11.658877766933202
2064,2019,9,NCAAF_20191026_UTAHST@AF,Air Force,Falcons,Utah St.,Aggies,6-2,4-3,1,17,0,31,7,0,17,7,7,0,0,7,0,2,17,0,17,24,0.29984435612100313,-8.305400061559908,0.3893031110580635,-4.424403531819586
2065,2019,9,NCAAF_20191026_SDGST@UNLV,UNLV,Rebels,San Diego St.,Aztecs,2-6,7-1,0,7,17,17,20,0,7,3,7,14,3,3,0,-5,-10,-14,-10,-3,0.1643135530953055,-15.458571575869996,0.2525217598598899,-10.490294512302988
2066,2019,9,NCAAF_20191026_WASHST@OREG,Oregon,Ducks,Washington St.,Cougars,7-1,4-4,1,17,17,37,35,9,8,7,13,3,14,3,15,3,0,6,0,2,0.5296261422031968,1.1762283265143196,0.6751587840593017,7.1480720462442875
2067,2019,9,NCAAF_20191025_USC@COLO,Colorado,Buffaloes,USC,Trojans,3-5,5-3,0,17,14,31,35,3,14,14,0,7,7,7,14,-2,3,-4,3,-4,0.21575283298540393,-12.447741912393326,,
2068,2019,9,NCAAF_20191024_SMU@HOU,Houston,Cougars,SMU,Mustangs,3-5,8-0,0,13,21,31,34,0,13,7,11,7,14,10,3,-5,-8,-7,-8,-3,0.4987754453953416,-0.04857307584040882,,
2069,2019,10,NCAAF_20191103_FRESNO@HAWAII,Hawaii,,Fresno St.,,5-4,4-4,,24,14,38,41,0,24,0,14,7,7,17,10,1,10,-7,10,-3,0.09776493674760034,-20.599206796022486,,
2070,2019,10,NCAAF_20191102_BC@CUSE,Syracuse,,Boston College,,3-6,5-4,,20,44,27,58,17,3,7,0,10,34,7,7,-2,-24,7,-24,-31,0.46243054603048817,-1.5009034870494133,0.6007918157638995,4.000844395451068
2071,2019,10,NCAAF_20191102_BUFF@EMICH,E. Michigan,Eagles,Buffalo,Bulls,4-5,5-4,1,7,29,14,43,7,0,0,7,2,27,7,7,-1,-22,5,-22,-29,0.40749302761140416,-3.7238980877092445,,
2072,2019,10,NCAAF_20191102_HOU@UCF,UCF,Knights,Houston,Cougars,7-2,3-6,0,21,23,44,29,14,7,21,2,17,6,0,6,4,-2,-3,-2,15,0.8475408631171004,16.32705653238048,0.8954153709728291,19.673173729102686
2073,2019,10,NCAAF_20191102_LIB@MA,UMass,Minutemen,Liberty,Flames,1-8,6-3,0,14,49,21,63,7,7,7,0,28,21,14,0,-5,-35,-21,-35,-42,0.3207172232638057,-7.41114444253185,,
2074,2019,10,NCAAF_20191102_MICH@MD,Maryland,Terrapins,Michigan,Wolverines,3-6,7-2,0,0,21,7,38,0,0,7,0,14,7,14,3,-4,-21,-14,-21,-31,0.07986981991397601,-22.374517845071068,0.03238006087955125,-28.93219892452153
2075,2019,10,NCAAF_20191102_NCST@WAKE,Wake Forest,Demon Deacons,NC State,Wolfpack,7-1,4-4,0,34,10,44,10,21,13,10,0,0,10,0,0,3,24,21,24,34,0.41811482324651994,-3.289758481566764,0.41451861960121117,-3.382685956648146
2076,2019,10,NCAAF_20191102_NEB@PURDUE,Purdue,Boilermakers,Nebraska,Cornhuskers,3-6,4-5,0,14,10,31,27,0,14,3,14,10,0,3,14,-1,4,-10,4,4,0.6923095178093398,7.9954064034430985,0.3167957362744841,-7.46724949672528
2077,2019,10,NCAAF_20191102_NILL@CMICH,C. Michigan,Chippewas,N. Illinois,Huskies,6-4,3-6,0,38,10,48,10,21,17,0,10,3,7,0,0,3,28,18,28,38,0.2988768637377921,-8.396859302249027,0.18672489721382624,-13.942486641967363
2078,2019,10,NCAAF_20191102_ODU@FIU,FIU,Panthers,Old Dominion,Monarchs,5-4,1-8,0,9,7,24,17,3,6,7,8,7,0,0,10,4,2,-4,2,7,0.7620765415361431,11.346786716940983,0.7266397944705757,9.441123139151522
2079,2019,10,NCAAF_20191102_TXSA@TXAM,Texas A&M,Aggies,UTSA,Roadrunners,6-3,3-5,0,21,7,45,14,14,7,14,10,7,0,0,7,3,14,7,14,31,0.9721981278653622,30.461801462502308,0.9990089208959704,48.45074436819888
2080,2019,10,NCAAF_20191102_AKRON@BGREEN,Bowling Green,Falcons,Akron,Zips,3-6,0-9,0,21,6,35,6,7,14,7,7,6,0,0,0,3,15,1,15,29,0.3818103930549197,-4.785865711154656,0.6154534713892954,4.598694838843315
2081,2019,10,NCAAF_20191102_VATECH@ND,Notre Dame,Fighting Irish,Virginia Tech,Hokies,6-2,5-3,1,14,14,21,20,7,7,0,7,7,7,3,3,1,0,0,0,1,0.8312624703544919,15.264350819153947,,
2082,2019,10,NCAAF_20191102_TROY@CSTCAR,C. Carolina,Chanticleers,Troy,Trojans,4-4,3-5,0,17,21,36,35,14,3,11,8,21,0,7,7,1,-4,-7,-4,1,0.19940083204858505,-13.427809037695852,,
2083,2019,10,NCAAF_20191102_ARKST@LAMON,UL-Monroe,Warhawks,Arkansas St.,Red Wolves,3-5,5-4,1,28,31,41,48,14,14,6,7,3,28,3,14,-2,-3,11,-3,-7,0.24742058942271217,-10.863489880214047,,
2084,2019,10,NCAAF_20191102_ARMY@AF,Air Force,Falcons,Army,Black Knights,7-2,3-6,0,3,6,17,13,0,3,7,7,0,6,7,0,4,-3,0,-3,4,0.5144512545518236,0.5766004805733473,0.8299627354458664,14.944871232462312
2085,2019,10,NCAAF_20191102_KSTATE@KANSAS,Kansas,Jayhawks,Kansas State,Wildcats,3-6,6-2,1,3,17,10,38,3,0,0,7,7,10,7,14,-3,-14,-4,-14,-28,0.15909625698124585,-15.885210725564889,0.2333794226552104,-11.400539804839717
2086,2019,10,NCAAF_20191102_MIAMI@FSU,Florida State,Seminoles,Miami (Fla.),Hurricanes,4-5,5-4,0,3,17,10,27,0,3,7,0,7,10,0,10,-1,-14,-7,-14,-17,0.36061110851521927,-5.678593187004026,0.44972867243015224,-1.9792476837558866
2087,2019,10,NCAAF_20191102_MRSHL@RICE,Rice,Owls,Marshall,Thundering Herd,0-9,6-3,0,7,17,7,20,0,7,0,0,3,14,3,0,-6,-10,-3,-10,-13,0.10788871101613806,-19.69913229498991,0.2932592450433824,-8.520108981955943
2088,2019,10,NCAAF_20191102_MTSU@CHARLO,Charlotte,49ers,Middle Tenn.,Blue Raiders,4-5,3-6,0,24,7,34,20,14,10,10,0,7,0,6,7,1,17,7,17,14,0.15635206818680358,-16.066394931506125,0.2129260051051145,-12.474342072845566
2089,2019,10,NCAAF_20191102_RUT@ILL,Illinois,Fighting Illini,Rutgers,Scarlet Knights,5-4,2-7,1,10,10,38,10,10,0,21,7,0,10,0,0,3,0,10,0,28,0.6146758346374983,4.639414991441299,0.8024499240043066,13.3217485744144
2090,2019,10,NCAAF_20191102_TCU@OKLAST,Oklahoma State,Cowboys,TCU,Horned Frogs,6-3,4-4,1,17,17,34,27,10,7,7,10,3,14,0,10,2,0,7,0,7,0.5058368668650128,0.23284650318635158,0.4904076696393924,-0.3766964449554919
2091,2019,10,NCAAF_20191102_UGA@FLA,Florida,Gators,Georgia,Bulldogs,7-2,7-1,1,3,13,17,24,0,3,0,14,3,10,3,8,0,-10,-3,-10,-7,0.16229372296442235,-15.676662514279371,0.2905767948861623,-8.642491450254845
2092,2019,10,NCAAF_20191102_UNLV@COLOST,Colorado St.,Rams,UNLV,Rebels,4-5,2-7,1,24,0,37,17,21,3,3,10,0,0,3,14,2,24,21,24,20,0.6556686800561254,6.376347951783828,0.5004470666854474,0.01755488303342645
2093,2019,10,NCAAF_20191102_UTEP@NTEXAS,North Texas,Mean Green,UTEP,Miners,4-5,1-7,1,38,14,52,26,21,17,7,7,7,7,6,6,3,24,14,24,26,0.9105315045120466,21.38923046319644,0.8651638205772662,17.291506784243936
2094,2019,10,NCAAF_20191102_FAU@WKY,W. Kentucky,Hilltoppers,FAU,Owls,5-4,6-3,1,14,21,24,35,14,0,7,3,0,21,7,7,-1,-7,14,-7,-11,0.18382338730552406,-14.336934478202352,0.2241944987586877,-11.875834436757408
2095,2019,10,NCAAF_20191102_MISSST@ARK,Arkansas,Razorbacks,Miss. State,Bulldogs,2-7,4-5,0,10,38,24,54,0,10,7,7,14,24,7,9,-2,-28,-14,-28,-30,0.09688841670340409,-20.68028219525695,0.08920076917361786,-21.08053393155999
2096,2019,10,NCAAF_20191102_PITT@GATECH,Georgia Tech,Yellow Jackets,Pittsburgh,Panthers,2-6,6-3,0,7,17,10,20,0,7,3,0,10,7,0,3,-4,-10,-10,-10,-10,0.4968804451400569,-0.12444329189168002,,
2097,2019,10,NCAAF_20191102_TULSA@TULANE,Tulane,Green Wave,Tulsa,Golden Hurricane,6-3,2-7,0,24,16,38,26,10,14,7,7,0,16,0,10,4,8,10,8,12,0.6966419479531463,8.192093344550585,0.5474024524734538,1.8657443503951825
2098,2019,10,NCAAF_20191102_UTAH@WASH,Washington,Huskies,Utah,Utes,5-4,8-1,0,14,13,28,33,7,7,7,7,0,13,6,14,-3,1,7,1,-5,0.6011141368442431,4.077723873053628,0.4598233431162937,-1.5802850777954447
2099,2019,10,NCAAF_20191102_WOFF@CLEM,Clemson,Tigers,Wofford,Terriers,9-0,5-3,1,42,0,59,14,21,21,14,3,0,0,14,0,4,42,21,42,45,0.9941652586894895,40.13533838105366,,
2100,2019,10,NCAAF_20191102_OREGST@ARIZ,Arizona,Wildcats,Oregon State,Beavers,4-5,4-4,0,19,35,38,56,6,13,12,7,7,28,7,14,0,-16,-1,-16,-18,0.8477301956927378,16.33984561249622,0.5514661931427383,2.02655132053782
2101,2019,10,NCAAF_20191102_TXSTSM@LALAF,Louisiana,Ragin' Cajuns,Texas St.,Bobcats,6-2,2-6,0,10,3,31,3,0,10,21,0,0,3,0,0,4,7,0,7,28,0.8078832809420495,13.847294380088442,,
2102,2019,10,NCAAF_20191102_CINCY@ECU,East Carolina,Pirates,Cincinnati,Bearcats,3-6,7-1,1,31,21,43,46,14,17,9,3,21,0,7,18,-4,10,-7,10,-3,0.10446847235606538,-19.99608153053464,0.01610385945724102,-33.552061356954965
2103,2019,10,NCAAF_20191102_MISS@AUBURN,Auburn,Tigers,Ole Miss,Rebels,7-2,3-6,0,10,7,20,14,0,10,10,0,0,7,0,7,4,3,0,3,6,0.8818206672667759,18.844586513021113,0.8869183282900197,18.959595392522814
2104,2019,10,NCAAF_20191102_NWEST@IND,Indiana,Hoosiers,Northwestern,Wildcats,7-2,1-7,1,24,3,34,3,10,14,7,3,0,3,0,0,6,21,10,21,31,0.4453140822926912,-2.1883505119679967,0.4767291411612762,-0.9142910349788735
2105,2019,10,NCAAF_20191102_UAB@TENN,Tennessee,Volunteers,UAB,Blazers,4-5,6-2,0,23,0,30,7,6,17,7,0,0,0,0,7,-2,23,6,23,23,0.6500263398705016,6.133194320756957,0.6607231660049211,6.492242619171208
2106,2019,10,NCAAF_20191102_SMU@MEMP,Memphis,Tigers,SMU,Mustangs,8-1,8-1,0,23,17,54,48,7,16,17,14,7,10,7,24,0,6,0,6,6,0.6219361912336241,4.942467891688807,0.6101244006835992,4.380664508696107
2107,2019,10,NCAAF_20191102_UVA@UNC,North Carolina,Tar Heels,Virginia,Cavaliers,4-5,6-3,1,17,17,31,38,3,14,14,0,7,10,21,0,-2,0,-4,0,-7,0.3565301128109184,-5.852430705634561,,
2108,2019,10,NCAAF_20191102_VANDY@SC,South Carolina,Gamecocks,Vanderbilt,Commodores,4-5,2-6,1,14,7,24,7,0,14,0,10,7,0,0,0,2,7,-7,7,17,0.7141709890052838,9.00124548641179,,
2109,2019,10,NCAAF_20191102_OREG@USC,USC,Trojans,Oregon,Ducks,5-4,8-1,1,17,28,24,56,10,7,0,7,0,28,14,14,-3,-11,10,-11,-32,0.44145476503674974,-2.34387171321373,0.22614826260186272,-11.773828049341255
2110,2019,10,NCAAF_20191102_COLO@UCLA,UCLA,Bruins,Colorado,Buffaloes,4-5,3-6,0,17,7,31,14,17,0,7,7,0,7,0,7,1,10,17,10,17,0.5685647725314165,2.748720282228078,,
2111,2019,10,NCAAF_20191102_BYU@UTAHST,Utah St.,Aggies,BYU,Cougars,4-4,4-4,1,14,21,14,42,7,7,0,0,7,14,14,7,0,-7,0,-7,-28,0.7137093274794823,8.97964316425373,,
2112,2019,10,NCAAF_20191102_BOISE@SJST,San Jose St.,Spartans,Boise St.,Broncos,4-5,7-1,1,24,17,42,52,14,10,10,8,7,10,14,21,-3,7,7,7,-10,0.030844460536002538,-29.736060326720235,0.06658805754146913,-23.524320954858098
2113,2019,10,NCAAF_20191102_NMEX@NEVADA,Nevada,Wolf Pack,New Mexico,Lobos,5-4,2-7,1,14,7,21,10,0,14,0,7,7,0,3,0,3,7,-7,7,11,0.6342381697050721,5.460149058385582,0.6310687157006228,5.242906489838816
2114,2019,10,NCAAF_20191101_NAVY@UCONN,UConn,Huskies,Navy,Midshipmen,2-7,7-1,1,10,28,10,56,7,3,0,0,14,14,14,14,-5,-18,-7,-18,-46,0.06562008162168842,-24.018161852182516,0.026544244742092937,-30.299613061571144
2115,2019,10,NCAAF_20191031_GAS@APLST,App. St.,Mountaineers,Ga. Southern,Eagles,7-1,5-3,1,7,10,21,24,0,7,0,14,7,3,14,0,2,-3,-7,-3,-3,0.8166722943380725,14.366629238955852,,
2116,2019,10,NCAAF_20191031_WVU@BAYLOR,Baylor,Bears,West Virginia,Mountaineers,8-0,3-5,0,7,0,17,14,7,0,7,3,0,0,14,0,5,7,7,7,3,0.2909155397710619,-8.764135561807848,,
2117,2019,11,NCAAF_20191109_ECU@SMU,SMU,Mustangs,East Carolina,Pirates,9-1,3-7,1,28,20,59,51,14,14,17,14,7,13,17,14,6,8,7,8,8,0.8885211347170803,19.48511304517865,0.9296349544257593,22.6615243272732
2118,2019,11,NCAAF_20191109_FSU@BC,Boston College,Eagles,Florida State,Seminoles,5-5,5-5,1,14,10,31,38,7,7,0,17,3,7,14,14,0,4,4,4,-7,0.5395830059550386,1.588981902827868,0.439887526200645,-2.3268663449461116
2119,2019,11,NCAAF_20191109_MA@ARMY,Army,Black Knights,UMass,Minutemen,4-6,1-9,0,35,7,63,7,14,21,14,14,7,0,0,0,3,28,7,28,56,0.9183276334745389,22.286433765117522,0.9752585270611034,30.220029091784795
2120,2019,11,NCAAF_20191109_MD@OHIOST,Ohio State,Buckeyes,Maryland,Terrapins,9-0,3-7,0,42,0,73,14,21,21,10,21,0,0,7,7,6,42,21,42,59,0.9745015329931319,31.201508273069066,0.998532843212232,45.75966129318405
2121,2019,11,NCAAF_20191109_PSU@MINN,Minnesota,Golden Gophers,Penn State,Nittany Lions,9-0,8-1,0,24,13,31,26,14,10,0,7,10,3,6,7,1,11,4,11,5,0.09502225264251818,-20.951996253043376,,
2122,2019,11,NCAAF_20191109_PURDUE@NWEST,Northwestern,Wildcats,Purdue,Boilermakers,1-8,4-6,0,16,7,22,24,14,2,0,6,0,7,14,3,-3,9,14,9,-2,0.42250756880515505,-3.125460088404452,0.5610038530897581,2.361640647272907
2123,2019,11,NCAAF_20191109_TXTECH@WVU,West Virginia,Mountaineers,Texas Tech,Red Raiders,3-6,4-5,0,10,35,17,38,3,7,0,7,21,14,0,3,-1,-25,-18,-25,-21,0.5286147921364507,1.1477815006803667,,
2124,2019,11,NCAAF_20191109_VANDY@FLA,Florida,Gators,Vanderbilt,Commodores,8-2,2-7,1,14,0,56,0,0,14,28,14,0,0,0,0,6,14,0,14,56,0.81681118702451,14.442018574660324,,
2125,2019,11,NCAAF_20191109_WKY@ARK,Arkansas,Razorbacks,W. Kentucky,Hilltoppers,2-8,6-4,1,7,35,19,45,7,0,0,12,14,21,3,7,-4,-28,-7,-28,-26,0.6556217572928742,6.404056212211572,0.45047797914771126,-1.9145720716733194
2126,2019,11,NCAAF_20191109_GATECH@UVA,Virginia,Cavaliers,Georgia Tech,Yellow Jackets,7-3,2-7,0,24,21,33,28,14,10,0,9,14,7,0,7,5,3,0,3,5,0.4804218505810829,-0.784949651692159,,
2127,2019,11,NCAAF_20191109_TXSA@ODU,Old Dominion,Monarchs,UTSA,Roadrunners,1-9,4-5,0,20,10,23,24,10,10,3,0,10,0,0,14,-3,10,0,10,-1,0.48034711929219187,-0.7879482865999989,0.686134364764779,7.459949196883642
2128,2019,11,NCAAF_20191109_CHARLO@UTEP,UTEP,Miners,Charlotte,49ers,1-8,5-5,1,21,7,21,28,14,7,0,0,0,7,14,7,-4,14,14,14,-7,0.27846084235003565,-9.391922487188936,0.13111772540780509,-17.247127984085893
2129,2019,11,NCAAF_20191109_SALA@TXSTSM,Texas St.,Bobcats,South Alabama,Jaguars,3-6,1-8,0,13,14,30,28,3,10,14,3,7,7,7,7,2,-1,-4,-1,2,0.4402277059565747,-2.4045306106031603,,
2130,2019,11,NCAAF_20191109_STNFRD@COLO,Colorado,Buffaloes,Stanford,Cardinal,4-6,4-5,1,10,6,16,13,7,3,0,6,3,3,0,7,0,4,4,4,3,0.22607487335905674,-12.020674986056633,,
2131,2019,11,NCAAF_20191109_GAS@TROY,Troy,Trojans,Ga. Southern,Eagles,4-5,5-4,1,27,14,49,28,14,13,0,22,0,14,0,14,-1,13,14,13,21,0.6546022484215441,6.3598091391414755,,
2132,2019,11,NCAAF_20191109_ILL@MICHST,Michigan St.,Spartans,Illinois,Fighting Illini,4-5,6-4,0,28,10,34,37,14,14,3,3,3,7,0,27,-2,18,11,18,-3,0.8537939989496912,16.833338738606926,0.8138286805276775,13.72378824667365
2133,2019,11,NCAAF_20191109_KSTATE@TEXAS,Texas,Longhorns,Kansas State,Wildcats,6-3,6-3,0,7,14,27,24,0,7,10,10,14,0,0,10,0,-7,-14,-7,3,0.6325159728550063,5.412473088574984,0.5244181393111416,0.9421876572057641
2134,2019,11,NCAAF_20191109_LSU@BAMA,Alabama,Crimson Tide,LSU,Tigers,8-1,9-0,1,13,33,41,46,7,6,7,21,10,23,0,13,-1,-20,-3,-20,-5,0.831444725414066,15.34713407475374,,
2135,2019,11,NCAAF_20191109_LVILLE@MIAMI,Miami (Fla.),Hurricanes,Louisville,Cardinals,6-4,5-4,0,35,14,52,27,21,14,17,0,7,7,7,6,1,21,14,21,25,0.7738398229995958,12.016140155712037,0.8661608123715198,17.051780214719813
2136,2019,11,NCAAF_20191109_UAB@USM,So. Miss,Golden Eagles,UAB,Blazers,6-3,6-3,0,20,2,37,2,7,13,10,7,0,2,0,0,0,18,7,18,35,0.487237221535887,-0.5115817676680763,,
2137,2019,11,NCAAF_20191109_UCONN@CINCY,Cincinnati,Bearcats,UConn,Huskies,8-1,2-8,0,38,0,48,3,14,24,3,7,0,0,0,3,6,38,14,38,45,0.9445311794758918,25.48544116541177,0.9938444066828352,38.50712684897712
2138,2019,11,NCAAF_20191109_USC@ARIZST,Arizona St.,Sun Devils,USC,Trojans,5-4,6-4,0,13,28,26,31,7,6,7,6,28,0,3,0,-1,-15,-21,-15,-5,0.39391238101707593,-4.303067354904215,0.4046794177301488,-3.7113905515469696
2139,2019,11,NCAAF_20191109_WAKE@VATECH,Virginia Tech,Hokies,Wake Forest,Demon Deacons,6-3,7-2,1,6,10,36,17,3,3,17,13,3,7,7,0,-1,-4,0,-4,19,0.46070754993765894,-1.577280055496658,,
2140,2019,11,NCAAF_20191109_IOWA@WISC,Wisconsin,Badgers,Iowa,Hawkeyes,7-2,6-3,1,14,6,24,22,0,14,7,3,3,3,0,16,1,8,-3,8,2,0.5177651743411824,0.7122112174181439,,
2141,2019,11,NCAAF_20191109_NMEXST@MISS,Ole Miss,Rebels,New Mexico St.,Aggies,4-6,0-9,1,24,3,41,3,10,14,7,10,0,3,0,0,4,21,10,21,38,0.9330404215574335,23.96384971371981,,
2142,2019,11,NCAAF_20191109_NTEXAS@LATECH,Louisiana Tech,Bulldogs,North Texas,Mean Green,8-1,4-6,0,17,3,52,17,7,10,14,21,3,0,0,14,4,14,4,14,35,0.49100585283097253,-0.360489410361879,,
2143,2019,11,NCAAF_20191109_GAST@LAMON,UL-Monroe,Warhawks,Georgia St.,Panthers,4-5,6-3,1,24,24,45,31,14,10,7,14,10,14,7,0,-2,0,4,0,14,0.48960069143788243,-0.4168208011038814,,
2144,2019,11,NCAAF_20191109_FIU@FAU,FAU,Owls,FIU,Panthers,7-3,5-5,0,13,7,37,7,7,6,15,9,0,7,0,0,2,6,7,6,30,0.7424820627810762,10.408730127383706,0.7959477214736821,12.725994802257219
2145,2019,11,NCAAF_20191109_APLST@SC,South Carolina,Gamecocks,App. St.,Mountaineers,4-6,8-1,1,6,13,15,20,6,0,3,6,3,10,7,0,-4,-7,3,-7,-5,0.6531454314984658,6.296667055484704,0.34213474303920977,-6.255727522818788
2146,2019,11,NCAAF_20191109_MIZZOU@UGA,Georgia,Bulldogs,Missouri,Tigers,8-1,5-4,0,16,0,27,0,7,9,3,8,0,0,0,0,3,16,7,16,27,0.8276109414587531,15.105331509912617,0.7629975424220719,11.014458882937646
2147,2019,11,NCAAF_20191109_UTAHST@FRESNO,Fresno St.,Bulldogs,Utah St.,Aggies,4-5,5-4,1,14,21,35,37,7,7,14,7,7,14,10,6,-1,-7,0,-7,-2,0.5269091831715871,1.079259695401447,,
2148,2019,11,NCAAF_20191109_WASHST@CAL,California,Golden Bears,Washington St.,Cougars,5-4,4-5,0,13,11,33,20,6,7,7,13,5,6,3,6,1,2,1,2,13,0.27468487320282975,-9.572349407807451,0.2561289171183079,-10.081401721204102
2149,2019,11,NCAAF_20191109_CLEM@NCST,NC State,Wolfpack,Clemson,Tigers,4-5,10-0,0,0,42,10,55,0,0,7,3,28,14,7,6,-6,-42,-28,-42,-45,0.07632021830197899,-22.867720459871407,0.05206971231027291,-25.00033648429296
2150,2019,11,NCAAF_20191109_LIB@BYU,BYU,Cougars,Liberty,Flames,5-4,6-4,0,17,7,31,24,7,10,7,7,7,0,10,7,-1,10,0,10,7,0.754166762024262,10.994614221357665,,
2151,2019,11,NCAAF_20191109_ND@DUKE,Duke,Blue Devils,Notre Dame,Fighting Irish,4-5,7-2,0,7,21,7,38,0,7,0,0,14,7,7,10,-3,-14,-14,-14,-31,0.1683943155036589,-15.357362803220553,0.14249674272792312,-16.447877532811546
2152,2019,11,NCAAF_20191109_TENN@UK,Kentucky,Wildcats,Tennessee,Volunteers,4-5,5-5,1,13,3,13,17,13,0,0,0,0,3,14,0,-1,10,13,10,-4,0.6691695469705767,6.996875361968478,0.6138270364929019,4.450650074815883
2153,2019,11,NCAAF_20191109_IOWAST@OKLA,Oklahoma,Sooners,Iowa St.,Cyclones,8-1,5-4,1,35,14,42,41,14,21,7,0,7,7,7,20,3,21,7,21,1,0.735944717931812,10.08698609986584,0.5877794091403935,3.412686789151138
2154,2019,11,NCAAF_20191109_NEVADA@SDGST,San Diego St.,Aztecs,Nevada,Wolf Pack,7-2,6-4,1,3,3,13,17,0,3,7,3,3,0,7,7,1,0,-3,0,-4,0.788814852375161,12.827769471442366,,
2155,2019,11,NCAAF_20191109_SJST@HAWAII,Hawaii,Rainbow Warriors,San Jose St.,Spartans,6-4,4-6,0,21,23,42,40,7,14,7,14,3,20,3,14,2,-2,4,-2,2,0.6504224286228528,6.178907238422539,,
2156,2019,11,NCAAF_20191108_UCF@TULSA,Tulsa,Golden Hurricane,UCF,Knights,3-7,7-3,1,17,28,34,31,7,10,7,10,14,14,3,0,-4,-11,-7,-11,3,0.043859454434271195,-27.301124917234574,0.06647501534145839,-23.11522416645205
2157,2019,11,NCAAF_20191108_WASH@OREGST,Oregon State,Beavers,Washington,Huskies,4-5,6-4,1,0,10,7,19,0,0,7,0,3,7,9,0,-2,-10,-3,-10,-12,0.024936814477305114,-31.35404858484378,0.0821182760390251,-21.398293777230556
2158,2019,11,NCAAF_20191107_LALAF@CSTCAR,C. Carolina,Chanticleers,Louisiana,Ragin' Cajuns,4-5,7-2,0,0,24,7,48,0,0,0,7,14,10,21,3,-3,-24,-14,-24,-41,0.3192747223590817,-7.510210891816996,,
2159,2019,11,NCAAF_20191107_TEMPLE@SFLA,South Florida,Bulls,Temple,Owls,4-5,6-3,1,0,7,7,17,0,0,7,0,0,7,7,3,-2,-7,0,-7,-10,0.4329559739803388,-2.6997007229693963,0.2876278741437174,-8.619970448986024
2160,2019,11,NCAAF_20191106_MIAOH@OHIO,Ohio,Bobcats,Miami-OH,RedHawks,4-5,5-4,1,7,7,21,24,0,7,0,14,0,7,7,10,-1,0,0,0,-3,0.6747493145161512,7.24381015415554,,
2161,2019,11,NCAAF_20191105_KENTST@TOLEDO,Toledo,Rockets,Kent St.,Golden Flashes,6-3,3-6,0,28,17,35,33,14,14,0,7,10,7,10,6,3,11,4,11,2,0.888022965497856,19.44322466040319,,
2162,2019,11,NCAAF_20191105_BALLST@WMICH,W. Michigan,Broncos,Ball St.,Cardinals,6-4,4-5,1,21,10,35,31,7,14,0,14,7,3,7,14,2,11,0,11,4,0.8225401307041402,14.790715973377473,,
2163,2019,12,NCAAF_20191116_ALST@FSU,Florida State,Seminoles,Alabama St.,Hornets,6-5,5-5,0,21,6,49,12,14,7,14,14,3,3,6,0,1,15,11,15,37,0.9938726931126902,40.20228080729191,,
2164,2019,12,NCAAF_20191116_BAMA@MISSST,Miss. State,Bulldogs,Alabama,Crimson Tide,4-6,9-1,0,7,35,7,38,7,0,0,0,21,14,3,0,-5,-28,-14,-28,-31,0.10981899440837684,-19.701932093209848,0.09817362955704301,-19.53406722160574
2165,2019,12,NCAAF_20191116_FLA@MIZZOU,Missouri,Tigers,Florida,Gators,5-5,9-2,0,3,6,6,23,0,3,3,0,3,3,14,3,-4,-3,-3,-3,-17,0.45393631606584894,-1.8574085958620117,0.18270199248784835,-13.684368708847813
2166,2019,12,NCAAF_20191116_IND@PSU,Penn State,Nittany Lions,Indiana,Hoosiers,9-1,7-3,1,20,14,34,27,17,3,7,7,14,0,3,10,2,6,3,6,7,0.9118140244969335,21.7005361546764,0.8848766773895715,18.138519072981353
2167,2019,12,NCAAF_20191116_KANSAS@OKLAST,Oklahoma State,Cowboys,Kansas,Jayhawks,7-3,3-7,0,24,0,31,13,14,10,7,0,0,0,0,13,4,24,14,24,18,0.9075777221425738,21.282817181756172,0.8058361595254943,13.042392177460528
2168,2019,12,NCAAF_20191116_MA@NWEST,Northwestern,Wildcats,UMass,Minutemen,2-8,1-10,1,21,6,45,6,0,21,3,21,3,3,0,0,1,15,-3,15,39,0.9820240033404986,33.6655833884538,0.9996699791345307,51.48988681300003
2169,2019,12,NCAAF_20191116_MICHST@MICH,Michigan,Wolverines,Michigan St.,Spartans,8-2,4-6,1,17,7,44,10,0,17,10,17,7,0,3,0,4,10,-7,10,34,0.8031079739370749,13.687523862986382,,
2170,2019,12,NCAAF_20191116_TCU@TXTECH,Texas Tech,Red Raiders,TCU,Horned Frogs,4-6,5-5,0,16,27,31,33,0,16,12,3,17,10,0,6,-1,-11,-17,-11,-2,0.41070684732159257,-3.6230477536598755,,
2171,2019,12,NCAAF_20191116_TULANE@TEMPLE,Temple,Owls,Tulane,Green Wave,7-3,6-4,1,13,7,29,21,3,10,9,7,0,7,0,14,1,6,3,6,8,0.5138805251450091,0.5585652047607255,0.3710171607292774,-4.976550090025313
2172,2019,12,NCAAF_20191116_VMI@ARMY,Army,Black Knights,VMI,Keydets,5-6,4-7,1,14,6,47,6,7,7,19,14,3,3,0,0,1,8,4,8,41,0.999955853888471,62.929455922857755,,
2173,2019,12,NCAAF_20191116_WISC@NEB,Nebraska,Cornhuskers,Wisconsin,Badgers,4-6,8-2,1,14,27,21,37,7,7,7,0,7,20,7,3,-4,-13,0,-13,-16,0.10967066829168615,-19.714614214922108,,
2174,2019,12,NCAAF_20191116_UTEP@UAB,UAB,Blazers,UTEP,Miners,7-3,1-9,0,23,7,37,10,17,6,7,7,0,7,0,3,6,16,17,16,27,0.9008160923510576,20.64449099025626,0.8676185496253859,16.86067623059978
2175,2019,12,NCAAF_20191116_NAVY@ND,Notre Dame,Fighting Irish,Navy,Midshipmen,8-2,7-2,1,38,3,52,20,14,24,7,7,0,3,7,10,1,35,14,35,32,0.8626444550926147,17.531675905802786,0.6798458269133375,7.064580067420593
2176,2019,12,NCAAF_20191116_CSTCAR@ARKST,Arkansas St.,Red Wolves,C. Carolina,Chanticleers,6-4,4-6,0,7,13,28,27,7,0,14,7,3,10,0,14,2,-6,4,-6,1,0.7978535420211796,13.385833492714369,,
2177,2019,12,NCAAF_20191116_IDST@BYU,BYU,Cougars,Idaho State,Bengals,6-4,3-8,1,28,3,42,10,7,21,14,0,0,3,7,0,3,25,7,25,32,0.8526412462961337,16.818246382582174,,
2178,2019,12,NCAAF_20191116_LAMON@GAS,Ga. Southern,Eagles,UL-Monroe,Warhawks,6-4,4-6,1,24,7,51,29,7,17,7,20,7,0,7,15,2,17,0,17,22,0.592030147179823,3.7360968964043195,,
2179,2019,12,NCAAF_20191116_TROY@TXSTSM,Texas St.,Bobcats,Troy,Trojans,3-7,5-5,0,10,35,27,63,3,7,10,7,14,21,7,21,-2,-25,-11,-25,-36,0.10557038010899866,-20.070188190176168,,
2180,2019,12,NCAAF_20191116_CMICH@BALLST,Ball St.,Cardinals,C. Michigan,Chippewas,4-6,7-4,1,27,11,44,45,3,24,14,3,3,8,20,14,-3,16,0,16,-1,0.2771067837937269,-9.493237094648748,,
2181,2019,12,NCAAF_20191116_MEMP@HOU,Houston,Cougars,Memphis,Tigers,3-7,9-1,1,20,28,27,45,17,3,0,7,7,21,14,3,-6,-8,10,-8,-18,0.3666024430787944,-5.47108371518766,0.24929664297507403,-10.2310406505716
2182,2019,12,NCAAF_20191116_OHIOST@RUT,Rutgers,Scarlet Knights,Ohio State,Buckeyes,2-8,10-0,1,7,35,21,56,7,0,7,7,21,14,14,7,-8,-28,-14,-28,-35,0.0024934586352477472,-45.0680296220433,2.158861863577055e-05,-61.833110739256
2183,2019,12,NCAAF_20191116_TEXAS@IOWAST,Iowa St.,Cyclones,Texas,Longhorns,6-4,6-4,0,10,7,23,21,7,3,10,3,0,7,0,14,0,3,7,3,2,0.5447645572801065,1.8047998204820033,0.6086123150712688,4.168345847482698
2184,2019,12,NCAAF_20191116_UGA@AUBURN,Auburn,Tigers,Georgia,Bulldogs,7-3,9-1,1,0,14,14,21,0,0,0,14,7,7,7,0,-2,-14,-7,-14,-7,0.3220511442757541,-7.414892912599726,0.5173778072642083,0.6587837692148355
2185,2019,12,NCAAF_20191116_UK@VANDY,Vanderbilt,Commodores,Kentucky,Wildcats,2-8,5-5,1,14,24,14,38,14,0,0,0,3,21,14,0,-3,-10,11,-10,-24,0.28237221970151793,-9.242057704819103,,
2186,2019,12,NCAAF_20191116_VATECH@GATECH,Georgia Tech,Yellow Jackets,Virginia Tech,Hokies,2-8,7-3,1,0,31,0,45,0,0,0,0,14,17,14,0,-5,-31,-14,-31,-45,0.4591750767584515,-1.6453785106079977,,
2187,2019,12,NCAAF_20191116_WAKE@CLEM,Clemson,Tigers,Wake Forest,Demon Deacons,11-0,7-3,0,31,3,52,3,14,17,14,7,3,0,0,0,4,28,11,28,49,0.9411729589745337,25.11426741420655,0.9452028470100898,24.19055237375244
2188,2019,12,NCAAF_20191116_WVU@KSTATE,Kansas State,Wildcats,West Virginia,Mountaineers,6-4,4-6,0,13,14,20,24,10,3,7,0,14,0,0,10,2,-1,-4,-1,-4,0.504566983535482,0.18374657830213437,0.8297211148549438,14.409287988385387
2189,2019,12,NCAAF_20191116_CUSE@DUKE,Duke,Blue Devils,Syracuse,Orange,4-6,4-6,1,6,14,6,49,0,6,0,0,14,0,21,14,0,-8,-14,-8,-43,0.5133367372115324,0.5366743508760692,0.6012296229141177,3.8784716885274406
2190,2019,12,NCAAF_20191116_HAWAII@UNLV,UNLV,Rebels,Hawaii,Rainbow Warriors,2-8,7-4,1,7,7,7,21,7,0,0,0,0,7,7,7,-5,0,7,0,-14,0.5080041102201156,0.3220494254055666,0.18256034931678056,-13.692456052039262
2191,2019,12,NCAAF_20191116_MINN@IOWA,Iowa,Hawkeyes,Minnesota,Golden Gophers,7-3,9-1,1,20,6,23,19,13,7,0,3,0,6,7,6,-2,14,13,14,4,0.7722939205195385,11.980506704503114,,
2192,2019,12,NCAAF_20191116_UIW@NMEXST,New Mexico St.,,Incarnate Word,,1-9,5-6,,24,7,41,28,14,10,3,14,0,7,7,14,-4,17,14,17,13,0.9746906623437399,31.374019259627175,,
2193,2019,12,NCAAF_20191116_WYO@UTAHST,Utah St.,Aggies,Wyoming,Cowboys,6-4,6-4,1,20,14,26,21,0,20,3,3,0,14,0,7,0,6,0,6,5,0.6526716270685045,6.300544469889587,,
2194,2019,12,NCAAF_20191116_RICE@MTSU,Middle Tenn.,Blue Raiders,Rice,Owls,3-7,1-9,1,14,31,28,31,0,14,7,7,10,21,0,0,2,-17,-10,-17,-3,0.8811928800951665,18.955255002195827,,
2195,2019,12,NCAAF_20191116_STNFRD@WASHST,Washington St.,Cougars,Stanford,Cardinal,5-5,4-6,1,22,14,49,22,13,9,10,17,0,14,8,0,1,8,13,8,27,0.5313607484636123,1.2630332184207873,0.6755864105650516,6.885033532022135
2196,2019,12,NCAAF_20191116_LALAF@SALA,South Alabama,Jaguars,Louisiana,Ragin' Cajuns,1-9,8-2,0,14,17,27,37,7,7,7,6,3,14,6,14,-7,-3,4,-3,-10,0.19986527615315797,-13.51622393026912,,
2197,2019,12,NCAAF_20191116_USM@TXSA,UTSA,Roadrunners,So. Miss,Golden Eagles,4-6,7-3,1,10,16,17,36,7,3,7,0,7,9,13,7,-3,-6,0,-6,-19,0.20616692915589896,-13.158150370314502,0.05924453569799948,-23.602845687076353
2198,2019,12,NCAAF_20191116_AF@COLOST,Colorado St.,Rams,Air Force,Falcons,4-6,8-2,1,14,10,21,38,14,0,0,7,0,10,0,28,-4,4,14,4,-17,0.3597006034890068,-5.766313772497483,,
2199,2019,12,NCAAF_20191116_CINCY@SFLA,South Florida,Bulls,Cincinnati,Bearcats,4-6,9-1,0,10,0,17,20,7,3,7,0,0,0,10,10,-5,10,7,10,-3,0.3651905996995428,-5.531322445253181,0.0642775334317961,-22.97809582327173
2200,2019,12,NCAAF_20191116_LSU@MISS,Ole Miss,Rebels,LSU,Tigers,4-7,10-0,0,7,31,37,58,0,7,16,14,14,17,13,14,-6,-24,-14,-24,-21,0.14413182305614614,-17.044714216782154,,
2201,2019,12,NCAAF_20191116_APLST@GAST,Georgia St.,Panthers,App. St.,Mountaineers,6-4,9-1,1,21,35,27,56,21,0,0,6,14,21,7,14,-3,-14,7,-14,-29,0.12196266794209254,-18.702625431048432,,
2202,2019,12,NCAAF_20191116_ARIZST@OREGST,Oregon State,Beavers,Arizona St.,Sun Devils,5-5,5-5,1,28,21,35,34,14,14,7,0,14,7,7,6,0,7,0,7,1,0.1323937017575435,-17.89874340069582,0.35272161291978843,-5.714692044043488
2203,2019,12,NCAAF_20191116_LVILLE@NCST,NC State,Wolfpack,Louisville,Cardinals,4-6,6-4,1,10,7,20,34,0,10,0,10,0,7,20,7,-2,3,0,3,-14,0.6902432391030344,7.96974771709165,0.7033230360503969,8.073228725456573
2204,2019,12,NCAAF_20191116_OKLA@BAYLOR,Baylor,Bears,Oklahoma,Sooners,9-1,9-1,1,31,10,31,34,14,17,0,0,3,7,7,17,0,21,11,21,-3,0.06632172933442715,-24.1361837484302,,
2205,2019,12,NCAAF_20191116_SC@TXAM,Texas A&M,Aggies,South Carolina,Gamecocks,7-3,4-7,0,13,3,30,6,3,10,0,17,3,0,0,3,3,10,0,10,24,0.5758258526480382,3.0692907454036913,,
2206,2019,12,NCAAF_20191116_UCLA@UTAH,Utah,Utes,UCLA,Bruins,9-1,4-6,0,28,3,49,3,7,21,7,14,3,0,0,0,5,25,4,25,46,0.7785330295652086,12.314769597174859,0.8899183234520296,18.537206564701904
2207,2019,12,NCAAF_20191116_NMEX@BOISE,Boise St.,Broncos,New Mexico,Lobos,9-1,2-8,0,28,0,42,9,28,0,14,0,0,0,3,6,7,28,28,28,33,0.9444124102325708,25.56748181017531,,
2208,2019,12,NCAAF_20191116_ARIZ@OREG,Oregon,Ducks,Arizona,Wildcats,9-1,4-6,1,21,6,34,6,14,7,7,6,0,6,0,0,5,15,14,15,28,0.7928405346483185,13.102349010445437,0.9841666339418746,32.48438022359355
2209,2019,12,NCAAF_20191116_USC@CAL,California,Golden Bears,USC,Trojans,5-5,7-4,1,10,17,17,41,7,3,0,7,10,7,17,7,-2,-7,-3,-7,-24,0.33625569479053175,-6.784635754318742,0.37101667839834285,-4.976569386718609
2210,2019,12,NCAAF_20191115_LATECH@MRSHL,Marshall,Thundering Herd,Louisiana Tech,Bulldogs,7-3,8-2,0,17,7,31,10,0,17,7,7,7,0,3,0,-1,10,-7,10,21,0.5297662818686459,1.1986944045381733,,
2211,2019,12,NCAAF_20191115_FRESNO@SDGST,San Diego St.,Aztecs,Fresno St.,Bulldogs,8-2,4-6,1,10,7,17,7,7,3,0,7,7,0,0,0,4,3,0,3,10,0.3892658335846607,-4.513949858095657,,
2212,2019,12,NCAAF_20191114_BUFF@KENTST,Kent St.,Golden Flashes,Buffalo,Bulls,4-6,5-5,0,6,17,30,27,0,6,0,24,7,10,7,3,-1,-11,-7,-11,3,0.12112353081453753,-18.76935230090703,,
2213,2019,12,NCAAF_20191113_BGREEN@MIAOH,Miami-OH,RedHawks,Bowling Green,Falcons,6-4,3-7,0,37,3,44,3,10,27,7,0,3,0,0,0,3,34,7,34,41,0.812266956350365,14.225314196365275,0.9251843483767823,21.78385904493183
2214,2019,12,NCAAF_20191113_NILL@TOLEDO,Toledo,Rockets,N. Illinois,Huskies,6-4,4-6,0,7,14,28,31,7,0,0,21,7,7,14,3,2,-7,0,-7,-3,0.527756514479403,1.117624962040054,,
2215,2019,12,NCAAF_20191112_EMICH@AKRON,Akron,Zips,E. Michigan,Eagles,0-10,5-5,1,0,21,14,42,0,0,7,7,7,14,14,7,-5,-21,-7,-21,-28,0.24392573659654226,-11.13476216901961,,
2216,2019,13,NCAAF_20191123_BALLST@KENTST,Kent St.,Golden Flashes,Ball St.,Cardinals,5-6,4-7,0,21,24,41,38,7,14,10,10,7,17,0,14,1,-3,0,-3,3,0.4565442452246511,-1.7526578054415722,,
2217,2019,13,NCAAF_20191123_BYU@MA,UMass,Minutemen,BYU,Cougars,1-11,7-4,0,0,49,24,56,0,0,10,14,7,42,7,0,-6,-49,-7,-49,-32,0.07707272953556477,-22.883665118397175,,
2218,2019,13,NCAAF_20191123_ECU@UCONN,UConn,Huskies,East Carolina,Pirates,2-9,4-7,0,7,17,24,31,7,0,7,10,10,7,7,7,-2,-10,-3,-10,-7,0.32128036601585563,-7.452980465362771,0.29373120619750215,-8.033610994066237
2219,2019,13,NCAAF_20191123_ILL@IOWA,Iowa,Hawkeyes,Illinois,Fighting Illini,8-3,6-5,1,13,7,19,10,7,6,0,6,7,0,0,3,2,6,0,6,9,0.9456234397991717,25.75459463302866,0.8703003878439564,16.70068421353554
2220,2019,13,NCAAF_20191123_KANSAS@IOWAST,Iowa St.,Cyclones,Kansas,Jayhawks,7-4,3-8,1,14,9,41,31,7,7,7,20,6,3,15,7,4,5,1,5,10,0.9302449856223943,23.72796753624732,0.9424165864716483,23.328407717689416
2221,2019,13,NCAAF_20191123_LIB@UVA,Virginia,Cavaliers,Liberty,Flames,8-3,6-5,0,24,14,55,27,10,14,14,17,7,7,7,6,2,10,3,10,28,0.8720646467128679,18.245471923076366,,
2222,2019,13,NCAAF_20191123_MICHST@RUT,Rutgers,Scarlet Knights,Michigan St.,Spartans,2-9,5-6,0,0,17,0,27,0,0,0,0,10,7,3,7,-3,-17,-10,-17,-27,0.09426633077067126,-21.115517394409835,0.05842419089935902,-23.22107875352468
2223,2019,13,NCAAF_20191123_MINN@NWEST,Northwestern,Wildcats,Minnesota,Golden Gophers,2-9,10-1,1,9,21,22,38,0,9,7,6,14,7,7,10,-8,-12,-14,-12,-16,0.4369238189188934,-2.5496189687989954,,
2224,2019,13,NCAAF_20191123_OKLAST@WVU,West Virginia,Mountaineers,Oklahoma State,Cowboys,4-7,8-3,1,10,7,13,20,0,10,3,0,7,0,3,10,-4,3,-7,3,-7,0.38924909035895905,-4.51681284381516,0.20597837275236985,-12.149327882734482
2225,2019,13,NCAAF_20191123_PSU@OHIOST,Ohio State,Buckeyes,Penn State,Nittany Lions,11-0,9-2,0,14,0,28,17,7,7,7,7,0,0,17,0,2,14,7,14,11,0.6308267013787802,5.364158477126239,0.8247236047735229,13.82356215186617
2226,2019,13,NCAAF_20191123_SAMF@AUBURN,Auburn,Tigers,Samford,Bulldogs,8-3,5-7,0,31,0,52,0,7,24,7,14,0,0,0,0,3,31,7,31,52,0.9254554555361373,23.1681505198801,,
2227,2019,13,NCAAF_20191123_UCF@TULANE,Tulane,Green Wave,UCF,Knights,6-5,8-3,1,7,17,31,34,0,7,10,14,10,7,14,3,-2,-10,-10,-10,-3,0.12923136881273012,-18.14634168204725,0.2235364040786284,-11.258611071817441
2228,2019,13,NCAAF_20191123_WCAR@BAMA,Alabama,Crimson Tide,W. Carolina,Catamounts,10-1,3-9,1,38,0,66,3,17,21,21,7,0,0,0,3,7,38,17,38,63,0.9999970733644088,72.76992854656692,,
2229,2019,13,NCAAF_20191123_AF@NMEX,New Mexico,Lobos,Air Force,Falcons,2-9,9-2,1,10,14,22,44,7,3,6,6,7,7,16,14,-7,-4,0,-4,-22,0.1418717774206294,-17.213607968259453,,
2230,2019,13,NCAAF_20191123_SALA@GAST,Georgia St.,Panthers,South Alabama,Jaguars,7-4,1-10,1,14,3,28,15,0,14,7,7,3,0,0,12,6,11,-3,11,13,0.6436761152078214,5.914293569880783,,
2231,2019,13,NCAAF_20191123_BC@ND,Notre Dame,Fighting Irish,Boston College,Eagles,9-2,5-6,1,16,7,40,7,3,13,17,7,0,7,0,0,4,9,3,9,33,0.8028559766369794,13.679493343085596,0.9150683434242781,20.32614906655337
2232,2019,13,NCAAF_20191123_TXSTSM@APLST,App. St.,Mountaineers,Texas St.,Bobcats,10-1,3-8,0,14,10,35,13,7,7,14,7,0,10,3,0,7,4,7,4,22,0.9593219767645963,27.98747582858391,,
2233,2019,13,NCAAF_20191123_GAS@ARKST,Arkansas St.,Red Wolves,Ga. Southern,Eagles,7-4,6-5,1,35,19,38,33,14,21,3,0,3,16,8,6,1,16,11,16,5,0.628788792995212,5.277499422615847,,
2234,2019,13,NCAAF_20191123_ETNST@VANDY,Vanderbilt,Commodores,ETSU,Buccaneers,3-8,3-9,0,14,0,38,0,7,7,17,7,0,0,0,0,0,14,7,14,38,0.9946669769288885,41.00400945739011,,
2235,2019,13,NCAAF_20191123_LATECH@UAB,UAB,Blazers,Louisiana Tech,Bulldogs,8-3,8-3,1,13,7,20,14,3,10,7,0,0,7,0,7,0,6,3,6,6,0.4772320124549263,-0.9169568079560122,,
2236,2019,13,NCAAF_20191123_MERCER@UNC,North Carolina,Tar Heels,Mercer,Bears,5-6,4-8,0,42,0,56,7,21,21,14,0,0,0,0,7,1,42,21,42,49,0.6246532621472667,5.102110427023376,,
2237,2019,13,NCAAF_20191123_MICH@IND,Indiana,Hoosiers,Michigan,Wolverines,7-4,9-2,1,14,21,14,39,7,7,0,0,7,14,18,0,-2,-7,0,-7,-25,0.13422268944919646,-17.770863806182433,,
2238,2019,13,NCAAF_20191123_MRSHL@CHARLO,Charlotte,49ers,Marshall,Thundering Herd,6-5,7-4,0,7,10,24,13,0,7,3,14,7,3,3,0,-1,-3,-7,-3,11,0.1702679146491235,-15.305235831464188,0.30273539664639615,-7.6490811074260705
2239,2019,13,NCAAF_20191123_NEB@MD,Maryland,Terrapins,Nebraska,Cornhuskers,3-8,5-6,0,0,34,7,54,0,0,0,7,17,17,10,10,-2,-34,-17,-34,-47,0.45772649382735453,-1.7047932735589484,,
2240,2019,13,NCAAF_20191123_NTEXAS@RICE,Rice,Owls,North Texas,Mean Green,2-9,4-7,0,20,0,20,14,10,10,0,0,0,0,7,7,-2,20,10,20,6,0.163124730593471,-15.76433002146996,,
2241,2019,13,NCAAF_20191123_PITT@VATECH,Virginia Tech,Hokies,Pittsburgh,Panthers,8-3,7-4,1,21,0,28,0,14,7,0,7,0,0,0,0,1,21,14,21,28,0.5579799266911968,2.3420894556875282,,
2242,2019,13,NCAAF_20191123_SMU@NAVY,Navy,Midshipmen,SMU,Mustangs,8-2,9-2,0,10,21,35,28,7,3,10,15,7,14,0,7,-1,-11,0,-11,7,0.49062109296725687,-0.3775552516862035,,
2243,2019,13,NCAAF_20191123_TEXAS@BAYLOR,Baylor,Bears,Texas,Longhorns,10-1,6-5,1,7,3,24,10,0,7,14,3,0,3,0,7,4,4,0,4,14,0.22401414203241354,-12.183498482980212,,
2244,2019,13,NCAAF_20191123_TNMART@UK,Kentucky,Wildcats,UT Martin,Skyhawks,6-5,7-5,0,29,0,50,7,16,13,7,14,0,0,0,7,-1,29,16,29,43,0.9816072245194251,33.53182263777967,,
2245,2019,13,NCAAF_20191123_TXAM@UGA,Georgia,Bulldogs,Texas A&M,Aggies,10-1,7-4,1,13,3,19,13,3,10,3,3,0,3,3,7,3,10,3,10,6,0.8514751287813549,16.745242460974623,,
2246,2019,13,NCAAF_20191123_UCLA@USC,USC,Trojans,UCLA,Bruins,8-4,4-7,0,24,14,52,35,10,14,14,14,7,7,14,7,4,10,3,10,17,0.7166369381453329,9.199448707435295,0.8411143741397435,14.793944494375936
2247,2019,13,NCAAF_20191123_WKY@USM,So. Miss,Golden Eagles,W. Kentucky,Hilltoppers,7-4,7-4,0,7,21,10,28,7,0,0,3,7,14,0,7,0,-14,0,-14,-18,0.6425822700743948,5.8671995822768395,0.519031271440233,0.7066754764847332
2248,2019,13,NCAAF_20191123_CAL@STNFRD,Stanford,Cardinal,California,Golden Bears,4-7,6-5,1,10,10,20,24,7,3,7,3,7,3,0,14,-2,0,0,0,-4,0.665378182194212,6.859866442429734,0.46432166249631013,-1.3260874615395721
2249,2019,13,NCAAF_20191123_CUSE@LVILLE,Louisville,Cardinals,Syracuse,Orange,7-4,4-7,1,28,10,56,34,21,7,21,7,3,7,17,7,3,18,18,18,22,0.3863756550050096,-4.637269778244558,0.513077369474582,0.4854959257744582
2250,2019,13,NCAAF_20191123_MEMP@SFLA,South Florida,Bulls,Memphis,Tigers,4-7,10-1,0,10,28,10,49,10,0,0,0,7,21,14,7,-6,-18,3,-18,-39,0.2524400659696022,-10.70814089041869,0.0827805863045612,-20.532948711581724
2251,2019,13,NCAAF_20191123_PURDUE@WISC,Wisconsin,Badgers,Purdue,Boilermakers,9-2,4-7,1,24,17,45,24,14,10,14,7,3,14,7,0,5,7,11,7,21,0.7731204473335522,12.03024650334578,0.9300388783908649,21.85785539002292
2252,2019,13,NCAAF_20191123_SJST@UNLV,UNLV,Rebels,San Jose St.,Spartans,3-8,4-7,0,21,6,38,35,7,14,3,14,6,0,22,7,-1,15,1,15,3,0.6395900913559722,5.738631505001649,0.302021182937275,-7.679391068312569
2253,2019,13,NCAAF_20191123_UTEP@NMEXST,New Mexico St.,Aggies,UTEP,Miners,2-9,1-10,1,14,13,44,35,7,7,7,23,0,13,3,19,1,1,7,1,9,0.6692254343219851,7.029908252831774,0.6388007686019064,5.26063083811097
2254,2019,13,NCAAF_20191123_ODU@MTSU,Middle Tenn.,Blue Raiders,Old Dominion,Monarchs,4-7,1-10,1,28,10,38,17,14,14,7,3,7,3,7,0,3,18,7,18,21,0.8065564145610293,13.894826677583296,0.8463975194769999,15.120551273619014
2255,2019,13,NCAAF_20191123_CSTCAR@LAMON,UL-Monroe,Warhawks,C. Carolina,Chanticleers,5-6,4-7,0,21,14,45,42,14,7,10,14,14,0,14,14,1,7,0,7,3,0.5569983317227358,2.3021629342736105,,
2256,2019,13,NCAAF_20191123_TROY@LALAF,Louisiana,Ragin' Cajuns,Troy,Trojans,9-2,5-6,1,31,3,53,3,14,17,19,3,3,0,0,0,4,28,11,28,50,0.37644111042013884,-5.055800303646151,0.7765201035144131,11.261411665360669
2257,2019,13,NCAAF_20191123_FAU@TXSA,UTSA,Roadrunners,FAU,Owls,4-7,8-3,1,3,17,26,40,3,0,8,15,7,10,16,7,-4,-14,-4,-14,-14,0.09433619772299684,-21.108843195107738,0.0346504384819879,-26.898104756252124
2258,2019,13,NCAAF_20191123_ARK@LSU,LSU,Tigers,Arkansas,Razorbacks,11-0,2-9,1,28,6,56,20,7,21,21,7,3,3,0,14,9,22,4,22,36,0.9616990207778079,28.435185737918232,,
2259,2019,13,NCAAF_20191123_KSTATE@TXTECH,Texas Tech,Red Raiders,Kansas State,Wildcats,4-7,7-4,1,3,6,27,30,0,3,14,10,3,3,17,7,-3,-3,-3,-3,-3,0.5055235216011821,0.22234030969502783,,
2260,2019,13,NCAAF_20191123_MIAMI@FIU,FIU,Panthers,Miami (Fla.),Hurricanes,6-5,6-5,1,13,0,30,24,10,3,3,14,0,0,3,21,0,13,10,13,6,0.08077154138940024,-22.479960437812792,,
2261,2019,13,NCAAF_20191123_TEMPLE@CINCY,Cincinnati,Bearcats,Temple,Owls,10-1,7-4,0,6,0,15,13,0,6,7,2,0,0,0,13,3,6,0,6,2,0.5584281458873659,2.36032563953097,0.8114645133042242,13.080026765136154
2262,2019,13,NCAAF_20191123_ABIL@MISSST,Miss. State,Bulldogs,Abil Christian,Wildcats,5-6,5-7,1,21,7,45,7,7,14,7,17,0,7,0,0,0,14,7,14,38,0.9989645987054641,49.4575838582773,,
2263,2019,13,NCAAF_20191123_DUKE@WAKE,Wake Forest,Demon Deacons,Duke,Blue Devils,8-3,4-7,0,13,10,39,27,3,10,10,16,7,3,3,14,4,3,-4,3,12,0.583869207575298,3.401168861500537,0.8256404747726562,13.876267105545736
2264,2019,13,NCAAF_20191123_HOU@TULSA,Tulsa,Golden Hurricane,Houston,Cougars,3-8,4-7,0,7,14,14,24,7,0,0,7,0,14,3,7,-1,-7,7,-7,-10,0.2695865348712807,-9.860795236300419,,
2265,2019,13,NCAAF_20191123_OREG@ARIZST,Arizona St.,Sun Devils,Oregon,Ducks,6-5,9-2,0,10,7,31,28,7,3,3,18,7,0,0,21,-3,3,0,3,3,0.2711770630407401,-9.783603488358267,0.04854460749128686,-24.56848502331644
2266,2019,13,NCAAF_20191123_TENN@MIZZOU,Missouri,Tigers,Tennessee,Volunteers,5-6,6-5,0,10,17,20,24,3,7,7,3,0,17,7,0,-1,-7,3,-7,-4,0.7672027389657933,11.717158368261721,,
2267,2019,13,NCAAF_20191123_TCU@OKLA,Oklahoma,Sooners,TCU,Horned Frogs,10-1,5-6,0,21,10,28,24,14,7,7,0,0,10,7,7,5,11,14,11,4,0.7806610549185274,12.435957664106127,,
2268,2019,13,NCAAF_20191123_OREGST@WASHST,Washington St.,Cougars,Oregon State,Beavers,6-5,5-6,1,21,24,54,53,7,14,14,19,7,17,0,29,1,-3,0,-3,1,0.9328752203687143,24.048079099456913,0.7370575162026847,9.392739257092671
2269,2019,13,NCAAF_20191123_UTAH@ARIZ,Arizona,Wildcats,Utah,Utes,4-7,10-1,1,0,14,7,35,0,0,0,7,14,0,14,7,-6,-14,-14,-14,-28,0.1796636653327579,-14.719760598652783,0.037037321073966845,-26.44940389659591
2270,2019,13,NCAAF_20191123_WASH@COLO,Colorado,Buffaloes,Washington,Huskies,5-6,6-5,1,13,0,20,14,3,10,7,0,0,0,7,7,-1,13,3,13,6,0.1195773953124557,-18.90220385713451,,
2271,2019,13,NCAAF_20191123_BOISE@UTAHST,Utah St.,Aggies,Boise St.,Broncos,6-5,10-1,0,7,42,21,56,7,0,7,7,21,21,14,0,-4,-35,-14,-35,-35,0.3962412456274428,-4.2247395359586335,,
2272,2019,13,NCAAF_20191123_NEVADA@FRESNO,Fresno St.,Bulldogs,Nevada,Wolf Pack,4-7,7-4,0,21,14,28,35,7,14,7,0,14,0,14,7,-3,7,-7,7,-7,0.8421318169615918,16.11057335479211,,
2273,2019,13,NCAAF_20191123_SDGST@HAWAII,Hawaii,Rainbow Warriors,San Diego St.,Aztecs,8-4,8-3,0,7,3,14,11,7,0,7,0,0,3,0,8,0,4,7,4,3,0.1781618198835888,-14.812021015350524,,
2274,2019,13,NCAAF_20191122_COLOST@WYO,Wyoming,Cowboys,Colorado St.,Rams,7-4,4-7,0,7,7,17,7,0,7,7,3,0,7,0,0,3,0,0,0,10,0.6211079236698264,4.952235477797217,,
2275,2019,13,NCAAF_20191121_NCST@GATECH,Georgia Tech,Yellow Jackets,NC State,Wolfpack,3-8,4-7,1,21,3,28,26,7,14,7,0,0,3,10,13,-1,18,7,18,2,0.40062798176319137,-4.042215701507757,,
2276,2019,13,NCAAF_20191120_AKRON@MIAOH,Miami-OH,RedHawks,Akron,Zips,7-4,0-11,0,17,3,20,17,3,14,3,0,0,3,7,7,7,14,3,14,3,0.7872124501893635,12.79499874109274,0.9872048896854844,33.05708222038854
2277,2019,13,NCAAF_20191120_TOLEDO@BUFF,Buffalo,Bulls,Toledo,Rockets,6-5,6-5,1,28,20,49,30,14,14,7,14,7,13,3,7,0,8,7,8,19,0.4968773075211148,-0.125696135462249,,
2278,2019,13,NCAAF_20191119_EMICH@NILL,N. Illinois,Huskies,E. Michigan,Eagles,4-7,6-5,1,7,14,17,45,0,7,3,7,7,7,24,7,-2,-7,-7,-7,-28,0.585859623709258,3.483149265743805,,
2279,2019,13,NCAAF_20191119_OHIO@BGREEN,Bowling Green,Falcons,Ohio,Bobcats,3-8,5-6,1,24,38,24,66,14,10,0,0,24,14,28,0,-2,-14,-10,-14,-42,0.08901684059197001,-21.627804298732485,,
2280,2019,14,NCAAF_20191201_ARMY@HAWAII,Hawaii,,Army,,9-4,5-7,,24,17,52,31,10,14,14,14,10,7,14,0,4,7,0,7,21,0.2163240135544715,-12.634516014459791,0.55406276688417,1.9705934750764413
2281,2019,14,NCAAF_20191130_CLEM@SC,South Carolina,Gamecocks,Clemson,Tigers,4-8,12-0,0,3,24,3,38,0,3,0,0,14,10,7,7,-8,-21,-14,-21,-35,0.059749298627375214,-25.068482576245515,0.009301727805495319,-34.11659314568439
2282,2019,14,NCAAF_20191130_LVILLE@UK,Kentucky,Wildcats,Louisville,Cardinals,7-5,7-5,0,17,13,45,13,7,10,14,14,6,7,0,0,0,4,1,4,32,0.6493146751927252,6.174543588443726,0.5083289200077419,0.3026796349200538
2283,2019,14,NCAAF_20191130_NWEST@ILL,Illinois,Fighting Illini,Northwestern,Wildcats,6-6,3-9,0,7,10,10,29,0,7,3,0,3,7,7,12,3,-3,-3,-3,-19,0.2505981323334031,-10.830161674097667,0.6899331351120976,7.185510359919391
2284,2019,14,NCAAF_20191130_OHIOST@MICH,Michigan,Wolverines,Ohio State,Buckeyes,9-3,12-0,1,16,28,27,56,13,3,3,8,14,14,14,14,-3,-12,-1,-12,-29,0.3002418444708115,-8.432556053790222,,
2285,2019,14,NCAAF_20191130_TULSA@ECU,East Carolina,Pirates,Tulsa,Golden Hurricane,4-8,4-8,1,3,21,24,49,3,0,7,14,7,14,14,14,0,-18,-4,-18,-25,0.29712395759071397,-8.577235329955215,,
2286,2019,14,NCAAF_20191130_TXSTSM@CSTCAR,C. Carolina,Chanticleers,Texas St.,Bobcats,5-7,3-9,1,7,7,24,21,0,7,7,10,0,7,0,14,2,0,0,0,3,0.6570887327866406,6.513642291198494,,
2287,2019,14,NCAAF_20191130_UGA@GATECH,Georgia Tech,Yellow Jackets,Georgia,Bulldogs,3-9,11-1,1,7,17,7,52,0,7,0,0,17,0,21,14,-8,-10,-17,-10,-45,0.06446260061792886,-24.448120307165482,,
2288,2019,14,NCAAF_20191130_CHARLO@ODU,Old Dominion,Monarchs,Charlotte,49ers,1-11,7-5,1,7,24,22,38,7,0,7,8,14,10,14,0,-6,-17,-7,-17,-16,0.47059381747784046,-1.1879410279411786,0.2551414061831653,-9.544674525678118
2289,2019,14,NCAAF_20191130_MTSU@WKY,W. Kentucky,Hilltoppers,Middle Tenn.,Blue Raiders,8-4,4-8,0,10,13,31,26,3,7,7,14,3,10,0,13,4,-3,0,-3,5,0.3707791944656543,-5.310193975750053,0.6806289298434118,6.805655681047142
2290,2019,14,NCAAF_20191130_NMEXST@LIB,Liberty,Flames,New Mexico St.,Aggies,7-5,2-10,0,20,14,49,28,10,10,15,14,7,7,7,7,5,6,3,6,21,0.681770738173085,7.610580106959901,0.8559770432001925,15.401693990868353
2291,2019,14,NCAAF_20191130_WYO@AF,Air Force,Falcons,Wyoming,Cowboys,10-2,7-5,1,7,0,20,6,0,7,3,10,0,0,0,6,3,7,0,7,14,0.5413170890081517,1.6705932213551478,,
2292,2019,14,NCAAF_20191130_RICE@UTEP,UTEP,Miners,Rice,Owls,1-11,3-9,1,16,14,16,30,6,10,0,0,14,0,10,6,-2,2,-8,2,-14,0.3565537577645812,-5.920376679286051,,
2293,2019,14,NCAAF_20191130_BAMA@AUBURN,Auburn,Tigers,Alabama,Crimson Tide,9-3,10-2,1,27,31,48,45,7,20,13,8,3,28,7,7,-1,-4,4,-4,3,0.2168079745363004,-12.607958318126975,0.341219626595629,-5.931186683293959
2294,2019,14,NCAAF_20191130_BAYLOR@KANSAS,Kansas,Jayhawks,Baylor,Bears,3-9,11-1,1,0,34,6,61,0,0,6,0,21,13,14,13,-8,-34,-21,-34,-55,0.26290600465025293,-10.21512810365357,,
2295,2019,14,NCAAF_20191130_BC@PITT,Pittsburgh,Panthers,Boston College,Eagles,7-5,6-6,0,9,13,19,26,0,9,7,3,6,7,10,3,1,-4,-6,-4,-7,0.4550920655481172,-1.816376091683992,0.5461163819298911,1.6795342504514394
2296,2019,14,NCAAF_20191130_MD@MICHST,Michigan St.,Spartans,Maryland,Terrapins,6-6,3-9,1,13,7,19,16,3,10,0,6,7,0,9,0,3,6,-4,6,3,0.7484993999112569,10.78453501389697,0.895083730827603,18.179401454929916
2297,2019,14,NCAAF_20191130_MIAMI@DUKE,Duke,Blue Devils,Miami (Fla.),Hurricanes,5-7,6-6,1,13,14,27,17,3,10,0,14,0,14,3,0,-1,-1,3,-1,10,0.28208074448296383,-9.285404661145776,,
2298,2019,14,NCAAF_20191130_RUT@PSU,Penn State,Nittany Lions,Rutgers,Scarlet Knights,10-2,2-10,1,7,3,27,6,7,0,6,14,3,0,0,3,8,4,4,4,21,0.9922654482519822,38.98559982591837,0.9992869428798793,46.23492444931492
2299,2019,14,NCAAF_20191130_TXSA@LATECH,Louisiana Tech,Bulldogs,UTSA,Roadrunners,9-3,4-8,0,24,17,41,27,14,10,10,7,10,7,3,7,5,7,4,7,14,0.7710526815804934,11.952603145913258,,
2300,2019,14,NCAAF_20191130_UCONN@TEMPLE,Temple,Owls,UConn,Huskies,8-4,2-10,0,14,17,49,17,7,7,28,7,14,3,0,0,6,-3,-7,-3,32,0.9348805576223753,24.36449790469078,0.9338059656002581,21.814120372747794
2301,2019,14,NCAAF_20191130_USM@FAU,FAU,Owls,So. Miss,Golden Eagles,9-3,7-5,0,17,10,34,17,10,7,7,10,0,10,7,0,2,7,10,7,17,0.7000992408293719,8.448350097334469,0.7497033973245494,9.764436100159458
2302,2019,14,NCAAF_20191130_WISC@MINN,Minnesota,Golden Gophers,Wisconsin,Badgers,10-2,10-2,0,7,10,17,38,7,0,3,7,0,10,14,14,0,-3,7,-3,-21,0.21971684120210766,-12.449048332599318,,
2303,2019,14,NCAAF_20191130_ND@STNFRD,Stanford,Cardinal,Notre Dame,Fighting Irish,4-8,10-2,1,17,21,24,45,10,7,0,7,7,14,7,17,-6,-4,3,-4,-21,0.22277771979101957,-12.283132742001726,0.07558034080856246,-20.80938317135937
2304,2019,14,NCAAF_20191130_OREGST@OREG,Oregon,Ducks,Oregon State,Beavers,10-2,5-7,1,17,3,24,10,10,7,0,7,3,0,0,7,5,14,7,14,14,0.9439756973258964,25.586484891929217,0.9345645006668003,21.900013218847675
2305,2019,14,NCAAF_20191130_TULANE@SMU,SMU,Mustangs,Tulane,Green Wave,10-2,6-6,1,21,10,37,20,14,7,0,16,7,3,7,3,4,11,7,11,17,0.5497986580226574,2.0151741739629188,,
2306,2019,14,NCAAF_20191130_UAB@NTEXAS,North Texas,,UAB,,4-8,9-3,,14,17,21,26,7,7,7,0,3,14,9,0,-5,-3,4,-3,-5,0.47664012980531634,-0.9433681679989832,0.40203784895260397,-3.596313659908475
2307,2019,14,NCAAF_20191130_UTAHST@NMEX,New Mexico,Lobos,Utah St.,Aggies,2-10,7-5,0,6,31,25,38,0,6,12,7,7,24,7,0,-5,-25,-7,-25,-13,0.09421592981811577,-21.177510613333766,0.15717394961927256,-14.585849722039313
2308,2019,14,NCAAF_20191130_VANDY@TENN,Tennessee,Volunteers,Vanderbilt,Commodores,7-5,3-9,1,21,3,28,10,7,14,0,7,3,0,0,7,4,18,4,18,18,0.5952874878602488,3.883218946480497,,
2309,2019,14,NCAAF_20191130_GAST@GAS,Ga. Southern,Eagles,Georgia St.,Panthers,7-5,7-5,0,17,7,38,10,7,10,14,7,7,0,3,0,0,10,0,10,28,0.6254822001212921,5.151123812709102,,
2310,2019,14,NCAAF_20191130_IOWAST@KSTATE,Kansas State,Wildcats,Iowa St.,Cyclones,8-4,7-5,1,14,14,27,17,7,7,3,10,0,14,3,0,1,0,7,0,10,0.3396186167880024,-6.658132006909568,0.2714269805923164,-8.821363111451603
2311,2019,14,NCAAF_20191130_NAVY@HOU,Houston,Cougars,Navy,Midshipmen,4-8,9-2,1,27,28,41,56,14,13,7,7,21,7,14,14,-5,-1,-7,-1,-15,0.49478424815951516,-0.21051918769171607,0.25884147949692715,-9.37830583735203
2312,2019,14,NCAAF_20191130_TXAM@LSU,LSU,Tigers,Texas A&M,Aggies,12-0,7-5,1,31,0,50,7,21,10,10,9,0,0,7,0,5,31,21,31,43,0.7019790307910104,8.53554081922266,0.8490591064864732,14.966618912170972
2313,2019,14,NCAAF_20191130_UNC@NCST,NC State,Wolfpack,North Carolina,Tar Heels,4-8,6-6,0,10,6,10,41,3,7,0,0,0,6,28,7,-2,4,3,4,-31,0.6863705929789126,7.818816578997598,,
2314,2019,14,NCAAF_20191130_COLO@UTAH,Utah,Utes,Colorado,Buffaloes,11-1,5-7,0,17,7,45,15,0,17,14,14,7,0,0,8,6,10,-7,10,30,0.8389461612621156,15.94289862363678,,
2315,2019,14,NCAAF_20191130_FSU@FLA,Florida,Gators,Florida State,Seminoles,10-2,6-6,1,30,7,40,17,7,23,7,3,7,0,10,0,4,23,0,23,23,0.7192074947466055,9.346872818912857,,
2316,2019,14,NCAAF_20191130_LAMON@LALAF,Louisiana,,UL-Monroe,,10-2,5-7,,21,14,31,30,7,14,7,3,7,7,10,6,5,7,0,7,1,0.7003909370921905,8.461863619332462,,
2317,2019,14,NCAAF_20191130_OKLA@OKLAST,Oklahoma State,Cowboys,Oklahoma,Sooners,8-4,11-1,0,13,20,16,34,7,6,3,0,10,10,7,7,-3,-7,-3,-7,-18,0.24372308704109402,-11.1806596245616,0.2259142139719621,-10.90698313911605
2318,2019,14,NCAAF_20191130_BYU@SDGST,San Diego St.,Aztecs,BYU,Cougars,9-3,7-5,1,7,3,13,3,0,7,3,3,3,0,0,0,2,4,-3,4,10,0.564616077216239,2.61948107803903,,
2319,2019,14,NCAAF_20191130_ARIZ@ARIZST,Arizona St.,Sun Devils,Arizona,Wildcats,7-5,4-8,0,6,7,24,14,0,6,15,3,0,7,0,7,3,-1,0,-1,10,0.6201750755827762,4.926172521258309,0.7782767813191992,11.110172409177807
2320,2019,14,NCAAF_20191130_CAL@UCLA,UCLA,Bruins,California,Golden Bears,4-8,7-5,1,10,14,18,28,7,3,8,0,7,7,7,7,-3,-4,0,-4,-10,0.4521333050169586,-1.9366087354121646,0.3954397777313692,-3.8441044286532247
2321,2019,14,NCAAF_20191130_FRESNO@SJST,San Jose St.,Spartans,Fresno St.,Bulldogs,5-7,4-8,1,3,16,17,16,3,0,7,7,14,2,0,0,1,-13,-11,-13,1,0.06500816589970027,-24.37861827742813,,
2322,2019,14,NCAAF_20191129_BGREEN@BUFF,Buffalo,Bulls,Bowling Green,Falcons,7-5,3-9,1,35,7,49,7,21,14,0,14,0,7,0,0,4,28,21,28,42,0.9012313433921475,20.748679386577123,0.9651112387565349,26.28785667050562
2323,2019,14,NCAAF_20191129_KENTST@EMICH,E. Michigan,Eagles,Kent St.,Golden Flashes,6-6,6-6,1,14,24,26,34,7,7,6,6,14,10,7,3,0,-10,-7,-10,-8,0.812449722179193,14.28158420116415,,
2324,2019,14,NCAAF_20191129_MIAOH@BALLST,Ball St.,Cardinals,Miami-OH,RedHawks,5-7,7-5,1,14,27,41,27,7,7,6,21,7,20,0,0,-2,-13,0,-13,14,0.23134040987474547,-11.825746972804723,0.6225816372188222,4.526898384035206
2325,2019,14,NCAAF_20191129_TOLEDO@CMICH,C. Michigan,Chippewas,Toledo,Rockets,8-4,6-6,0,35,7,49,7,14,21,7,7,0,7,0,0,2,28,14,28,42,0.34649278915362525,-6.357069076051403,,
2326,2019,14,NCAAF_20191129_TXTECH@TEXAS,Texas,Longhorns,Texas Tech,Red Raiders,7-5,4-8,1,28,21,49,24,6,22,14,7,14,7,3,0,3,7,-8,7,25,0.6125563884427756,4.604902576516906,,
2327,2019,14,NCAAF_20191129_VATECH@UVA,Virginia,Cavaliers,Virginia Tech,Hokies,9-3,8-4,1,13,6,39,30,13,0,7,19,3,3,21,3,1,7,10,7,9,0.4053848502610923,-3.8552877715682143,0.5038339593552611,0.13932118097389434
2328,2019,14,NCAAF_20191129_IOWA@NEB,Nebraska,Cornhuskers,Iowa,Hawkeyes,5-7,9-3,0,10,24,24,27,3,7,14,0,14,10,0,3,-4,-14,-11,-14,-3,0.15127751002261158,-16.600392948817444,,
2329,2019,14,NCAAF_20191129_MIZZOU@ARK,Arkansas,Razorbacks,Missouri,Tigers,2-10,6-6,1,7,10,14,24,7,0,7,0,0,10,7,7,-4,-3,7,-3,-10,0.10928379985209036,-19.81069391973415,0.15510421713767664,-14.711161548982062
2330,2019,14,NCAAF_20191129_BOISE@COLOST,Colorado St.,Rams,Boise St.,Broncos,4-8,11-1,1,14,24,24,31,7,7,7,3,7,17,0,7,-7,-10,0,-10,-7,0.15490812391905417,-16.353037532843246,,
2331,2019,14,NCAAF_20191129_CINCY@MEMP,Memphis,Tigers,Cincinnati,Bearcats,11-1,10-2,1,20,17,34,24,17,3,0,14,3,14,0,7,1,3,14,3,10,0.6472133268814799,6.083358756762323,0.6172393091895169,4.323508002801731
2332,2019,14,NCAAF_20191129_WASHST@WASH,Washington,Huskies,Washington St.,Cougars,7-5,6-6,0,21,10,31,13,7,14,7,3,7,3,3,0,1,11,0,11,18,0.6371395446957593,5.648861112206305,0.6409860447857655,5.234742646083475
2333,2019,14,NCAAF_20191129_WVU@TCU,TCU,Horned Frogs,West Virginia,Mountaineers,5-7,5-7,1,10,10,17,20,7,3,7,0,7,3,3,7,0,0,0,0,-3,0.5958288827160722,3.9057187921152945,,
2334,2019,14,NCAAF_20191129_ARKST@SALA,South Alabama,Jaguars,Arkansas St.,Red Wolves,2-10,7-5,0,14,7,34,30,14,0,6,14,7,0,10,13,-5,7,7,7,4,0.14953447602638736,-16.720549457972197,,
2335,2019,14,NCAAF_20191129_APLST@TROY,Troy,Trojans,App. St.,Mountaineers,5-7,11-1,1,13,34,13,48,10,3,0,0,20,14,7,7,-6,-21,-10,-21,-35,0.2984103687691295,-8.517458731739225,0.08428003136086326,-19.95989209851882
2336,2019,14,NCAAF_20191129_SFLA@UCF,UCF,Knights,South Florida,Bulls,9-3,4-8,1,24,0,34,7,7,17,7,3,0,0,7,0,5,24,7,24,27,0.899257172022193,20.567223975345996,0.9512706674670964,24.02560744997365
2337,2019,14,NCAAF_20191128_MISS@MISSST,Miss. State,Bulldogs,Ole Miss,Rebels,6-6,4-8,1,14,14,21,20,7,7,7,0,0,14,0,6,2,0,7,0,1,0.752980230148013,11.01193983460621,0.5234653011218153,0.8531781768454891
2338,2019,14,NCAAF_20191126_OHIO@AKRON,Akron,Zips,Ohio,Bobcats,0-12,6-6,1,3,31,3,52,3,0,0,0,14,17,7,14,-6,-28,-11,-28,-49,0.12018686450735117,-18.904283622825233,,
2339,2019,14,NCAAF_20191126_WMICH@NILL,N. Illinois,Huskies,W. Michigan,Broncos,5-7,7-5,1,10,0,17,14,3,7,0,7,0,0,7,7,-2,10,3,10,3,0.5152148759285475,0.614237220931841,,
2340,2019,15,NCAAF_20191207_LALAF@APLST,App. St.,Mountaineers,Louisiana,Ragin' Cajuns,12-1,10-3,1,35,17,45,38,21,14,7,3,7,10,7,14,2,18,14,18,7,0.7596246232858581,11.387928534271396,0.5376049026759138,1.3519525544296584
2341,2019,15,NCAAF_20191207_MIAOH@CMICH,C. Michigan,Chippewas,Miami-OH,RedHawks,8-5,8-5,0,14,10,21,26,0,14,0,7,7,3,7,9,0,4,-7,4,-5,0.4744453375006399,-1.0352712278562421,0.6422622290658822,5.220288315260518
2342,2019,15,NCAAF_20191207_UAB@FAU,FAU,Owls,UAB,Blazers,10-3,9-4,0,35,6,49,6,14,21,7,7,3,3,0,0,1,29,11,29,43,0.7201739516930574,9.421762407984716,0.8384776779384575,14.152601109298956
2343,2019,15,NCAAF_20191207_CINCY@MEMP,Memphis,Tigers,Cincinnati,Bearcats,12-1,10-3,0,10,14,29,24,10,0,10,9,7,7,7,3,2,-4,3,-4,5,0.6562006997092116,6.494536702496362,0.6806664374716603,6.724754481646585
2344,2019,15,NCAAF_20191207_HAWAII@BOISE,Boise St.,Broncos,Hawaii,Rainbow Warriors,12-1,9-5,1,17,3,31,10,3,14,14,0,3,0,0,7,3,14,0,14,21,0.9048397540643269,21.15172950529916,0.7609508500747062,10.159020718687998
2345,2019,15,NCAAF_20191207_UGA@LSU,LSU,Tigers,Georgia,Bulldogs,13-0,11-2,0,17,3,37,10,14,3,17,3,0,3,0,7,2,14,14,14,27,0.3362193330878922,-6.828656475533876,0.6465493346092941,5.3851079212178945
2346,2019,15,NCAAF_20191207_UVA@CLEM,Clemson,Tigers,Virginia,Cavaliers,13-0,9-4,0,31,7,62,17,14,17,14,17,7,0,7,3,4,24,7,24,45,0.9551597242185654,27.409454127499657,0.9629687416802943,25.581088797514923
2347,2019,15,NCAAF_20191207_OHIOST@WISC,Wisconsin,Badgers,Ohio State,Buckeyes,10-3,13-0,1,21,7,21,34,7,14,0,0,0,7,17,10,-3,14,7,14,-13,0.2398992920343228,-11.412655014941038,0.1412895750875267,-15.38885804403165
2348,2019,15,NCAAF_20191206_UTAH@OREG,Oregon,Ducks,Utah,Utes,11-2,11-2,0,20,0,37,15,10,10,3,14,0,0,15,0,0,20,10,20,22,0.4518395169246565,-1.954503659136435,0.4677620600286161,-1.1585454713945467
2349,2020,1,NCAAF_20200907_BYU@NAVY,Navy,Midshipmen,BYU,Cougars,0-1,1-0,1,0,31,3,55,0,0,3,0,14,17,17,7,-1,-31,-14,-31,-52,0.6368406478254531,5.656657628382277,,
2350,2020,1,NCAAF_20200905_EKY@MRSHL,Marshall,Thundering Herd,E. Kentucky,Colonels,1-0,0-1,1,38,0,59,0,21,17,14,7,0,0,0,0,1,38,21,38,59,0.8877263496088149,19.627512394201972,,
2351,2020,1,NCAAF_20200905_MTSU@ARMY,Army,Black Knights,Middle Tenn.,Blue Raiders,1-0,0-1,0,21,0,42,0,7,14,14,7,0,0,0,0,1,21,7,21,42,0.5986296434540984,4.036957385911137,0.463475796048338,-1.3115220863033414
2352,2020,1,NCAAF_20200905_SMU@TXSTSM,Texas St.,Bobcats,SMU,Mustangs,0-1,1-0,1,14,14,24,31,0,14,7,3,0,14,14,3,-1,0,0,0,-7,0.04213907896877778,-27.899503069737648,0.016176948288341264,-30.613487868508145
2353,2020,1,NCAAF_20200905_HOUBP@NTEXAS,North Texas,Mean Green,Houston Christian,Huskies,1-0,0-1,1,23,10,57,31,14,9,20,14,0,10,7,14,1,13,14,13,26,0.933043016247192,24.22230024148314,,
2354,2020,1,NCAAF_20200905_ARKST@MEMP,Memphis,Tigers,Arkansas St.,Red Wolves,1-0,0-1,0,21,14,37,24,7,14,13,3,14,0,3,7,1,7,-7,7,13,0.8360986437144762,15.813991882434038,0.9544368891943543,24.168605918488282
2355,2020,1,NCAAF_20200905_SFA@UTEP,UTEP,Miners,S.F. Austin,Lumberjacks,1-0,0-1,0,17,14,24,14,3,14,0,7,7,7,0,0,1,3,-4,3,10,0.6884299615681012,7.941422542069972,,
2356,2020,1,NCAAF_20200903_CAR@UAB,UAB,Blazers,Cent. Ark.,Bears,1-0,1-1,0,28,21,45,35,14,14,3,14,7,14,0,14,0,7,7,7,10,0.7648364293061385,11.667129901367844,,
2357,2020,1,NCAAF_20200903_SALA@USM,So. Miss,Golden Eagles,South Alabama,Jaguars,0-1,1-0,0,10,13,21,32,0,10,3,8,13,0,10,9,-1,-3,-13,-3,-11,0.8251454587127605,15.112690965344427,0.8145037215280889,12.797742541566492
2358,2020,2,NCAAF_20200912_ARKST@KSTATE,Kansas State,Wildcats,Arkansas St.,Red Wolves,0-1,1-1,0,21,14,31,35,7,14,0,10,7,7,7,14,-1,7,0,7,-4,0.8524338324707681,16.986376291588385,0.9328460477058391,22.067052296478224
2359,2020,2,NCAAF_20200912_CHARLO@APLST,App. St.,Mountaineers,Charlotte,49ers,1-0,0-1,0,14,10,35,20,0,14,7,14,7,3,10,0,1,4,-7,4,15,0.9111784786613396,21.87201411502201,0.9467684007627686,23.79088325441262
2360,2020,2,NCAAF_20200912_CUSE@UNC,North Carolina,Tar Heels,Syracuse,Orange,1-0,0-1,1,7,3,31,6,7,0,3,21,0,3,3,0,1,4,7,4,25,0.4134868791788131,-3.546523193972689,,
2361,2020,2,NCAAF_20200912_EKY@WVU,West Virginia,Mountaineers,E. Kentucky,Colonels,1-0,0-2,1,42,7,56,10,14,28,7,7,0,7,3,0,1,35,14,35,46,0.9944359641984747,41.18950270913592,,
2362,2020,2,NCAAF_20200912_LALAF@IOWAST,Iowa St.,Cyclones,Louisiana,Ragin' Cajuns,0-1,1-0,0,14,10,14,31,0,14,0,0,0,10,7,14,-1,4,0,4,-17,0.9290646385990272,23.83219098355835,0.7346311266329404,9.238722474681964
2363,2020,2,NCAAF_20200912_LAMON@ARMY,Army,Black Knights,UL-Monroe,Warhawks,2-0,0-1,0,17,7,37,7,14,3,13,7,0,7,0,0,2,10,14,10,30,0.8226650211760201,15.01731763545422,,
2364,2020,2,NCAAF_20200912_DUKE@ND,Notre Dame,Fighting Irish,Duke,Blue Devils,1-0,0-1,0,10,6,27,13,0,10,7,10,3,3,7,0,1,4,-3,4,14,0.8697347265856863,18.25531472357443,0.9525593144872235,24.614655448084832
2365,2020,2,NCAAF_20200912_AP@PITT,Pittsburgh,Panthers,Austin Peay,Governors,1-0,0-2,0,42,0,55,0,21,21,0,13,0,0,0,0,1,42,21,42,55,0.9348362324735445,24.545300296031428,,
2366,2020,2,NCAAF_20200912_GATECH@FSU,Florida State,Seminoles,Georgia Tech,Yellow Jackets,0-1,1-0,0,10,0,13,16,10,0,3,0,0,0,7,9,-1,10,10,10,-3,0.5529000273671332,2.157784425579621,,
2367,2020,2,NCAAF_20200912_CAMP@GAS,Ga. Southern,Eagles,Campbell,Fighting Camels,1-0,0-1,0,6,13,27,26,3,3,7,14,13,0,7,6,1,-7,-10,-7,1,0.9845992746149013,35.03987451039757,,
2368,2020,2,NCAAF_20200912_CIT@SFLA,South Florida,Bulls,The Citadel,Bulldogs,1-0,0-1,0,20,6,27,6,7,13,0,7,3,3,0,0,1,14,4,14,21,0.7030149904794101,8.649391205327447,,
2369,2020,2,NCAAF_20200912_MOST@OKLA,Oklahoma,Sooners,Missouri St.,Bears,1-0,0-1,0,41,0,48,0,31,10,0,7,0,0,0,0,1,41,31,41,48,0.9999212968095246,61.31546893009158,,
2370,2020,2,NCAAF_20200912_CLEM@WAKE,Wake Forest,Demon Deacons,Clemson,Tigers,0-1,1-0,0,0,27,13,37,0,0,3,10,14,13,10,0,-1,-27,-14,-27,-24,0.04964282488281846,-26.74402756431573,,
2371,2020,2,NCAAF_20200912_TULANE@SALA,South Alabama,Jaguars,Tulane,Green Wave,1-1,1-0,0,14,6,24,27,0,14,10,0,0,6,7,14,0,8,0,8,-3,0.10030345033261434,-20.765094161794423,0.07629620585929231,-21.081196689424758
2372,2020,2,NCAAF_20200912_HOUBP@TXTECH,Texas Tech,Red Raiders,Houston Christian,Huskies,1-0,0-2,1,21,10,35,33,14,7,7,7,3,7,10,13,1,11,11,11,2,0.9959850729661159,43.00930608545332,,
2373,2020,2,NCAAF_20200912_UTEP@TEXAS,Texas,Longhorns,UTEP,Miners,1-0,1-1,1,45,3,59,3,21,24,7,7,0,3,0,0,0,42,21,42,56,0.9972335516248862,45.01209988849428,0.9991993272733937,46.50694033825201
2374,2020,2,NCAAF_20200912_WKY@LVILLE,Louisville,Cardinals,W. Kentucky,Hilltoppers,1-0,0-1,1,28,7,35,21,7,21,7,0,7,0,7,7,1,21,0,21,14,0.7483741092688923,10.860694540699797,0.4798429898048463,-0.7449520281923441
2375,2020,2,NCAAF_20200912_CSTCAR@KANSAS,Kansas,Jayhawks,C. Carolina,Chanticleers,0-1,1-0,1,3,28,23,38,0,3,14,6,14,14,0,10,-1,-25,-14,-25,-15,0.7595176183767436,11.434565308797573,,
2376,2020,2,NCAAF_20200910_UAB@MIAMI,Miami (Fla.),Hurricanes,UAB,Blazers,1-0,1-1,0,14,7,31,14,7,7,17,0,7,0,7,0,0,7,0,7,17,0.8868417637669725,19.630607481477455,,
2377,2020,3,NCAAF_20200919_AP@CINCY,Cincinnati,Bearcats,Austin Peay,Governors,1-0,0-3,1,28,3,55,20,14,14,14,13,3,0,3,14,1,25,11,25,35,0.9691711516061878,30.37206684975922,,
2378,2020,3,NCAAF_20200919_BC@DUKE,Duke,Blue Devils,Boston College,Eagles,0-2,1-0,1,6,7,6,26,6,0,0,0,7,0,16,3,-1,-1,-1,-1,-20,0.4321756344405101,-2.776562064992504,,
2379,2020,3,NCAAF_20200919_CUSE@PITT,Pittsburgh,Panthers,Syracuse,Orange,2-0,0-2,0,14,10,21,10,7,7,7,0,3,7,0,0,2,4,4,4,11,0.5506817279584861,2.070322008184121,,
2380,2020,3,NCAAF_20200919_LIB@WKY,W. Kentucky,Hilltoppers,Liberty,Flames,0-2,1-0,1,10,17,24,30,0,10,7,7,10,7,7,6,-1,-7,-10,-7,-6,0.5572028426639828,2.3384453260748614,,
2381,2020,3,NCAAF_20200919_NAVY@TULANE,Tulane,Green Wave,Navy,Midshipmen,1-1,1-1,0,24,0,24,27,10,14,0,0,0,0,16,11,0,24,10,24,-3,0.45339205485161505,-1.9031137472616138,0.34241422653871856,-6.003416841437378
2382,2020,3,NCAAF_20200919_TULSA@OKLAST,Oklahoma State,Cowboys,Tulsa,Golden Hurricane,1-0,0-1,0,3,7,16,7,3,0,0,13,0,7,0,0,1,-4,3,-4,9,0.9043657896179541,21.239504508276696,,
2383,2020,3,NCAAF_20200919_SFLA@ND,Notre Dame,Fighting Irish,South Florida,Bulls,2-0,1-1,1,35,0,52,0,14,21,10,7,0,0,0,0,1,35,14,35,52,0.9344809920281951,24.541795866927714,0.9837442072220273,31.624092970360607
2384,2020,3,NCAAF_20200919_APLST@MRSHL,Marshall,Thundering Herd,App. St.,Mountaineers,2-0,1-1,1,10,7,17,7,7,3,7,0,7,0,0,0,1,3,0,3,10,0.30314762147740404,-8.376093658733907,,
2385,2020,3,NCAAF_20200919_SFA@TXSA,UTSA,Roadrunners,S.F. Austin,Lumberjacks,2-0,0-2,1,17,7,24,10,3,14,0,7,0,7,3,0,2,10,3,10,14,0.8842836681675855,19.449124871312506,,
2386,2020,3,NCAAF_20200919_TROY@MTSU,Middle Tenn.,Blue Raiders,Troy,Trojans,0-2,1-0,0,7,26,14,47,7,0,0,7,7,19,14,7,-1,-19,0,-19,-33,0.45712237887469964,-1.7501796539063434,0.4641692783191297,-1.330234165874728
2387,2020,3,NCAAF_20200919_UCF@GATECH,Georgia Tech,Yellow Jackets,UCF,Knights,1-1,1-0,1,14,28,21,49,7,7,0,7,7,21,0,21,0,-14,0,-14,-28,0.19180370736902086,-14.160397564812683,,
2388,2020,3,NCAAF_20200919_CIT@CLEM,Clemson,Tigers,The Citadel,Bulldogs,2-0,0-2,1,49,0,49,0,28,21,0,0,0,0,0,0,2,49,28,49,49,0.998694697877264,48.92391624144693,,
2389,2020,3,NCAAF_20200919_SMU@NTEXAS,North Texas,Mean Green,SMU,Mustangs,1-1,2-0,1,7,34,35,65,0,7,14,14,21,13,21,10,-1,-27,-21,-27,-30,0.2586872689112889,-10.52190790638997,,
2390,2020,3,NCAAF_20200919_LATECH@USM,So. Miss,Golden Eagles,Louisiana Tech,Bulldogs,0-2,1-0,1,13,10,30,31,0,13,14,3,7,3,14,7,-1,3,-7,3,-1,0.48425604667516065,-0.6415637260347467,,
2391,2020,3,NCAAF_20200919_MIAMI@LVILLE,Louisville,Cardinals,Miami (Fla.),Hurricanes,1-1,2-0,0,6,20,34,47,3,3,14,14,14,6,17,10,-1,-14,-11,-14,-13,0.24541914397758968,-11.197665061445832,,
2392,2020,3,NCAAF_20200919_TXSTSM@LAMON,UL-Monroe,Warhawks,Texas St.,Bobcats,0-2,1-2,0,14,31,17,38,7,7,3,0,14,17,0,7,-1,-17,-7,-17,-21,0.6840794500788691,7.787231646960436,,
2393,2020,3,NCAAF_20200919_WAKE@NCST,NC State,Wolfpack,Wake Forest,Demon Deacons,1-0,0-2,1,21,21,45,42,14,7,14,10,7,14,14,7,1,0,7,0,3,0.4898137535962598,-0.41502533143693654,,
2394,2020,3,NCAAF_20200919_ABIL@UTEP,UTEP,Miners,Abil Christian,Wildcats,2-1,0-1,0,10,7,17,13,0,10,0,7,7,0,3,3,2,3,-7,3,4,0.5626676037934732,2.563623575674683,,
2395,2020,3,NCAAF_20200918_CAMP@CSTCAR,C. Carolina,Chanticleers,Campbell,Fighting Camels,2-0,0-2,0,21,9,43,21,14,7,7,15,0,9,0,12,2,12,14,12,22,0.8408243460581205,16.21770024845364,,
2396,2020,4,NCAAF_20200926_CAMP@APLST,App. St.,Mountaineers,Campbell,Fighting Camels,2-1,0-3,0,17,13,52,21,7,10,21,14,7,6,0,8,2,4,0,4,31,0.9906296709437625,38.16724838395862,,
2397,2020,4,NCAAF_20200926_FLA@MISS,Ole Miss,Rebels,Florida,Gators,0-1,1-0,1,14,28,35,51,7,7,7,14,14,14,13,10,-1,-14,-7,-14,-16,0.242873131277489,-11.318580490283694,,
2398,2020,4,NCAAF_20200926_GAS@LALAF,Louisiana,Ragin' Cajuns,Ga. Southern,Eagles,3-0,1-1,0,7,7,20,18,0,7,3,10,0,7,3,8,2,0,0,0,2,0.6119298032854303,4.616997938625218,,
2399,2020,4,NCAAF_20200926_GATECH@CUSE,Syracuse,Orange,Georgia Tech,Yellow Jackets,1-2,1-2,1,23,13,37,20,17,6,7,7,0,13,7,0,0,10,17,10,17,0.5073510024299,0.2992016477132893,,
2400,2020,4,NCAAF_20200926_KSTATE@OKLA,Oklahoma,Sooners,Kansas State,Wildcats,1-1,1-1,1,21,7,35,38,7,14,14,0,0,7,14,17,0,14,7,14,-3,0.833021086669326,15.687639995830068,,
2401,2020,4,NCAAF_20200926_LVILLE@PITT,Pittsburgh,Panthers,Louisville,Cardinals,3-0,1-2,1,20,17,23,20,13,7,3,0,7,10,3,0,2,3,6,3,3,0.625558272903989,5.1976234431151624,,
2402,2020,4,NCAAF_20200926_UCF@ECU,East Carolina,Pirates,UCF,Knights,0-1,2-0,1,7,27,28,51,7,0,7,14,10,17,14,10,-2,-20,-3,-20,-23,0.017094838572150883,-34.386936870647105,,
2403,2020,4,NCAAF_20200926_UK@AUBURN,Auburn,Tigers,Kentucky,Wildcats,1-0,0-1,1,8,7,29,13,8,0,7,14,7,0,6,0,1,1,1,1,16,0.8117600856750777,14.35992217441435,,
2404,2020,4,NCAAF_20200926_FIU@LIB,Liberty,Flames,FIU,Panthers,2-0,0-1,0,14,14,36,34,14,0,13,9,14,0,14,6,2,0,0,0,2,0.4063611249432958,-3.8467733817035423,,
2405,2020,4,NCAAF_20200926_IOWAST@TCU,TCU,Horned Frogs,Iowa St.,Cyclones,0-1,1-1,1,7,16,34,37,0,7,14,13,0,16,7,14,-1,-9,0,-9,-3,0.4674378746868534,-1.3267486404097326,,
2406,2020,4,NCAAF_20200926_TULANE@USM,So. Miss,Golden Eagles,Tulane,Green Wave,0-3,2-1,1,21,31,24,66,14,7,3,0,7,24,21,14,-2,-10,7,-10,-42,0.3301654629775057,-7.135404801773802,0.3742127401018398,-4.748897613430671
2407,2020,4,NCAAF_20200926_ARMY@CINCY,Cincinnati,Bearcats,Army,Black Knights,2-0,2-1,1,10,7,24,10,3,7,7,7,7,0,0,3,0,3,-4,3,14,0.5687246401607637,2.811062640255386,0.6336654881271157,5.057791561340778
2408,2020,4,NCAAF_20200926_MISSST@LSU,LSU,Tigers,Miss. State,Bulldogs,0-1,1-0,0,14,17,34,44,0,14,10,10,3,14,10,17,-1,-3,-3,-3,-10,0.7027067623838094,8.641297559308214,,
2409,2020,4,NCAAF_20200926_UTEP@LAMON,UL-Monroe,Warhawks,UTEP,Miners,0-3,3-1,0,0,24,6,31,0,0,6,0,7,17,0,7,-3,-24,-7,-24,-25,0.7934346116165991,13.288216817117245,0.8617698936024731,16.114721249293808
2410,2020,4,NCAAF_20200926_WVU@OKLAST,Oklahoma State,Cowboys,West Virginia,Mountaineers,2-0,1-1,0,20,7,27,13,0,20,0,7,0,7,3,3,1,13,0,13,14,0.6035824305393489,4.264308346168264,,
2411,2020,4,NCAAF_20200926_DUKE@UVA,Virginia,Cavaliers,Duke,Blue Devils,1-0,0-3,1,17,10,38,20,0,17,0,21,10,0,10,0,1,7,-10,7,18,0.5444203382665636,1.8116531755279084,,
2412,2020,4,NCAAF_20200926_UGA@ARK,Arkansas,Razorbacks,Georgia,Bulldogs,0-1,1-0,1,7,5,10,37,7,0,3,0,0,5,22,10,-1,2,7,2,-27,0.015085272987004683,-35.19905146572205,,
2413,2020,4,NCAAF_20200926_TXSTSM@BC,Boston College,Eagles,Texas St.,Bobcats,2-0,1-3,0,7,14,24,21,0,7,7,10,7,7,7,0,1,-7,-7,-7,3,0.9634212297219306,29.094019885892067,,
2414,2020,4,NCAAF_20200926_BAMA@MIZZOU,Missouri,Tigers,Alabama,Crimson Tide,0-1,1-0,0,3,28,19,38,0,3,3,13,14,14,7,3,-1,-25,-14,-25,-19,0.08488216017268213,-22.29262738317948,,
2415,2020,4,NCAAF_20200926_HOUBP@LATECH,Louisiana Tech,Bulldogs,Houston Christian,Huskies,2-0,0-3,1,38,17,66,38,17,21,14,14,14,3,7,14,2,21,3,21,28,0.8666035958831501,18.030722491663937,,
2416,2020,4,NCAAF_20200926_SFA@SMU,SMU,Mustangs,S.F. Austin,Lumberjacks,3-0,0-3,1,29,0,50,7,22,7,7,14,0,0,7,0,3,29,22,29,43,0.993108189981402,39.98908727624894,,
2417,2020,4,NCAAF_20200926_FSU@MIAMI,Miami (Fla.),Hurricanes,Florida State,Seminoles,3-0,0-2,1,38,3,52,10,14,24,0,14,3,0,7,0,3,35,11,35,42,0.6612141374559127,6.750958766817348,,
2418,2020,4,NCAAF_20200926_KANSAS@BAYLOR,Baylor,Bears,Kansas,Jayhawks,1-0,0-2,0,17,7,47,14,7,10,14,16,7,0,0,7,1,10,0,10,33,0.7934272724978364,13.287799302647272,,
2419,2020,4,NCAAF_20200926_TENN@SC,South Carolina,Gamecocks,Tennessee,Volunteers,0-1,1-0,1,7,14,27,31,7,0,14,6,7,7,10,7,-1,-7,0,-7,-4,0.6416033674484356,5.889897378440082,,
2420,2020,4,NCAAF_20200926_VANDY@TXAM,Texas A&M,Aggies,Vanderbilt,Commodores,1-0,0-1,0,7,5,17,12,7,0,7,3,3,2,7,0,1,2,4,2,5,0.8172287293838663,14.692022762075112,,
2421,2020,4,NCAAF_20200926_NCST@VATECH,Virginia Tech,Hokies,NC State,Wolfpack,1-0,1-1,1,31,10,45,24,17,14,6,8,0,10,7,7,0,21,17,21,21,0.5557401642154458,2.2760485172518656,,
2422,2020,4,NCAAF_20200926_TROY@BYU,BYU,Cougars,Troy,Trojans,2-0,1-1,0,24,7,48,7,7,17,14,10,0,7,0,0,1,17,7,17,41,0.5893070878231852,3.665688022515951,,
2423,2020,4,NCAAF_20200925_MTSU@TXSA,UTSA,Roadrunners,Middle Tenn.,Blue Raiders,3-0,0-3,0,17,10,37,35,0,17,17,3,3,7,13,12,3,7,-3,7,2,0.24069107925492372,-11.432091686053354,,
2424,2020,4,NCAAF_20200924_UAB@SALA,South Alabama,Jaguars,UAB,Blazers,1-2,2-1,0,10,28,10,42,0,10,0,0,14,14,0,14,-1,-18,-14,-18,-32,0.2381161860914498,-11.566761723262516,,
2425,2020,5,NCAAF_20201003_ARKST@CSTCAR,C. Carolina,Chanticleers,Arkansas St.,Red Wolves,3-0,1-2,0,24,14,52,23,7,17,7,21,14,0,0,9,2,10,-7,10,29,0.2320967791903138,-11.897195666509901,,
2426,2020,5,NCAAF_20201003_ECU@GAST,Georgia St.,Panthers,East Carolina,Pirates,1-1,0-2,1,35,13,49,29,21,14,0,14,7,6,3,13,1,22,14,22,20,0.49041214098826835,-0.3906710258589783,,
2427,2020,5,NCAAF_20201003_MIZZOU@TENN,Tennessee,Volunteers,Missouri,Tigers,2-0,0-2,1,21,6,35,12,7,14,7,7,0,6,6,0,2,15,7,15,23,0.26828826177304754,-10.044886347993497,,
2428,2020,5,NCAAF_20201003_NCST@PITT,Pittsburgh,Panthers,NC State,Wolfpack,3-1,2-1,1,13,17,29,30,7,6,7,9,10,7,0,13,1,-4,-3,-4,-1,0.5019164452714657,0.0780810853427738,,
2429,2020,5,NCAAF_20201003_SC@FLA,Florida,Gators,South Carolina,Gamecocks,2-0,0-2,0,24,14,38,24,14,10,14,0,7,7,3,7,2,10,7,10,14,0.6970993102550602,8.38825101428506,,
2430,2020,5,NCAAF_20201003_TCU@TEXAS,Texas,Longhorns,TCU,Horned Frogs,2-1,1-1,1,14,20,31,33,7,7,7,10,7,13,3,10,1,-6,0,-6,-2,0.548641007809463,1.9866923459644568,,
2431,2020,5,NCAAF_20201003_TXSA@UAB,UAB,Blazers,UTSA,Roadrunners,3-1,3-1,0,14,6,21,13,7,7,7,0,3,3,0,7,0,8,4,8,8,0.7487892164044939,10.901243901588145,,
2432,2020,5,NCAAF_20201003_NAL@LIB,Liberty,Flames,North Alabama,Lions,3-0,0-1,0,7,0,28,7,0,7,14,7,0,0,0,7,3,7,0,7,21,,,,
2433,2020,5,NCAAF_20201003_ABIL@ARMY,Army,Black Knights,Abil Christian,Wildcats,3-1,0-2,0,23,3,55,23,7,16,15,17,0,3,7,13,3,20,7,20,32,0.9741301884125901,31.618628424984877,,
2434,2020,5,NCAAF_20201003_MEMP@SMU,SMU,Mustangs,Memphis,Tigers,4-0,1-1,1,24,20,30,27,17,7,3,3,3,17,7,0,3,4,14,4,3,0.3518250532013273,-6.182952003019409,,
2435,2020,5,NCAAF_20201003_OKLAST@KANSAS,Kansas,Jayhawks,Oklahoma State,Cowboys,0-3,3-0,1,0,31,7,47,0,0,0,7,10,21,13,3,-3,-31,-10,-31,-40,0.07778100811056654,-23.083100114347644,,
2436,2020,5,NCAAF_20201003_SFLA@CINCY,Cincinnati,Bearcats,South Florida,Bulls,3-0,1-2,0,14,0,28,7,7,7,14,0,0,0,7,0,2,14,7,14,21,0.6653345740494168,6.941500792583383,0.8609852617907656,16.232205017594083
2437,2020,5,NCAAF_20201003_TXAM@BAMA,Alabama,Crimson Tide,Texas A&M,Aggies,2-0,1-1,0,35,14,52,24,14,21,7,10,7,7,3,7,1,21,7,21,28,0.9179859840534431,22.619772306517007,,
2438,2020,5,NCAAF_20201003_TXTECH@KSTATE,Kansas State,Wildcats,Texas Tech,Red Raiders,2-1,1-2,1,14,0,31,21,7,7,3,14,0,0,14,7,1,14,7,14,10,0.5532430303783635,2.1757346846915198,,
2439,2020,5,NCAAF_20201003_UNC@BC,Boston College,Eagles,North Carolina,Tar Heels,2-1,2-0,1,16,21,22,26,3,13,0,6,14,7,3,2,0,-5,-11,-5,-4,0.6082057811941403,4.464066440528768,,
2440,2020,5,NCAAF_20201003_CHARLO@FAU,FAU,Owls,Charlotte,49ers,1-0,0-2,1,0,10,21,17,0,0,21,0,10,0,0,7,1,-10,-10,-10,4,0.8995326907860597,20.787015554529717,,
2441,2020,5,NCAAF_20201003_JAXST@FSU,Florida State,Seminoles,Jacksonville St.,Gamecocks,1-2,0-1,0,14,21,41,24,0,14,20,7,14,7,3,0,1,-7,-14,-7,17,0.959861914057184,28.429482518520672,,
2442,2020,5,NCAAF_20201003_VATECH@DUKE,Duke,Blue Devils,Virginia Tech,Hokies,0-4,2-0,1,7,10,31,38,7,0,7,17,7,3,14,14,-2,-3,0,-3,-7,0.35014407764709354,-6.2566417094624285,,
2443,2020,5,NCAAF_20201003_WKY@MTSU,Middle Tenn.,Blue Raiders,W. Kentucky,Hilltoppers,0-4,1-2,1,10,10,17,20,0,10,0,7,0,10,3,7,-1,0,0,0,-3,0.5725169810056404,2.9709847967676524,0.19387520582619833,-12.924395759333649
2444,2020,5,NCAAF_20201003_NAVY@AF,Air Force,Falcons,Navy,Midshipmen,1-0,1-2,0,16,7,40,7,3,13,3,21,0,7,0,0,0,9,3,9,33,0.4659411565468764,-1.3893326287911805,,
2445,2020,5,NCAAF_20201003_GAS@LAMON,UL-Monroe,Warhawks,Ga. Southern,Eagles,0-4,2-1,1,17,21,30,35,3,14,6,7,7,14,14,0,-2,-4,-4,-4,-5,0.33121533240688694,-7.095802163556868,,
2446,2020,5,NCAAF_20201003_ARK@MISSST,Miss. State,Bulldogs,Arkansas,Razorbacks,1-1,1-1,1,7,14,14,21,7,0,7,0,7,7,7,0,0,-7,0,-7,-7,0.9124470132914444,22.03995252523123,,
2447,2020,5,NCAAF_20201003_AUBURN@UGA,Georgia,Bulldogs,Auburn,Tigers,2-0,1-1,1,24,3,27,6,10,14,3,0,0,3,3,0,1,21,10,21,21,0.6305595660718009,5.418008593095692,,
2448,2020,5,NCAAF_20201003_LSU@VANDY,Vanderbilt,Commodores,LSU,Tigers,0-2,1-1,1,7,21,7,41,0,7,0,0,7,14,13,7,-1,-14,-7,-14,-34,0.0582569274088347,-25.511740142111876,,
2449,2020,5,NCAAF_20201003_OKLA@IOWAST,Iowa St.,Cyclones,Oklahoma,Sooners,2-1,1-2,0,13,17,37,30,3,10,10,14,10,7,3,10,1,-4,-7,-4,7,0.26236771114899704,-10.33850837318073,0.31081098749481184,-7.385483385944511
2450,2020,5,NCAAF_20201003_TULSA@UCF,UCF,Knights,Tulsa,Golden Hurricane,2-1,1-1,0,23,12,26,34,16,7,3,0,2,10,13,9,1,11,14,11,-8,0.9313162074307364,24.14787353634722,,
2451,2020,5,NCAAF_20201003_USM@NTEXAS,North Texas,Mean Green,So. Miss,Golden Eagles,1-2,1-3,1,10,20,31,41,3,7,7,14,17,3,7,14,0,-10,-14,-10,-10,0.4952710693706718,-0.19267300180820257,,
2452,2020,5,NCAAF_20201003_UVA@CLEM,Clemson,Tigers,Virginia,Cavaliers,3-0,1-1,1,24,10,41,23,10,14,10,7,0,10,7,6,2,14,10,14,18,0.95310139106449,27.236654207112565,,
2453,2020,5,NCAAF_20201002_CAMP@WAKE,Wake Forest,Demon Deacons,Campbell,Fighting Camels,1-2,0-4,0,24,7,66,14,14,10,28,14,0,7,7,0,1,17,14,17,52,0.9918666293361603,39.05611279057871,,
2454,2020,5,NCAAF_20201002_LATECH@BYU,BYU,Cougars,Louisiana Tech,Bulldogs,3-0,2-1,0,28,7,45,14,7,21,10,7,7,0,0,7,1,21,0,21,31,0.6738829974544753,7.325000254677889,,
2455,2020,6,NCAAF_20201010_FLA@TXAM,Texas A&M,Aggies,Florida,Gators,2-1,2-1,0,17,21,41,38,7,10,7,17,14,7,7,10,0,-4,-7,-4,3,0.388905722856847,-4.589429605354212,,
2456,2020,6,NCAAF_20201010_LAMON@LIB,Liberty,Flames,UL-Monroe,Warhawks,4-0,0-5,0,24,0,40,7,14,10,7,9,0,0,0,7,4,24,14,24,33,0.6247116376356707,5.170187182690029,,
2457,2020,6,NCAAF_20201010_LSU@MIZZOU,Missouri,Tigers,LSU,Tigers,1-2,1-2,1,24,24,45,41,14,10,14,7,14,10,17,0,0,0,0,0,4,0.23374346145733615,-11.817464921099372,,
2458,2020,6,NCAAF_20201010_NCST@UVA,Virginia,Cavaliers,NC State,Wolfpack,1-2,3-1,0,7,24,21,38,0,7,7,7,14,10,0,14,-2,-17,-14,-17,-17,0.5047975902395547,0.19559961117954572,,
2459,2020,6,NCAAF_20201010_SC@VANDY,Vanderbilt,Commodores,South Carolina,Gamecocks,0-3,1-2,0,0,10,7,41,0,0,7,0,3,7,17,14,-1,-10,-3,-10,-34,0.2697968723341001,-9.9771760113058,,
2460,2020,6,NCAAF_20201010_VATECH@UNC,North Carolina,Tar Heels,Virginia Tech,Hokies,3-0,2-1,1,35,14,56,45,21,14,7,14,0,14,23,8,1,21,21,21,11,0.33190314019321754,-7.069654286125342,,
2461,2020,6,NCAAF_20201010_DUKE@CUSE,Syracuse,Orange,Duke,Blue Devils,1-3,1-4,0,14,24,24,38,7,7,7,3,10,14,6,8,0,-10,-3,-10,-14,0.5112724256837906,0.4596312506500908,,
2462,2020,6,NCAAF_20201010_CIT@ARMY,Army,Black Knights,The Citadel,Bulldogs,4-1,0-4,1,7,3,14,9,0,7,7,0,3,0,0,6,4,4,-3,4,5,0.8460878759031588,16.586647289304437,,
2463,2020,6,NCAAF_20201010_CAR@ARKST,Arkansas St.,Red Wolves,Cent. Ark.,Bears,2-2,2-3,0,23,13,50,27,2,21,20,7,3,10,0,14,0,10,-1,10,23,0.7966501237013981,13.495020420765286,,
2464,2020,6,NCAAF_20201010_TENN@UGA,Georgia,Bulldogs,Tennessee,Volunteers,3-0,2-1,1,17,21,44,21,7,10,13,14,7,14,0,0,1,-4,0,-4,23,0.9401225217497565,25.304573566155227,,
2465,2020,6,NCAAF_20201010_TXSA@BYU,BYU,Cougars,UTSA,Roadrunners,4-0,3-2,1,14,3,27,20,0,14,7,6,3,0,3,14,1,11,-3,11,7,0.8925107071668668,20.16801220464606,,
2466,2020,6,NCAAF_20201010_TXSTSM@TROY,Troy,Trojans,Texas St.,Bobcats,2-1,1-4,1,23,3,37,17,6,17,7,7,3,0,7,7,1,20,3,20,20,0.8483198367768587,16.74044513227045,,
2467,2020,6,NCAAF_20201010_TXTECH@IOWAST,Iowa St.,Cyclones,Texas Tech,Red Raiders,3-1,1-3,0,21,7,31,15,7,14,7,3,7,0,0,8,2,14,0,14,16,0.6732231823332772,7.300072875262003,,
2468,2020,6,NCAAF_20201010_ARK@AUBURN,Auburn,Tigers,Arkansas,Razorbacks,2-1,1-2,0,20,12,30,28,10,10,0,10,0,12,6,10,1,8,10,8,2,0.9585348935499951,28.20177245518653,,
2469,2020,6,NCAAF_20201010_KSTATE@TCU,TCU,Horned Frogs,Kansas State,Wildcats,1-2,3-1,1,7,14,14,21,7,0,0,7,6,8,7,0,-2,-7,1,-7,-7,0.5736535387524533,3.020076075307202,,
2470,2020,6,NCAAF_20201010_MTSU@FIU,FIU,Panthers,Middle Tenn.,Blue Raiders,0-2,1-4,0,14,17,28,31,7,7,14,0,0,17,7,7,-1,-3,7,-3,-3,0.4826070903187858,-0.7093233537027572,,
2471,2020,6,NCAAF_20201010_TEMPLE@NAVY,Navy,Midshipmen,Temple,Owls,2-2,0-1,1,21,10,31,29,7,14,7,3,0,10,7,12,2,11,7,11,2,0.5036529263803546,0.14892971385927467,,
2472,2020,6,NCAAF_20201010_ECU@SFLA,South Florida,Bulls,East Carolina,Pirates,1-3,1-2,0,17,31,24,44,7,10,0,7,17,14,7,6,0,-14,-10,-14,-20,0.7827280926548033,12.709837905426184,,
2473,2020,6,NCAAF_20201010_BAMA@MISS,Ole Miss,Rebels,Alabama,Crimson Tide,1-2,3-0,1,21,21,48,63,7,14,14,13,7,14,21,21,-2,0,0,0,-15,0.03187853296557519,-30.152605560412326,,
2474,2020,6,NCAAF_20201010_FSU@ND,Notre Dame,Fighting Irish,Florida State,Seminoles,3-0,1-3,1,35,20,42,26,14,21,7,0,17,3,6,0,2,15,-3,15,16,0.8743390247817608,18.657889551840412,,
2475,2020,6,NCAAF_20201010_MIAMI@CLEM,Clemson,Tigers,Miami (Fla.),Hurricanes,4-0,3-1,1,21,10,42,17,7,14,14,7,0,10,0,7,1,11,7,11,25,0.8898668766131319,19.937527411732503,,
2476,2020,6,NCAAF_20201010_MISSST@UK,Kentucky,Wildcats,Miss. State,Bulldogs,1-2,1-2,1,14,0,24,2,0,14,0,10,0,0,2,0,0,14,0,14,22,0.34709825692808405,-6.394711176793066,,
2477,2020,6,NCAAF_20201010_MRSHL@WKY,W. Kentucky,Hilltoppers,Marshall,Thundering Herd,1-3,3-0,0,0,28,14,38,0,0,7,7,14,14,10,0,-2,-28,-14,-28,-24,0.3277563349447139,-7.255933456109005,,
2478,2020,6,NCAAF_20201010_UTEP@LATECH,Louisiana Tech,Bulldogs,UTEP,Miners,3-1,3-2,1,14,7,21,17,7,7,0,7,0,7,3,7,0,7,7,7,4,0.9030234143205201,21.12732824366708,,
2479,2020,6,NCAAF_20201010_CHARLO@NTEXAS,North Texas,Mean Green,Charlotte,49ers,1-3,1-2,1,7,21,21,49,0,7,7,7,7,14,14,14,0,-14,-7,-14,-28,0.69760847132878,8.417512696836297,,
2480,2020,6,NCAAF_20201009_LVILLE@GATECH,Georgia Tech,Yellow Jackets,Louisville,Cardinals,2-2,1-3,0,14,21,46,27,7,7,12,20,7,14,6,0,1,-7,0,-7,19,0.5529040264704316,2.16322648677135,,
2481,2020,6,NCAAF_20201008_TULANE@HOU,Houston,Cougars,Tulane,Green Wave,1-0,2-2,1,21,24,49,31,7,14,21,7,17,7,7,0,-1,-3,-10,-3,18,0.531878068216377,1.3010360064558881,,
2482,2020,7,NCAAF_20201017_AUBURN@SC,South Carolina,Gamecocks,Auburn,Tigers,1-2,2-1,1,14,16,30,22,0,14,13,3,9,7,3,3,-1,-2,-9,-2,8,0.2051970339734035,-13.39757234385138,,
2483,2020,7,NCAAF_20201017_CLEM@GATECH,Georgia Tech,Yellow Jackets,Clemson,Tigers,2-2,4-0,1,7,52,7,73,7,0,0,0,17,35,7,14,-2,-45,-10,-45,-66,0.03343243988430966,-29.82522877750239,,
2484,2020,7,NCAAF_20201017_KANSAS@WVU,West Virginia,Mountaineers,Kansas,Jayhawks,2-1,0-3,1,17,10,38,17,7,10,7,14,10,0,0,7,2,7,-3,7,21,0.8747385864003734,18.701264887281127,,
2485,2020,7,NCAAF_20201017_LIB@CUSE,Syracuse,Orange,Liberty,Flames,1-3,4-0,1,14,21,21,38,7,7,0,7,14,7,14,3,-3,-7,-7,-7,-17,0.8055314737230488,14.021657315659127,,
2486,2020,7,NCAAF_20201017_NAVY@ECU,East Carolina,Pirates,Navy,Midshipmen,1-2,3-2,0,13,13,23,27,6,7,0,10,7,6,14,0,-2,0,-1,0,-4,0.14836990102765257,-16.98213613256769,,
2487,2020,7,NCAAF_20201017_PITT@MIAMI,Miami (Fla.),Hurricanes,Pittsburgh,Panthers,3-1,3-2,0,14,6,31,19,7,7,14,3,0,6,13,0,0,8,7,8,12,0.6630608280643526,6.849020997171465,,
2488,2020,7,NCAAF_20201017_SFLA@TEMPLE,Temple,Owls,South Florida,Bulls,1-1,1-4,0,17,21,39,37,10,7,9,13,7,14,10,6,0,-4,3,-4,2,0.6376381213167894,5.73127924423909,,
2489,2020,7,NCAAF_20201017_TXSTSM@SALA,South Alabama,Jaguars,Texas St.,Bobcats,1-2,1-4,0,17,10,30,20,3,14,0,13,7,3,7,3,0,7,-4,7,10,0.5313353850057034,1.279654804437314,,
2490,2020,7,NCAAF_20201017_UK@TENN,Tennessee,Volunteers,Kentucky,Wildcats,2-1,1-2,0,7,17,7,34,0,7,0,0,0,17,10,7,1,-10,0,-10,-27,0.36083456370103384,-5.79762004942495,,
2491,2020,7,NCAAF_20201017_ARMY@TXSA,UTSA,Roadrunners,Army,Black Knights,3-2,4-1,1,10,14,16,28,0,10,0,6,7,7,7,7,-1,-4,-7,-4,-12,0.13513747693591283,-17.942023599611275,0.12388588470954942,-17.359698281271193
2492,2020,7,NCAAF_20201017_WKY@UAB,UAB,Blazers,W. Kentucky,Hilltoppers,3-1,1-3,0,24,14,37,14,10,14,10,3,7,7,0,0,2,10,3,10,23,0.5795002191978751,3.265007243867217,0.29157418528229406,-8.242807122268886
2493,2020,7,NCAAF_20201017_LVILLE@ND,Notre Dame,Fighting Irish,Louisville,Cardinals,3-0,1-3,1,6,0,12,7,6,0,6,0,0,0,7,0,2,6,6,6,5,0.913558889643056,22.18281777063794,,
2494,2020,7,NCAAF_20201017_DUKE@NCST,NC State,Wolfpack,Duke,Blue Devils,3-1,1-4,0,14,20,31,20,0,14,7,10,7,13,0,0,2,-6,-7,-6,11,0.5697264848176444,2.859154301142894,0.4546573651191552,-1.7108129067061384
2495,2020,7,NCAAF_20201017_EKY@TROY,Troy,Trojans,E. Kentucky,Colonels,2-1,1-3,1,21,17,31,29,14,7,7,3,7,10,0,12,1,4,7,4,2,0.9454564796015422,26.07757170388561,,
2496,2020,7,NCAAF_20201017_MISS@ARK,Arkansas,Razorbacks,Ole Miss,Rebels,1-2,1-2,1,20,0,33,21,7,13,0,13,0,0,7,14,0,20,7,20,12,0.27106280509348535,-9.921259581840445,,
2497,2020,7,NCAAF_20201017_UCF@MEMP,Memphis,Tigers,UCF,Knights,2-1,2-2,1,14,27,50,49,7,7,15,21,7,20,8,14,0,-13,0,-13,1,0.3215823754526804,-7.539850127049704,,
2498,2020,7,NCAAF_20201017_TXAM@MISSST,Miss. State,Bulldogs,Texas A&M,Aggies,1-2,2-1,1,0,14,14,28,0,0,7,7,0,14,14,0,-1,-14,0,-14,-14,0.5576301302715218,2.35927758407513,,
2499,2020,7,NCAAF_20201017_UMASS@GAS,Ga. Southern,Eagles,UMass,Minutemen,2-1,0-0,1,28,0,41,0,14,14,10,3,0,0,0,0,2,28,14,28,41,0.8093346146960796,14.247884633678723,,
2500,2020,7,NCAAF_20201017_UVA@WAKE,Wake Forest,Demon Deacons,Virginia,Cavaliers,1-2,1-2,1,20,20,40,23,14,6,3,17,3,17,0,3,0,0,11,0,17,0.526650591367994,1.0880296990648048,,
2501,2020,7,NCAAF_20201017_NTEXAS@MTSU,Middle Tenn.,Blue Raiders,North Texas,Mean Green,1-4,1-3,1,28,21,35,52,21,7,0,7,7,14,21,10,0,7,14,7,-17,0.5458808204484876,1.8758686528360613,0.6447818588810482,5.576448137294932
2502,2020,7,NCAAF_20201017_MRSHL@LATECH,Louisiana Tech,Bulldogs,Marshall,Thundering Herd,3-1,3-0,0,3,14,17,35,0,3,7,7,7,7,14,7,0,-11,-7,-11,-18,0.3820287102337083,-4.885049906420136,,
2503,2020,7,NCAAF_20201017_UNC@FSU,Florida State,Seminoles,North Carolina,Tar Heels,1-3,3-0,0,31,7,31,28,7,24,0,0,0,7,14,7,-2,24,7,24,3,0.5251735929151178,1.0276476048989025,,
2504,2020,7,NCAAF_20201017_BC@VATECH,Virginia Tech,Hokies,Boston College,Eagles,2-1,3-1,0,17,7,40,14,3,14,10,13,0,7,7,0,-1,10,3,10,26,0.5691344556823033,2.834629922764748,,
2505,2020,7,NCAAF_20201017_UGA@BAMA,Alabama,Crimson Tide,Georgia,Bulldogs,3-0,3-0,1,20,24,41,24,7,13,14,7,7,17,0,0,0,-4,0,-4,17,0.6366826082954201,5.689823803263835,,
2506,2020,7,NCAAF_20201016_BYU@HOU,Houston,Cougars,BYU,Cougars,1-1,4-0,1,20,14,26,43,3,17,6,0,14,0,7,22,-3,6,-11,6,-17,0.5225128663800185,0.9189079066367185,,
2507,2020,7,NCAAF_20201015_GAST@ARKST,Arkansas St.,Red Wolves,Georgia St.,Panthers,2-2,1-1,0,28,28,59,52,14,14,17,14,7,21,14,10,1,0,7,0,7,0.7304529198292583,9.995824368074295,,
2508,2020,7,NCAAF_20201014_CSTCAR@LALAF,Louisiana,Ragin' Cajuns,C. Carolina,Chanticleers,3-0,3-0,1,13,13,27,30,7,6,7,7,7,6,7,10,0,0,0,0,-3,0.731238309516037,10.034543525552522,,
2509,2020,8,NCAAF_20201024_AUBURN@MISS,Ole Miss,Rebels,Auburn,Tigers,1-4,3-2,1,14,14,28,35,0,14,7,7,7,7,7,14,-2,0,-7,0,-7,0.14708727906208208,-17.08210429241649,,
2510,2020,8,NCAAF_20201024_CUSE@CLEM,Clemson,Tigers,Syracuse,Orange,6-0,1-5,1,27,14,47,21,17,10,7,13,0,14,7,0,5,13,17,13,26,0.9732637348176588,31.44590436260239,,
2511,2020,8,NCAAF_20201024_FSU@LVILLE,Louisville,Cardinals,Florida State,Seminoles,2-4,2-4,0,31,14,48,16,21,10,7,10,7,7,2,0,0,17,14,17,32,0.4201610415604081,-3.280936936672333,0.5253229605755259,1.9452687013471461
2512,2020,8,NCAAF_20201024_GAS@CSTCAR,C. Carolina,Chanticleers,Ga. Southern,Eagles,5-0,3-2,0,14,14,28,14,7,7,0,14,7,7,0,0,2,0,0,0,14,0.3616567537662817,-5.76510841785273,,
2513,2020,8,NCAAF_20201024_KANSAS@KSTATE,Kansas State,Wildcats,Kansas,Jayhawks,4-1,0-5,0,34,7,55,14,7,27,21,0,0,7,0,7,4,27,7,27,41,0.8876458877432134,19.77053263868254,,
2514,2020,8,NCAAF_20201024_MERCER@ARMY,Army,Black Knights,Mercer,Bears,6-1,0-2,0,21,3,49,3,7,14,21,7,3,0,0,0,6,18,4,18,46,0.8917111547472975,20.12187970972616,,
2515,2020,8,NCAAF_20201024_NCST@UNC,North Carolina,Tar Heels,NC State,Wolfpack,4-1,4-2,0,17,7,48,21,7,10,21,10,0,7,7,7,0,10,7,10,27,0.40664620738911694,-3.8459813972397114,,
2516,2020,8,NCAAF_20201024_NEB@OHIOST,Ohio State,Buckeyes,Nebraska,Cornhuskers,1-0,0-1,0,24,14,52,17,14,10,14,14,7,7,3,0,1,10,7,10,35,0.9658356350826872,29.683116376566318,,
2517,2020,8,NCAAF_20201024_OKLA@TCU,TCU,Horned Frogs,Oklahoma,Sooners,1-3,3-2,0,7,17,14,33,0,7,0,7,10,7,10,6,-2,-10,-10,-10,-19,0.24177131846999833,-11.408873968595913,,
2518,2020,8,NCAAF_20201024_RUT@MICHST,Michigan St.,Spartans,Rutgers,Scarlet Knights,0-1,1-0,0,13,28,27,38,7,6,7,7,14,14,0,10,-1,-15,-7,-15,-11,0.8995933524068285,20.831185880629732,,
2519,2020,8,NCAAF_20201024_TEMPLE@MEMP,Memphis,Tigers,Temple,Owls,3-1,1-2,0,10,15,41,29,7,3,17,14,3,12,7,7,2,-5,4,-5,12,0.7005775884678904,8.56643205693581,,
2520,2020,8,NCAAF_20201024_UTEP@CHARLO,Charlotte,49ers,UTEP,Miners,2-2,3-3,0,14,14,38,28,7,7,7,17,7,7,0,14,-1,0,0,0,10,0.7644605873516955,11.736326139673906,,
2521,2020,8,NCAAF_20201024_USM@LIB,Liberty,Flames,So. Miss,Golden Eagles,6-0,1-4,0,35,7,56,35,14,21,7,14,7,0,21,7,5,28,7,28,21,0.45509341079061794,-1.8368890757366216,,
2522,2020,8,NCAAF_20201024_TULANE@UCF,UCF,Knights,Tulane,Green Wave,3-2,2-4,1,37,14,51,34,10,27,14,0,14,0,14,6,1,23,-4,23,17,0.8423220417956265,16.34996246976607,,
2523,2020,8,NCAAF_20201024_FAU@MRSHL,Marshall,Thundering Herd,FAU,Owls,5-0,1-1,1,7,6,20,9,7,0,10,3,0,6,3,0,4,1,7,1,11,0.38061331823558986,-4.948243498120291,,
2524,2020,8,NCAAF_20201024_BAMA@TENN,Tennessee,Volunteers,Alabama,Crimson Tide,2-3,5-0,0,10,28,17,48,0,10,7,0,14,14,14,6,-3,-18,-14,-18,-31,0.026586076609482534,-31.48555700640793,,
2525,2020,8,NCAAF_20201024_BAYLOR@TEXAS,Texas,Longhorns,Baylor,Bears,3-2,1-2,0,13,3,27,16,0,13,14,0,3,0,0,13,2,10,-3,10,11,0.7190220257349965,9.443756446493467,,
2526,2020,8,NCAAF_20201024_HOU@NAVY,Navy,Midshipmen,Houston,Cougars,3-3,2-1,0,13,16,21,37,7,6,0,8,3,13,7,14,1,-3,4,-3,-16,0.47390708679025395,-1.0658232179131346,,
2527,2020,8,NCAAF_20201024_IOWA@PURDUE,Purdue,Boilermakers,Iowa,Hawkeyes,1-0,0-1,0,14,17,24,20,7,7,0,10,0,17,0,3,1,-3,7,-3,4,0.26935315583845787,-10.010958906581664,,
2528,2020,8,NCAAF_20201024_IOWAST@OKLAST,Oklahoma State,Cowboys,Iowa St.,Cyclones,4-0,3-2,1,14,7,24,21,7,7,7,3,7,0,7,7,1,7,0,7,3,0.48637030353983546,-0.5564463638929737,,
2529,2020,8,NCAAF_20201024_ND@PITT,Pittsburgh,Panthers,Notre Dame,Fighting Irish,3-4,5-0,0,3,28,3,45,3,0,0,0,7,21,17,0,-2,-25,-4,-25,-42,0.15802478301704936,-16.326544040430804,,
2530,2020,8,NCAAF_20201024_VATECH@WAKE,Wake Forest,Demon Deacons,Virginia Tech,Hokies,3-2,3-2,0,17,10,23,16,10,7,3,3,0,10,3,3,0,7,10,7,7,0.4455341985161002,-2.2301414872506484,,
2531,2020,8,NCAAF_20201024_GAST@TROY,Troy,Trojans,Georgia St.,Panthers,3-2,2-2,0,21,13,34,36,7,14,0,13,7,6,20,3,1,8,0,8,-2,0.7313723520603342,10.046756824282966,,
2532,2020,8,NCAAF_20201024_GATECH@BC,Boston College,Eagles,Georgia Tech,Yellow Jackets,4-2,2-4,0,34,14,48,27,14,20,14,0,0,14,7,6,2,20,14,20,21,0.5824740889156605,3.390778868268285,,
2533,2020,8,NCAAF_20201024_TNCHAT@WKY,W. Kentucky,Hilltoppers,Chattanooga,Mocs,2-4,0-1,0,3,7,13,10,3,0,3,7,7,0,3,0,2,-4,-4,-4,3,0.8592243034297822,17.53533961228368,,
2534,2020,8,NCAAF_20201024_UK@MIZZOU,Missouri,Tigers,Kentucky,Wildcats,2-2,2-3,0,10,3,20,10,0,10,7,3,0,3,0,7,0,7,0,7,10,0.557204117415594,2.3430218981500275,,
2535,2020,8,NCAAF_20201024_WVU@TXTECH,Texas Tech,Red Raiders,West Virginia,Mountaineers,2-3,3-2,0,20,13,34,27,13,7,7,7,7,6,14,0,-1,7,6,7,7,0.4482938531562233,-2.1164897424728224,,
2536,2020,8,NCAAF_20201024_LAMON@SALA,South Alabama,Jaguars,UL-Monroe,Warhawks,3-2,0-6,1,17,6,38,14,17,0,14,7,0,6,0,8,3,11,17,11,24,0.43654955829459996,-2.600942243434588,,
2537,2020,8,NCAAF_20201024_SC@LSU,LSU,Tigers,South Carolina,Gamecocks,2-2,2-3,1,31,10,52,24,10,21,14,7,7,3,7,7,0,21,3,21,28,0.8016053664974373,13.798613303284469,,
2538,2020,8,NCAAF_20201024_UTAHST@BOISE,Boise St.,Broncos,Utah St.,Aggies,1-0,0-1,1,28,0,42,13,7,21,0,14,0,0,7,6,1,28,7,28,29,0.6351808611852727,5.627880738956719,,
2539,2020,8,NCAAF_20201024_HAWAII@FRESNO,Fresno St.,Bulldogs,Hawaii,Rainbow Warriors,0-1,1-0,0,13,17,19,34,7,6,3,3,7,10,7,10,-1,-4,0,-4,-15,0.833755850925594,15.781110448881691,,
2540,2020,8,NCAAF_20201024_MD@NWEST,Northwestern,Wildcats,Maryland,Terrapins,1-0,0-1,0,30,3,43,3,14,16,7,6,3,0,0,0,1,27,11,27,40,0.6762760513284781,7.446871043259648,,
2541,2020,8,NCAAF_20201024_MICH@MINN,Minnesota,Golden Gophers,Michigan,Wolverines,0-1,1-0,0,17,35,24,49,10,7,7,0,21,14,7,7,-1,-18,-11,-18,-25,0.1805424923659058,-14.87222519492866,,
2542,2020,8,NCAAF_20201024_LATECH@TXSA,UTSA,Roadrunners,Louisiana Tech,Bulldogs,4-3,3-3,0,6,19,27,26,3,3,7,14,3,16,7,0,1,-13,0,-13,1,0.26995922734012345,-9.981091255773777,0.38761569593707845,-8.744769130332656
2543,2020,8,NCAAF_20201024_UVA@MIAMI,Miami (Fla.),Hurricanes,Virginia,Cavaliers,5-1,1-4,1,10,7,19,14,7,3,3,6,7,0,0,7,4,3,0,3,5,0.6765998956593432,7.4615498620316885,,
2544,2020,8,NCAAF_20201024_CINCY@SMU,SMU,Mustangs,Cincinnati,Bearcats,5-1,4-0,1,10,14,13,42,0,10,0,3,14,0,14,14,1,-4,-14,-4,-29,0.49264681420595213,-0.30015995008204754,,
2545,2020,8,NCAAF_20201024_TXSTSM@BYU,BYU,Cougars,Texas St.,Bobcats,6-0,1-6,0,35,7,52,14,14,21,14,3,7,0,0,7,5,28,7,28,38,0.9289497452955444,23.905221840762692,0.8623223806775411,33.406692795110104
2546,2020,8,NCAAF_20201024_AF@SJST,San Jose St.,Spartans,Air Force,Falcons,1-0,1-1,1,0,0,17,6,0,0,14,3,0,0,0,6,0,0,0,0,11,0.10924582075576605,-20.038330775629788,,
2547,2020,8,NCAAF_20201024_UNLV@SDGST,San Diego St.,Aztecs,UNLV,Rebels,1-0,0-1,1,27,0,34,6,7,20,0,7,0,0,6,0,1,27,7,27,28,0.8254116988397713,15.244934630803414,,
2548,2020,8,NCAAF_20201023_JAXST@FIU,FIU,Panthers,Jacksonville St.,Gamecocks,0-3,3-1,1,3,13,10,19,3,0,7,0,3,10,3,3,-3,-10,0,-10,-9,0.741273464208114,10.540287381766689,,
2549,2020,8,NCAAF_20201023_TULSA@SFLA,South Florida,Bulls,Tulsa,Golden Hurricane,1-5,2-1,1,6,21,13,42,6,0,7,0,7,14,21,0,-1,-15,-1,-15,-29,0.5236447126403232,0.9656976020035017,,
2550,2020,8,NCAAF_20201023_ILL@WISC,Wisconsin,Badgers,Illinois,Fighting Illini,1-0,0-1,0,28,7,45,7,7,21,0,17,0,7,0,0,1,21,7,21,38,0.9536471616561847,27.378303638506964,,
2551,2020,8,NCAAF_20201023_LALAF@UAB,UAB,Blazers,Louisiana,Ragin' Cajuns,4-2,4-1,1,13,10,20,24,3,10,7,0,0,10,7,7,0,3,3,3,-4,0.4694075219816526,-1.2499526967569636,,
2552,2020,8,NCAAF_20201022_ARKST@APLST,App. St.,Mountaineers,Arkansas St.,Red Wolves,3-1,3-3,0,31,7,45,17,14,17,7,7,7,0,10,0,0,24,7,24,28,0.7251989488102101,9.743672359899847,0.7240957150606183,18.223773574047215
2553,2020,9,NCAAF_20201031_BC@CLEM,Clemson,Tigers,Boston College,Eagles,7-0,4-3,0,13,28,34,28,7,6,13,8,14,14,0,0,3,-15,-7,-15,6,0.9549997121689016,27.665042133505494,,
2554,2020,9,NCAAF_20201031_CSTCAR@GAST,Georgia St.,Panthers,C. Carolina,Chanticleers,2-3,6-0,1,0,34,0,51,0,0,0,0,7,27,14,3,-4,-34,-7,-34,-51,0.492687553399063,-0.29911451211262374,,
2555,2020,9,NCAAF_20201031_IOWAST@KANSAS,Kansas,Jayhawks,Iowa St.,Cyclones,0-6,4-2,1,7,20,22,52,0,7,7,8,13,7,15,17,-4,-13,-13,-13,-30,0.06387412797195191,-24.852628917887046,,
2556,2020,9,NCAAF_20201031_KSTATE@WVU,West Virginia,Mountaineers,Kansas State,Wildcats,4-2,4-2,0,24,10,37,10,3,21,10,3,3,7,0,0,0,14,0,14,27,0.4609293679978175,-1.6006519977640892,,
2557,2020,9,NCAAF_20201031_MEMP@CINCY,Cincinnati,Bearcats,Memphis,Tigers,5-0,3-2,1,21,10,49,10,7,14,14,14,7,3,0,0,2,11,0,11,39,0.3801467702243314,-4.978472305003265,,
2558,2020,9,NCAAF_20201031_MICHST@MICH,Michigan,Wolverines,Michigan St.,Spartans,1-1,1-1,0,10,14,24,27,7,3,7,7,7,7,6,7,0,-4,0,-4,-3,0.8297945152217955,15.556593660453473,,
2559,2020,9,NCAAF_20201031_PURDUE@ILL,Illinois,Fighting Illini,Purdue,Boilermakers,0-2,2-0,1,10,17,24,31,0,10,0,14,7,10,14,0,-2,-7,-7,-7,-7,0.1788931093603241,-15.005674321862443,,
2560,2020,9,NCAAF_20201031_TEMPLE@TULANE,Tulane,,Temple,,3-4,1-3,,10,3,38,3,0,10,14,14,3,0,0,0,2,7,-3,7,35,0.48663102314841533,-0.546927721070233,,
2561,2020,9,NCAAF_20201031_TXSA@FAU,FAU,,UTSA,,2-1,4-4,,17,3,24,3,10,7,0,7,0,3,0,0,-2,14,10,14,21,0.8876092910371769,19.80832002182865,,
2562,2020,9,NCAAF_20201031_UGA@UK,Kentucky,Wildcats,Georgia,Bulldogs,2-4,4-1,1,3,7,3,14,0,3,0,0,7,0,7,0,-2,-4,-7,-4,-11,0.12985605661414312,-18.39128676062387,,
2563,2020,9,NCAAF_20201031_WAKE@CUSE,Syracuse,Orange,Wake Forest,Demon Deacons,1-6,4-2,0,7,17,14,38,0,7,0,7,10,7,21,0,-3,-10,-10,-10,-24,0.38330405709038595,-4.8433479936715,,
2564,2020,9,NCAAF_20201031_UCF@HOU,Houston,,UCF,,2-2,4-2,,7,23,21,44,7,0,6,8,10,13,0,21,-2,-16,-3,-16,-23,0.193985397660826,-14.0871734861488,,
2565,2020,9,NCAAF_20201031_RICE@USM,So. Miss,,Rice,,1-5,1-1,,6,23,6,30,0,6,0,0,3,20,0,7,0,-17,-3,-17,-24,0.8001612218798727,13.742771875168955,,
2566,2020,9,NCAAF_20201031_TROY@ARKST,Arkansas St.,,Troy,,3-4,4-2,,3,24,10,38,0,3,7,0,14,10,0,14,-1,-21,-14,-21,-28,0.48912317837441066,-0.444944944939607,0.5845455366351463,4.009288617812501
2567,2020,9,NCAAF_20201031_IND@RUT,Rutgers,Scarlet Knights,Indiana,Hoosiers,1-1,2-0,1,7,20,21,37,7,0,8,6,3,17,10,7,-1,-13,4,-13,-16,0.14971830329380664,-16.931997611979796,,
2568,2020,9,NCAAF_20201031_LSU@AUBURN,Auburn,Tigers,LSU,Tigers,4-2,2-3,1,21,3,48,11,0,21,21,6,0,3,0,8,2,18,0,18,37,0.4426532777067935,-2.35376452915159,,
2569,2020,9,NCAAF_20201031_ND@GATECH,Georgia Tech,Yellow Jackets,Notre Dame,Fighting Irish,2-5,6-0,0,7,17,13,31,0,7,0,6,7,10,7,7,-4,-10,-7,-10,-18,0.10199456210451396,-20.72793010023338,0.036073487579046826,-33.76227662830934
2570,2020,9,NCAAF_20201031_NWEST@IOWA,Iowa,Hawkeyes,Northwestern,Wildcats,0-2,2-0,0,20,14,20,21,17,3,0,0,0,14,7,0,-2,6,17,6,-1,0.7620700711478977,11.634190521497771,,
2571,2020,9,NCAAF_20201031_TCU@BAYLOR,Baylor,Bears,TCU,Horned Frogs,1-3,2-3,0,7,30,23,33,0,7,7,9,20,10,3,0,-1,-23,-20,-23,-10,0.3268990963530035,-7.31838371200422,,
2572,2020,9,NCAAF_20201031_APLST@LAMON,UL-Monroe,,App. St.,,0-7,4-1,,7,21,13,31,0,7,0,6,14,7,7,3,-4,-14,-14,-14,-18,0.07872625236078767,-23.068277420601703,0.04659554683168554,-31.520647403724126
2573,2020,9,NCAAF_20201031_MISS@VANDY,Vanderbilt,Commodores,Ole Miss,Rebels,0-4,2-4,0,14,33,21,54,0,14,0,7,21,12,21,0,-2,-19,-21,-19,-33,0.3277736548947028,-7.278848699706828,,
2574,2020,9,NCAAF_20201031_VATECH@LVILLE,Louisville,Cardinals,Virginia Tech,Hokies,2-5,4-2,1,14,21,35,42,0,14,0,21,14,7,7,14,-2,-7,-14,-7,-7,0.31750924674365666,-7.745635723095575,,
2575,2020,9,NCAAF_20201031_BOISE@AF,Air Force,Falcons,Boise St.,Broncos,1-2,2-0,0,17,28,30,49,14,3,0,13,7,21,7,14,-1,-11,7,-11,-19,0.27128060799092135,-9.936610018405531,,
2576,2020,9,NCAAF_20201031_CHARLO@DUKE,Duke,Blue Devils,Charlotte,49ers,2-5,2-3,1,24,7,53,19,17,7,13,16,0,7,6,6,0,17,17,17,34,0.8804389561334929,19.20900452862793,,
2577,2020,9,NCAAF_20201031_MISSST@BAMA,Alabama,Crimson Tide,Miss. State,Bulldogs,6-0,1-4,1,27,0,41,0,17,10,0,14,0,0,0,0,5,27,17,27,41,0.8958604862792721,20.532828478008128,,
2578,2020,9,NCAAF_20201031_NMEX@SJST,San Jose St.,Spartans,New Mexico,Lobos,2-0,0-1,0,21,14,38,21,7,14,10,7,0,14,7,0,2,7,7,7,17,0.4713080190668635,-1.1745889344954321,,
2579,2020,9,NCAAF_20201031_ARK@TXAM,Texas A&M,Aggies,Arkansas,Razorbacks,4-1,2-3,1,28,14,42,31,14,14,14,0,7,7,3,14,2,14,7,14,11,0.8484652539437704,16.8052243614286,,
2580,2020,9,NCAAF_20201031_MIZZOU@FLA,Florida,Gators,Missouri,Tigers,3-1,2-3,0,20,7,41,17,6,14,14,7,0,7,0,10,1,13,6,13,24,0.5904167010712345,3.730517431337489,,
2581,2020,9,NCAAF_20201031_NAVY@SMU,SMU,Mustangs,Navy,Midshipmen,6-1,3-4,1,31,17,51,37,0,31,14,6,7,10,0,20,3,14,-7,14,14,0.5503805093695529,2.0661997308889113,,
2582,2020,9,NCAAF_20201031_OHIOST@PSU,Penn State,Nittany Lions,Ohio State,Buckeyes,0-2,2-0,0,6,21,25,38,3,3,7,12,14,7,10,7,-2,-15,-11,-15,-13,0.3324040891408857,-7.070230341211868,,
2583,2020,9,NCAAF_20201031_LALAF@TXSTSM,Texas St.,,Louisiana,,1-7,5-1,,21,34,34,44,14,7,6,7,14,20,3,7,-4,-13,0,-13,-10,0.15258428665280244,-16.73243498276622,,
2584,2020,9,NCAAF_20201031_OKLA@TXTECH,Texas Tech,Red Raiders,Oklahoma,Sooners,2-4,4-2,1,14,48,28,62,7,7,0,14,21,27,7,7,-2,-34,-14,-34,-34,0.1496925443007584,-16.933802735992344,,
2585,2020,9,NCAAF_20201031_UNC@UVA,Virginia,Cavaliers,North Carolina,Tar Heels,2-4,4-2,0,27,20,44,41,13,14,14,3,10,10,7,14,-2,7,3,7,3,0.549834233589949,2.043677771005946,,
2586,2020,9,NCAAF_20201031_SDGST@UTAHST,Utah St.,Aggies,San Diego St.,Aztecs,0-2,2-0,0,7,10,7,38,0,7,0,0,7,3,14,14,-2,-3,-7,-3,-31,0.5430030578723678,1.7623551912208768,,
2587,2020,9,NCAAF_20201031_WKY@BYU,BYU,Cougars,W. Kentucky,Hilltoppers,7-0,2-5,1,35,3,41,10,14,21,3,3,3,0,7,0,5,32,11,32,31,0.8028631807697033,13.900980299407252,0.8765215330678622,21.737992912563072
2588,2020,9,NCAAF_20201031_NEVADA@UNLV,UNLV,Rebels,Nevada,Wolf Pack,0-2,2-0,0,12,24,19,37,3,9,7,0,10,14,3,10,-2,-12,-7,-12,-18,0.39778458269305417,-4.227697076552431,,
2589,2020,9,NCAAF_20201030_ECU@TULSA,Tulsa,Golden Hurricane,East Carolina,Pirates,3-1,1-4,0,3,17,34,30,3,0,17,14,7,10,3,10,2,-14,-4,-14,4,0.7420260982909397,10.600087878657177,,
2590,2020,9,NCAAF_20201030_HAWAII@WYO,Wyoming,Cowboys,Hawaii,Rainbow Warriors,1-1,1-1,1,10,7,31,7,10,0,7,14,0,7,0,0,0,3,10,3,24,0.7076637657436903,8.918838420842349,,
2591,2020,9,NCAAF_20201029_SALA@GAS,Ga. Southern,Eagles,South Alabama,Jaguars,4-2,3-3,0,10,10,24,17,0,10,0,14,3,7,7,0,1,0,-3,0,7,0.7253463566969902,9.771049183206628,,
2592,2020,9,NCAAF_20201029_COLOST@FRESNO,Fresno St.,Bulldogs,Colorado St.,Rams,1-1,0-1,0,24,10,38,17,7,17,7,7,3,7,0,7,1,14,4,14,21,0.7247906086629383,9.7438677590535,,
2593,2020,10,NCAAF_20201107_ARIZST@USC,USC,Trojans,Arizona St.,Sun Devils,1-0,0-1,0,14,17,28,27,7,7,0,14,3,14,7,3,1,-3,4,-3,1,0.6215805899035032,5.072926090790702,,
2594,2020,10,NCAAF_20201107_ARKST@LALAF,Louisiana,Ragin' Cajuns,Arkansas St.,Red Wolves,6-1,3-5,0,0,6,27,20,0,0,14,13,3,3,0,14,3,-6,-3,-6,7,0.5206769697862585,0.8495333217425696,0.8884642961601725,19.747138482807998
2595,2020,10,NCAAF_20201107_LAMON@GAST,Georgia St.,,UL-Monroe,,3-3,0-8,,42,14,52,34,21,21,3,7,7,7,6,14,3,28,14,28,18,0.5473290331920282,1.9482701372879774,,
2596,2020,10,NCAAF_20201107_LIB@VATECH,Virginia Tech,Hokies,Liberty,Flames,4-3,7-0,0,20,14,35,38,3,17,0,15,7,7,7,17,-3,6,-4,6,-3,0.8662684169838748,18.168146165191956,,
2597,2020,10,NCAAF_20201107_MICH@IND,Indiana,Hoosiers,Michigan,Wolverines,3-0,1-2,0,24,7,38,21,14,10,7,7,7,0,7,7,2,17,7,17,17,0.14331867234617235,-17.457161210202912,,
2598,2020,10,NCAAF_20201107_MICHST@IOWA,Iowa,Hawkeyes,Michigan St.,Spartans,1-2,1-2,1,35,0,49,7,14,21,7,7,0,0,7,0,0,35,14,35,42,0.716300730897204,9.369560676769652,,
2599,2020,10,NCAAF_20201107_NEB@NWEST,Northwestern,Wildcats,Nebraska,Cornhuskers,3-0,0-2,0,7,13,21,13,7,0,7,7,0,13,0,0,3,-6,7,-6,8,0.5955400115085294,3.961872079934551,,
2600,2020,10,NCAAF_20201107_SFLA@MEMP,Memphis,,South Florida,,4-2,1-6,,13,27,34,33,6,7,7,14,3,24,3,3,3,-14,3,-14,1,0.7972895453373126,13.630797701947813,,
2601,2020,10,NCAAF_20201107_SMU@TEMPLE,Temple,Owls,SMU,Mustangs,1-4,7-1,1,13,10,23,47,13,0,3,7,7,3,10,27,-6,3,6,3,-24,0.4265132725221883,-3.035193490759184,,
2602,2020,10,NCAAF_20201107_TULANE@ECU,East Carolina,,Tulane,,1-5,4-4,,7,21,21,38,7,0,0,14,7,14,10,7,-3,-14,0,-14,-17,0.16069798367779997,-16.245855535049486,,
2603,2020,10,NCAAF_20201107_UNC@DUKE,Duke,Blue Devils,North Carolina,Tar Heels,2-6,5-2,0,10,42,24,56,0,10,7,7,21,21,7,7,-3,-32,-21,-32,-32,0.5046711791068337,0.19183833156967012,,
2604,2020,10,NCAAF_20201107_WVU@TEXAS,Texas,Longhorns,West Virginia,Mountaineers,5-2,4-3,1,10,7,17,13,7,3,7,0,7,0,6,0,1,3,0,3,4,0.6214150470440651,5.06579429611611,,
2605,2020,10,NCAAF_20201107_TROY@GAS,Ga. Southern,,Troy,,5-2,4-3,,6,10,20,13,0,6,14,0,0,10,3,0,1,-4,0,-4,7,0.3779821584444094,-5.091768069605223,0.5023280330818201,0.09457911966268284
2606,2020,10,NCAAF_20201107_BC@CUSE,Syracuse,,Boston College,,1-7,5-3,,3,10,13,16,0,3,3,7,3,7,0,6,-4,-7,-3,-7,-3,0.39338366352497967,-4.431937045075983,,
2607,2020,10,NCAAF_20201107_UMASS@MRSHL,Marshall,Thundering Herd,UMass,Minutemen,6-0,0-2,1,31,10,51,10,14,17,13,7,7,3,0,0,6,21,7,21,41,0.919418173143969,22.956169108111112,,
2608,2020,10,NCAAF_20201107_APLST@TXSTSM,Texas St.,,App. St.,,1-8,5-1,,10,24,17,38,7,3,0,7,14,10,0,14,-4,-14,-7,-14,-21,0.05151168159876962,-26.711306659426214,0.08189824750139385,-22.567460552487432
2609,2020,10,NCAAF_20201107_NAL@USM,So. Miss,,North Alabama,,2-5,0-3,,7,10,24,13,0,7,0,17,7,3,3,0,2,-3,-7,-3,11,0.8923530449396894,20.30154764416352,,
2610,2020,10,NCAAF_20201107_FLA@UGA,Georgia,Bulldogs,Florida,Gators,4-2,4-1,1,21,38,28,44,14,7,7,0,14,24,3,3,0,-17,0,-17,-16,0.7576604788546089,11.448798316839088,,
2611,2020,10,NCAAF_20201107_FRESNO@UNLV,UNLV,Rebels,Fresno St.,Bulldogs,0-3,2-1,0,17,20,27,40,7,10,10,0,6,14,7,13,-2,-3,1,-3,-13,0.1299452380755467,-18.458569653775157,,
2612,2020,10,NCAAF_20201107_HOU@CINCY,Cincinnati,Bearcats,Houston,Cougars,6-0,2-3,0,28,10,38,10,7,21,3,7,0,10,0,0,4,18,7,18,28,0.5861758587804335,3.567013635928788,,
2613,2020,10,NCAAF_20201107_KANSAS@OKLA,Oklahoma,Sooners,Kansas,Jayhawks,5-2,0-7,0,31,3,62,9,14,17,10,21,0,3,0,6,5,28,14,28,53,0.9834144614486673,34.89714827379487,,
2614,2020,10,NCAAF_20201107_MD@PSU,Penn State,,Maryland,,0-3,2-1,,7,28,19,35,0,7,0,12,14,14,7,0,-2,-21,-14,-21,-16,0.9590967578864772,28.512345565516284,,
2615,2020,10,NCAAF_20201107_MINN@ILL,Illinois,Fighting Illini,Minnesota,Golden Gophers,0-3,1-2,0,7,28,14,41,0,7,0,7,7,21,7,6,-1,-21,-7,-21,-27,0.1969552097296181,-13.967782847184253,,
2616,2020,10,NCAAF_20201107_TXTECH@TCU,TCU,Horned Frogs,Texas Tech,Red Raiders,3-3,2-5,0,10,3,34,18,3,7,17,7,0,3,7,8,1,7,3,7,16,0.6335731671881688,5.592242649976924,,
2617,2020,10,NCAAF_20201107_VANDY@MISSST,Miss. State,Bulldogs,Vanderbilt,Commodores,2-4,0-5,0,17,0,24,17,14,3,0,7,0,0,7,10,2,17,14,17,7,0.8478293167495474,16.828696926834255,,
2618,2020,10,NCAAF_20201107_OKLAST@KSTATE,Kansas State,Wildcats,Oklahoma State,Cowboys,4-3,5-1,0,12,0,18,20,3,9,0,6,0,0,13,7,-1,12,3,12,-2,0.38871832287742514,-4.631002769179645,,
2619,2020,10,NCAAF_20201107_PITT@FSU,Florida State,,Pittsburgh,,2-5,4-4,,17,24,17,41,14,3,0,0,10,14,7,10,-2,-7,4,-7,-24,0.46088024369965297,-1.6091364423081131,,
2620,2020,10,NCAAF_20201107_WKY@FAU,FAU,,W. Kentucky,,3-1,2-6,,0,0,10,6,0,0,3,7,0,0,3,3,1,0,0,0,4,0.8043330699224689,14.04402629164315,,
2621,2020,10,NCAAF_20201107_BAYLOR@IOWAST,Iowa St.,Cyclones,Baylor,Bears,5-2,1-4,1,10,21,38,31,0,10,21,7,14,7,3,7,4,-11,-14,-11,7,0.7227334864621143,9.68239210204706,,
2622,2020,10,NCAAF_20201107_TXAM@SC,South Carolina,Gamecocks,Texas A&M,Aggies,2-4,5-1,1,0,21,3,48,0,0,0,3,7,14,13,14,-3,-21,-7,-21,-45,0.41635917625435304,-3.4604837109617392,,
2623,2020,10,NCAAF_20201107_UCLA@COLO,Colorado,Buffaloes,UCLA,Bruins,1-0,0-1,1,35,14,48,42,14,21,10,3,7,7,21,7,1,21,7,21,6,0.4690677307323513,-1.2715884480871864,,
2624,2020,10,NCAAF_20201107_RUT@OHIOST,Ohio State,Buckeyes,Rutgers,Scarlet Knights,3-0,1-2,0,35,3,49,27,7,28,7,7,3,0,6,18,2,32,4,32,22,0.996632067742166,44.393433174656025,,
2625,2020,10,NCAAF_20201107_STNFRD@OREG,Oregon,Ducks,Stanford,Cardinal,1-0,0-1,0,14,7,35,14,7,7,14,7,7,0,0,7,1,7,0,7,21,0.6404429507554958,5.892243174428927,,
2626,2020,10,NCAAF_20201107_TENN@ARK,Arkansas,Razorbacks,Tennessee,Volunteers,3-3,2-4,0,0,13,24,13,0,0,24,0,3,10,0,0,1,-13,-3,-13,11,0.32824331721742994,-7.2869133981876075,,
2627,2020,10,NCAAF_20201107_SALA@CSTCAR,C. Carolina,Chanticleers,South Alabama,Jaguars,7-0,3-4,0,17,6,23,6,14,3,0,6,3,3,0,0,4,11,11,11,17,0.6449427077818219,6.089815653652977,,
2628,2020,10,NCAAF_20201107_WASHST@OREGST,Oregon State,Beavers,Washington St.,Cougars,0-1,1-0,0,7,14,28,38,0,7,7,14,7,7,14,10,-1,-7,-7,-7,-10,0.0899104242464337,-21.975418351674648,,
2629,2020,10,NCAAF_20201107_NMEX@HAWAII,Hawaii,,New Mexico,,2-1,0-2,,14,20,39,33,7,7,14,11,17,3,7,6,2,-6,-10,-6,6,0.6514135084532967,6.375500512512417,,
2630,2020,10,NCAAF_20201106_MIAMI@NCST,NC State,Wolfpack,Miami (Fla.),Hurricanes,4-3,6-1,1,24,21,41,44,14,10,14,3,14,7,10,13,-2,3,0,3,-3,0.3405298141891715,-6.733942927211501,,
2631,2020,10,NCAAF_20201106_SJST@SDGST,San Diego St.,Aztecs,San Jose St.,Spartans,2-1,3-0,0,10,7,17,28,3,7,0,7,0,7,7,14,-1,3,3,3,-11,0.8908927973858698,20.17294840479633,,
2632,2020,10,NCAAF_20201106_BYU@BOISE,Boise St.,Broncos,BYU,Cougars,2-1,8-0,1,3,16,17,51,3,0,0,14,7,9,22,13,-6,-13,-4,-13,-34,0.6994128612221006,8.56390752659047,,
2633,2020,10,NCAAF_20201105_UTAHST@NEVADA,Nevada,Wolf Pack,Utah St.,Aggies,3-0,0-3,1,21,9,34,9,7,14,10,3,9,0,0,0,3,12,-2,12,25,0.22826588413662074,-12.198726318334252,,
2634,2020,10,NCAAF_20201105_WYO@COLOST,Colorado St.,Rams,Wyoming,Cowboys,1-1,1-2,1,24,14,34,24,14,10,7,3,0,14,3,7,0,10,14,10,10,0.37777491227836624,-5.100701039969067,,
2635,2020,10,NCAAF_20201104_EMICH@KENTST,Kent St.,,E. Michigan,,1-0,0-1,,20,9,27,23,13,7,0,7,9,0,6,8,1,11,4,11,4,0.2110077516060347,-13.154865358895677,,
2636,2020,10,NCAAF_20201104_WMICH@AKRON,Akron,,W. Michigan,,0-1,1-0,,13,30,13,58,7,6,0,0,16,14,21,7,-1,-17,-9,-17,-45,0.18550832177439924,-14.656276829336434,,
2637,2020,10,NCAAF_20201104_BALLST@MIAOH,Miami-OH,RedHawks,Ball St.,Cardinals,1-0,0-1,1,10,14,38,31,0,10,14,14,7,7,7,10,1,-4,-7,-4,7,0.7412281418767475,10.602414781243738,,
2638,2020,10,NCAAF_20201104_BUFF@NILL,N. Illinois,Huskies,Buffalo,Bulls,0-1,1-0,1,16,21,30,49,3,13,0,14,14,7,21,7,-1,-5,-11,-5,-19,0.4390306476120396,-2.5136900909978976,,
2639,2020,10,NCAAF_20201104_OHIO@CMICH,C. Michigan,Chippewas,Ohio,Bobcats,1-0,0-1,1,20,20,30,27,14,6,7,3,7,13,7,0,1,0,7,0,3,0.28068993177296275,-9.515475735950417,,
2640,2020,10,NCAAF_20201104_BGREEN@TOLEDO,Toledo,,Bowling Green,,1-0,0-1,,21,0,38,3,21,0,7,10,0,0,3,0,1,21,21,21,35,0.8855585540688766,19.713412154960793,,
2641,2020,11,NCAAF_20201115_CAL@UCLA,UCLA,Bruins,California,Golden Bears,1-1,0-1,1,27,10,34,10,7,20,0,7,3,7,0,0,1,17,4,17,24,0.42833379891669754,-2.971584619156829,,
2642,2020,11,NCAAF_20201114_ARMY@TULANE,Tulane,Green Wave,Army,Black Knights,5-4,6-2,0,14,12,38,12,14,0,10,14,0,12,0,0,-1,2,14,2,26,0.5087903721708612,0.36254334869295235,,
2643,2020,11,NCAAF_20201114_IND@MICHST,Michigan St.,Spartans,Indiana,Hoosiers,1-3,4-0,0,0,24,0,24,0,0,0,0,14,10,0,0,-3,-24,-14,-24,-24,0.5273622122587118,1.1293008797990751,,
2644,2020,11,NCAAF_20201114_MIAMI@VATECH,Virginia Tech,Hokies,Miami (Fla.),Hurricanes,4-4,7-1,1,14,13,24,25,7,7,10,0,3,10,6,6,-3,1,4,1,-1,0.40963833109378656,-3.7589546319525198,,
2645,2020,11,NCAAF_20201114_MTSU@MRSHL,Marshall,Thundering Herd,Middle Tenn.,Blue Raiders,7-0,2-6,1,21,7,42,14,7,14,21,0,0,7,7,0,5,14,7,14,28,0.6583394608373254,6.711491239434167,,
2646,2020,11,NCAAF_20201114_PSU@NEB,Nebraska,Cornhuskers,Penn State,Nittany Lions,1-2,0-4,1,27,6,30,23,10,17,0,3,0,6,10,7,1,21,10,21,7,0.09271504276994236,-21.786509063799713,,
2647,2020,11,NCAAF_20201114_TCU@WVU,West Virginia,Mountaineers,TCU,Horned Frogs,5-3,3-4,0,14,3,24,6,7,7,3,7,0,3,3,0,2,11,7,11,18,0.4231406479273544,-3.1895384970190435,,
2648,2020,11,NCAAF_20201114_VANDY@UK,Kentucky,Wildcats,Vanderbilt,Commodores,3-4,0-6,1,24,14,38,35,14,10,7,7,0,14,7,14,3,10,14,10,3,0.7855332517367273,13.01409450522533,,
2649,2020,11,NCAAF_20201114_WAKE@UNC,North Carolina,Tar Heels,Wake Forest,Demon Deacons,6-2,4-3,1,24,35,59,53,17,7,7,28,14,21,10,8,2,-11,3,-11,6,0.41244919857239193,-3.640066520211917,,
2650,2020,11,NCAAF_20201114_WCAR@LIB,Liberty,Flames,W. Carolina,Catamounts,8-0,0-1,0,28,7,58,14,7,21,14,16,0,7,7,0,8,21,7,21,44,0.9385576609617271,25.382301694032094,,
2651,2020,11,NCAAF_20201114_ILL@RUT,Rutgers,Scarlet Knights,Illinois,Fighting Illini,1-3,1-3,1,13,7,20,23,10,3,7,0,0,7,10,6,0,6,10,6,-3,0.38867972945627083,-4.652092011158857,,
2652,2020,11,NCAAF_20201114_SALA@LALAF,Louisiana,Ragin' Cajuns,South Alabama,Jaguars,7-1,3-5,0,28,10,38,10,14,14,3,7,3,7,0,0,4,18,11,18,28,0.8088940007966643,14.376510705323085,0.7198771159359783,18.145124905619923
2653,2020,11,NCAAF_20201114_FRESNO@UTAHST,Utah St.,Aggies,Fresno St.,Bulldogs,0-4,3-1,0,16,28,16,35,13,3,0,0,7,21,0,7,-3,-12,6,-12,-19,0.4485087990041221,-2.1294220914937796,,
2654,2020,11,NCAAF_20201114_GAST@APLST,App. St.,Mountaineers,Georgia St.,Panthers,6-1,3-4,0,3,10,17,13,3,0,7,7,7,3,0,3,3,-7,-4,-7,4,0.8925591342156973,20.405064795127828,,
2655,2020,11,NCAAF_20201114_UTEP@TXSA,UTSA,Roadrunners,UTEP,Miners,5-4,3-4,1,24,21,52,21,3,21,14,14,7,14,0,0,2,3,-4,3,31,0.733288455585524,10.24633702057315,,
2656,2020,11,NCAAF_20201114_COLO@STNFRD,Stanford,Cardinal,Colorado,Buffaloes,0-2,2-0,1,9,14,32,35,3,6,7,16,7,7,14,7,-2,-5,-4,-5,-3,0.7067433557062185,8.948354412720391,,
2657,2020,11,NCAAF_20201114_LVILLE@UVA,Virginia,Cavaliers,Louisville,Cardinals,3-4,2-6,1,14,10,31,17,7,7,7,10,3,7,7,0,1,4,4,4,14,0.5987352985098097,4.114317039943671,,
2658,2020,11,NCAAF_20201114_ND@BC,Boston College,Eagles,Notre Dame,Fighting Irish,5-4,8-0,0,16,31,31,45,10,6,7,8,10,21,7,7,-3,-15,0,-15,-14,0.1662669719771721,-15.942685418477822,,
2659,2020,11,NCAAF_20201114_SFLA@HOU,Houston,Cougars,South Florida,Bulls,3-3,1-7,1,28,0,56,21,14,14,14,14,0,0,7,14,2,28,14,28,35,0.6516294045483425,6.41185851972466,,
2660,2020,11,NCAAF_20201114_TXSTSM@GAS,Ga. Southern,Eagles,Texas St.,Bobcats,6-2,1-9,0,27,21,40,38,17,10,3,10,7,14,7,10,5,6,10,6,2,0.7726782987520191,12.301350477607457,0.5678277615999283,5.3221560394907215
2661,2020,11,NCAAF_20201114_USC@ARIZ,Arizona,Wildcats,USC,Trojans,0-1,2-0,1,13,17,30,34,7,6,7,10,10,7,3,14,-2,-4,-3,-4,-4,0.26631580678867384,-10.266157401447686,,
2662,2020,11,NCAAF_20201114_USM@WKY,W. Kentucky,Hilltoppers,So. Miss,Golden Eagles,3-6,2-6,0,10,0,10,7,7,3,0,0,0,0,0,7,1,10,7,10,3,0.4529423605880307,-1.9451743227966745,0.5933209550244469,7.354791970402857
2663,2020,11,NCAAF_20201114_BAYLOR@TXTECH,Texas Tech,Red Raiders,Baylor,Bears,3-5,1-5,0,6,13,24,23,3,3,6,12,7,6,10,0,2,-7,-4,-7,1,0.5366018357603145,1.5115797138934113,,
2664,2020,11,NCAAF_20201114_HAWAII@SDGST,San Diego St.,Aztecs,Hawaii,Rainbow Warriors,3-1,2-2,1,28,0,34,10,14,14,0,6,0,0,3,7,1,28,14,28,24,0.7833872049136174,12.89343227540985,,
2665,2020,11,NCAAF_20201114_NWEST@PURDUE,Purdue,Boilermakers,Northwestern,Wildcats,2-1,4-0,0,10,17,20,27,3,7,3,7,7,10,7,3,-2,-7,-4,-7,-7,0.5431644483461863,1.783584704474265,,
2666,2020,11,NCAAF_20201114_NEVADA@NMEX,New Mexico,Lobos,Nevada,Wolf Pack,0-3,4-0,1,13,10,20,27,7,6,0,7,0,10,10,7,-4,3,7,3,-7,0.2947794032368357,-8.875632550710293,,
2667,2020,11,NCAAF_20201114_ARK@FLA,Florida,Gators,Arkansas,Razorbacks,5-1,3-4,1,35,14,63,35,7,28,7,21,7,7,7,14,2,21,0,21,28,0.8971595697172714,20.820950944876245,,
2668,2020,11,NCAAF_20201114_OREG@WASHST,Washington St.,Cougars,Oregon,Ducks,1-1,2-0,1,19,14,29,43,13,6,0,10,7,7,7,22,-1,5,6,5,-14,0.3962586980378968,-4.32767295996166,,
2669,2020,11,NCAAF_20201114_SMU@TULSA,Tulsa,Golden Hurricane,SMU,Mustangs,4-1,7-2,0,7,24,28,24,0,7,7,14,14,10,0,0,-3,-17,-14,-17,4,0.30619721202113004,-8.335717114529643,,
2670,2020,11,NCAAF_20201114_FSU@NCST,NC State,Wolfpack,Florida State,Seminoles,5-3,2-6,1,21,3,38,22,7,14,14,3,0,3,6,13,3,18,7,18,16,0.5780592144562293,3.2399744129181727,,
2671,2020,11,NCAAF_20201114_SC@MISS,Ole Miss,Rebels,South Carolina,Gamecocks,3-4,2-5,0,24,21,59,42,14,10,14,21,7,14,14,7,1,3,7,3,17,0.442608975299282,-2.375022928529006,,
2672,2020,11,NCAAF_20201114_TEMPLE@UCF,UCF,Knights,Temple,Owls,5-2,1-5,0,21,3,38,13,21,0,17,0,0,3,0,10,4,18,21,18,25,0.8538989470369098,17.32929735978007,,
2673,2020,11,NCAAF_20201114_WISC@MICH,Michigan,Wolverines,Wisconsin,Badgers,1-3,2-0,0,0,28,11,49,0,0,11,0,14,14,7,14,-1,-28,-14,-28,-38,0.5087593263371458,0.3612627120306797,,
2674,2020,11,NCAAF_20201114_UNLV@SJST,San Jose St.,Spartans,UNLV,Rebels,4-0,0-4,1,24,10,34,17,10,14,7,3,3,7,7,0,4,14,7,14,17,0.44670342866929047,-2.2045240558129535,,
2675,2020,11,NCAAF_20201114_OREGST@WASH,Washington,Huskies,Oregon State,Beavers,1-0,0-2,1,24,21,27,21,10,14,0,3,7,14,0,0,1,3,3,3,6,0.9569827862667964,28.243688567085655,,
2676,2020,11,NCAAF_20201113_FAU@FIU,FIU,Panthers,FAU,Owls,0-4,4-1,0,10,24,19,38,0,10,0,9,7,17,0,14,-4,-14,-7,-14,-19,0.25386536253103253,-10.89762180390801,,
2677,2020,11,NCAAF_20201113_IOWA@MINN,Minnesota,Golden Gophers,Iowa,Hawkeyes,1-3,2-2,0,0,14,7,35,0,0,0,7,7,7,0,21,-1,-14,-7,-14,-28,0.27007993994531587,-10.078228504452113,,
2678,2020,11,NCAAF_20201113_ECU@CINCY,Cincinnati,Bearcats,East Carolina,Pirates,7-0,1-6,0,35,10,55,17,7,28,7,13,0,10,0,7,6,25,7,25,38,0.9045368357102821,21.517085369189886,,
2679,2020,11,NCAAF_20201112_COLOST@BOISE,Boise St.,Broncos,Colorado St.,Rams,3-1,1-2,0,42,7,52,21,21,21,10,0,0,7,14,0,2,35,21,35,31,0.8270247574209888,15.505884845765763,,
2680,2020,11,NCAAF_20201111_EMICH@BALLST,Ball St.,Cardinals,E. Michigan,Eagles,1-1,0-2,1,13,21,38,31,7,6,8,17,14,7,3,7,1,-8,-7,-8,7,0.25006917103923176,-11.09335176177467,,
2681,2020,11,NCAAF_20201111_CMICH@NILL,N. Illinois,Huskies,C. Michigan,Chippewas,0-2,2-0,1,0,9,10,40,0,0,0,10,7,2,17,14,-2,-9,-7,-9,-30,0.5939772967176655,3.91217086506947,,
2682,2020,11,NCAAF_20201111_TOLEDO@WMICH,W. Michigan,Broncos,Toledo,Rockets,2-0,1-1,1,14,24,41,38,14,0,7,20,14,10,7,7,1,-10,0,-10,3,0.481979891702219,-0.7434002307526271,,
2683,2020,11,NCAAF_20201110_AKRON@OHIO,Ohio,Bobcats,Akron,Zips,1-1,0-2,1,14,7,24,10,7,7,3,7,0,7,3,0,1,7,7,7,14,0.9023275748512576,21.304602316461,,
2684,2020,11,NCAAF_20201110_KENTST@BGREEN,Bowling Green,Falcons,Kent St.,Golden Flashes,0-2,2-0,0,10,38,24,62,10,0,0,14,10,28,7,17,-2,-28,0,-28,-38,0.3717391961929368,-5.38403630699554,,
2685,2020,11,NCAAF_20201110_MIAOH@BUFF,Buffalo,Bulls,Miami-OH,RedHawks,2-0,1-1,0,14,7,42,10,0,14,21,7,0,7,0,3,1,7,0,7,32,0.6458325665073714,6.15470986367427,,
2686,2020,12,NCAAF_20201121_APLST@CSTCAR,C. Carolina,Chanticleers,App. St.,Mountaineers,8-0,6-2,0,9,17,34,23,6,3,12,13,7,10,3,3,2,-8,-1,-8,11,0.14491897351321847,-17.43242293787523,,
2687,2020,12,NCAAF_20201121_ARKST@TXSTSM,Texas St.,Bobcats,Arkansas St.,Red Wolves,2-9,3-6,1,27,24,47,45,10,17,0,20,3,21,7,14,-1,3,7,3,2,0.18070635183244788,-15.031181676548044,0.4355480682852976,-2.7674887978789684
2688,2020,12,NCAAF_20201121_ECU@TEMPLE,Temple,Owls,East Carolina,Pirates,1-6,2-6,1,3,21,3,28,0,3,0,0,7,14,7,0,-1,-18,-7,-18,-25,0.8135846203039752,14.677205246790209,,
2689,2020,12,NCAAF_20201121_FLA@VANDY,Vanderbilt,Commodores,Florida,Gators,0-7,6-1,1,10,17,17,38,10,0,7,0,7,10,14,7,-6,-7,3,-7,-21,0.10915174230150071,-20.27461361875271,,
2690,2020,12,NCAAF_20201121_GAS@ARMY,Army,Black Knights,Ga. Southern,Eagles,7-2,6-3,0,7,21,28,27,0,7,14,7,14,7,6,0,1,-14,-14,-14,1,0.7247508077388092,9.832419192694033,,
2691,2020,12,NCAAF_20201121_ILL@NEB,Nebraska,Cornhuskers,Illinois,Fighting Illini,1-3,2-3,1,10,28,23,41,7,3,7,6,14,14,10,3,-1,-18,-7,-18,-18,0.7221010720984418,9.701999554976283,,
2692,2020,12,NCAAF_20201121_IND@OHIOST,Ohio State,Buckeyes,Indiana,Hoosiers,4-0,4-1,0,28,7,42,35,7,21,14,0,0,7,14,14,0,21,7,21,7,0.9393274953664219,25.513526416664035,,
2693,2020,12,NCAAF_20201121_LSU@ARK,Arkansas,Razorbacks,LSU,Tigers,3-5,3-3,1,14,20,24,27,7,7,7,3,3,17,0,7,0,-6,4,-6,-3,0.05431263361408778,-26.423460719092418,,
2694,2020,12,NCAAF_20201121_SFA@MEMP,Memphis,Tigers,S.F. Austin,Lumberjacks,5-2,6-4,0,20,14,56,14,14,6,15,21,0,14,0,0,-1,6,14,6,42,0.9967891529033429,44.886111211602156,,
2695,2020,12,NCAAF_20201121_FIU@WKY,W. Kentucky,Hilltoppers,FIU,Panthers,4-6,0-5,1,10,13,38,21,0,10,14,14,7,6,0,8,4,-3,-7,-3,17,0.4425883085840192,-2.378339863436395,,
2696,2020,12,NCAAF_20201121_RICE@NTEXAS,North Texas,Mean Green,Rice,Owls,3-3,1-2,0,14,10,27,17,0,14,3,10,10,0,0,7,2,4,-10,4,10,0.7731788141878231,12.341408350629422,,
2697,2020,12,NCAAF_20201121_NAL@BYU,BYU,Cougars,North Alabama,Lions,9-0,0-4,0,42,7,66,14,14,28,14,10,0,7,0,7,9,35,14,35,52,0.9575542981849304,28.376414410903863,,
2698,2020,12,NCAAF_20201121_TXSA@USM,So. Miss,Golden Eagles,UTSA,Roadrunners,2-7,6-4,1,10,9,20,23,3,7,3,7,0,9,14,0,-4,1,3,1,-3,0.6723653415191253,7.3528040687639304,0.38189613358127683,-5.125174434882524
2699,2020,12,NCAAF_20201121_CAL@OREGST,Oregon State,Beavers,California,Golden Bears,1-2,0-2,1,14,20,31,27,14,0,3,14,7,13,0,7,1,-6,7,-6,4,0.22260765615477496,-12.572960113574254,,
2700,2020,12,NCAAF_20201121_CINCY@UCF,UCF,Knights,Cincinnati,Bearcats,5-3,8-0,1,17,19,33,36,14,3,8,8,3,16,3,14,-3,-2,11,-2,-3,0.7314831568260111,10.16660435347967,,
2701,2020,12,NCAAF_20201121_GAST@SALA,South Alabama,Jaguars,Georgia St.,Panthers,3-6,4-4,0,7,7,14,31,7,0,7,0,0,7,14,10,-1,0,7,0,-17,0.3906296346291356,-4.5731800224717745,,
2702,2020,12,NCAAF_20201121_IOWA@PSU,Penn State,Nittany Lions,Iowa,Hawkeyes,0-5,3-2,1,7,24,21,41,7,0,14,0,3,21,7,10,-3,-17,4,-17,-20,0.6147711552784699,4.805363239987287,,
2703,2020,12,NCAAF_20201121_MTSU@TROY,Troy,Trojans,Middle Tenn.,Blue Raiders,4-4,3-6,1,10,17,17,20,3,7,0,7,7,10,0,3,1,-7,-4,-7,-3,0.58737360613337,3.6363329487805913,,
2704,2020,12,NCAAF_20201121_SDGST@NEVADA,Nevada,Wolf Pack,San Diego St.,Aztecs,5-0,3-2,1,16,21,26,21,6,10,10,0,7,14,0,0,2,-5,-1,-5,5,0.25605077443921054,-10.796788339856334,,
2705,2020,12,NCAAF_20201121_UCLA@OREG,Oregon,Ducks,UCLA,Bruins,3-0,1-2,0,24,21,38,35,14,10,14,0,7,14,7,7,2,3,7,3,3,0.8095966517382562,14.433910947225058,,
2706,2020,12,NCAAF_20201121_WISC@NWEST,Northwestern,Wildcats,Wisconsin,Badgers,5-0,2-1,0,14,7,17,7,7,7,0,3,7,0,0,0,3,7,0,7,10,0.17215990756198674,-15.57446963664313,,
2707,2020,12,NCAAF_20201121_ABIL@UVA,Virginia,Cavaliers,Abil Christian,Wildcats,4-4,1-5,1,28,7,55,15,14,14,14,13,0,7,0,8,3,21,14,21,40,0.9890893027291958,37.77181793261502,,
2708,2020,12,NCAAF_20201121_KSTATE@IOWAST,Iowa St.,Cyclones,Kansas State,Wildcats,6-2,4-4,1,35,0,45,0,7,28,3,7,0,0,0,0,2,35,7,35,45,0.6173576856010092,4.916896028893348,,
2709,2020,12,NCAAF_20201121_UK@BAMA,Alabama,Crimson Tide,Kentucky,Wildcats,7-0,3-5,0,28,3,63,3,7,21,21,14,3,0,0,0,4,25,4,25,60,0.9387873762747851,25.43975713002078,,
2710,2020,12,NCAAF_20201121_VATECH@PITT,Pittsburgh,Panthers,Virginia Tech,Hokies,5-4,4-5,1,23,14,47,14,6,17,17,7,0,14,0,0,1,9,6,9,33,0.4143949443001883,-3.561558475599327,,
2711,2020,12,NCAAF_20201121_TENN@AUBURN,Auburn,Tigers,Tennessee,Volunteers,5-2,2-5,0,10,10,30,17,0,10,10,10,7,3,0,7,3,0,-7,0,13,0.8850973866986379,19.777386391817345,,
2712,2020,12,NCAAF_20201121_LIB@NCST,NC State,Wolfpack,Liberty,Flames,6-3,8-1,1,7,7,15,14,0,7,2,6,0,7,7,0,-2,0,0,0,1,0.792731359977734,13.437913652935435,,
2713,2020,12,NCAAF_20201121_MISSST@UGA,Georgia,Bulldogs,Miss. State,Bulldogs,5-2,2-5,1,17,17,31,24,0,17,7,7,3,14,7,0,3,0,-3,0,7,0.8009651369602074,13.917806904265603,,
2714,2020,12,NCAAF_20201121_MIZZOU@SC,South Carolina,Gamecocks,Missouri,Tigers,2-6,3-3,1,0,17,10,17,0,0,3,7,7,10,0,0,-1,-17,-7,-17,-7,0.39008007137155987,-4.596763810550442,,
2715,2020,12,NCAAF_20201121_OKLAST@OKLA,Oklahoma,Sooners,Oklahoma State,Cowboys,6-2,5-2,1,27,13,41,13,21,6,0,14,7,6,0,0,1,14,14,14,28,0.7419481845497846,10.69458507897707,,
2716,2020,12,NCAAF_20201121_ARIZ@WASH,Washington,Huskies,Arizona,Wildcats,2-0,0-2,1,24,0,44,27,17,7,13,7,0,0,0,27,2,24,17,24,17,0.8477292653591423,16.909782718500423,,
2717,2020,12,NCAAF_20201121_USC@UTAH,Utah,Utes,USC,Trojans,0-1,3-0,1,17,24,17,33,3,14,0,0,3,21,6,3,-3,-7,0,-7,-16,0.6349212835773549,5.680541571197978,,
2718,2020,12,NCAAF_20201121_BOISE@HAWAII,Hawaii,Rainbow Warriors,Boise St.,Broncos,2-3,4-1,0,3,19,32,40,3,0,14,15,3,16,21,0,-2,-16,0,-16,-8,0.10072538422994481,-21.038418264411348,,
2719,2020,12,NCAAF_20201120_CUSE@LVILLE,Louisville,Cardinals,Syracuse,Orange,3-6,1-8,0,20,0,30,0,3,17,7,3,0,0,0,0,2,20,3,20,30,0.47565099253156273,-1.0058132502163062,,
2720,2020,12,NCAAF_20201120_PURDUE@MINN,Minnesota,Golden Gophers,Purdue,Boilermakers,2-3,2-2,1,21,10,34,31,14,7,7,6,7,3,14,7,0,11,7,11,3,0.4890711515321754,-0.45122683777481143,,
2721,2020,12,NCAAF_20201120_UMASS@FAU,FAU,Owls,UMass,Minutemen,5-1,0-3,0,7,0,24,2,7,0,14,3,0,0,2,0,5,7,7,7,22,0.9533834477744586,27.6451778571942,,
2722,2020,12,NCAAF_20201120_NMEX@AF,Air Force,Falcons,New Mexico,Lobos,2-2,0-4,0,21,0,28,0,7,14,0,7,0,0,0,0,2,21,7,21,28,0.8507012271182235,17.118985261646685,,
2723,2020,12,NCAAF_20201118_NILL@BALLST,Ball St.,Cardinals,N. Illinois,Huskies,2-1,0-3,0,14,14,31,25,0,14,6,11,7,7,0,11,2,0,-7,0,6,0.23319060797720015,-11.995933715516458,,
2724,2020,12,NCAAF_20201118_TOLEDO@EMICH,E. Michigan,Eagles,Toledo,Rockets,0-3,2-1,0,7,24,28,45,0,7,6,15,7,17,14,7,-2,-17,-7,-17,-17,0.4208235424741995,-3.2903622320676504,,
2725,2020,12,NCAAF_20201118_WMICH@CMICH,C. Michigan,Chippewas,W. Michigan,Broncos,2-1,3-0,1,14,31,44,52,14,0,16,14,14,17,14,7,-1,-17,0,-17,-8,0.425601175258701,-3.0893938894112125,,
2726,2020,12,NCAAF_20201117_BUFF@BGREEN,Bowling Green,Falcons,Buffalo,Bulls,0-3,3-0,0,3,21,17,42,3,0,0,14,7,14,14,7,-3,-18,-4,-18,-25,0.06833061019696796,-24.51198265519315,,
2727,2020,12,NCAAF_20201117_AKRON@KENTST,Kent St.,Golden Flashes,Akron,Zips,3-0,0-3,0,35,28,69,35,14,21,20,14,7,21,0,7,3,7,7,7,34,0.5652654880030142,2.70645600133696,,
2728,2020,13,NCAAF_20201128_BALLST@TOLEDO,Toledo,Rockets,Ball St.,Cardinals,2-2,3-1,0,3,17,24,27,0,3,6,15,14,3,7,3,-1,-14,-14,-14,-3,0.7892696549471951,13.273120296732259,,
2729,2020,13,NCAAF_20201128_BGREEN@OHIO,Ohio,Bobcats,Bowling Green,Falcons,2-1,0-4,1,45,10,52,10,21,24,7,0,3,7,0,0,2,35,18,35,42,0.9383410548092765,25.44356350359908,,
2730,2020,13,NCAAF_20201128_GAS@GAST,Georgia St.,Panthers,Ga. Southern,Eagles,5-4,6-4,1,13,14,30,24,3,10,0,17,0,14,3,7,-1,-1,3,-1,6,0.3665564694166622,-5.63008725133875,,
2731,2020,13,NCAAF_20201128_KENTST@BUFF,Buffalo,Bulls,Kent St.,Golden Flashes,4-0,3-1,1,35,24,70,41,21,14,14,21,10,14,7,10,1,11,11,11,29,0.8414519560623607,16.51843883236029,,
2732,2020,13,NCAAF_20201128_MD@IND,Indiana,Hoosiers,Maryland,Terrapins,5-1,2-2,0,7,3,27,11,7,0,10,10,0,3,0,8,3,4,7,4,16,0.7164092400010968,9.447784874776175,,
2733,2020,13,NCAAF_20201128_NCST@CUSE,Syracuse,Orange,NC State,Wolfpack,1-9,7-3,1,22,14,29,36,7,15,7,0,7,7,13,9,-6,8,0,8,-7,0.39177876342525264,-4.535373119358269,,
2734,2020,13,NCAAF_20201128_NILL@WMICH,W. Michigan,Broncos,N. Illinois,Huskies,4-0,0-4,0,20,17,30,27,7,13,0,10,3,14,7,3,4,3,4,3,3,0.5348381816739398,1.4436938180614334,,
2735,2020,13,NCAAF_20201128_PSU@MICH,Michigan,Wolverines,Penn State,Nittany Lions,2-4,1-5,0,7,17,17,27,7,0,3,7,7,10,3,7,1,-10,0,-10,-10,0.44575193480188835,-2.2521421394068284,,
2736,2020,13,NCAAF_20201128_SMU@ECU,East Carolina,Pirates,SMU,Mustangs,3-6,7-3,0,45,7,52,38,21,24,0,7,7,0,17,14,-4,38,14,38,14,0.14132729894227225,-17.739137948765688,,
2737,2020,13,NCAAF_20201128_TXTECH@OKLAST,Oklahoma State,Cowboys,Texas Tech,Red Raiders,6-2,3-6,0,21,17,50,44,7,14,20,9,7,10,14,13,3,4,0,4,6,0.6698464854339534,7.25646138397417,,
2738,2020,13,NCAAF_20201128_UK@FLA,Florida,Gators,Kentucky,Wildcats,7-1,3-6,0,14,10,34,10,7,7,17,3,0,10,0,0,4,4,7,4,24,0.6958606690491602,8.462479807028785,,
2739,2020,13,NCAAF_20201128_VANDY@MIZZOU,Missouri,Tigers,Vanderbilt,Commodores,4-3,0-8,0,21,0,41,0,7,14,6,14,0,0,0,0,4,21,7,21,41,0.8203702503909382,15.137016806458064,,
2740,2020,13,NCAAF_20201128_MIAOH@AKRON,Akron,Zips,Miami-OH,RedHawks,0-4,2-1,1,0,24,7,38,0,0,0,7,7,17,7,7,-2,-24,-7,-24,-31,0.2048968180900531,-13.609404947798453,,
2741,2020,13,NCAAF_20201128_CSTCAR@TXSTSM,Texas St.,Bobcats,C. Carolina,Chanticleers,2-10,9-0,1,7,35,14,49,7,0,0,7,14,21,7,7,-7,-28,-7,-28,-35,0.29900445164645406,-8.705752538677302,,
2742,2020,13,NCAAF_20201128_LALAF@LAMON,UL-Monroe,Warhawks,Louisiana,Ragin' Cajuns,0-9,8-1,0,14,49,20,70,14,0,0,6,21,28,7,14,-8,-35,-7,-35,-50,0.20916186275330007,-13.36299283992355,,
2743,2020,13,NCAAF_20201128_NTEXAS@TXSA,UTSA,Roadrunners,North Texas,Mean Green,7-4,3-4,1,28,7,49,17,7,21,7,14,0,7,3,7,4,21,7,21,32,0.32072770615145396,-7.688649062851823,,
2744,2020,13,NCAAF_20201128_SALA@ARKST,Arkansas St.,Red Wolves,South Alabama,Jaguars,3-7,4-6,0,17,14,31,38,7,10,7,7,7,7,14,10,-1,3,0,3,-7,0.7925491646104709,13.461486821292965,0.5131900200427371,1.755440614034626
2745,2020,13,NCAAF_20201128_AUBURN@BAMA,Alabama,Crimson Tide,Auburn,Tigers,8-0,5-3,0,21,3,42,13,7,14,14,7,0,3,3,7,3,18,7,18,29,0.7966193823146074,13.697735726359838,,
2746,2020,13,NCAAF_20201128_NWEST@MICHST,Michigan St.,Spartans,Northwestern,Wildcats,2-3,5-1,1,17,6,29,20,10,7,0,12,0,6,7,7,-3,11,10,11,9,0.4765238618515846,-0.9721741032889213,,
2747,2020,13,NCAAF_20201128_PITT@CLEM,Clemson,Tigers,Pittsburgh,Panthers,8-1,5-5,0,38,10,52,17,31,7,7,7,0,10,7,0,3,28,31,28,35,0.9492284159574186,27.035607088825827,,
2748,2020,13,NCAAF_20201128_TROY@APLST,App. St.,Mountaineers,Troy,Trojans,7-2,4-5,0,34,10,47,10,21,13,13,0,0,10,0,0,3,24,21,24,37,0.7024604179761103,8.775498538521106,,
2749,2020,13,NCAAF_20201128_LVILLE@BC,Boston College,Eagles,Louisville,Cardinals,6-4,3-7,0,13,10,34,27,7,6,7,14,3,7,3,14,3,3,4,3,7,0.6073660106251239,4.498628033789146,,
2750,2020,13,NCAAF_20201128_MISSST@MISS,Ole Miss,Rebels,Miss. State,Bulldogs,4-4,2-6,0,21,14,31,24,14,7,0,10,0,14,0,10,2,7,14,7,7,0.32335377582078706,-7.567722176709367,,
2751,2020,13,NCAAF_20201128_RUT@PURDUE,Purdue,Boilermakers,Rutgers,Scarlet Knights,2-3,2-4,1,23,13,30,37,7,16,7,0,13,0,21,3,0,10,-6,10,-7,0.8810893366144442,19.490551814858918,,
2752,2020,13,NCAAF_20201128_SDGST@COLO,Colorado,Buffaloes,San Diego St.,Aztecs,3-0,3-3,0,14,10,20,10,7,7,3,3,0,10,0,0,0,4,7,4,10,0.469438122876379,-1.2661116095227953,,
2753,2020,13,NCAAF_20201128_DUKE@GATECH,Georgia Tech,Yellow Jackets,Duke,Blue Devils,3-5,2-7,1,28,26,56,33,14,14,14,14,7,19,7,0,1,2,7,2,23,0.47159818018100397,-1.1764677854698675,,
2754,2020,13,NCAAF_20201128_KSTATE@BAYLOR,Baylor,Bears,Kansas State,Wildcats,2-5,4-5,0,6,17,32,31,6,0,9,17,14,3,0,14,-2,-11,-8,-11,1,0.4118032988890028,-3.6804719645049317,,
2755,2020,13,NCAAF_20201128_LSU@TXAM,Texas A&M,Aggies,LSU,Tigers,6-1,3-4,1,13,0,20,7,10,3,7,0,0,0,0,7,3,13,10,13,13,0.3001478958683469,-8.651418195131441,,
2756,2020,13,NCAAF_20201128_MEMP@NAVY,Navy,Midshipmen,Memphis,Tigers,3-5,6-2,1,7,7,7,10,7,0,0,0,7,0,0,3,-3,0,0,0,-3,0.3148913708093366,-7.958899965106184,,
2757,2020,13,NCAAF_20201128_UGA@SC,South Carolina,Gamecocks,Georgia,Bulldogs,2-7,6-2,1,10,28,16,45,0,10,0,6,21,7,10,7,-4,-18,-21,-18,-29,0.11409709424646652,-19.896291346324915,,
2758,2020,13,NCAAF_20201128_UTAH@WASH,Washington,Huskies,Utah,Utes,3-0,0-2,0,0,21,24,21,0,0,17,7,7,14,0,0,3,-21,-7,-21,3,0.5465984289612924,1.9329870268364857,,
2759,2020,13,NCAAF_20201128_ARIZ@UCLA,UCLA,Bruins,Arizona,Wildcats,2-2,0-3,0,20,7,27,10,3,17,0,7,7,0,3,0,2,13,-4,13,17,0.5241972794279928,1.0020735446340723,,
2760,2020,13,NCAAF_20201128_TCU@KANSAS,Kansas,Jayhawks,TCU,Horned Frogs,0-8,4-4,0,12,38,23,59,6,6,8,3,24,14,7,14,-4,-26,-18,-26,-36,0.08301030792575093,-22.86962347956012,,
2761,2020,13,NCAAF_20201128_NEVADA@HAWAII,Hawaii,Rainbow Warriors,Nevada,Wolf Pack,3-3,5-1,0,10,7,24,21,0,10,7,7,0,7,0,14,-2,3,0,3,3,0.43262150135955224,-2.802001819252382,,
2762,2020,13,NCAAF_20201127_IOWAST@TEXAS,Texas,Longhorns,Iowa St.,Cyclones,5-3,7-2,1,13,10,20,23,13,0,7,0,7,3,3,10,-2,3,6,3,-3,0.47793370031504145,-0.9137295112924448,,
2763,2020,13,NCAAF_20201127_UMASS@LIB,Liberty,Flames,UMass,Minutemen,9-1,0-4,0,31,0,45,0,14,17,14,0,0,0,0,0,9,31,14,31,45,0.8611018459789166,17.919240538584063,,
2764,2020,13,NCAAF_20201127_NEB@IOWA,Iowa,Hawkeyes,Nebraska,Cornhuskers,4-2,1-4,1,13,13,26,20,10,3,7,6,0,13,7,0,3,0,10,0,6,0.8469674724503089,16.89935816093555,,
2765,2020,13,NCAAF_20201127_ND@UNC,North Carolina,Tar Heels,Notre Dame,Fighting Irish,6-3,9-0,0,17,17,17,31,14,3,0,0,14,3,7,7,-3,0,0,0,-14,0.13685828353176344,-18.072145107005326,,
2766,2020,13,NCAAF_20201127_UCF@SFLA,South Florida,Bulls,UCF,Knights,1-8,6-3,1,14,31,46,58,7,7,14,18,14,17,14,13,-5,-17,-7,-17,-12,0.09194649242096964,-21.941028019290457,,
2767,2020,13,NCAAF_20201127_CMICH@EMICH,E. Michigan,Eagles,C. Michigan,Chippewas,0-4,3-1,0,17,6,23,31,7,10,3,3,6,0,0,25,-3,11,1,11,-8,0.5060221207312634,0.2492484482539794,,
2768,2020,13,NCAAF_20201127_WYO@UNLV,UNLV,Rebels,Wyoming,Cowboys,0-5,2-2,0,7,17,14,45,0,7,0,7,10,7,21,7,-2,-10,-10,-10,-31,0.21726433736738682,-12.902874319586715,,
2769,2020,13,NCAAF_20201127_STNFRD@CAL,California,Golden Bears,Stanford,Cardinal,0-3,1-2,1,10,10,23,24,7,3,7,6,0,10,14,0,-1,0,7,0,-1,0.3609785166491688,-5.875391553895497,,
2770,2020,13,NCAAF_20201127_OREG@OREGST,Oregon State,Beavers,Oregon,Ducks,2-2,3-1,0,13,24,41,38,7,6,6,22,14,10,7,7,-1,-11,-7,-11,3,0.06748682621286406,-24.68038150662892,,
2771,2020,13,NCAAF_20201126_NMEX@UTAHST,Utah St.,Aggies,New Mexico,Lobos,1-4,0-5,0,6,13,41,27,3,3,28,7,3,10,7,7,1,-7,0,-7,14,0.8730339494966113,18.83672296317775,,
2772,2020,14,NCAAF_20201206_WKY@CHARLO,Charlotte,49ers,W. Kentucky,Hilltoppers,2-4,5-6,1,0,17,19,37,0,0,7,12,3,14,10,10,-3,-17,-3,-17,-18,0.36078503846394017,-5.886600284889937,,
2773,2020,14,NCAAF_20201206_WASHST@USC,USC,Trojans,Washington St.,Cougars,4-0,1-2,0,35,6,38,13,28,7,3,0,0,6,0,7,3,29,28,29,25,0.5001500375224543,0.00621246498428718,,
2774,2020,14,NCAAF_20201205_ARK@MIZZOU,Missouri,Tigers,Arkansas,Razorbacks,5-3,3-6,1,20,27,50,48,10,10,3,27,6,21,6,15,2,-7,4,-7,2,0.8288776793070523,15.688398755877301,,
2775,2020,14,NCAAF_20201205_KANSAS@TXTECH,Texas Tech,Red Raiders,Kansas,Jayhawks,4-6,0-9,0,10,3,16,13,10,0,3,3,0,3,3,7,4,7,10,7,3,0.8554507923755171,17.511428838174538,,
2776,2020,14,NCAAF_20201205_MEMP@TULANE,Tulane,Green Wave,Memphis,Tigers,6-5,6-3,1,21,14,35,21,14,7,7,7,7,7,7,0,0,7,7,7,14,0.3462258375824504,-6.533617706331825,,
2777,2020,14,NCAAF_20201205_NEB@PURDUE,Purdue,Boilermakers,Nebraska,Cornhuskers,2-4,2-4,1,13,27,27,37,3,10,7,7,17,10,7,3,0,-14,-14,-14,-10,0.6167437312849805,4.905038352418842,,
2778,2020,14,NCAAF_20201205_OHIOST@MICHST,Michigan St.,Spartans,Ohio State,Buckeyes,2-4,5-0,1,0,28,12,52,0,0,7,5,14,14,10,14,-3,-28,-14,-28,-40,0.06574961595276063,-24.913669191935014,,
2779,2020,14,NCAAF_20201205_OKLAST@TCU,TCU,Horned Frogs,Oklahoma State,Cowboys,5-4,6-3,0,7,16,29,22,0,7,14,8,13,3,6,0,-1,-9,-13,-9,7,0.46497797868518675,-1.4519920515505191,,
2780,2020,14,NCAAF_20201205_PSU@RUT,Rutgers,Scarlet Knights,Penn State,Nittany Lions,2-5,2-5,0,0,17,7,23,0,0,7,0,7,10,3,3,0,-17,-7,-17,-16,0.020655015745570493,-33.70469848394089,,
2781,2020,14,NCAAF_20201205_RICE@MRSHL,Marshall,Thundering Herd,Rice,Owls,7-1,2-2,1,0,10,0,20,0,0,0,0,7,3,10,0,5,-10,-7,-10,-20,0.893560087038787,20.57702498998674,,
2782,2020,14,NCAAF_20201205_TEXAS@KSTATE,Kansas State,Wildcats,Texas,Longhorns,4-6,6-3,1,17,31,31,69,7,10,14,0,17,14,35,3,-2,-14,-10,-14,-38,0.36064978316815144,-5.892568198823028,,
2783,2020,14,NCAAF_20201205_TOLEDO@NILL,N. Illinois,Huskies,Toledo,Rockets,0-5,3-2,1,24,24,24,41,7,17,0,0,7,17,0,17,-3,0,0,0,-17,0.45584260446094205,-1.8321338921120969,,
2784,2020,14,NCAAF_20201205_TXAM@AUBURN,Auburn,Tigers,Texas A&M,Aggies,5-4,7-1,1,10,14,20,31,0,10,10,0,7,7,0,17,-2,-4,-7,-4,-11,0.6780530671527337,7.6359270420904295,,
2785,2020,14,NCAAF_20201205_WCAR@UNC,North Carolina,Tar Heels,W. Carolina,Catamounts,7-3,0-3,0,42,3,49,9,21,21,7,0,3,0,0,6,7,39,18,39,40,0.9924119970656691,40.109744060468984,,
2786,2020,14,NCAAF_20201205_BALLST@CMICH,C. Michigan,Chippewas,Ball St.,Cardinals,3-2,4-1,1,7,24,20,45,0,7,7,6,10,14,14,7,-1,-17,-10,-17,-25,0.7022536266568625,8.76963139400425,,
2787,2020,14,NCAAF_20201205_BGREEN@AKRON,Akron,Zips,Bowling Green,Falcons,1-4,0-5,1,17,3,31,3,3,14,7,7,3,0,0,0,1,14,0,14,28,0.5871424006475918,3.637407360392899,,
2788,2020,14,NCAAF_20201205_EMICH@WMICH,W. Michigan,Broncos,E. Michigan,Eagles,4-1,1-4,0,21,30,42,53,7,14,7,14,9,21,13,10,3,-9,-2,-9,-11,0.5827167037545727,3.4498901145741456,,
2789,2020,14,NCAAF_20201205_TROY@SALA,South Alabama,Jaguars,Troy,Trojans,4-7,5-5,0,0,27,0,29,0,0,0,0,3,24,0,2,-1,-27,-3,-27,-29,0.1948487020080405,-14.208771347894753,,
2790,2020,14,NCAAF_20201205_CUSE@ND,Notre Dame,Fighting Irish,Syracuse,Orange,10-0,1-10,1,24,7,45,21,3,21,14,7,0,7,7,7,9,17,3,17,24,0.8950439313316649,20.711179909843963,,
2791,2020,14,NCAAF_20201205_LAMON@ARKST,Arkansas St.,Red Wolves,UL-Monroe,Warhawks,4-7,0-10,0,28,7,48,15,14,14,7,13,7,0,8,0,4,21,7,21,33,0.7630523282733003,11.829910278037573,,
2792,2020,14,NCAAF_20201205_BC@UVA,Virginia,Cavaliers,Boston College,Eagles,5-4,6-5,0,20,17,43,32,6,14,10,13,7,10,0,15,-1,3,-1,3,11,0.4913397680752406,-0.3586143763668588,,
2793,2020,14,NCAAF_20201205_FLA@TENN,Tennessee,Volunteers,Florida,Gators,2-6,8-1,1,7,17,19,31,0,7,0,12,3,14,7,7,-6,-10,-3,-10,-12,0.18198294657548608,-14.996178609298227,,
2794,2020,14,NCAAF_20201205_IND@WISC,Wisconsin,Badgers,Indiana,Hoosiers,2-2,6-1,1,3,7,6,14,0,3,3,0,0,7,7,0,-4,-4,0,-4,-8,0.8093936303965075,14.464772411739887,,
2795,2020,14,NCAAF_20201205_IOWA@ILL,Illinois,Fighting Illini,Iowa,Hawkeyes,2-4,5-2,0,14,13,21,35,7,7,0,7,0,13,8,14,-3,1,7,1,-14,0.06608766378261433,-24.870105270632166,,
2796,2020,14,NCAAF_20201205_TULSA@NAVY,Navy,Midshipmen,Tulsa,Golden Hurricane,3-6,6-1,0,3,6,6,19,0,3,3,0,0,6,7,6,-3,-3,0,-3,-13,0.6190396704255221,5.004478490882775,,
2797,2020,14,NCAAF_20201205_WVU@IOWAST,Iowa St.,Cyclones,West Virginia,Mountaineers,8-2,5-4,0,21,0,42,6,7,14,14,7,0,0,0,6,3,21,7,21,36,0.632036708371068,5.570950117095549,,
2798,2020,14,NCAAF_20201205_GATECH@NCST,NC State,Wolfpack,Georgia Tech,Yellow Jackets,8-3,3-6,1,20,7,23,13,3,17,0,3,0,7,3,3,5,13,3,13,10,0.59261755438683,3.8700434130637404,,
2799,2020,14,NCAAF_20201205_STNFRD@WASH,Washington,Huskies,Stanford,Cardinal,3-1,2-2,0,3,24,26,31,0,3,13,10,14,10,7,0,1,-21,-14,-21,-5,0.7126237746860654,9.268046081932766,,
2800,2020,14,NCAAF_20201205_BYU@CSTCAR,C. Carolina,Chanticleers,BYU,Cougars,10-0,9-1,1,13,14,22,17,6,7,3,6,0,14,3,0,1,-1,6,-1,5,0.16257482468248086,-16.25318884576984,,
2801,2020,14,NCAAF_20201205_FAU@GAS,Ga. Southern,Eagles,FAU,Owls,7-4,5-2,1,10,0,20,3,0,10,0,10,0,0,3,0,2,10,0,10,17,0.23368395397082597,-12.005219332368142,,
2802,2020,14,NCAAF_20201205_SJST@HAWAII,Hawaii,Rainbow Warriors,San Jose St.,Spartans,3-4,5-0,0,10,21,24,35,0,10,7,7,21,0,7,7,-2,-11,-21,-11,-11,0.6274622820983605,5.370861624702343,,
2803,2020,14,NCAAF_20201205_COLO@ARIZ,Arizona,Wildcats,Colorado,Buffaloes,0-4,4-0,1,13,14,13,24,10,3,0,0,0,14,7,3,-4,-1,10,-1,-11,0.494820027539146,-0.21448835279761624,,
2804,2020,14,NCAAF_20201205_COLOST@SDGST,San Diego St.,Aztecs,Colorado St.,Rams,4-3,1-3,0,23,17,29,17,7,16,0,6,0,17,0,0,3,6,7,6,12,0.6850014556191417,7.957537105498318,,
2805,2020,14,NCAAF_20201205_OREG@CAL,California,Golden Bears,Oregon,Ducks,1-3,3-2,0,14,17,21,17,7,7,7,0,3,14,0,0,-2,-3,4,-3,4,0.23217443373951618,-12.086760894646886,,
2806,2020,14,NCAAF_20201205_CLEM@VATECH,Virginia Tech,Hokies,Clemson,Tigers,4-6,9-1,1,10,17,10,45,7,3,0,0,10,7,14,14,-5,-7,-3,-7,-35,0.06384630809238212,-25.16224374398132,,
2807,2020,14,NCAAF_20201205_SC@UK,Kentucky,Wildcats,South Carolina,Gamecocks,4-6,2-8,0,27,3,41,18,10,17,7,7,3,0,7,8,2,24,7,24,23,0.5281500593246606,1.166552375658057,,
2808,2020,14,NCAAF_20201205_BAMA@LSU,LSU,Tigers,Alabama,Crimson Tide,3-5,9-0,0,14,45,17,55,0,14,3,0,21,24,7,3,-6,-31,-21,-31,-38,0.19149657392795538,-14.410766850288724,,
2809,2020,14,NCAAF_20201205_BAYLOR@OKLA,Oklahoma,Sooners,Baylor,Bears,7-2,2-6,1,10,0,27,14,3,7,7,10,0,0,7,7,5,10,3,10,13,0.8876692280895444,20.057349915962845,,
2810,2020,14,NCAAF_20201205_MIAMI@DUKE,Duke,Blue Devils,Miami (Fla.),Hurricanes,2-8,8-1,0,0,21,0,48,0,0,0,0,14,7,21,6,-6,-21,-14,-21,-48,0.26907656820508685,-10.169006457988758,,
2811,2020,14,NCAAF_20201205_FRESNO@NEVADA,Nevada,Wolf Pack,Fresno St.,Bulldogs,6-1,3-2,1,24,20,37,26,17,7,0,13,7,13,0,6,3,4,10,4,11,0.22223675704882995,-12.631152850552894,,
2812,2020,14,NCAAF_20201205_OREGST@UTAH,Utah,Utes,Oregon State,Beavers,1-2,2-3,1,16,10,30,24,6,10,7,7,0,10,0,14,-1,6,6,6,6,0.9275088296026077,24.075673446676774,,
2813,2020,14,NCAAF_20201205_UCLA@ARIZST,Arizona St.,Sun Devils,UCLA,Bruins,0-2,3-2,1,3,17,18,25,0,3,9,6,0,17,0,8,-3,-14,0,-14,-7,0.5902093373529691,3.7676278510471093,,
2814,2020,14,NCAAF_20201205_WYO@NMEX,New Mexico,Lobos,Wyoming,Cowboys,1-5,2-3,1,10,13,17,16,0,10,0,7,3,10,0,3,-1,-3,-3,-3,1,0.16627760640989364,-16.006224295016636,,
2815,2020,14,NCAAF_20201204_LALAF@APLST,App. St.,Mountaineers,Louisiana,Ragin' Cajuns,7-3,9-1,0,10,9,21,24,7,3,0,11,0,9,15,0,-2,1,7,1,-3,0.6978415157468786,8.559997855883239,,
2816,2020,14,NCAAF_20201203_LATECH@NTEXAS,North Texas,Mean Green,Louisiana Tech,Bulldogs,3-5,5-3,1,17,28,31,42,14,3,7,7,7,21,14,0,-2,-11,7,-11,-11,0.4564139869568421,-1.808331109906021,,
2817,2020,14,NCAAF_20201203_AF@UTAHST,Utah St.,Aggies,Air Force,Falcons,1-5,3-2,1,7,21,7,35,7,0,0,0,7,14,7,7,-2,-14,0,-14,-28,0.5267467257538563,1.1083078963345088,,
2818,2020,15,NCAAF_20201212_BAMA@ARK,Arkansas,Razorbacks,Alabama,Crimson Tide,3-7,10-0,1,3,38,3,52,3,0,0,0,10,28,7,7,-7,-35,-7,-35,-49,0.008649310718554681,-39.43249358578578,,
2819,2020,15,NCAAF_20201212_ILL@NWEST,Northwestern,Wildcats,Illinois,Fighting Illini,6-1,2-5,0,14,3,28,10,0,14,14,0,3,0,0,7,4,11,-3,11,18,0.7761286476882152,12.576786114581864,,
2820,2020,15,NCAAF_20201212_MICHST@PSU,Penn State,Nittany Lions,Michigan St.,Spartans,3-5,2-5,0,10,21,39,24,3,7,15,14,0,21,3,0,1,-11,3,-11,15,0.8377787506507068,16.323829111983514,,
2821,2020,15,NCAAF_20201212_MINN@NEB,Nebraska,Cornhuskers,Minnesota,Golden Gophers,2-5,3-3,1,14,17,17,24,0,14,0,3,10,7,0,7,-1,-3,-10,-3,-7,0.385129919592086,-4.837909945762249,,
2822,2020,15,NCAAF_20201212_NILL@EMICH,E. Michigan,Eagles,N. Illinois,Huskies,2-4,0-6,1,20,10,41,33,10,10,14,7,10,0,14,9,2,10,0,10,8,0.47414463537674334,-1.0744044507043782,,
2823,2020,15,NCAAF_20201212_UGA@MIZZOU,Missouri,Tigers,Georgia,Bulldogs,5-4,7-2,1,14,21,14,49,0,14,0,0,14,7,21,7,-2,-7,-14,-7,-35,0.18141772545286394,-15.074832993505424,,
2824,2020,15,NCAAF_20201212_UTAH@COLO,Colorado,Buffaloes,Utah,Utes,4-1,2-2,0,14,10,21,38,0,14,7,0,7,3,14,14,2,4,-7,4,-17,0.19475846783281114,-14.255108946698442,,
2825,2020,15,NCAAF_20201212_WAKE@LVILLE,Louisville,Cardinals,Wake Forest,Demon Deacons,4-7,4-4,0,21,10,45,21,0,21,7,17,7,3,3,8,0,11,-7,11,24,0.3672760055964407,-5.617210162012952,,
2826,2020,15,NCAAF_20201212_WMICH@BALLST,Ball St.,Cardinals,W. Michigan,Broncos,5-1,4-2,0,13,20,30,27,6,7,0,17,3,17,7,0,1,-7,3,-7,3,0.25913560225863885,-10.70197192790863,,
2827,2020,15,NCAAF_20201212_UAB@RICE,Rice,Owls,UAB,Blazers,2-3,5-3,0,13,7,16,21,3,10,0,3,0,7,14,0,-3,6,3,6,-5,0.2045963916058322,-13.672330935354807,,
2828,2020,15,NCAAF_20201212_AKRON@BUFF,Buffalo,Bulls,Akron,Zips,5-0,1-5,0,35,0,56,7,14,21,14,7,0,0,0,7,4,35,14,35,49,0.8966377746736814,20.91687307808479,,
2829,2020,15,NCAAF_20201212_CMICH@TOLEDO,Toledo,Rockets,C. Michigan,Chippewas,4-2,3-3,0,17,10,24,23,10,7,0,7,7,3,13,0,1,7,3,7,1,0.6129334485299194,4.754048967535596,,
2830,2020,15,NCAAF_20201212_CSTCAR@TROY,Troy,Trojans,C. Carolina,Chanticleers,5-6,11-0,0,16,21,38,42,3,13,7,15,14,7,7,14,-6,-5,-11,-5,-4,0.6426552205805697,6.056024941663281,,
2831,2020,15,NCAAF_20201212_NAVY@ARMY,Army,Black Knights,Navy,Midshipmen,8-2,3-7,1,3,0,15,0,0,3,0,12,0,0,0,0,5,3,0,3,15,0.5005401615435912,0.022430376158013132,,
2832,2020,15,NCAAF_20201212_OKLAST@BAYLOR,Baylor,Bears,Oklahoma State,Cowboys,2-7,7-3,0,0,28,3,42,0,0,0,3,14,14,7,7,-5,-28,-14,-28,-39,0.3104304983597447,-8.194145772084426,,
2833,2020,15,NCAAF_20201212_UNC@MIAMI,Miami (Fla.),Hurricanes,North Carolina,Tar Heels,8-2,8-3,1,10,34,26,62,3,7,8,8,21,13,7,21,0,-24,-18,-24,-36,0.706194299421597,8.983859701866663,,
2834,2020,15,NCAAF_20201212_WISC@IOWA,Iowa,Hawkeyes,Wisconsin,Badgers,6-2,2-3,1,6,0,28,7,3,3,15,7,0,0,7,0,4,6,3,6,21,0.44107712606224914,-2.455754460481785,,
2835,2020,15,NCAAF_20201212_HOU@MEMP,Memphis,Tigers,Houston,Cougars,7-3,3-4,0,17,6,30,27,3,14,10,3,3,3,0,21,4,11,0,11,3,0.6278319481463047,5.402512675010257,,
2836,2020,15,NCAAF_20201212_DUKE@FSU,Florida State,Seminoles,Duke,Blue Devils,3-6,2-9,1,28,21,56,35,28,0,14,14,7,14,0,14,1,7,21,7,21,0.5243941003677373,1.0136043672666801,,
2837,2020,15,NCAAF_20201212_TENN@VANDY,Vanderbilt,Commodores,Tennessee,Volunteers,0-9,3-6,1,10,28,17,42,7,3,0,7,7,21,7,7,-3,-18,0,-18,-25,0.3512545512905221,-6.327221177162869,,
2838,2020,15,NCAAF_20201212_APLST@GAS,Ga. Southern,Eagles,App. St.,Mountaineers,7-5,8-3,1,17,7,26,34,7,10,0,9,0,7,10,17,-1,10,7,10,-8,0.21148253149172325,-13.274291438976434,0.37404851298479347,-11.0324761536896
2839,2020,15,NCAAF_20201212_BOISE@WYO,Wyoming,Cowboys,Boise St.,Broncos,2-4,5-1,0,3,10,9,17,3,0,3,3,7,3,7,0,-3,-7,-4,-7,-8,0.24882382543310466,-11.235122900251383,,
2840,2020,15,NCAAF_20201212_LATECH@TCU,TCU,Horned Frogs,Louisiana Tech,Bulldogs,6-4,5-4,0,31,0,52,10,10,21,14,7,0,0,3,7,1,31,10,31,42,0.9069561359443348,21.904514393090153,,
2841,2020,15,NCAAF_20201212_LSU@FLA,Florida,Gators,LSU,Tigers,8-2,4-5,1,17,24,34,37,7,10,14,3,7,17,3,10,4,-7,0,-7,-3,0.4079899602799044,-3.85526232734162,,
2842,2020,15,NCAAF_20201212_AUBURN@MISSST,Miss. State,Bulldogs,Auburn,Tigers,2-7,6-4,0,3,6,10,24,0,3,0,7,3,3,3,15,-4,-3,-3,-3,-14,0.31343469862197293,-8.053456341107335,,
2843,2020,15,NCAAF_20201212_USC@UCLA,UCLA,Bruins,USC,Trojans,3-3,5-0,0,21,10,38,43,7,14,14,3,0,10,13,20,-2,11,7,11,-5,0.2868065223464944,-9.322435025883806,,
2844,2020,15,NCAAF_20201212_UVA@VATECH,Virginia Tech,Hokies,Virginia,Cavaliers,5-6,5-5,1,27,7,33,15,3,24,3,3,7,0,8,0,0,20,-4,20,18,0.5380830402184785,1.583819097802916,,
2845,2020,15,NCAAF_20201212_SDGST@BYU,BYU,Cougars,San Diego St.,Aztecs,10-1,4-4,1,17,14,28,14,7,10,3,8,14,0,0,0,6,3,-7,3,14,0.5217536171254329,0.9037735569241931,,
2846,2020,15,NCAAF_20201212_STNFRD@OREGST,Oregon State,Beavers,Stanford,Cardinal,2-4,3-2,1,14,9,24,27,7,7,7,3,6,3,7,11,-1,5,1,5,-3,0.15374625398630215,-16.905765201683835,,
2847,2020,15,NCAAF_20201212_FRESNO@NMEX,New Mexico,Lobos,Fresno St.,Bulldogs,2-5,3-3,1,21,24,49,39,7,14,7,21,7,17,7,8,-1,-3,0,-3,10,0.10576635628539033,-20.697176788057277,,
2848,2020,15,NCAAF_20201212_UNLV@HAWAII,Hawaii,Rainbow Warriors,UNLV,Rebels,4-4,0-6,0,21,7,38,21,7,14,14,3,0,7,14,0,4,14,7,14,17,0.5973360816961124,4.0828691966474935,,
2849,2020,15,NCAAF_20201211_UTEP@NTEXAS,North Texas,Mean Green,UTEP,Miners,4-5,3-5,0,17,21,45,43,7,10,14,14,7,14,0,22,1,-4,0,-4,2,0.8605669235856159,17.939037150469062,,
2850,2020,15,NCAAF_20201211_ARIZST@ARIZ,Arizona,Wildcats,Arizona St.,Sun Devils,0-5,1-2,1,7,42,7,70,0,7,0,0,21,21,21,7,-1,-35,-21,-35,-63,0.3682823246420498,-5.572969829064391,,
2851,2020,15,NCAAF_20201211_NEVADA@SJST,San Jose St.,Spartans,Nevada,Wolf Pack,6-0,6-2,0,7,20,30,20,7,0,20,3,10,10,0,0,0,-13,-3,-13,10,0.3152566457473511,-7.96841563665248,,
2852,2020,15,NCAAF_20201210_FAU@USM,So. Miss,Golden Eagles,FAU,Owls,3-7,5-3,0,24,17,45,31,10,14,14,7,7,10,14,0,-2,7,3,7,14,0.24574109762730756,-11.396769938349166,,
2853,2020,15,NCAAF_20201210_PITT@GATECH,Georgia Tech,Yellow Jackets,Pittsburgh,Panthers,3-7,6-5,0,7,16,20,34,7,0,6,7,3,13,7,11,-3,-9,4,-9,-14,0.40855626228270603,-3.831105073055028,,
2854,2021,1,NCAAF_20210906_LVILLE@MISS,Ole Miss,Rebels,Louisville,Cardinals,1-0,0-1,1,26,0,43,24,9,17,3,14,0,0,10,14,1,26,9,26,19,0.5853188394298132,3.579002390342339,,
2855,2021,1,NCAAF_20210904_ARMY@GAST,Georgia St.,Panthers,Army,Black Knights,0-1,1-0,1,7,27,10,43,0,7,3,0,14,13,6,10,-1,-20,-14,-20,-33,0.18008703224968192,-15.195409929358902,,
2856,2021,1,NCAAF_20210904_COLG@BC,Boston College,Eagles,Colgate,Raiders,1-0,0-1,1,27,0,51,0,7,20,3,21,0,0,0,0,1,27,7,27,51,0.9699927506480326,31.23143831511959,,
2857,2021,1,NCAAF_20210904_FORD@NEB,Nebraska,,Fordham,,1-1,0-1,,24,7,52,7,7,17,14,14,0,7,0,0,1,17,7,17,45,0.9996810202241456,56.709860800973615,,
2858,2021,1,NCAAF_20210904_HOLY@UCONN,UConn,Huskies,Holy Cross,Crusaders,0-2,1-0,0,21,24,28,38,14,7,7,0,7,17,7,7,-1,-3,7,-3,-10,0.7879115103415801,13.271760977687677,,
2859,2021,1,NCAAF_20210904_LAMON@UK,Kentucky,Wildcats,UL-Monroe,Warhawks,1-0,0-1,1,28,7,45,10,14,14,3,14,7,0,0,3,1,21,7,21,35,0.9528583863611746,27.78622219425631,,
2860,2021,1,NCAAF_20210904_PSU@WISC,Wisconsin,Badgers,Penn State,Nittany Lions,0-1,1-0,0,0,0,10,16,0,0,7,3,0,0,7,9,-1,0,0,0,-6,0.44896325147433924,-2.1302874068936717,,
2861,2021,1,NCAAF_20210904_STNFRD@KSTATE,Kansas State,Wildcats,Stanford,Cardinal,1-0,0-1,0,14,0,24,7,7,7,0,10,0,0,0,7,1,14,7,14,17,0.4878545868172445,-0.5056439051779762,,
2862,2021,1,NCAAF_20210904_TEMPLE@RUT,Rutgers,Scarlet Knights,Temple,Owls,1-0,0-1,1,26,7,61,14,12,14,14,21,0,7,7,0,1,19,12,19,47,0.3871767066281375,-4.760807643746034,,
2863,2021,1,NCAAF_20210904_TULANE@OKLA,Oklahoma,Sooners,Tulane,Green Wave,1-0,0-1,1,37,14,40,35,14,23,3,0,14,0,8,13,1,23,0,23,5,0.9316387571367764,24.712109367090648,,
2864,2021,1,NCAAF_20210904_WMICH@MICH,Michigan,Wolverines,W. Michigan,Broncos,1-0,0-1,1,27,7,47,14,10,17,6,14,7,0,0,7,1,20,3,20,33,0.959730712943374,29.02083737820533,,
2865,2021,1,NCAAF_20210904_FRESNO@OREG,Oregon,Ducks,Fresno St.,Bulldogs,1-0,1-1,0,21,13,31,24,14,7,0,10,0,13,8,3,0,8,14,8,7,0.7645857138945706,11.975397854260905,,
2866,2021,1,NCAAF_20210904_LAF@AF,Air Force,Falcons,Lafayette,Leopards,1-0,0-1,0,28,7,35,14,14,14,0,7,0,7,7,0,1,21,14,21,21,0.8767018462668077,19.241107906828802,,
2867,2021,1,NCAAF_20210904_RICE@ARK,Arkansas,Razorbacks,Rice,Owls,1-0,0-1,1,7,10,38,17,7,0,10,21,0,10,7,0,1,-3,7,-3,21,0.8433286156456536,16.743113409616285,,
2868,2021,1,NCAAF_20210904_BAMA@MIAMI,Miami (Fla.),Hurricanes,Alabama,Crimson Tide,0-1,1-0,0,3,27,13,44,0,3,10,0,10,17,14,3,-1,-24,-10,-24,-31,0.07286496607252635,-24.1586705136433,,
2869,2021,1,NCAAF_20210904_IND@IOWA,Iowa,Hawkeyes,Indiana,Hoosiers,1-0,0-1,1,31,3,34,6,14,17,0,3,3,0,3,0,1,28,11,28,28,0.7521872280596072,11.315412735347536,,
2870,2021,1,NCAAF_20210904_MIAOH@CINCY,Cincinnati,Bearcats,Miami-OH,RedHawks,1-0,0-1,1,35,0,49,14,21,14,0,14,0,0,0,14,1,35,21,35,35,0.805202300423851,14.28733690371132,,
2871,2021,1,NCAAF_20210904_MRSHL@NAVY,Navy,Midshipmen,Marshall,Thundering Herd,0-1,1-0,0,0,21,7,49,0,0,0,7,14,7,7,21,-1,-21,-14,-21,-42,0.5388981330355677,1.6217504143095312,,
2872,2021,1,NCAAF_20210904_WVU@MD,Maryland,Terrapins,West Virginia,Mountaineers,1-0,0-1,1,20,21,30,24,17,3,0,10,14,7,0,3,1,-1,3,-1,6,0.279417728140821,-9.707637409760537,,
2873,2021,1,NCAAF_20210904_CMICH@MIZZOU,Missouri,Tigers,C. Michigan,Chippewas,1-0,0-1,1,17,14,34,24,7,10,7,10,7,7,0,10,1,3,0,3,10,0.8799394635994714,19.507273897796267,,
2874,2021,1,NCAAF_20210904_LATECH@MISSST,Miss. State,Bulldogs,Louisiana Tech,Bulldogs,1-0,0-1,1,14,21,35,34,14,0,0,21,7,14,10,3,1,-7,7,-7,1,0.9013437993136679,21.4097407617204,,
2875,2021,1,NCAAF_20210904_MTST@WYO,Wyoming,Cowboys,Montana St.,Bobcats,1-0,0-1,0,3,7,19,16,0,3,0,16,7,0,0,9,1,-4,-7,-4,3,0.9117646389618891,22.44689857994598,,
2876,2021,1,NCAAF_20210904_UMASS@PITT,Pittsburgh,Panthers,UMass,Minutemen,1-0,0-1,0,23,0,51,7,13,10,14,14,0,0,0,7,1,23,13,23,44,0.9720923241855014,31.75931405055485,,
2877,2021,1,NCAAF_20210904_LALAF@TEXAS,Texas,Longhorns,Louisiana,Ragin' Cajuns,1-0,0-1,0,14,6,38,18,7,7,14,10,3,3,6,6,1,8,4,8,20,0.8920228876560173,20.548058631694175,,
2878,2021,1,NCAAF_20210904_NOIOWA@IOWAST,Iowa St.,Cyclones,Northern Iowa,Panthers,1-0,0-1,0,13,10,16,10,3,10,0,3,7,3,0,0,1,3,-4,3,6,0.8668126408047302,18.45718049456582,,
2879,2021,1,NCAAF_20210904_SJST@USC,USC,Trojans,San Jose St.,Spartans,1-0,1-1,0,13,0,30,7,10,3,0,17,0,0,7,0,0,13,10,13,23,0.950628522624602,27.416807087913753,,
2880,2021,1,NCAAF_20210904_CAMP@LIB,Liberty,Flames,Campbell,Fighting Camels,1-0,0-1,0,20,7,48,7,14,6,14,14,0,7,0,0,1,13,14,13,41,0.9463160184330179,26.738575127765557,,
2881,2021,1,NCAAF_20210904_GRDWB@GAS,Ga. Southern,Eagles,Gardner-Webb,Runnin' Bulldogs,1-0,0-1,0,20,6,30,25,3,17,0,10,6,0,6,13,1,14,-3,14,5,0.9851826337552121,36.117893014711285,,
2882,2021,1,NCAAF_20210904_ABIL@SMU,SMU,Mustangs,Abil Christian,Wildcats,1-0,0-1,0,35,3,56,9,7,28,14,7,0,3,6,0,1,32,7,32,47,0.9810788949929062,34.48417809964451,,
2883,2021,1,NCAAF_20210904_AKRON@AUBURN,Auburn,Tigers,Akron,Zips,1-0,0-1,0,37,0,60,10,13,24,16,7,0,0,0,10,1,37,13,37,50,0.9952405083650239,43.057565860768136,,
2884,2021,1,NCAAF_20210904_BAYLOR@TXSTSM,Texas St.,Bobcats,Baylor,Bears,0-1,1-0,1,10,14,20,29,3,7,3,7,7,7,10,5,-1,-4,-4,-4,-9,0.04737793776964361,-27.74641651360014,,
2885,2021,1,NCAAF_20210904_CAR@ARKST,Arkansas St.,,Cent. Ark.,,1-0,0-1,,6,7,40,21,3,3,14,20,7,0,7,7,1,-1,-4,-1,19,0.8091962686616481,14.529574206796156,,
2886,2021,1,NCAAF_20210904_CUSE@OHIO,Ohio,Bobcats,Syracuse,Orange,0-1,1-0,1,6,12,9,29,0,6,0,3,9,3,10,7,-1,-6,-9,-6,-20,0.487804838239854,-0.507715706922454,,
2887,2021,1,NCAAF_20210904_EIL@SC,South Carolina,Gamecocks,E. Illinois,Panthers,1-0,0-2,1,29,0,46,0,15,14,3,14,0,0,0,0,1,29,15,29,46,0.9957392015665607,43.686004256632145,,
2888,2021,1,NCAAF_20210904_MONNJ@MTSU,Middle Tenn.,Blue Raiders,Monmouth,Hawks,1-0,0-1,0,21,7,50,15,0,21,7,22,0,7,8,0,1,14,0,14,35,0.969412305807825,31.09092491991089,,
2889,2021,1,NCAAF_20210904_MOST@OKLAST,Oklahoma State,Cowboys,Missouri St.,Bears,1-0,0-1,0,20,3,23,16,6,14,0,3,0,3,6,7,1,17,6,17,7,0.9968904142663656,45.435044722437624,,
2890,2021,1,NCAAF_20210904_NICHST@MEMP,Memphis,,Nicholls St.,,1-0,0-1,,29,7,42,17,10,19,6,7,7,0,7,3,1,22,3,22,25,0.9611740257409052,29.301583416407766,,
2891,2021,1,NCAAF_20210904_NRFST@TOLEDO,Toledo,Rockets,Norfolk St.,Spartans,1-0,0-1,0,28,7,49,10,14,14,14,7,7,0,0,3,1,21,7,21,39,0.9805208265885935,34.28601084874583,,
2892,2021,1,NCAAF_20210904_OREGST@PURDUE,Purdue,Boilermakers,Oregon State,Beavers,1-0,0-1,0,13,7,30,21,7,6,3,14,7,0,0,14,1,6,0,6,9,0.8483286860806847,17.092827550538345,,
2893,2021,1,NCAAF_20210904_SO@TROY,Troy,,Southern U.,,1-0,0-1,,34,3,55,3,14,20,14,7,0,3,0,0,1,31,14,31,52,0.9889094941444864,37.98304767283639,,
2894,2021,1,NCAAF_20210904_TXTECH@HOU,Houston,Cougars,Texas Tech,Red Raiders,0-1,1-0,1,21,7,21,38,14,7,0,0,0,7,17,14,-1,14,14,14,-17,0.36989029545065866,-5.515714089445851,,
2895,2021,1,NCAAF_20210904_FAU@FLA,Florida,Gators,FAU,Owls,1-0,0-1,1,14,0,35,14,14,0,7,14,0,0,0,14,1,14,14,14,21,0.8370583782912431,16.31478588243749,,
2896,2021,1,NCAAF_20210904_NILL@GATECH,Georgia Tech,Yellow Jackets,N. Illinois,Huskies,0-1,1-0,0,7,14,21,22,0,7,0,14,7,7,0,8,-1,-7,-7,-7,-1,0.6876780462674311,8.125168404584997,,
2897,2021,1,NCAAF_20210904_NWST@NTEXAS,North Texas,Mean Green,Northwestern St.,Demons,1-0,0-1,0,24,14,44,14,7,17,17,3,0,14,0,0,1,10,7,10,30,0.9151529782655521,22.80369943858716,,
2898,2021,1,NCAAF_20210904_TXSA@ILL,Illinois,,UTSA,,1-1,1-0,,14,20,30,37,0,14,3,13,7,13,3,14,0,-6,-7,-6,-7,0.798488734556251,13.886856673695661,,
2899,2021,1,NCAAF_20210904_UGA@CLEM,Clemson,Tigers,Georgia,Bulldogs,0-1,1-0,0,0,7,3,10,0,0,0,3,0,7,3,0,-1,-7,0,-7,-7,0.6450911700513042,6.179257163664602,,
2900,2021,1,NCAAF_20210904_WMMARY@UVA,Virginia,Cavaliers,William & Mary,Tribe,1-0,0-1,0,17,0,43,0,3,14,12,14,0,0,0,0,1,17,3,17,43,0.9726657106795377,31.909210285395716,,
2901,2021,1,NCAAF_20210904_DUQ@TCU,TCU,Horned Frogs,Duquesne,Dukes,1-0,0-1,1,35,0,45,3,21,14,3,7,0,0,3,0,1,35,21,35,42,0.9969164250261497,45.48092788708004,,
2902,2021,1,NCAAF_20210904_ETNST@VANDY,Vanderbilt,Commodores,ETSU,Buccaneers,0-1,1-0,1,3,10,3,23,3,0,0,0,0,10,3,10,-1,-7,3,-7,-20,0.9883083769983543,37.64860215046474,,
2903,2021,1,NCAAF_20210904_KENTST@TXAM,Texas A&M,Aggies,Kent St.,Golden Flashes,1-0,0-1,1,10,3,41,10,10,0,17,14,3,0,0,7,1,7,7,7,31,0.9714094551639115,31.5841073001244,,
2904,2021,1,NCAAF_20210904_MT@WASH,Washington,Huskies,Montana,Grizzlies,0-1,1-0,1,7,3,7,13,7,0,0,0,3,0,0,10,-1,4,4,4,-6,0.9968550809632799,45.37326691722035,,
2905,2021,1,NCAAF_20210904_USM@SALA,South Alabama,,So. Miss,,1-0,0-1,,14,7,31,7,0,14,10,7,7,0,0,0,1,7,-7,7,24,0.26406725324728,-10.476250385635694,,
2906,2021,1,NCAAF_20210904_LSU@UCLA,UCLA,Bruins,LSU,Tigers,2-0,0-1,1,14,10,38,27,0,14,10,14,0,10,10,7,2,4,0,4,11,0.15335273142076078,-16.974385939287345,,
2907,2021,1,NCAAF_20210904_BTHN@UTEP,UTEP,Miners,Bethune-Cook.,Wildcats,2-0,0-1,0,10,0,38,28,10,0,7,21,0,0,14,14,2,10,10,10,10,0.6020646310263897,4.295988710802476,,
2908,2021,1,NCAAF_20210904_BYU@ARIZ,Arizona,Wildcats,BYU,Cougars,0-1,1-0,0,3,14,16,24,0,3,10,3,0,14,7,3,-1,-11,0,-11,-8,0.4106097329767605,-3.7526606748839413,,
2909,2021,1,NCAAF_20210904_NEVADA@CAL,California,Golden Bears,Nevada,Wolf Pack,0-1,1-0,1,14,13,17,22,14,0,0,3,0,13,9,0,-1,1,14,1,-5,0.7655480303506891,12.027409140499117,,
2910,2021,1,NCAAF_20210904_NMEXST@SDGST,San Diego St.,Aztecs,New Mexico St.,Aggies,1-0,0-2,0,0,10,28,10,0,0,21,7,3,7,0,0,1,-10,-3,-10,18,0.9067200763723459,21.934139540584624,,
2911,2021,1,NCAAF_20210904_UTAHST@WASHST,Washington St.,Cougars,Utah St.,Aggies,0-1,1-0,1,6,5,23,26,0,6,14,3,3,2,6,15,-1,1,-3,1,-3,0.7345929145254622,10.408286777189232,,
2912,2021,1,NCAAF_20210904_PORTST@HAWAII,Hawaii,,Portland St.,,1-1,0-1,,35,7,49,35,28,7,7,7,0,7,21,7,1,28,28,28,14,0.6706473286867946,7.335068235915628,,
2913,2021,1,NCAAF_20210903_UNC@VATECH,Virginia Tech,Hokies,North Carolina,Tar Heels,1-0,0-1,1,14,0,17,10,7,7,0,3,0,0,7,3,1,14,7,14,7,0.5679754737183408,2.843384010638033,0.414546686906878,-8.045630669757294
2914,2021,1,NCAAF_20210903_DUKE@CHARLO,Charlotte,49ers,Duke,Blue Devils,1-0,0-1,0,10,14,31,28,7,3,7,14,0,14,0,14,1,-4,7,-4,3,0.13463246784603755,-18.346033091220647,,
2915,2021,1,NCAAF_20210903_ODU@WAKE,Wake Forest,Demon Deacons,Old Dominion,Monarchs,1-0,0-1,0,28,3,42,10,14,14,7,7,3,0,0,7,1,25,11,25,32,0.9434950153583267,26.31795220824165,,
2916,2021,1,NCAAF_20210903_STFRPA@EMICH,E. Michigan,Eagles,St. Fran.-Pa.,Red Flash,1-0,0-1,1,28,7,35,15,14,14,7,0,0,7,0,8,1,21,14,21,20,,,,
2917,2021,1,NCAAF_20210903_SD@KANSAS,Kansas,Jayhawks,South Dakota,Coyotes,1-0,0-1,1,7,0,17,14,0,7,3,7,0,0,7,7,1,7,0,7,3,0.8097351784264442,14.562496360597152,,
2918,2021,1,NCAAF_20210903_MICHST@NWEST,Northwestern,Wildcats,Michigan St.,Spartans,0-1,1-0,0,7,21,21,38,0,7,0,14,14,7,7,10,-1,-14,-14,-14,-17,0.512404176205661,0.5164202936666697,,
2919,2021,1,NCAAF_20210903_NCO@COLO,Colorado,Buffaloes,N. Colorado,Bears,1-0,0-1,0,14,0,35,7,0,14,7,14,0,0,7,0,1,14,0,14,28,0.9576117025042964,28.623108018157268,,
2920,2021,1,NCAAF_20210903_SDST@COLOST,Colorado St.,Rams,S. Dakota St.,Jackrabbits,0-1,1-0,1,10,21,23,42,0,10,0,13,7,14,14,7,-1,-11,-7,-11,-19,0.2760435573709953,-9.874754594704882,,
2921,2021,1,NCAAF_20210902_CIT@CSTCAR,C. Carolina,Chanticleers,The Citadel,Bulldogs,1-0,0-1,0,31,0,52,14,7,24,14,7,0,0,7,7,1,31,7,31,38,0.5583548460203074,2.43781033774178,,
2922,2021,1,NCAAF_20210902_WAG@BUFF,Buffalo,Bulls,Wagner,Seahawks,1-0,0-1,1,38,0,69,7,14,24,21,10,0,0,0,7,1,38,14,38,62,0.9894888990930596,38.32068347379527,,
2923,2021,1,NCAAF_20210902_WIL@BALLST,Ball St.,Cardinals,W. Illinois,Leathernecks,1-0,0-1,0,7,7,31,21,7,0,14,10,0,7,7,7,1,0,7,0,10,0.3190555933752769,-7.810675070795696,,
2924,2021,1,NCAAF_20210902_DAVIS@TULSA,Tulsa,Golden Hurricane,UC-Davis,Aggies,0-1,1-0,0,10,10,17,19,3,7,7,0,7,3,3,6,-1,0,-4,0,-2,0.6956107097600398,8.49944898512831,,
2925,2021,1,NCAAF_20210902_ECU@APLST,App. St.,Mountaineers,East Carolina,Pirates,1-0,0-1,0,20,6,33,19,14,6,7,6,6,0,3,10,1,14,8,14,14,0.8627933502177247,18.150055622541913,,
2926,2021,1,NCAAF_20210902_SFLA@NCST,NC State,Wolfpack,South Florida,Bulls,1-0,0-1,0,24,0,45,0,10,14,14,7,0,0,0,0,1,24,10,24,45,0.7543387514322002,11.428637824564134,,
2927,2021,1,NCAAF_20210902_WBRST@UTAH,Utah,Utes,Weber St.,Wildcats,1-0,0-1,0,19,7,40,17,13,6,7,14,7,0,3,7,1,12,6,12,23,0.9338449686973909,24.993534397519966,,
2928,2021,1,NCAAF_20210902_BGREEN@TENN,Tennessee,Volunteers,Bowling Green,Falcons,1-0,0-1,0,14,6,38,6,14,0,14,10,0,6,0,0,1,8,14,8,32,0.957850086888892,28.66703670149718,,
2929,2021,1,NCAAF_20210902_HOUBP@NMEX,New Mexico,Lobos,Houston Christian,Huskies,1-0,0-1,0,21,10,27,17,14,7,3,3,0,10,0,7,1,11,14,11,10,0.7574709438893668,11.594428194714169,,
2930,2021,1,NCAAF_20210902_LIUPOST@FIU,FIU,,LIU,,1-0,0-1,,28,10,48,10,21,7,10,10,0,10,0,0,1,18,21,18,38,,,,
2931,2021,1,NCAAF_20210902_OHIOST@MINN,Minnesota,Golden Gophers,Ohio State,Buckeyes,0-1,1-0,1,14,10,31,45,0,14,7,10,7,3,21,14,-1,4,-7,4,-14,0.07264302688244173,-24.185319094470742,,
2932,2021,1,NCAAF_20210902_TNMART@WKY,W. Kentucky,Hilltoppers,UT Martin,Skyhawks,1-0,0-1,0,28,14,59,21,7,21,17,14,7,7,0,7,1,14,0,14,38,0.8475674039374003,17.039094295575865,,
2933,2021,1,NCAAF_20210902_BOISE@UCF,UCF,Knights,Boise St.,Broncos,1-0,0-1,0,14,24,36,31,0,14,14,8,14,10,0,7,1,-10,-14,-10,5,0.6394868335328668,5.929936499315545,,
2934,2021,1,NCAAF_20210902_SUT@ARIZST,Arizona St.,Sun Devils,So. Utah,Thunderbirds,1-0,0-2,0,28,7,41,14,13,15,6,7,7,0,7,0,1,21,6,21,27,0.9968794955281085,45.41588689489322,,
2935,2021,1,NCAAF_20210901_UAB@JAXST,Jacksonville St.,Gamecocks,UAB,Blazers,0-1,1-0,1,0,10,0,31,0,0,0,0,0,10,14,7,-1,-10,0,-10,-31,0.34981940012322443,-6.406882807165175,,
2936,2021,1,NCAAF_20210828_NEB@ILL,Illinois,Fighting Illini,Nebraska,Cornhuskers,1-1,1-1,0,16,9,30,22,2,14,14,0,0,9,7,6,0,7,2,7,8,0.30240546336161067,-8.59372160574685,,
2937,2021,1,NCAAF_20210828_UCONN@FRESNO,Fresno St.,,UConn,,1-1,0-2,,31,0,45,0,7,24,7,7,0,0,0,0,1,31,7,31,45,0.9515297735556163,27.564474819698034,,
2938,2021,1,NCAAF_20210828_HAWAII@UCLA,UCLA,,Hawaii,,2-0,1-1,,31,3,44,10,24,7,13,0,3,0,7,0,1,28,21,28,34,0.797910427927927,13.852737421338475,,
2939,2021,1,NCAAF_20210828_UTEP@NMEXST,New Mexico St.,,UTEP,,0-2,2-0,,3,20,3,30,0,3,0,0,17,3,10,0,-2,-17,-17,-17,-27,0.6903358519463404,8.25010094533286,,
2940,2021,1,NCAAF_20210828_SUT@SJST,San Jose St.,,So. Utah,,1-1,0-2,,38,14,45,14,21,17,7,0,0,14,0,0,1,24,21,24,31,0.9127861252995935,22.553369418521925,,
2941,2021,2,NCAAF_20210911_ILL@UVA,Virginia,Cavaliers,Illinois,Fighting Illini,2-0,1-2,1,21,7,42,14,14,7,14,7,0,7,7,0,1,14,14,14,28,0.6856009827270502,8.042867683008126,,
2942,2021,2,NCAAF_20210911_VMI@KENTST,Kent St.,,VMI,,1-1,1-1,,39,0,60,10,22,17,14,7,0,0,3,7,0,39,22,39,50,0.9894054584508023,38.34265253068952,,
2943,2021,2,NCAAF_20210911_WKY@ARMY,Army,Black Knights,W. Kentucky,Hilltoppers,2-0,1-1,0,21,14,38,35,0,21,7,10,0,14,0,21,1,7,0,7,3,0.7428701203925636,10.851268739209218,,
2944,2021,2,NCAAF_20210911_ALST@AUBURN,Auburn,Tigers,Alabama St.,Hornets,2-0,1-1,0,20,0,62,0,6,14,35,7,0,0,0,0,1,20,6,20,62,0.9994981403245665,54.7286143270876,,
2945,2021,2,NCAAF_20210911_INST@NWEST,Northwestern,,Indiana St.,,1-1,1-1,,14,0,24,6,14,0,3,7,0,0,0,6,0,14,14,14,18,0.9789130445657573,33.80398272688876,,
2946,2021,2,NCAAF_20210911_KENSAW@GATECH,Georgia Tech,,Kennesaw St.,,1-1,1-1,,24,3,45,17,14,10,7,14,0,3,0,14,0,21,14,21,28,,,,
2947,2021,2,NCAAF_20210911_MIAOH@MINN,Minnesota,Golden Gophers,Miami-OH,RedHawks,1-1,0-2,0,21,3,31,26,7,14,0,10,0,3,10,13,1,18,7,18,5,0.8798726516500123,19.538203524507708,,
2948,2021,2,NCAAF_20210911_NRFST@WAKE,Wake Forest,,Norfolk St.,,2-0,0-2,,24,9,41,16,7,17,17,0,3,6,0,7,2,15,4,15,25,0.9969416576149346,45.61091686650798,,
2949,2021,2,NCAAF_20210911_OREG@OHIOST,Ohio State,Buckeyes,Oregon,Ducks,1-1,2-0,1,7,14,28,35,0,7,7,14,0,14,14,7,-1,-7,0,-7,-7,0.8783955511951443,19.415971923349844,,
2950,2021,2,NCAAF_20210911_PITT@TENN,Tennessee,Volunteers,Pittsburgh,Panthers,1-1,2-0,0,20,27,34,41,10,10,7,7,0,27,7,7,-1,-7,10,-7,-7,0.42336906611133873,-3.2157205845589942,,
2951,2021,2,NCAAF_20210911_SC@ECU,East Carolina,Pirates,South Carolina,Gamecocks,0-2,2-0,1,14,7,17,20,7,7,0,3,0,7,7,6,-2,7,7,7,-3,0.1070794422381669,-20.6672236736415,,
2952,2021,2,NCAAF_20210911_TULSA@OKLAST,Oklahoma State,Cowboys,Tulsa,Golden Hurricane,2-0,0-2,1,7,7,28,23,0,7,0,21,0,7,7,9,2,0,0,0,5,0.8827899101290546,19.782759254675284,,
2953,2021,2,NCAAF_20210911_YST@MICHST,Michigan St.,Spartans,Youngstown St.,Penguins,2-0,1-1,1,35,7,42,14,14,21,7,0,0,7,7,0,1,28,14,28,28,0.9838258487534481,35.6054869923712,,
2954,2021,2,NCAAF_20210911_FLA@SFLA,South Florida,Bulls,Florida,Gators,0-2,2-0,0,3,35,20,42,3,0,10,7,14,21,0,7,-2,-32,-11,-32,-22,0.07803061922412846,-23.599296308002295,,
2955,2021,2,NCAAF_20210911_MRGNST@TULANE,Tulane,,Morgan St.,,1-1,0-2,,52,7,69,20,17,35,7,10,0,7,7,6,1,45,17,45,49,0.9997834567152217,58.54812662343306,,
2956,2021,2,NCAAF_20210911_WYO@NILL,N. Illinois,,Wyoming,,1-1,2-0,,10,28,43,50,3,7,12,21,14,14,14,8,-1,-18,-11,-18,-7,0.3768842092750081,-5.218742474028204,,
2957,2021,2,NCAAF_20210911_DUQ@OHIO,Ohio,,Duquesne,,0-2,1-1,,13,11,26,28,13,0,0,13,8,3,7,10,-1,2,5,2,-2,0.9633443640221404,29.7958202711593,,
2958,2021,2,NCAAF_20210911_MTSU@VATECH,Virginia Tech,Hokies,Middle Tenn.,Blue Raiders,2-0,1-1,1,14,7,35,14,7,7,14,7,0,7,0,7,1,7,7,7,21,0.84039979158321,16.572609177118238,,
2959,2021,2,NCAAF_20210911_RUT@CUSE,Syracuse,,Rutgers,,1-1,2-0,,0,0,7,17,0,0,7,0,0,0,14,3,-1,0,0,0,-10,0.6610133912915772,6.908378215663333,,
2960,2021,2,NCAAF_20210911_TOLEDO@ND,Notre Dame,Fighting Irish,Toledo,Rockets,2-0,1-1,1,14,16,32,29,7,7,0,18,6,10,0,13,1,-2,1,-2,3,0.9365956739360786,25.402208420590796,,
2961,2021,2,NCAAF_20210911_PURDUE@UCONN,UConn,Huskies,Purdue,Boilermakers,0-3,2-0,1,0,35,0,49,0,0,0,0,7,28,14,0,-2,-35,-7,-35,-49,0.015656368481762217,-35.82170091973603,,
2962,2021,2,NCAAF_20210911_ROB@CMICH,C. Michigan,,Robert Morris,,1-1,0-1,,28,0,45,0,7,21,14,3,0,0,0,0,1,28,7,28,45,0.8782836253313617,19.406752596984006,,
2963,2021,2,NCAAF_20210911_AF@NAVY,Navy,Midshipmen,Air Force,Falcons,0-2,2-0,0,3,7,3,23,0,3,0,0,0,7,7,9,-2,-4,0,-4,-20,0.42164495651656797,-3.2890098166801636,,
2964,2021,2,NCAAF_20210911_BALLST@PSU,Penn State,Nittany Lions,Ball St.,Cardinals,2-0,1-1,0,24,6,44,13,14,10,10,10,0,6,0,7,1,18,14,18,31,0.9933834474415661,41.21819179814929,,
2965,2021,2,NCAAF_20210911_BC@UMASS,UMass,,Boston College,,0-2,2-0,,0,14,28,45,0,0,21,7,14,0,21,10,-2,-14,-14,-14,-17,0.025449668245024593,-32.4817628210335,,
2966,2021,2,NCAAF_20210911_BUFF@NEB,Nebraska,Cornhuskers,Buffalo,Bulls,2-1,1-1,0,14,0,28,3,0,14,0,14,0,0,3,0,1,14,0,14,25,0.6247751097557848,5.291482148517389,,
2967,2021,2,NCAAF_20210911_CAL@TCU,TCU,Horned Frogs,California,Golden Bears,2-0,0-2,0,14,19,34,32,0,14,7,13,6,13,0,13,2,-5,-6,-5,2,0.720726997241789,9.732954167535127,,
2968,2021,2,NCAAF_20210911_GAS@FAU,FAU,,Ga. Southern,,1-1,1-1,,10,6,38,6,0,10,21,7,6,0,0,0,0,4,-6,4,32,0.7275225747528496,10.07127406206564,,
2969,2021,2,NCAAF_20210911_MURYST@CINCY,Cincinnati,Bearcats,Murray St.,Racers,2-0,1-1,0,7,7,42,7,0,7,14,21,0,7,0,0,1,0,0,0,35,0.994051437244843,41.846215099153596,,
2970,2021,2,NCAAF_20210911_TEMPLE@AKRON,Akron,,Temple,,0-2,1-1,,17,24,24,45,14,3,0,7,7,17,14,7,-1,-7,7,-7,-21,0.13561030416997655,-18.30546048930978,,
2971,2021,2,NCAAF_20210911_TXAM@COLO,Colorado,Buffaloes,Texas A&M,Aggies,1-1,2-0,0,7,3,7,10,7,0,0,0,0,3,0,7,-1,4,7,4,-3,0.23348902869045074,-12.10216428200556,,
2972,2021,2,NCAAF_20210911_UAB@UGA,Georgia,Bulldogs,UAB,Blazers,2-0,1-1,1,35,0,56,7,21,14,14,7,0,0,0,7,1,35,21,35,49,0.9781096107036509,33.54416649194991,,
2973,2021,2,NCAAF_20210911_MERCER@BAMA,Alabama,Crimson Tide,Mercer,Bears,2-0,1-1,1,31,0,48,14,14,17,14,3,0,0,7,7,1,31,14,31,34,0.999897074594182,61.75367726167815,,
2974,2021,2,NCAAF_20210911_SALA@BGREEN,Bowling Green,,South Alabama,,0-2,2-0,,8,6,19,22,8,0,11,0,0,6,6,10,-2,2,8,2,-3,0.338686591270567,-6.922018928132729,,
2975,2021,2,NCAAF_20210911_IOWA@IOWAST,Iowa St.,Cyclones,Iowa,Hawkeyes,1-1,2-0,0,10,14,17,27,3,7,0,7,0,14,10,3,-1,-4,3,-4,-10,0.3570888072142704,-6.093488840524287,,
2976,2021,2,NCAAF_20210911_ILST@WMICH,W. Michigan,,Illinois St.,,1-1,1-1,,14,0,28,0,7,7,14,0,0,0,0,0,0,14,7,14,28,0.49190155075398356,-0.33776026177201857,,
2977,2021,2,NCAAF_20210911_LIUPOST@WVU,West Virginia,,LIU,,1-1,0-2,,38,0,66,0,21,17,21,7,0,0,0,0,1,38,21,38,66,0.9997295601551798,57.559760445169104,,
2978,2021,2,NCAAF_20210911_SCST@CLEM,Clemson,Tigers,SC State,Bulldogs,1-1,0-2,1,35,3,49,3,28,7,14,0,0,3,0,0,1,32,28,32,46,0.999971877575544,67.01626409460528,,
2979,2021,2,NCAAF_20210911_GRDWB@CHARLO,Charlotte,,Gardner-Webb,,2-0,0-2,,28,10,38,10,14,14,7,3,3,7,0,0,2,18,11,18,28,0.9092284542856992,22.22795603708505,,
2980,2021,2,NCAAF_20210911_LAMAR@TXSA,UTSA,,Lamar,,2-0,1-1,,34,0,54,0,13,21,10,10,0,0,0,0,1,34,13,34,54,0.9932732077921193,41.11999040695332,,
2981,2021,2,NCAAF_20210911_PORTST@WASHST,Washington St.,Cougars,Portland St.,Vikings,1-1,0-2,1,30,10,44,24,7,23,7,7,0,10,0,14,1,20,7,20,20,0.9641041608068114,29.95468993861141,,
2982,2021,2,NCAAF_20210911_BTHN@UCF,UCF,,Bethune-Cook.,,2-0,0-2,,35,7,63,14,14,21,21,7,7,0,7,0,2,28,7,28,49,0.998243224860571,48.5617989258692,,
2983,2021,2,NCAAF_20210911_HOU@RICE,Rice,Owls,Houston,Cougars,0-2,1-1,1,7,17,7,44,0,7,0,0,17,0,14,13,-1,-10,-17,-10,-37,0.09940567712444315,-21.378223186317882,,
2984,2021,2,NCAAF_20210911_NCCEN@MRSHL,Marshall,,NC Central,,2-0,1-1,,30,7,44,10,6,24,7,7,0,7,0,3,1,23,6,23,34,0.9973567468760349,46.402476866997176,,
2985,2021,2,NCAAF_20210911_APLST@MIAMI,Miami (Fla.),Hurricanes,App. St.,Mountaineers,1-1,1-1,0,12,14,25,23,9,3,7,6,7,7,3,6,0,-2,2,-2,2,0.6695244997939218,7.29719735584149,0.7629199361629554,10.47128265446895
2986,2021,2,NCAAF_20210911_EKY@LVILLE,Louisville,,E. Kentucky,,1-1,1-1,,20,3,30,3,7,13,7,3,0,3,0,0,0,17,7,17,27,0.9617876233695017,29.478546252449405,,
2987,2021,2,NCAAF_20210911_EMICH@WISC,Wisconsin,Badgers,E. Michigan,Eagles,1-1,1-1,1,24,0,34,7,7,17,3,7,0,0,0,7,0,24,7,24,27,0.968139889134912,30.848046273555155,,
2988,2021,2,NCAAF_20210911_GRAM@USM,So. Miss,,Grambling,,1-1,1-1,,10,0,37,0,7,3,10,17,0,0,0,0,0,10,7,10,37,0.853031457598928,17.461406972231316,,
2989,2021,2,NCAAF_20210911_HAMP@ODU,Old Dominion,,Hampton,,1-1,1-1,,34,0,47,7,10,24,7,6,0,0,7,0,0,34,10,34,40,0.9660367023851297,30.37156754181001,,
2990,2021,2,NCAAF_20210911_LIB@TROY,Troy,Trojans,Liberty,Flames,1-1,2-0,1,7,14,13,21,7,0,0,6,7,7,0,7,-1,-7,0,-7,-8,0.5181322329762792,0.7564456949885425,0.26772377062656216,-9.066557932729921
2991,2021,2,NCAAF_20210911_MEMP@ARKST,Arkansas St.,,Memphis,,1-1,2-0,,23,34,50,55,10,13,7,20,20,14,7,14,-1,-11,-10,-11,-5,0.20995843933733227,-13.419197483155358,,
2992,2021,2,NCAAF_20210911_NCST@MISSST,Miss. State,Bulldogs,NC State,Wolfpack,2-0,1-1,0,14,3,24,10,7,7,7,3,0,3,0,7,1,11,7,11,14,0.6273266827680871,5.403533832128915,,
2993,2021,2,NCAAF_20210911_NICHST@LALAF,Louisiana,,Nicholls St.,,1-1,0-2,,17,10,27,24,10,7,7,3,7,3,0,14,1,7,3,7,3,0.8511200475867478,17.323737937570513,,
2994,2021,2,NCAAF_20210911_NMEXST@NMEX,New Mexico,,New Mexico St.,,2-0,0-3,,24,20,34,25,14,10,3,7,3,17,2,3,2,4,11,4,9,0.6149980574828895,4.864289956050243,,
2995,2021,2,NCAAF_20210911_NTEXAS@SMU,SMU,,North Texas,,2-0,1-1,,7,6,35,12,0,7,14,14,3,3,6,0,1,1,-3,1,23,0.7671049706619172,12.134461575323257,,
2996,2021,2,NCAAF_20210911_SELOU@LATECH,Louisiana Tech,,SE Louisiana,,1-1,1-1,,24,21,45,42,14,10,14,7,7,14,14,7,0,3,7,3,3,0.49054885956512095,-0.3941864607984371,,
2997,2021,2,NCAAF_20210911_SFA@TXTECH,Texas Tech,,S.F. Austin,,2-0,1-1,,7,13,28,22,7,0,14,7,7,6,0,9,1,-6,0,-6,6,0.9958954924295704,43.978618123465594,,
2998,2021,2,NCAAF_20210911_SIL@KSTATE,Kansas State,,S. Illinois,,2-0,1-1,,21,23,31,23,14,7,3,7,0,23,0,0,1,-2,14,-2,8,0.9193603732254972,23.305450121996046,,
2999,2021,2,NCAAF_20210911_TEXAS@ARK,Arkansas,Razorbacks,Texas,Longhorns,2-0,1-1,1,16,0,40,21,3,13,17,7,0,0,7,14,1,16,3,16,19,0.11496190915796012,-19.97418315320101,,
3000,2021,2,NCAAF_20210911_TXSO@BAYLOR,Baylor,Bears,Texas Southern,Tigers,2-0,0-2,1,42,0,66,7,21,21,10,14,0,0,0,7,2,42,21,42,59,0.9998718332973249,60.82400744387178,,
3001,2021,2,NCAAF_20210911_WCAR@OKLA,Oklahoma,Sooners,W. Carolina,Catamounts,2-0,0-2,0,45,0,76,0,17,28,17,14,0,0,0,0,2,45,17,45,76,0.9998893104135569,61.44680041170977,,
3002,2021,2,NCAAF_20210911_AP@MISS,Ole Miss,Rebels,Austin Peay,Governors,2-0,1-1,0,37,7,54,17,14,23,14,3,0,7,3,7,1,30,14,30,37,0.9764198395232252,33.022980597586866,,
3003,2021,2,NCAAF_20210911_GAST@UNC,North Carolina,Tar Heels,Georgia St.,Panthers,1-1,0-2,0,24,10,59,17,14,10,21,14,3,7,0,7,1,14,11,14,42,0.8848941547570837,19.961848280066306,,
3004,2021,2,NCAAF_20210911_HOW@MD,Maryland,,Howard,,2-0,0-2,,38,0,62,0,14,24,14,10,0,0,0,0,2,38,14,38,62,0.9960643173889031,44.214676384098766,,
3005,2021,2,NCAAF_20210911_IDAHO@IND,Indiana,,Idaho,,1-1,1-1,,35,7,56,14,21,14,7,14,0,7,7,0,0,28,21,28,42,0.9581208808888011,28.770890428118037,,
3006,2021,2,NCAAF_20210911_MIZZOU@UK,Kentucky,Wildcats,Missouri,Tigers,2-0,1-1,1,21,14,35,28,14,7,7,7,7,7,7,7,1,7,7,7,7,0.43225897538164104,-2.8387805111017315,,
3007,2021,2,NCAAF_20210911_JAXST@FSU,Florida State,,Jacksonville St.,,0-2,1-1,,14,7,17,20,0,14,3,0,0,7,0,13,-1,7,0,7,-3,0.9081154909197834,22.11516126983429,,
3008,2021,2,NCAAF_20210911_MCN@LSU,LSU,Tigers,McNeese St.,Cowboys,1-1,0-2,0,17,0,34,7,7,10,7,10,0,0,0,7,1,17,7,17,27,0.9967630764044088,45.29985074308047,,
3009,2021,2,NCAAF_20210911_WASH@MICH,Michigan,Wolverines,Washington,Huskies,2-0,0-2,0,10,0,31,10,3,7,7,14,0,0,3,7,2,10,3,10,21,0.6440782412269246,6.145565544126839,,
3010,2021,2,NCAAF_20210911_CPOLY@FRESNO,Fresno St.,,Cal-Poly,,2-1,1-1,,35,10,63,10,7,28,21,7,0,10,0,0,1,25,7,25,53,0.9960626455277105,44.21229461887356,,
3011,2021,2,NCAAF_20210911_SDGST@ARIZ,Arizona,Wildcats,San Diego St.,Aztecs,0-2,2-0,0,7,35,14,38,7,0,0,7,21,14,3,0,-2,-28,-14,-28,-24,0.44082478677984593,-2.476958098804289,,
3012,2021,2,NCAAF_20210911_VANDY@COLOST,Colorado St.,Rams,Vanderbilt,Commodores,0-2,1-1,1,14,7,21,24,7,7,0,7,0,7,14,3,-1,7,7,7,-3,0.49139111085283704,-0.35905227502644266,,
3013,2021,2,NCAAF_20210911_UTAH@BYU,BYU,Cougars,Utah,Utes,2-0,1-1,1,16,7,26,17,3,13,7,3,0,7,0,10,1,9,3,9,9,0.22421410582325774,-12.61182458425128,,
3014,2021,2,NCAAF_20210911_IDST@NEVADA,Nevada,,Idaho State,,2-0,0-2,,21,7,49,10,14,7,7,21,7,0,3,0,2,14,7,14,39,0.7688838548760839,12.231459069689208,,
3015,2021,2,NCAAF_20210911_STNFRD@USC,USC,Trojans,Stanford,Cardinal,1-1,1-1,0,10,21,28,42,0,10,3,15,7,14,14,7,0,-11,-7,-11,-14,0.578524015994885,3.296195988931686,,
3016,2021,2,NCAAF_20210911_UNLV@ARIZST,Arizona St.,Sun Devils,UNLV,Rebels,2-0,0-2,1,14,10,37,10,0,14,7,16,3,7,0,0,2,4,-3,4,27,0.911830483122813,22.49572774190665,,
3017,2021,2,NCAAF_20210911_HAWAII@OREGST,Oregon State,Beavers,Hawaii,Rainbow Warriors,1-1,1-2,1,24,7,45,27,21,3,7,14,0,7,13,7,0,17,21,17,18,0.5909338970800628,3.8257491390090763,,
3018,2021,2,NCAAF_20210910_KANSAS@CSTCAR,C. Carolina,Chanticleers,Kansas,Jayhawks,2-0,1-1,0,28,15,49,22,7,21,7,14,9,6,7,0,1,13,-2,13,27,0.4804522174653164,-0.8155456030328878,,
3019,2021,2,NCAAF_20210910_NCAT@DUKE,Duke,Blue Devils,NC A&T,Aggies,1-1,0-2,1,21,14,45,17,0,21,21,3,7,7,3,0,1,7,-7,7,28,0.9110185971592872,22.411553665869633,,
3020,2021,2,NCAAF_20210910_NDK@UTAHST,Utah St.,Aggies,North Dakota,Fighting Hawks,2-0,1-1,0,20,21,48,24,7,13,7,21,21,0,3,0,1,-1,-14,-1,24,0.830962575481135,15.93828404468627,,
3021,2021,2,NCAAF_20210910_UTEP@BOISE,Boise St.,Broncos,UTEP,Miners,1-1,2-1,0,41,13,54,13,10,31,10,3,3,10,0,0,-1,28,7,28,41,0.9870024228427632,37.03970487470201,,
3022,2021,3,NCAAF_20210919_SJST@HAWAII,Hawaii,,San Jose St.,,1-3,2-1,,7,14,13,17,7,0,6,0,0,14,0,3,-1,-7,7,-7,-4,0.5934514557396142,3.9204169922313667,,
3023,2021,3,NCAAF_20210918_ALBANY@CUSE,Syracuse,Orange,Albany,Great Danes,2-1,0-3,1,45,10,62,24,21,24,10,7,10,0,0,14,2,35,11,35,38,0.963989581281069,29.829981331008298,,
3024,2021,3,NCAAF_20210918_BC@TEMPLE,Temple,Owls,Boston College,Eagles,1-2,3-0,0,0,21,3,28,0,0,0,3,14,7,0,7,-2,-21,-14,-21,-25,0.2864474619424938,-9.348563742414967,,
3025,2021,3,NCAAF_20210918_CINCY@IND,Indiana,Hoosiers,Cincinnati,Bearcats,1-2,3-0,0,14,10,24,38,7,7,10,0,0,10,13,15,-2,4,7,4,-14,0.6111109513055483,4.679574077395159,,
3026,2021,3,NCAAF_20210918_CSTCAR@BUFF,Buffalo,Bulls,C. Carolina,Chanticleers,1-2,3-0,1,14,14,25,28,14,0,3,8,7,7,7,7,-2,0,7,0,-3,0.7262520986560608,9.974081115636181,,
3027,2021,3,NCAAF_20210918_MICHST@MIAMI,Miami (Fla.),Hurricanes,Michigan St.,Spartans,1-2,3-0,1,7,10,17,38,0,7,7,3,0,10,7,21,-2,-3,0,-3,-21,0.5309528949099289,1.287812825851006,,
3028,2021,3,NCAAF_20210918_NEB@OKLA,Oklahoma,Sooners,Nebraska,Cornhuskers,3-0,2-2,1,7,3,23,16,7,0,9,7,3,0,6,7,1,4,4,4,7,0.8785209196430626,19.361027560260027,,
3029,2021,3,NCAAF_20210918_NILL@MICH,Michigan,Wolverines,N. Illinois,Huskies,3-0,1-2,0,35,3,63,10,14,21,28,0,3,0,0,7,2,32,11,32,53,0.9686961885477573,30.874311824055212,,
3030,2021,3,NCAAF_20210918_NMEX@TXAM,Texas A&M,Aggies,New Mexico,Lobos,3-0,2-1,0,24,0,34,0,14,10,10,0,0,0,0,0,1,24,14,24,34,0.959283399253979,28.892191882908605,,
3031,2021,3,NCAAF_20210918_SEMOST@MIZZOU,Missouri,Tigers,SE Missouri St.,Redhawks,2-1,0-3,1,38,0,59,28,21,17,14,7,0,0,7,21,2,38,21,38,31,0.99768304682652,46.949646630870234,,
3032,2021,3,NCAAF_20210918_TNCHAT@UK,Kentucky,Wildcats,Chattanooga,Mocs,3-0,1-2,1,14,10,28,23,7,7,0,14,7,3,3,10,2,4,0,4,5,0.9820065627196235,34.77276438162971,,
3033,2021,3,NCAAF_20210918_TNTECH@TENN,Tennessee,Volunteers,Tenn. Tech,Golden Eagles,2-1,0-3,1,28,0,56,0,14,14,21,7,0,0,0,0,2,28,14,28,56,0.9967315908834109,45.09457324577784,,
3034,2021,3,NCAAF_20210918_UCONN@ARMY,Army,Black Knights,UConn,Huskies,3-0,0-4,0,42,0,52,21,14,28,7,3,0,0,14,7,3,42,14,42,31,0.9415176001586757,25.99392653503685,,
3035,2021,3,NCAAF_20210918_VATECH@WVU,West Virginia,Mountaineers,Virginia Tech,Hokies,2-1,2-1,0,24,7,27,21,14,10,3,0,7,0,7,7,0,17,7,17,6,0.533490440144239,1.3936283083310173,,
3036,2021,3,NCAAF_20210918_WMICH@PITT,Pittsburgh,Panthers,W. Michigan,Broncos,2-1,2-1,0,27,27,41,44,7,20,7,7,14,13,7,10,0,0,-7,0,-3,0.7406059876512253,10.698660370480525,,
3037,2021,3,NCAAF_20210918_MINN@COLO,Colorado,Buffaloes,Minnesota,Golden Gophers,1-2,2-1,1,0,13,0,30,0,0,0,0,0,13,7,10,-1,-13,0,-13,-30,0.28453331069744814,-9.44197648152658,,
3038,2021,3,NCAAF_20210918_NEVADA@KSTATE,Kansas State,Wildcats,Nevada,Wolf Pack,3-0,2-1,1,17,7,38,17,7,10,0,21,7,0,10,0,1,10,0,10,21,0.8110383244084192,14.620433705781124,,
3039,2021,3,NCAAF_20210918_PURDUE@ND,Notre Dame,Fighting Irish,Purdue,Boilermakers,3-0,2-1,1,10,3,27,13,0,10,7,10,3,0,10,0,1,7,-3,7,14,0.7363932982070052,10.483941625676493,,
3040,2021,3,NCAAF_20210918_BAMA@FLA,Florida,Gators,Alabama,Crimson Tide,2-1,3-0,0,9,21,29,31,3,6,14,6,21,0,7,3,-1,-12,-18,-12,-2,0.12343407065170309,-19.20126743700979,0.07739989595301622,-20.90633496755757
3041,2021,3,NCAAF_20210918_BAYLOR@KANSAS,Kansas,Jayhawks,Baylor,Bears,1-2,3-0,0,7,14,7,45,0,7,0,0,7,7,14,17,-2,-7,-7,-7,-38,0.17288421887122296,-15.633563648231757,,
3042,2021,3,NCAAF_20210918_BRY@AKRON,Akron,,Bryant,,1-2,1-2,,14,7,35,14,7,7,0,21,0,7,7,0,0,7,7,7,21,,,,
3043,2021,3,NCAAF_20210918_DE@RUT,Rutgers,,Delaware,,3-0,2-1,,35,10,45,13,7,28,3,7,0,10,3,0,1,25,7,25,32,0.5724308445698804,3.027232500091486,,
3044,2021,3,NCAAF_20210918_ELON@APLST,App. St.,,Elon,,2-1,1-2,,13,3,44,10,7,6,14,17,3,0,7,0,1,10,4,10,34,0.9930889067312959,40.82131307202462,,
3045,2021,3,NCAAF_20210918_EMICH@UMASS,UMass,,E. Michigan,,0-3,2-1,,7,21,28,42,0,7,7,14,14,7,7,14,-2,-14,-14,-14,-14,0.12386227923003923,-19.166511809508847,,
3046,2021,3,NCAAF_20210918_FSU@WAKE,Wake Forest,Demon Deacons,Florida State,Seminoles,3-0,0-3,1,27,14,35,14,14,13,8,0,7,7,0,0,3,13,7,13,21,0.5995488179679305,4.181525955458255,,
3047,2021,3,NCAAF_20210918_GATECH@CLEM,Clemson,Tigers,Georgia Tech,Yellow Jackets,2-1,1-2,1,7,3,14,8,7,0,0,7,0,3,0,5,1,4,7,4,6,0.9697335040544808,31.121766041695082,,
3048,2021,3,NCAAF_20210918_IDAHO@OREGST,Oregon State,,Idaho,,2-1,1-2,,28,0,42,0,14,14,14,0,0,0,0,0,1,28,14,28,42,0.7716118841758771,12.339420451033106,,
3049,2021,3,NCAAF_20210918_KENTST@IOWA,Iowa,Hawkeyes,Kent St.,Golden Flashes,3-0,1-2,1,16,7,30,7,9,7,7,7,7,0,0,0,2,9,2,9,23,0.9928481477249078,40.617242695418554,,
3050,2021,3,NCAAF_20210918_LIUPOST@MIAOH,Miami-OH,,LIU,,1-2,0-3,,21,7,42,7,7,14,14,7,0,7,0,0,1,14,7,14,35,0.9964153768867519,44.58577527056855,,
3051,2021,3,NCAAF_20210918_SMU@LATECH,Louisiana Tech,Bulldogs,SMU,Mustangs,1-2,3-0,1,14,16,37,39,7,7,14,9,7,9,17,6,-2,-2,0,-2,-2,0.26412810276053855,-10.457488638579889,,
3052,2021,3,NCAAF_20210918_TULSA@OHIOST,Ohio State,Buckeyes,Tulsa,Golden Hurricane,2-1,0-3,1,13,6,41,20,3,10,14,14,3,3,7,7,2,7,0,7,21,0.9915748048404668,39.62917391105782,,
3053,2021,3,NCAAF_20210918_USC@WASHST,Washington St.,Cougars,USC,Trojans,1-2,2-1,0,14,7,14,45,7,7,0,0,0,7,28,10,-1,7,7,7,-31,0.4779602813977335,-0.9165205012511706,,
3054,2021,3,NCAAF_20210918_BALLST@WYO,Wyoming,,Ball St.,,3-0,1-2,,31,0,45,12,10,21,0,14,0,0,6,6,2,31,10,31,33,0.7915248012428342,13.459630707627639,,
3055,2021,3,NCAAF_20210918_COLOST@TOLEDO,Toledo,,Colorado St.,,1-2,1-2,,3,3,6,22,0,3,3,0,3,0,10,9,0,0,-3,0,-16,0.5718091830068123,3.0009634690966323,,
3056,2021,3,NCAAF_20210918_GAS@ARK,Arkansas,Razorbacks,Ga. Southern,Eagles,3-0,1-2,0,24,10,45,10,14,10,14,7,0,10,0,0,2,14,14,14,35,0.6684862601180319,7.225196375032851,0.9074417732953497,19.471971751813697
3057,2021,3,NCAAF_20210918_MISSST@MEMP,Memphis,Tigers,Miss. State,Bulldogs,3-0,2-1,0,7,17,31,29,7,0,7,17,3,14,0,12,1,-10,4,-10,2,0.3710201787827573,-5.457859897041885,0.3471185742744576,-5.77637950024112
3058,2021,3,NCAAF_20210918_NWEST@DUKE,Duke,Blue Devils,Northwestern,Wildcats,2-1,1-2,0,30,7,30,23,21,9,0,0,0,7,13,3,1,23,21,23,7,0.2832982765826104,-9.502406787909763,,
3059,2021,3,NCAAF_20210918_SACST@CAL,California,,Sacramento St.,,1-2,1-2,,21,6,42,30,14,7,14,7,6,0,14,10,0,15,8,15,12,0.8922047010575134,20.533569964364347,,
3060,2021,3,NCAAF_20210918_ARKST@WASH,Washington,,Arkansas St.,,1-2,1-2,,28,0,52,3,14,14,7,17,0,0,3,0,0,28,14,28,49,0.9265061272901127,24.047455760671028,,
3061,2021,3,NCAAF_20210918_MURYST@BGREEN,Bowling Green,,Murray St.,,1-2,1-2,,10,10,27,10,7,3,10,7,0,10,0,0,0,0,7,0,17,0.6698875687932757,7.289294408225487,,
3062,2021,3,NCAAF_20210918_ECU@MRSHL,Marshall,,East Carolina,,2-1,1-2,,24,21,38,42,10,14,14,0,7,14,0,21,1,3,3,3,-4,0.7852438049850758,13.099860676906246,,
3063,2021,3,NCAAF_20210918_FORD@FAU,FAU,,Fordham,,2-1,0-3,,14,7,45,14,7,7,14,17,0,7,0,7,2,7,7,7,31,0.9978349668333533,47.308128840206564,,
3064,2021,3,NCAAF_20210918_MTSU@TXSA,UTSA,,Middle Tenn.,,3-0,1-2,,10,0,27,13,7,3,7,10,0,0,0,13,2,10,7,10,14,0.34752498390724407,-6.500152425371994,,
3065,2021,3,NCAAF_20210918_ODU@LIB,Liberty,,Old Dominion,,3-0,1-2,,28,17,45,17,14,14,14,3,3,14,0,0,2,11,11,11,28,0.7907513436510729,13.414987580053548,,
3066,2021,3,NCAAF_20210918_CHARLO@GAST,Georgia St.,,Charlotte,,1-2,2-1,,7,7,20,9,0,7,6,7,0,7,2,0,-1,0,0,0,11,0.5194222782830464,0.8075824707400443,,
3067,2021,3,NCAAF_20210918_FAMU@SFLA,South Florida,,Florida A&M,,1-2,1-2,,24,3,38,17,10,14,7,7,3,0,7,7,0,21,7,21,21,0.9952465838010475,43.00042142959717,,
3068,2021,3,NCAAF_20210918_FIU@TXTECH,Texas Tech,,FIU,,3-0,1-2,,35,14,54,21,7,28,9,10,7,7,7,0,2,21,0,21,33,0.8268890703879564,15.6188732457789,,
3069,2021,3,NCAAF_20210918_GRAM@HOU,Houston,,Grambling,,2-1,1-2,,21,0,45,0,7,14,21,3,0,0,0,0,1,21,7,21,45,0.9798369362310743,33.998687448794385,,
3070,2021,3,NCAAF_20210918_SC@UGA,Georgia,Bulldogs,South Carolina,Gamecocks,3-0,2-1,1,26,6,40,13,14,12,14,0,6,0,0,7,1,20,8,20,27,0.9069830018858449,21.927490407047344,0.9811584843058988,30.538330707145377
3071,2021,3,NCAAF_20210918_TROY@USM,So. Miss,,Troy,,1-2,2-1,,3,0,9,21,3,0,0,6,0,0,14,7,-1,3,3,3,-12,0.3986372241722177,-4.259403161078922,0.2256366600062114,-11.068899647150843
3072,2021,3,NCAAF_20210918_UIW@TXSTSM,Texas St.,,Incarnate Word,,1-2,2-1,,17,14,34,42,7,10,7,10,14,0,14,14,-1,3,-7,3,-8,0.9447886099292315,26.469056746116962,,
3073,2021,3,NCAAF_20210918_AUBURN@PSU,Penn State,Nittany Lions,Auburn,Tigers,3-0,2-1,1,14,10,28,20,7,7,7,7,3,7,7,3,1,4,4,4,8,0.6170791128117254,4.938290428661844,,
3074,2021,3,NCAAF_20210918_CMICH@LSU,LSU,Tigers,C. Michigan,Chippewas,2-1,1-2,1,35,7,49,21,21,14,7,7,7,0,7,7,1,28,14,28,28,0.9505197298565354,27.358129441569417,,
3075,2021,3,NCAAF_20210918_FUR@NCST,NC State,,Furman,,2-1,2-1,,38,0,45,7,10,28,7,0,0,0,7,0,0,38,10,38,38,0.9091595199575573,22.1462712670816,,
3076,2021,3,NCAAF_20210918_STONYBRK@OREG,Oregon,Ducks,Stony Brook,Seawolves,3-0,1-2,0,17,7,48,7,10,7,14,17,7,0,0,0,2,10,3,10,41,0.9993641997107103,53.43094533815622,,
3077,2021,3,NCAAF_20210918_UAB@NTEXAS,North Texas,,UAB,,1-2,2-1,,0,30,6,40,0,0,0,6,17,13,3,7,-1,-30,-17,-30,-34,0.4048758467561555,-3.9919479201645345,,
3078,2021,3,NCAAF_20210918_UTAHST@AF,Air Force,,Utah St.,,2-1,3-0,,24,13,45,49,10,14,14,7,7,6,21,15,-1,11,3,11,-4,0.5033589794225255,0.1396135333861821,,
3079,2021,3,NCAAF_20210918_UVA@UNC,North Carolina,Tar Heels,Virginia,Cavaliers,2-1,2-1,0,24,28,59,39,21,3,21,14,7,21,3,8,0,-4,14,-4,20,0.483125842228846,-0.7015630495823189,0.6708056091083137,6.496786676314457
3080,2021,3,NCAAF_20210918_ALCORN@SALA,South Alabama,,Alcorn St.,,3-0,1-2,,7,14,28,21,7,0,21,0,0,14,0,7,2,-7,7,-7,7,0.6994193513327509,8.667693839268622,,
3081,2021,3,NCAAF_20210918_JACKST@LAMON,UL-Monroe,,Jackson St.,,1-1,2-1,,3,7,12,7,3,0,3,6,0,7,0,0,-1,-4,3,-4,5,0.9443263945548823,26.400593951014798,,
3082,2021,3,NCAAF_20210918_RICE@TEXAS,Texas,Longhorns,Rice,Owls,2-1,0-3,1,44,0,58,0,16,28,14,0,0,0,0,0,2,44,16,44,58,0.9834728791162936,35.3423094979579,,
3083,2021,3,NCAAF_20210918_SCST@NMEXST,New Mexico St.,,SC State,,1-3,0-3,,36,13,43,35,15,21,7,0,0,13,7,15,1,23,15,23,8,0.6576717847443985,6.7340537285589335,,
3084,2021,3,NCAAF_20210918_STNFRD@VANDY,Vanderbilt,Commodores,Stanford,Cardinal,1-2,2-1,0,14,27,23,41,7,7,3,6,14,13,7,7,-1,-13,-7,-13,-18,0.18339639644047057,-14.964802399504833,,
3085,2021,3,NCAAF_20210918_TULANE@MISS,Ole Miss,Rebels,Tulane,Green Wave,3-0,1-2,1,40,21,61,21,19,21,21,0,7,14,0,0,2,19,12,19,40,0.5990673981777439,4.160873093012469,,
3086,2021,3,NCAAF_20210918_OKLAST@BOISE,Boise St.,Broncos,Oklahoma State,Cowboys,1-2,3-0,1,20,21,20,21,10,10,0,0,7,14,0,0,-2,-1,3,-1,-1,0.4233429765710991,-3.2060196603709983,,
3087,2021,3,NCAAF_20210918_NAZ@ARIZ,Arizona,Wildcats,N. Arizona,Lumberjacks,0-3,1-2,1,13,7,19,21,10,3,0,6,0,7,7,7,-1,6,10,6,-2,0.9692266832471422,30.999999999999204,,
3088,2021,3,NCAAF_20210918_ARIZST@BYU,BYU,Cougars,Arizona St.,Sun Devils,3-0,2-1,1,21,7,27,17,7,14,0,6,7,0,10,0,1,14,0,14,10,0.41643270527897425,-3.499171464016399,,
3089,2021,3,NCAAF_20210918_IOWAST@UNLV,UNLV,Rebels,Iowa St.,Cyclones,0-3,2-1,0,0,24,3,48,0,0,3,0,7,17,14,10,-2,-24,-7,-24,-45,0.031617510964827567,-30.80081476209466,,
3090,2021,3,NCAAF_20210918_FRESNO@UCLA,UCLA,Bruins,Fresno St.,Bulldogs,2-1,3-1,0,10,23,37,40,7,3,7,20,6,17,3,14,-1,-13,1,-13,-3,0.4938033211028241,-0.25756775975514756,,
3091,2021,3,NCAAF_20210917_UCF@LVILLE,Louisville,Cardinals,UCF,Knights,2-1,2-1,1,21,14,42,35,7,14,7,14,7,7,7,14,0,7,0,7,7,0.2003808853542327,-13.932837945167648,0.31549452423762747,-7.058045091004942
3092,2021,3,NCAAF_20210917_MD@ILL,Illinois,Fighting Illini,Maryland,Terrapins,1-3,3-0,1,3,3,17,20,0,3,7,7,0,3,7,10,-2,0,0,0,-3,0.3954940329206301,-4.394571136581931,,
3093,2021,3,NCAAF_20210916_OHIO@LALAF,Louisiana,Ragin' Cajuns,Ohio,Bobcats,2-1,0-3,0,21,7,49,14,7,14,7,21,0,7,7,0,2,14,7,14,35,0.41416392939541513,-3.595653370590867,,
3094,2021,4,NCAAF_20210925_BGREEN@MINN,Minnesota,Golden Gophers,Bowling Green,Falcons,2-2,2-2,0,3,7,10,14,3,0,7,0,0,7,7,0,0,-4,3,-4,-4,0.9892036087192853,38.10999171998242,,
3095,2021,4,NCAAF_20210925_BOISE@UTAHST,Utah St.,Aggies,Boise St.,Broncos,3-1,2-2,1,0,10,3,27,0,0,0,3,10,0,7,10,1,-10,-10,-10,-24,0.30236705207608694,-8.585980557870926,,
3096,2021,4,NCAAF_20210925_FIU@CMICH,C. Michigan,Chippewas,FIU,Panthers,2-2,1-3,1,10,14,31,27,0,10,0,21,0,14,13,0,1,-4,0,-4,4,0.5509491407413524,2.124243086878778,,
3097,2021,4,NCAAF_20210925_LSU@MISSST,Miss. State,Bulldogs,LSU,Tigers,2-2,3-1,1,3,7,25,28,0,3,7,15,7,0,14,7,-1,-4,-7,-4,-3,0.3241055154595991,-7.568215478633988,0.36872820823144226,-4.989738460605793
3098,2021,4,NCAAF_20210925_MIAOH@ARMY,Army,Black Knights,Miami-OH,RedHawks,4-0,1-3,0,17,3,23,10,7,10,0,6,0,3,0,7,3,14,7,14,13,0.6985077887703182,8.62759748524661,,
3099,2021,4,NCAAF_20210925_ND@WISC,Wisconsin,Badgers,Notre Dame,Fighting Irish,1-2,4-0,0,3,10,13,41,3,0,7,3,0,10,0,31,-3,-7,3,-7,-28,0.5639850653138612,2.671991689384413,,
3100,2021,4,NCAAF_20210925_NH@PITT,Pittsburgh,Panthers,New Hamp.,Wildcats,3-1,3-1,0,49,7,77,7,28,21,21,7,0,7,0,0,0,42,28,42,70,0.917713335132295,23.054768039797523,,
3101,2021,4,NCAAF_20210925_NOVA@PSU,Penn State,Nittany Lions,Villanova,Wildcats,4-0,3-1,0,17,3,38,17,7,10,14,7,3,0,0,14,1,14,4,14,21,0.9783161236673097,33.5100805773634,,
3102,2021,4,NCAAF_20210925_OHIO@NWEST,Northwestern,Wildcats,Ohio,Bobcats,2-2,0-4,0,17,0,35,6,14,3,0,18,0,0,0,6,2,17,14,17,29,0.7535986651942694,11.3769510301139,,
3103,2021,4,NCAAF_20210925_RICH@VATECH,Virginia Tech,Hokies,Richmond,Spiders,3-1,2-2,1,14,7,21,10,7,7,7,0,0,7,3,0,1,7,7,7,11,0.9783020776539477,33.5055879980207,,
3104,2021,4,NCAAF_20210925_SMU@TCU,TCU,Horned Frogs,SMU,Mustangs,2-1,4-0,0,21,21,34,42,14,7,6,7,14,7,14,7,-2,0,0,0,-8,0.7625884271905914,11.854609391139661,,
3105,2021,4,NCAAF_20210925_TXTECH@TEXAS,Texas,Longhorns,Texas Tech,Red Raiders,3-1,3-1,1,42,14,70,35,14,28,21,7,0,14,14,7,0,28,14,28,35,0.7042019432720894,8.899820438355164,,
3106,2021,4,NCAAF_20210925_UGA@VANDY,Vanderbilt,Commodores,Georgia,Bulldogs,1-3,4-0,1,0,38,0,62,0,0,0,0,35,3,17,7,-3,-38,-35,-38,-62,0.02304646135527011,-33.08527453997044,0.003588311145364398,-40.01832905038128
3107,2021,4,NCAAF_20210925_WAG@TEMPLE,Temple,Owls,Wagner,Seahawks,2-2,0-4,0,17,7,41,7,0,17,17,7,7,0,0,0,2,10,-7,10,34,0.9909799223263337,39.22697394766817,,
3108,2021,4,NCAAF_20210925_CCTST@MIAMI,Miami (Fla.),Hurricanes,CCSU,Blue Devils,2-2,1-3,1,49,0,69,0,21,28,13,7,0,0,0,0,1,49,21,49,69,0.9891793505502622,38.09588310899073,,
3109,2021,4,NCAAF_20210925_UMASS@CSTCAR,C. Carolina,Chanticleers,UMass,Minutemen,4-0,0-4,0,36,0,53,3,13,23,14,3,0,0,0,3,4,36,13,36,50,0.8296931777466721,15.807507258712576,,
3110,2021,4,NCAAF_20210925_SJST@WMICH,W. Michigan,Broncos,San Jose St.,Spartans,3-1,2-2,1,20,3,23,3,13,7,0,3,3,0,0,0,1,17,10,17,20,0.7023293987428836,8.81003769969766,,
3111,2021,4,NCAAF_20210925_TOLEDO@BALLST,Ball St.,Cardinals,Toledo,Rockets,1-3,2-2,1,9,14,12,22,6,3,0,3,7,7,0,8,-1,-5,-1,-5,-10,0.24223252792557814,-11.597258363622245,,
3112,2021,4,NCAAF_20210925_TXSTSM@EMICH,E. Michigan,Eagles,Texas St.,Bobcats,3-1,1-3,0,28,14,59,21,14,14,10,21,7,7,7,0,2,14,7,14,38,0.8125038164937805,14.716143226366853,,
3113,2021,4,NCAAF_20210925_ME@NILL,N. Illinois,Huskies,Maine,Black Bears,2-2,1-3,1,21,14,41,14,7,14,3,17,7,7,0,0,1,7,0,7,27,0.798754733941997,13.887092741305196,,
3114,2021,4,NCAAF_20210925_WASHST@UTAH,Utah,Utes,Washington St.,Cougars,2-2,1-3,0,7,6,24,13,0,7,3,14,0,6,7,0,1,1,0,1,11,0.6216862180757431,5.140799455986212,,
3115,2021,4,NCAAF_20210925_COLOST@IOWA,Iowa,Hawkeyes,Colorado St.,Rams,4-0,1-3,0,7,14,24,14,0,7,14,3,0,14,0,0,3,-7,0,-7,10,0.9540173020054941,27.95262251770737,,
3116,2021,4,NCAAF_20210925_ILL@PURDUE,Purdue,,Illinois,,3-1,1-4,,6,3,13,9,6,0,0,7,0,3,3,3,2,3,6,3,4,0.7915614273870202,13.466911670048603,,
3117,2021,4,NCAAF_20210925_IOWAST@BAYLOR,Baylor,Bears,Iowa St.,Cyclones,4-0,2-2,0,21,13,31,29,7,14,7,3,7,6,10,6,2,8,0,8,2,0.24722334302669724,-11.333747757783613,0.09885485505803882,-19.17318089109665
3118,2021,4,NCAAF_20210925_KENTST@MD,Maryland,,Kent St.,,4-0,1-3,,24,9,37,16,7,17,13,0,6,3,0,7,3,15,1,15,21,0.8749482240862945,19.077721393483785,,
3119,2021,4,NCAAF_20210925_LVILLE@FSU,Florida State,Seminoles,Louisville,Cardinals,0-4,3-1,0,13,31,23,31,0,13,7,3,17,14,0,0,-3,-18,-17,-18,-8,0.486745052515137,-0.5512385294605338,,
3120,2021,4,NCAAF_20210925_RUT@MICH,Michigan,Wolverines,Rutgers,Scarlet Knights,4-0,3-1,1,20,3,20,13,7,13,0,0,3,0,7,3,1,17,4,17,7,0.9633602730932046,29.710379168721488,,
3121,2021,4,NCAAF_20210925_TWST@SDGST,San Diego St.,,Towson,,4-0,1-3,,21,14,48,21,7,14,24,3,7,7,0,7,3,7,0,7,27,0.9771742609590292,33.15262499318351,,
3122,2021,4,NCAAF_20210925_TXAM@ARK,Arkansas,Razorbacks,Texas A&M,Aggies,4-0,3-1,0,17,3,20,10,10,7,0,3,0,3,7,0,1,14,10,14,10,0.16853792124249967,-15.923714551659828,0.28179653738001464,-8.596166635833413
3123,2021,4,NCAAF_20210925_TXSA@MEMP,Memphis,,UTSA,,3-1,4-0,,21,7,28,31,21,0,7,0,0,7,7,17,-1,14,21,14,-3,0.9051813287971995,21.757578061534332,0.5225609979877632,0.8422152805024439
3124,2021,4,NCAAF_20210925_WYO@UCONN,UConn,Huskies,Wyoming,Cowboys,0-5,4-0,1,13,3,22,24,10,3,0,9,0,3,7,14,-4,10,10,10,-2,0.06190577009523679,-25.52830258439485,,
3125,2021,4,NCAAF_20210925_GAST@AUBURN,Auburn,Tigers,Georgia St.,Panthers,3-1,1-3,0,12,24,34,24,6,6,7,15,3,21,0,0,2,-12,3,-12,10,0.9876188297183895,37.24135658536204,0.9732440065060488,28.73907923210743
3126,2021,4,NCAAF_20210925_KANSAS@DUKE,Duke,,Kansas,,3-1,1-3,,21,24,52,33,7,14,21,10,3,21,3,6,2,-3,4,-3,19,0.7527183995192072,11.330688769804851,0.72835550141627,9.047683924802186
3127,2021,4,NCAAF_20210925_ARKST@TULSA,Tulsa,Golden Hurricane,Arkansas St.,Red Wolves,1-3,1-3,0,24,14,41,34,7,17,14,3,14,0,17,3,0,10,-7,10,7,0.5641020591937151,2.6769199025380885,,
3128,2021,4,NCAAF_20210925_BUFF@ODU,Old Dominion,,Buffalo,,1-3,2-2,,7,35,34,35,7,0,14,13,7,28,0,0,-1,-28,0,-28,-1,0.12259084979747481,-19.277348173143082,,
3129,2021,4,NCAAF_20210925_CHARSO@ECU,East Carolina,,Charleston So.,,2-2,1-2,,24,14,31,28,0,24,7,0,14,0,0,14,1,10,-14,10,3,0.9104065973116795,22.28192805029869,,
3130,2021,4,NCAAF_20210925_UCLA@STNFRD,Stanford,Cardinal,UCLA,Bruins,2-2,3-1,1,7,21,24,35,0,7,7,10,14,7,0,14,-1,-14,-14,-14,-11,0.6239518193243037,5.239728776421998,,
3131,2021,4,NCAAF_20210925_UL@GAS,Ga. Southern,,Louisiana,,1-3,3-1,,13,14,20,28,7,6,0,7,0,14,14,0,-2,-1,7,-1,-8,0.33180887701516304,-7.214476861532489,0.1849524153563301,-13.34648611641552
3132,2021,4,NCAAF_20210925_TXSO@RICE,Rice,,Texas Southern,,1-3,0-3,,20,6,48,34,14,6,14,14,0,6,7,21,1,14,14,14,14,0.9792363316877605,33.80991112341201,,
3133,2021,4,NCAAF_20210925_KSTATE@OKLAST,Oklahoma State,Cowboys,Kansas State,Wildcats,4-0,3-1,0,31,13,31,20,21,10,0,0,10,3,7,0,1,18,11,18,11,0.6246320890902294,5.269469565802069,0.6995187082665422,7.785003342346442
3134,2021,4,NCAAF_20210925_NAVY@HOU,Houston,Cougars,Navy,Midshipmen,3-1,0-3,0,7,17,28,20,7,0,7,14,7,10,0,3,3,-10,0,-10,8,0.5899930351539964,3.774198592849416,,
3135,2021,4,NCAAF_20210925_NTEXAS@LATECH,Louisiana Tech,,North Texas,,2-2,1-3,,24,7,24,17,14,10,0,0,0,7,0,10,1,17,14,17,7,0.5743133278313148,3.108017573355937,,
3136,2021,4,NCAAF_20210925_TENN@FLA,Florida,Gators,Tennessee,Volunteers,3-1,2-2,0,17,14,38,14,10,7,14,7,7,7,0,0,1,3,3,3,24,0.8005151799070807,13.991286376099993,0.8962091527743716,18.758473893218593
3137,2021,4,NCAAF_20210925_UK@SC,South Carolina,Gamecocks,Kentucky,Wildcats,2-2,4-0,0,0,10,10,16,0,0,7,3,7,3,3,3,-2,-10,-7,-10,-6,0.4456037801986463,-2.268834265544797,0.3162049654462262,-7.119962720355147
3138,2021,4,NCAAF_20210925_AKRON@OHIOST,Ohio State,Buckeyes,Akron,Zips,3-1,1-3,0,38,7,59,7,14,24,14,7,7,0,0,0,2,31,7,31,52,0.9997136083455009,57.13183623526936,,
3139,2021,4,NCAAF_20210925_UNC@GATECH,Georgia Tech,Yellow Jackets,North Carolina,Tar Heels,2-2,2-2,0,13,7,45,22,0,13,14,18,7,0,7,8,0,6,-7,6,23,0.4021902493777536,-4.1085260991833366,0.09170741813772387,-19.801466304645658
3140,2021,4,NCAAF_20210925_USM@BAMA,Alabama,Crimson Tide,So. Miss,Golden Eagles,4-0,1-3,0,42,7,63,14,21,21,7,14,0,7,0,7,3,35,21,35,49,0.9972083191718857,45.97001377610093,0.9999685271114638,59.56135230405084
3141,2021,4,NCAAF_20210925_WVU@OKLA,Oklahoma,Sooners,West Virginia,Mountaineers,4-0,2-2,0,7,10,16,13,7,0,3,6,7,3,3,0,2,-3,0,-3,3,0.8303854610109038,15.852893883835918,,
3142,2021,4,NCAAF_20210925_FAU@AF,Air Force,Falcons,FAU,Owls,3-1,2-2,0,24,7,31,7,14,10,7,0,0,7,0,0,1,17,14,17,24,0.5400212764097132,1.6668747435159048,,
3143,2021,4,NCAAF_20210925_HAWAII@NMEXST,New Mexico St.,,Hawaii,,1-4,2-3,,13,17,21,41,3,10,0,8,10,7,7,17,-1,-4,-7,-4,-20,0.26970241820053675,-10.180220536074103,,
3144,2021,4,NCAAF_20210925_IND@WKY,W. Kentucky,Hilltoppers,Indiana,Hoosiers,1-2,2-2,0,14,23,31,33,0,14,10,7,14,9,3,7,-1,-9,-14,-9,-2,0.1006195073559425,-21.19983987070293,,
3145,2021,4,NCAAF_20210925_TROY@LAMON,UL-Monroe,,Troy,,2-1,2-2,,10,3,29,16,7,3,10,9,0,3,7,6,0,7,7,7,13,0.1850823461803518,-14.865503662978654,,
3146,2021,4,NCAAF_20210925_UAB@TULANE,Tulane,,UAB,,1-3,3-1,,14,21,21,28,0,14,0,7,7,14,7,0,-2,-7,-7,-7,-7,0.6640727988889223,7.026710735911934,,
3147,2021,4,NCAAF_20210925_NMEX@UTEP,UTEP,,New Mexico,,3-1,2-2,,3,13,20,13,0,3,14,3,7,6,0,0,1,-10,-7,-10,7,0.23531321193959054,-11.967517351086826,,
3148,2021,4,NCAAF_20210925_SFLA@BYU,BYU,Cougars,South Florida,Bulls,4-0,1-3,1,28,6,35,27,21,7,7,0,0,6,14,7,3,22,21,22,8,0.7580558689978056,11.612574636512477,,
3149,2021,4,NCAAF_20210925_ARIZ@OREG,Oregon,Ducks,Arizona,Wildcats,4-0,0-4,1,24,10,41,19,17,7,0,17,7,3,9,0,4,14,10,14,22,0.8502800632122318,17.212201962783865,,
3150,2021,4,NCAAF_20210925_COLO@ARIZST,Arizona St.,Sun Devils,Colorado,Buffaloes,3-1,1-3,1,14,3,35,13,7,7,7,14,0,3,7,3,2,11,7,11,22,0.6457492921616418,6.201713783297805,,
3151,2021,4,NCAAF_20210925_OREGST@USC,USC,Trojans,Oregon State,Beavers,2-2,3-1,1,17,21,27,45,7,10,0,10,7,14,14,10,-1,-4,0,-4,-18,0.8644500714138125,18.25554717592854,,
3152,2021,4,NCAAF_20210924_MTSU@CHARLO,Charlotte,49ers,Middle Tenn.,Blue Raiders,3-1,1-3,0,14,17,42,39,14,0,14,14,7,10,7,15,2,-3,7,-3,3,0.32369496467499337,-7.587163497059919,,
3153,2021,4,NCAAF_20210924_WAKE@UVA,Virginia,Cavaliers,Wake Forest,Demon Deacons,2-2,4-0,0,3,20,17,37,0,3,14,0,10,10,14,3,-2,-17,-10,-17,-20,0.4759213547765636,-1.0017921187126149,,
3154,2021,4,NCAAF_20210924_LIB@CUSE,Syracuse,Orange,Liberty,Flames,3-1,3-1,1,14,7,24,21,0,14,7,3,0,7,7,7,0,7,0,7,3,0.649872428539703,6.385948771866651,0.27616074174383587,-8.845817732568719
3155,2021,4,NCAAF_20210924_UNLV@FRESNO,Fresno St.,Bulldogs,UNLV,Rebels,4-1,0-4,1,9,14,38,30,0,9,13,16,14,0,7,9,4,-5,-14,-5,8,0.8858768299042364,19.98658337071697,,
3156,2021,4,NCAAF_20210923_MRSHL@APLST,App. St.,Mountaineers,Marshall,Thundering Herd,3-1,2-2,0,21,20,31,30,7,14,0,10,6,14,10,0,1,1,1,1,1,0.6405065049966506,5.968545758234768,,
3157,2021,5,NCAAF_20211002_ARK@UGA,Georgia,Bulldogs,Arkansas,Razorbacks,5-0,4-1,1,24,0,37,0,21,3,3,10,0,0,0,0,1,24,21,24,37,0.963608843487412,29.805920677267522,0.846994999536172,15.434863979091006
3158,2021,5,NCAAF_20211002_CHARLO@ILL,Illinois,Fighting Illini,Charlotte,49ers,2-4,3-2,1,10,14,24,14,3,7,14,0,7,7,0,0,-1,-4,-4,-4,10,0.7955788166588065,13.720750572600423,,
3159,2021,5,NCAAF_20211002_DUKE@UNC,North Carolina,Tar Heels,Duke,Blue Devils,3-2,3-2,1,24,0,38,7,7,17,0,14,0,0,7,0,0,24,7,24,31,0.6045441689768115,4.404404365793312,0.9113568290925447,20.343348172705305
3160,2021,5,NCAAF_20211002_MEMP@TEMPLE,Temple,Owls,Memphis,Tigers,3-2,3-2,1,17,17,34,31,0,17,7,10,3,14,6,8,0,0,-3,0,3,0.261200195690525,-10.626138443339755,0.09741356412607016,-19.548302838912605
3161,2021,5,NCAAF_20211002_MICH@WISC,Wisconsin,Badgers,Michigan,Wolverines,1-3,5-0,0,10,13,17,38,0,10,0,7,7,6,7,18,-4,-3,-7,-3,-21,0.46745586335954925,-1.3566834402579389,,
3162,2021,5,NCAAF_20211002_MINN@PURDUE,Purdue,Boilermakers,Minnesota,Golden Gophers,3-2,3-2,1,13,10,13,20,3,10,0,0,7,3,7,3,0,3,-4,3,-7,0.4930674914294826,-0.28869250348361675,,
3163,2021,5,NCAAF_20211002_PITT@GATECH,Georgia Tech,Yellow Jackets,Pittsburgh,Panthers,2-3,4-1,0,14,42,21,52,7,7,7,0,21,21,7,3,-2,-28,-14,-28,-31,0.4110462515094294,-3.7353800202320144,0.38793396257840906,-4.292984122871928
3164,2021,5,NCAAF_20211002_TENN@MIZZOU,Missouri,Tigers,Tennessee,Volunteers,2-3,3-2,1,10,45,24,62,3,7,7,7,28,17,10,7,-1,-35,-25,-35,-38,0.6839101220500927,7.951726194878461,0.5209924368773268,0.7938036590596766
3165,2021,5,NCAAF_20211002_TEXAS@TCU,TCU,Horned Frogs,Texas,Longhorns,2-2,4-1,1,17,23,27,32,14,3,3,7,13,10,3,6,-2,-6,1,-6,-5,0.43165352001076307,-2.86009622901247,,
3166,2021,5,NCAAF_20211002_TOLEDO@UMASS,UMass,Minutemen,Toledo,Rockets,0-5,3-2,0,0,31,7,45,0,0,0,7,7,24,7,7,-3,-31,-7,-31,-38,0.0804375165784752,-23.292871408998053,,
3167,2021,5,NCAAF_20211002_WMICH@BUFF,Buffalo,Bulls,W. Michigan,Broncos,2-3,4-1,0,7,7,17,24,7,0,3,7,7,0,0,17,-2,0,0,0,-7,0.578987713921219,3.3109328066153694,,
3168,2021,5,NCAAF_20211002_LVILLE@WAKE,Wake Forest,Demon Deacons,Louisville,Cardinals,5-0,3-2,1,20,17,37,34,10,10,7,10,10,7,0,17,2,3,0,3,3,0.6097347272401756,4.6286847501304464,,
3169,2021,5,NCAAF_20211002_APLST@GAST,Georgia St.,Panthers,App. St.,Mountaineers,1-4,4-1,1,6,14,16,45,0,6,3,7,7,7,17,14,-3,-8,-7,-8,-29,0.12212946857085893,-19.343642943638883,0.16762776452613226,-14.52942485329504
3170,2021,5,NCAAF_20211002_USC@COLO,Colorado,Buffaloes,USC,Trojans,1-4,3-2,0,7,20,14,37,0,7,7,0,10,10,10,7,-2,-13,-10,-13,-23,0.249211713433924,-11.246161114153665,,
3171,2021,5,NCAAF_20211002_CINCY@ND,Notre Dame,Fighting Irish,Cincinnati,Bearcats,4-1,4-0,1,0,17,13,24,0,0,7,6,0,17,0,7,0,-17,0,-17,-11,0.819407474977736,15.168969325836883,,
3172,2021,5,NCAAF_20211002_EMICH@NILL,N. Illinois,Huskies,E. Michigan,Eagles,3-2,3-2,0,17,3,27,20,10,7,7,3,0,3,14,3,0,14,10,14,7,0.4925515595189257,-0.3101800189702999,,
3173,2021,5,NCAAF_20211002_LAMON@CSTCAR,C. Carolina,Chanticleers,UL-Monroe,Warhawks,5-0,2-2,0,38,3,59,6,14,24,0,21,3,0,3,0,3,35,11,35,53,0.7331302013529587,10.338045337199901,,
3174,2021,5,NCAAF_20211002_BGREEN@KENTST,Kent St.,,Bowling Green,,2-3,2-3,,13,6,27,20,10,3,7,7,3,3,14,0,0,7,7,7,7,0.6826098135390044,7.8910605275698344,,
3175,2021,5,NCAAF_20211002_CMICH@MIAOH,Miami-OH,,C. Michigan,,2-3,2-3,,14,7,28,17,14,0,0,14,0,7,3,7,0,7,14,7,11,0.4955433621544221,-0.18558360628696846,,
3176,2021,5,NCAAF_20211002_CUSE@FSU,Florida State,Seminoles,Syracuse,Orange,1-4,3-2,0,16,13,33,30,3,13,7,10,0,13,7,10,-2,3,3,3,3,0.5183151982695493,0.7629349339890723,,
3177,2021,5,NCAAF_20211002_FIU@FAU,FAU,Owls,FIU,Panthers,3-2,1-4,1,34,21,58,21,7,27,10,14,7,14,0,0,2,13,0,13,37,0.7393177395621383,10.652615298774435,,
3178,2021,5,NCAAF_20211002_MISS@BAMA,Alabama,Crimson Tide,Ole Miss,Rebels,5-0,3-1,0,28,0,42,21,7,21,7,7,0,0,7,14,2,28,7,28,21,0.9591547654977458,28.921596573400507,,
3179,2021,5,NCAAF_20211002_NEVADA@BOISE,Boise St.,Broncos,Nevada,Wolf Pack,2-3,3-1,0,21,20,31,41,14,7,3,7,10,10,18,3,-1,1,4,1,-10,0.8524142485255726,17.390629145068942,,
3180,2021,5,NCAAF_20211002_OHIO@AKRON,Akron,,Ohio,,1-4,1-4,,10,10,17,34,0,10,7,0,3,7,7,17,0,0,-3,0,-17,0.11142413910530813,-20.2503796114122,,
3181,2021,5,NCAAF_20211002_OHIOST@RUT,Rutgers,Scarlet Knights,Ohio State,Buckeyes,3-2,4-1,1,6,45,13,52,6,0,0,7,24,21,7,0,-1,-39,-18,-39,-39,0.010216752549139896,-38.51246074881726,,
3182,2021,5,NCAAF_20211002_OKLA@KSTATE,Kansas State,Wildcats,Oklahoma,Sooners,3-2,5-0,1,10,13,31,37,7,3,7,14,3,10,14,10,-2,-3,4,-3,-6,0.1584743749805957,-16.624857982591493,,
3183,2021,5,NCAAF_20211002_TROY@SC,South Carolina,Gamecocks,Troy,Trojans,3-2,2-3,1,17,7,23,14,3,14,3,3,0,7,7,0,1,10,3,10,9,0.7602326830539003,11.745842916821289,0.699269237584311,7.87552834065599
3184,2021,5,NCAAF_20211002_TULANE@ECU,East Carolina,,Tulane,,3-2,1-4,,31,7,52,29,17,14,0,21,0,7,16,6,2,24,17,24,23,0.18634186260417773,-14.809281662805347,,
3185,2021,5,NCAAF_20211002_TXTECH@WVU,West Virginia,Mountaineers,Texas Tech,Red Raiders,2-3,4-1,0,0,17,20,23,0,0,17,3,14,3,0,6,-2,-17,-14,-17,-3,0.5916071441743761,3.84878725551755,,
3186,2021,5,NCAAF_20211002_UCF@NAVY,Navy,Midshipmen,UCF,Knights,1-3,2-2,1,17,23,34,30,7,10,0,17,13,10,7,0,-1,-6,-6,-6,4,0.147670343989307,-17.384537428623617,,
3187,2021,5,NCAAF_20211002_ARKST@GAS,Ga. Southern,,Arkansas St.,,2-3,1-4,,31,19,59,33,10,21,14,14,3,16,0,14,1,12,7,12,26,0.4063606975161468,-3.935763719890133,0.6436162869824871,5.551048150439442
3188,2021,5,NCAAF_20211002_SFLA@SMU,SMU,Mustangs,South Florida,Bulls,5-0,1-4,1,17,3,41,17,10,7,10,14,0,3,14,0,4,14,10,14,24,0.7089010769495334,9.13978290852765,,
3189,2021,5,NCAAF_20211002_ARMY@BALLST,Ball St.,Cardinals,Army,Black Knights,2-3,4-1,0,21,14,28,16,21,0,0,7,0,14,0,2,-2,7,21,7,12,0.172816623649104,-15.66707417301177,,
3190,2021,5,NCAAF_20211002_WASHST@CAL,California,Golden Bears,Washington St.,Cougars,1-4,2-3,0,6,14,6,21,6,0,0,0,14,0,7,0,-1,-8,-8,-8,-15,0.3576082143192799,-6.061201639913179,,
3191,2021,5,NCAAF_20211002_FLA@UK,Kentucky,Wildcats,Florida,Gators,5-0,3-2,0,7,10,20,13,7,0,6,7,7,3,0,3,2,-3,0,-3,7,0.2925611766692876,-9.069026191930107,0.14993404260625676,-15.63218454178923
3192,2021,5,NCAAF_20211002_LATECH@NCST,NC State,Wolfpack,Louisiana Tech,Bulldogs,4-1,2-3,0,13,10,34,27,7,6,14,7,0,10,3,14,2,3,7,3,7,0.8095117600930957,14.554129764031359,,
3193,2021,5,NCAAF_20211002_UNLV@TXSA,UTSA,,UNLV,,5-0,0-5,,17,10,24,17,7,10,7,0,7,3,0,7,5,7,0,7,7,0.5115476578682135,0.4809254944049144,,
3194,2021,5,NCAAF_20211002_AF@NMEX,New Mexico,Lobos,Air Force,Falcons,2-3,4-1,1,0,24,10,38,0,0,7,3,7,17,7,7,-2,-24,-7,-24,-28,0.13860458981201107,-18.051239055692008,,
3195,2021,5,NCAAF_20211002_USM@RICE,Rice,,So. Miss,,2-3,1-4,,10,7,24,19,7,3,14,0,7,0,7,5,1,3,0,3,5,0.2497532147886825,-11.217821823544682,,
3196,2021,5,NCAAF_20211002_BAYLOR@OKLAST,Oklahoma State,Cowboys,Baylor,Bears,5-0,4-1,1,14,0,24,14,7,7,0,10,0,0,7,7,1,14,7,14,10,0.6920392266983662,8.333443793127344,0.6939501660019753,7.6460128577634805
3197,2021,5,NCAAF_20211002_KANSAS@IOWAST,Iowa St.,Cyclones,Kansas,Jayhawks,3-2,1-4,0,38,0,59,7,28,10,14,7,0,0,7,0,2,38,28,38,52,0.951566193074096,27.580510926141528,0.9979518435021314,43.28522627492697
3198,2021,5,NCAAF_20211002_LIB@UAB,UAB,Blazers,Liberty,Flames,3-2,4-1,1,3,3,12,36,3,0,0,9,0,3,21,12,-1,0,3,0,-24,0.4986038208889869,-0.0581386917706368,,
3199,2021,5,NCAAF_20211002_MISSST@TXAM,Texas A&M,Aggies,Miss. State,Bulldogs,3-2,3-2,1,13,17,22,26,7,6,6,3,10,7,7,2,0,-4,-3,-4,-4,0.5192064289515208,0.8000879456722032,0.8777283123609488,17.54699815187996
3200,2021,5,NCAAF_20211002_MRSHL@MTSU,Middle Tenn.,,Marshall,,2-3,2-3,,28,14,34,28,7,21,6,0,0,14,0,14,0,14,7,14,6,0.3135536548778186,-8.070359989510507,,
3201,2021,5,NCAAF_20211002_BC@CLEM,Clemson,Tigers,Boston College,Eagles,3-2,4-1,1,13,6,19,13,7,6,3,3,3,3,7,0,-1,7,4,7,6,0.9390980831679653,25.703530985041766,,
3202,2021,5,NCAAF_20211002_IND@PSU,Penn State,Nittany Lions,Indiana,Hoosiers,5-0,2-3,0,14,0,24,0,7,7,7,3,0,0,0,0,3,14,7,14,24,0.8252639813688787,15.54282452111454,,
3203,2021,5,NCAAF_20211002_NWEST@NEB,Nebraska,Cornhuskers,Northwestern,Wildcats,3-3,2-3,1,35,7,56,7,21,14,14,7,7,0,0,0,1,28,14,28,49,0.41615272584766727,-3.51761130862576,0.35166382150744147,-5.742401935665498
3204,2021,5,NCAAF_20211002_UCONN@VANDY,Vanderbilt,Commodores,UConn,Huskies,2-3,0-6,0,17,16,30,28,3,14,0,13,6,10,0,12,2,1,-3,1,2,0.8787143011487831,19.41302096202537,,
3205,2021,5,NCAAF_20211002_WKY@MICHST,Michigan St.,Spartans,W. Kentucky,Hilltoppers,5-0,1-3,0,42,16,48,31,21,21,3,3,10,6,0,15,4,26,11,26,17,0.8898548612323882,20.36280228974499,,
3206,2021,5,NCAAF_20211002_UL@SALA,South Alabama,,Louisiana,,3-1,4-1,,6,20,18,20,0,6,6,6,14,6,0,0,-1,-14,-14,-14,-2,0.16613186028044458,-16.106823864203875,0.09702856021726003,-19.582071352076582
3207,2021,5,NCAAF_20211002_AUBURN@LSU,LSU,Tigers,Auburn,Tigers,3-2,4-1,1,13,10,19,24,7,6,6,0,0,10,0,14,-1,3,7,3,-5,0.47474380855088893,-1.0524016121009936,0.38379969222042876,-4.455961265046199
3208,2021,5,NCAAF_20211002_ODU@UTEP,UTEP,,Old Dominion,,4-1,1-4,,17,7,28,21,3,14,3,8,0,7,14,0,3,10,3,10,7,0.33796134296306424,-6.944553005196553,,
3209,2021,5,NCAAF_20211002_WASH@OREGST,Oregon State,Beavers,Washington,Huskies,4-1,2-3,0,14,10,27,24,0,14,3,10,7,3,0,14,2,4,-7,4,3,0.08358015820186226,-22.948184885676937,,
3210,2021,5,NCAAF_20211002_ARIZST@UCLA,UCLA,Bruins,Arizona St.,Sun Devils,3-2,4-1,1,23,24,23,42,3,20,0,0,3,21,8,10,-1,-1,0,-1,-19,0.4226748393307628,-3.2403430352552505,,
3211,2021,5,NCAAF_20211002_NMEXST@SJST,San Jose St.,Spartans,New Mexico St.,Aggies,3-2,1-5,0,24,14,37,31,7,17,6,7,0,14,7,10,2,10,7,10,6,0.6540221308288606,6.581886281057791,,
3212,2021,5,NCAAF_20211002_FRESNO@HAWAII,Hawaii,Rainbow Warriors,Fresno St.,Bulldogs,3-3,4-2,0,10,14,27,24,10,0,0,17,7,7,10,0,-1,-4,3,-4,3,0.18680053042604983,-14.78088567527766,0.3503486474856189,-5.795885541098869
3213,2021,5,NCAAF_20211001_HOU@TULSA,Tulsa,Golden Hurricane,Houston,Cougars,1-4,4-1,0,3,28,10,45,0,3,0,7,14,14,7,10,-3,-25,-14,-25,-35,0.3584517109819991,-6.023675393016333,,
3214,2021,5,NCAAF_20211001_IOWA@MD,Maryland,Terrapins,Iowa,Hawkeyes,4-1,5-0,1,7,34,14,51,7,0,7,0,3,31,10,7,-1,-27,4,-27,-37,0.10789766195285533,-20.562643987990782,,
3215,2021,5,NCAAF_20211001_BYU@UTAHST,Utah St.,Aggies,BYU,Cougars,3-2,5-0,1,13,24,20,34,3,10,0,7,10,14,0,10,-2,-11,-7,-11,-14,0.43454218119421006,-2.738088980580301,,
3216,2021,5,NCAAF_20210930_UVA@MIAMI,Miami (Fla.),Hurricanes,Virginia,Cavaliers,2-3,3-2,0,7,16,28,30,0,7,14,7,9,7,11,3,-1,-9,-9,-9,-2,0.6498866296058741,6.396026882399951,0.5632276306662805,2.3998661256405853
3217,2021,6,NCAAF_20211009_AKRON@BGREEN,Bowling Green,Falcons,Akron,Zips,2-4,2-4,1,13,7,20,35,10,3,0,7,0,7,21,7,0,6,10,6,-15,0.4305575998814173,-2.9137808258751647,,
3218,2021,6,NCAAF_20211009_ARK@MISS,Ole Miss,Rebels,Arkansas,Razorbacks,4-1,4-2,0,21,14,52,51,0,21,10,21,7,7,17,20,0,7,-7,7,1,0.6972982973807578,8.60446987468822,,
3219,2021,6,NCAAF_20211009_MD@OHIOST,Ohio State,Buckeyes,Maryland,Terrapins,5-1,4-2,0,35,10,66,17,14,21,21,10,3,7,7,0,1,25,11,25,49,0.9763410760935143,33.03323721423601,,
3220,2021,6,NCAAF_20211009_MICHST@RUT,Rutgers,Scarlet Knights,Michigan St.,Spartans,3-3,6-0,0,13,21,13,31,7,6,0,0,7,14,7,3,-3,-8,0,-8,-18,0.18327352399170793,-15.038335080256616,0.5176054313621756,0.6837189093680536
3221,2021,6,NCAAF_20211009_NILL@TOLEDO,Toledo,Rockets,N. Illinois,Huskies,3-3,4-2,0,14,16,20,22,0,14,0,6,3,13,0,6,-1,-2,-3,-2,-2,0.587864742240771,3.6982232181964036,0.855950190832721,16.453073498755543
3222,2021,6,NCAAF_20211009_OKLA@TEXAS,Texas,Longhorns,Oklahoma,Sooners,4-2,6-0,1,38,20,48,55,28,10,3,7,7,13,10,25,-2,18,21,18,-7,0.29600130333985,-8.925741668176443,,
3223,2021,6,NCAAF_20211009_SC@TENN,Tennessee,Volunteers,South Carolina,Gamecocks,4-2,3-3,0,38,7,45,20,28,10,0,7,0,7,7,6,1,31,28,31,25,0.45405381122881716,-1.9223572763733046,0.6755132542507752,7.05003737225627
3224,2021,6,NCAAF_20211009_VANDY@FLA,Florida,Gators,Vanderbilt,Commodores,4-2,2-4,0,21,0,42,0,14,7,21,0,0,0,0,0,2,21,14,21,42,0.9183699135358381,23.21951827107,0.9924708361832685,37.65131284528991
3225,2021,6,NCAAF_20211009_WVU@BAYLOR,Baylor,Bears,West Virginia,Mountaineers,5-1,2-4,1,28,10,45,20,21,7,14,3,7,3,3,7,3,18,14,18,25,0.4042336427545087,-4.037110256218739,0.4219121797258001,-3.051231292557702
3226,2021,6,NCAAF_20211009_GATECH@DUKE,Duke,Blue Devils,Georgia Tech,Yellow Jackets,3-3,3-3,1,14,17,27,31,7,7,3,10,14,3,7,7,0,-3,-7,-3,-4,0.4635169821998051,-1.5251710482376666,0.25797145831080515,-10.06129657056357
3227,2021,6,NCAAF_20211009_UVA@LVILLE,Louisville,Cardinals,Virginia,Cavaliers,3-3,4-2,0,10,13,33,34,10,0,20,3,10,3,0,21,-1,-3,0,-3,-1,0.42921683764759844,-2.9706333953719195,0.6219281067051681,4.809828197707873
3228,2021,6,NCAAF_20211009_BALLST@WMICH,W. Michigan,Broncos,Ball St.,Cardinals,4-2,3-3,0,17,17,20,45,14,3,3,0,7,10,7,21,1,0,7,0,-25,0.7311802101469331,10.265595974817643,0.6226751841587553,4.840274189429977
3229,2021,6,NCAAF_20211009_BOISE@BYU,BYU,Cougars,Boise St.,Broncos,5-1,3-3,1,10,20,17,26,10,0,0,7,3,17,3,3,2,-10,7,-10,-9,0.36604335296970136,-5.701680356543761,0.6414066716660841,5.6101431898879355
3230,2021,6,NCAAF_20211009_CMICH@OHIO,Ohio,Bobcats,C. Michigan,Chippewas,1-5,3-3,1,10,13,27,30,3,7,9,8,7,6,7,10,-2,-3,-4,-3,-3,0.6397168429288648,5.95734264875,,
3231,2021,6,NCAAF_20211009_FAU@UAB,UAB,Blazers,FAU,Owls,4-2,3-3,1,24,14,31,14,14,10,7,0,7,7,0,0,1,10,7,10,17,0.3464131367571901,-6.578896031524664,,
3232,2021,6,NCAAF_20211009_FSU@UNC,North Carolina,Tar Heels,Florida State,Seminoles,3-3,2-4,1,10,21,25,35,10,0,7,8,0,21,14,0,1,-11,10,-11,-10,0.59947645997756,4.196800282650315,,
3233,2021,6,NCAAF_20211009_MIAOH@EMICH,E. Michigan,Eagles,Miami-OH,RedHawks,4-2,2-4,1,10,6,13,12,0,10,3,0,6,0,3,3,2,4,-6,4,1,0.5283176986150031,1.1831621025758068,,
3234,2021,6,NCAAF_20211009_MTSU@LIB,Liberty,Flames,Middle Tenn.,Blue Raiders,5-1,2-4,0,24,7,41,13,14,10,10,7,0,7,6,0,3,17,14,17,28,0.6043944312394034,4.409078279014466,,
3235,2021,6,NCAAF_20211009_SJST@COLOST,Colorado St.,Rams,San Jose St.,Spartans,2-3,3-3,1,16,7,32,14,10,6,10,6,0,7,0,7,-1,9,10,9,18,0.7083583606217152,9.136569906353316,,
3236,2021,6,NCAAF_20211009_SMU@NAVY,Navy,Midshipmen,SMU,Mustangs,1-4,6-0,0,21,21,24,31,7,14,3,0,7,14,3,7,-5,0,0,0,-7,0.3953790784125889,-4.41887145792748,,
3237,2021,6,NCAAF_20211009_UCONN@UMASS,UMass,Minutemen,UConn,Huskies,1-5,0-7,0,7,10,27,13,7,0,3,17,10,0,0,3,1,-3,-3,-3,14,0.45212139171651033,-2.0035916008209824,,
3238,2021,6,NCAAF_20211009_UGA@AUBURN,Auburn,Tigers,Georgia,Bulldogs,4-2,6-0,1,3,17,10,34,3,0,7,0,3,14,7,10,-2,-14,0,-14,-24,0.3295508853616247,-7.347186193673224,0.14658907847096192,-16.280773442905456
3239,2021,6,NCAAF_20211009_WISC@ILL,Illinois,Fighting Illini,Wisconsin,Badgers,2-5,2-3,1,0,10,0,24,0,0,0,0,3,7,14,0,0,-10,-3,-10,-24,0.06314882679972833,-25.462474867717788,,
3240,2021,6,NCAAF_20211009_NTEXAS@MIZZOU,Missouri,Tigers,North Texas,Mean Green,3-3,1-4,1,31,7,48,35,14,17,0,17,0,7,7,21,2,24,14,24,13,0.8950456049410145,20.881662914286494,,
3241,2021,6,NCAAF_20211009_OREGST@WASHST,Washington St.,Cougars,Oregon State,Beavers,3-3,4-2,1,3,10,31,24,0,3,14,14,0,10,7,7,-1,-7,0,-7,7,0.8119349631198035,14.740038241684147,,
3242,2021,6,NCAAF_20211009_PSU@IOWA,Iowa,Hawkeyes,Penn State,Nittany Lions,6-0,5-1,1,10,17,23,20,3,7,3,10,14,3,3,0,1,-7,-11,-7,3,0.41073641337647304,-3.758101876009164,0.7063150739387618,8.40467386974808
3243,2021,6,NCAAF_20211009_ECU@UCF,UCF,Knights,East Carolina,Pirates,3-2,3-3,0,3,3,20,16,0,3,7,10,0,3,10,3,0,0,0,0,4,0.9549737173505579,28.231356767775992,,
3244,2021,6,NCAAF_20211009_BUFF@KENTST,Kent St.,Golden Flashes,Buffalo,Bulls,3-3,2-4,1,31,10,48,38,14,17,3,14,0,10,28,0,1,21,14,21,10,0.16486654281147672,-16.232320040612308,,
3245,2021,6,NCAAF_20211009_GAS@TROY,Troy,Trojans,Ga. Southern,Eagles,3-3,2-4,1,17,3,27,24,10,7,7,3,0,3,15,6,1,14,10,14,3,0.6111027880525219,4.699802669542237,0.46554582684936474,-1.339283974223008
3246,2021,6,NCAAF_20211009_TCU@TXTECH,Texas Tech,Red Raiders,TCU,Horned Frogs,4-2,3-2,0,10,35,31,52,7,3,14,7,14,21,10,7,1,-25,-7,-25,-21,0.3388944816786734,-6.919641098378634,0.272987222428138,-9.351804319854068
3247,2021,6,NCAAF_20211009_TXSA@WKY,W. Kentucky,Hilltoppers,UTSA,Roadrunners,1-4,6-0,0,24,28,46,52,10,14,13,9,14,14,14,10,-5,-4,-4,-4,-6,0.6046174715137005,4.4187222693058175,0.3775146024805305,-4.83253795933166
3248,2021,6,NCAAF_20211009_UTEP@USM,So. Miss,Golden Eagles,UTEP,Miners,1-5,5-1,0,7,14,13,26,7,0,0,6,7,7,7,5,-4,-7,0,-7,-13,0.8294235197598347,15.853230363556918,,
3249,2021,6,NCAAF_20211009_WYO@AF,Air Force,Falcons,Wyoming,Cowboys,5-1,4-1,1,14,14,24,14,7,7,7,3,0,14,0,0,1,0,7,0,10,0.5862571821077592,3.6294692525126493,,
3250,2021,6,NCAAF_20211009_LSU@UK,Kentucky,Wildcats,LSU,Tigers,6-0,3-3,0,14,0,42,21,7,7,14,14,0,0,7,14,3,14,7,14,21,0.24855024511808455,-11.309376815261658,0.5165925722882878,0.6443604418909104
3251,2021,6,NCAAF_20211009_MICH@NEB,Nebraska,Cornhuskers,Michigan,Wolverines,3-4,6-0,0,0,13,29,32,0,0,22,7,0,13,6,13,-3,-13,0,-13,-3,0.1460364314920959,-17.54691780918779,,
3252,2021,6,NCAAF_20211009_ND@VATECH,Virginia Tech,Hokies,Notre Dame,Fighting Irish,3-2,5-1,0,13,14,29,32,7,6,9,7,0,14,7,11,-2,-1,7,-1,-3,0.1996250943673482,-14.039082300421342,0.1607343577724457,-15.355651115716228
3253,2021,6,NCAAF_20211009_BAMA@TXAM,Texas A&M,Aggies,Alabama,Crimson Tide,4-2,5-1,1,24,10,41,38,17,7,7,10,7,3,14,14,-1,14,10,14,3,0.08918037141448698,-22.41392863371982,0.07739411496365156,-22.036876063228874
3254,2021,6,NCAAF_20211009_GAST@LAMON,UL-Monroe,Warhawks,Georgia St.,Panthers,2-3,2-4,1,7,28,21,55,7,0,7,7,7,21,14,13,0,-21,0,-21,-34,0.3750661664733268,-5.303868128388672,,
3255,2021,6,NCAAF_20211009_UTAH@USC,USC,Trojans,Utah,Utes,3-3,3-2,1,10,21,26,42,3,7,0,16,7,14,14,7,0,-11,-4,-11,-16,0.416374042368862,-3.517066815938847,,
3256,2021,6,NCAAF_20211009_MEMP@TULSA,Tulsa,Golden Hurricane,Memphis,Tigers,2-4,3-3,0,14,13,35,29,7,7,7,14,0,13,0,16,-1,1,7,1,6,0.2514782527586883,-11.155925256413525,,
3257,2021,6,NCAAF_20211009_NMEX@SDGST,San Diego St.,Aztecs,New Mexico,Lobos,5-0,2-4,0,17,0,31,7,7,10,7,7,0,0,7,0,3,17,7,17,24,0.8708723767932884,18.82830330996103,0.8769956043476741,17.967793001633027
3258,2021,6,NCAAF_20211009_NMEXST@NEVADA,Nevada,Wolf Pack,New Mexico St.,Aggies,4-1,1-6,0,31,7,55,28,3,28,21,3,7,0,0,21,3,24,-4,24,27,0.8113479306987914,14.703817313718787,,
3259,2021,6,NCAAF_20211009_UCLA@ARIZ,Arizona,Wildcats,UCLA,Bruins,0-5,4-2,1,13,14,16,34,3,10,3,0,7,7,10,10,-4,-1,-4,-1,-18,0.378308098892128,-5.161680156994294,,
3260,2021,6,NCAAF_20211008_CHARLO@FIU,FIU,Panthers,Charlotte,49ers,1-5,4-2,1,6,17,33,45,3,3,7,20,7,10,14,14,-3,-11,-4,-11,-12,0.6295181858167118,5.505597955309213,,
3261,2021,6,NCAAF_20211008_TEMPLE@CINCY,Cincinnati,Bearcats,Temple,Owls,5-0,3-3,0,17,3,52,3,10,7,28,7,0,3,0,0,2,14,10,14,49,0.7515159954380866,11.312859443304774,,
3262,2021,6,NCAAF_20211008_STNFRD@ARIZST,Arizona St.,Sun Devils,Stanford,Cardinal,5-1,3-3,0,21,7,28,10,14,7,7,0,7,0,3,0,2,14,7,14,18,0.47538743679488693,-1.0281435083398947,,
3263,2021,6,NCAAF_20211007_CSTCAR@ARKST,Arkansas St.,Red Wolves,C. Carolina,Chanticleers,1-5,6-0,1,0,24,20,52,0,0,14,6,10,14,14,14,-5,-24,-10,-24,-32,0.5210372732348739,0.8786420484393602,0.020170231756276635,-31.75454198182956
3264,2021,6,NCAAF_20211007_HOU@TULANE,Tulane,Green Wave,Houston,Cougars,1-5,5-1,1,15,17,22,40,0,15,7,0,14,3,9,14,-4,-2,-14,-2,-18,0.44074766719059444,-2.4827485571902344,0.4152664357737721,-3.314748925732772
3265,2021,7,NCAAF_20211016_AUBURN@ARK,Arkansas,Razorbacks,Auburn,Tigers,4-3,5-2,0,10,14,23,38,3,7,13,0,7,7,14,10,-1,-4,-4,-4,-15,0.09095066290517084,-22.25138493732186,0.48446378379529975,-0.5996651728099778
3266,2021,7,NCAAF_20211016_FLA@LSU,LSU,Tigers,Florida,Gators,4-3,4-3,1,21,13,49,42,0,21,14,14,6,7,22,7,0,8,-6,8,7,0.5421166575468936,1.7630050841321463,0.14803110402336062,-16.085879977636182
3267,2021,7,NCAAF_20211016_MICHST@IND,Indiana,Hoosiers,Michigan St.,Spartans,2-4,7-0,0,9,7,15,20,3,6,0,6,7,0,10,3,-5,2,-4,2,-5,0.4921383725060291,-0.3284967797499121,0.6699421777373595,6.7697577528033435
3268,2021,7,NCAAF_20211016_NEB@MINN,Minnesota,Golden Gophers,Nebraska,Cornhuskers,4-2,3-5,0,21,9,30,23,7,14,0,9,3,6,7,7,1,12,4,12,7,0.5758826096981988,3.189900918178637,,
3269,2021,7,NCAAF_20211016_OHIO@BUFF,Buffalo,Bulls,Ohio,Bobcats,3-4,1-6,1,10,21,27,26,0,10,0,17,21,0,5,0,2,-11,-21,-11,1,0.5157541481603605,0.6584129921160411,,
3270,2021,7,NCAAF_20211016_OKLAST@TEXAS,Texas,Longhorns,Oklahoma State,Cowboys,4-3,6-0,1,17,13,24,32,10,7,7,0,3,10,3,16,-2,4,7,4,-8,0.548168215143956,2.017485492908463,,
3271,2021,7,NCAAF_20211016_RUT@NWEST,Northwestern,Wildcats,Rutgers,Scarlet Knights,3-3,3-4,1,14,7,21,7,7,7,0,7,0,7,0,0,0,7,7,7,14,0.7809464221273639,12.924768802536391,0.5567776145566647,2.198391247910479
3272,2021,7,NCAAF_20211016_TULSA@SFLA,South Florida,Bulls,Tulsa,Golden Hurricane,1-5,3-4,1,24,20,31,32,3,21,7,0,3,17,0,12,-2,4,0,4,-1,0.4421247174755063,-2.4266974535962618,,
3273,2021,7,NCAAF_20211016_TXAM@MIZZOU,Missouri,Tigers,Texas A&M,Aggies,3-4,5-2,1,7,28,14,35,0,7,7,0,21,7,7,0,-2,-21,-21,-21,-21,0.4106463958558152,-3.7651582788080304,0.11792930547069425,-18.248593956199613
3274,2021,7,NCAAF_20211016_UCF@CINCY,Cincinnati,Bearcats,UCF,Knights,6-0,3-3,0,35,7,56,21,14,21,7,14,0,7,7,7,3,28,14,28,35,0.35990805357840494,-5.979123475719234,,
3275,2021,7,NCAAF_20211016_YALE@UCONN,UConn,Huskies,Yale,Bulldogs,1-7,2-3,1,14,0,21,15,0,14,7,0,0,0,9,6,-1,14,0,14,6,,,,
3276,2021,7,NCAAF_20211016_DUKE@UVA,Virginia,Cavaliers,Duke,Blue Devils,5-2,3-4,1,34,0,48,0,10,24,7,7,0,0,0,0,2,34,10,34,48,0.6217267605606027,5.167600997490922,0.8892009358324865,18.816460606875694
3277,2021,7,NCAAF_20211016_BALLST@EMICH,E. Michigan,Eagles,Ball St.,Cardinals,4-3,4-3,0,14,17,31,38,0,14,3,14,14,3,7,14,0,-3,-14,-3,-7,0.6624889937748156,6.988594959974989,0.3469689054712938,-6.0579698231093175
3278,2021,7,NCAAF_20211016_AKRON@MIAOH,Miami-OH,RedHawks,Akron,Zips,3-4,2-5,0,21,7,34,21,14,7,13,0,0,7,0,14,1,14,14,14,13,0.8065708876988791,14.423872672648258,,
3279,2021,7,NCAAF_20211016_TROY@TXSTSM,Texas St.,Bobcats,Troy,Trojans,2-4,4-3,1,14,17,28,31,7,7,14,0,10,7,7,7,-2,-3,-3,-3,-3,0.1638488355049823,-16.314645284388916,,
3280,2021,7,NCAAF_20211016_ARIZ@COLO,Colorado,Buffaloes,Arizona,Wildcats,2-4,0-6,0,6,0,34,0,3,3,21,7,0,0,0,0,2,6,3,6,34,0.5364891280015901,1.5267253589618122,,
3281,2021,7,NCAAF_20211016_BGREEN@NILL,N. Illinois,Huskies,Bowling Green,Falcons,5-2,2-5,0,21,13,34,26,0,21,10,3,7,6,3,10,3,8,-7,8,8,0.8741455198060069,19.105753528875084,0.851198422770882,16.0346471369769
3282,2021,7,NCAAF_20211016_BYU@BAYLOR,Baylor,Bears,BYU,Cougars,6-1,5-2,1,17,7,38,24,3,14,14,7,0,7,7,10,1,10,3,10,14,0.5424575381886849,1.7773283434208906,0.32291420187883546,-7.074746309686077
3283,2021,7,NCAAF_20211016_FRESNO@WYO,Wyoming,Cowboys,Fresno St.,Bulldogs,4-2,5-2,0,0,7,0,17,0,0,0,0,7,0,7,3,-1,-7,-7,-7,-17,0.36981416497306085,-5.539754381265425,,
3284,2021,7,NCAAF_20211016_KENTST@WMICH,W. Michigan,Broncos,Kent St.,Golden Flashes,5-2,3-4,1,23,17,64,31,17,6,27,14,7,10,6,8,2,6,10,6,33,0.7656525244777443,12.078176957735081,,
3285,2021,7,NCAAF_20211016_MIAMI@UNC,North Carolina,Tar Heels,Miami (Fla.),Hurricanes,4-3,2-4,1,31,17,45,42,14,17,7,7,10,7,17,8,2,14,4,14,3,0.3601979657981027,-5.966207213258599,0.6164078262268953,4.557675331627365
3286,2021,7,NCAAF_20211016_PITT@VATECH,Virginia Tech,Hokies,Pittsburgh,Panthers,3-3,5-1,0,0,21,7,28,0,0,7,0,7,14,7,0,-2,-21,-7,-21,-21,0.5238058310747447,0.9952492856378967,0.4909294310825829,-0.3500464694002403
3287,2021,7,NCAAF_20211016_PURDUE@IOWA,Iowa,Hawkeyes,Purdue,Boilermakers,6-1,4-2,1,7,14,7,24,0,7,0,0,7,7,3,7,2,-7,-7,-7,-17,0.7733390715182731,12.499634285949696,0.8774994201636372,17.897218914318614
3288,2021,7,NCAAF_20211016_UAB@USM,So. Miss,Golden Eagles,UAB,Blazers,1-6,5-2,0,0,31,0,34,0,0,0,0,3,28,3,0,-4,-31,-3,-31,-34,0.3709486216635429,-5.489687905297274,,
3289,2021,7,NCAAF_20211016_UK@UGA,Georgia,Bulldogs,Kentucky,Wildcats,7-0,6-1,0,14,7,30,13,0,14,10,6,0,7,0,6,1,7,0,7,17,0.8793965805948991,19.53525981783821,0.9288460218496964,22.587493869296395
3290,2021,7,NCAAF_20211016_WKY@ODU,Old Dominion,Monarchs,W. Kentucky,Hilltoppers,1-6,2-4,0,3,30,20,43,0,3,3,14,14,16,3,10,-1,-27,-14,-27,-23,0.2763419787904381,-9.896899901728034,,
3291,2021,7,NCAAF_20211016_TXTECH@KANSAS,Kansas,Jayhawks,Texas Tech,Red Raiders,1-5,5-2,0,0,24,14,41,0,0,0,14,7,17,14,3,-4,-24,-7,-24,-27,0.14597594725552043,-17.566253334800194,0.08087458969969263,-21.540093599506633
3292,2021,7,NCAAF_20211016_VANDY@SC,South Carolina,Gamecocks,Vanderbilt,Commodores,4-3,2-5,1,14,10,21,20,14,0,0,7,3,7,7,3,2,4,11,4,1,0.7622317315334224,11.893083408294387,0.7389730383793316,9.855250141352315
3293,2021,7,NCAAF_20211016_RICE@TXSA,UTSA,Roadrunners,Rice,Owls,7-0,2-4,1,31,0,45,0,17,14,14,0,0,0,0,0,5,31,17,31,45,0.663878557120523,7.052038492315319,,
3294,2021,7,NCAAF_20211016_BAMA@MISSST,Miss. State,Bulldogs,Alabama,Crimson Tide,3-3,6-1,1,6,21,9,49,3,3,3,0,14,7,14,14,-3,-15,-11,-15,-40,0.08929354895983321,-22.421312239971826,0.014523587599687748,-33.603681029378095
3295,2021,7,NCAAF_20211016_COLOST@NMEX,New Mexico,Lobos,Colorado St.,Rams,2-5,3-3,1,7,13,7,36,0,7,0,0,7,6,10,13,-1,-6,-7,-6,-29,0.2500393066781915,-11.240776565321653,,
3296,2021,7,NCAAF_20211016_LIB@LAMON,UL-Monroe,Warhawks,Liberty,Flames,3-3,5-2,0,0,14,31,28,0,0,28,3,0,14,0,14,-2,-14,0,-14,3,0.15803881870889058,-16.711175616763626,,
3297,2021,7,NCAAF_20211016_UTAHST@UNLV,UNLV,Rebels,Utah St.,Aggies,0-6,4-2,1,17,14,24,28,17,0,7,0,7,7,7,7,-4,3,10,3,-4,0.16277616313990784,-16.38715643660305,,
3298,2021,7,NCAAF_20211016_IOWAST@KSTATE,Kansas State,Wildcats,Iowa St.,Cyclones,3-3,4-2,0,7,20,20,33,7,0,0,13,10,10,7,6,-1,-13,-3,-13,-13,0.3129095711870391,-8.127967783739678,0.11387196477276773,-18.568628578897403
3299,2021,7,NCAAF_20211016_MISS@TENN,Tennessee,Volunteers,Ole Miss,Rebels,4-3,5-1,0,12,24,26,31,9,3,7,7,10,14,7,0,-1,-12,-1,-12,-5,0.4459516356906784,-2.2652085783603297,,
3300,2021,7,NCAAF_20211016_NCST@BC,Boston College,Eagles,NC State,Wolfpack,4-2,5-1,0,7,10,7,33,7,0,0,0,7,3,21,2,-1,-3,0,-3,-26,0.5003882112785427,0.016220295443986288,0.5385488235992602,1.4898494855810895
3301,2021,7,NCAAF_20211016_STNFRD@WASHST,Washington St.,Cougars,Stanford,Cardinal,4-3,3-4,0,20,16,34,31,0,20,7,7,13,3,0,15,1,4,-13,4,3,0.5347478739596528,1.4536806769386885,,
3302,2021,7,NCAAF_20211016_TCU@OKLA,Oklahoma,Sooners,TCU,Horned Frogs,7-0,3-3,1,24,14,52,31,14,10,21,7,7,7,10,7,4,10,7,10,21,0.7567168448730411,11.597726283964107,0.7832547432784187,12.057425637149208
3303,2021,7,NCAAF_20211016_ARMY@WISC,Wisconsin,Badgers,Army,Black Knights,3-3,4-2,1,13,0,20,14,0,13,0,7,0,0,0,14,-1,13,0,13,6,0.9093238899111279,22.27937890013027,,
3304,2021,7,NCAAF_20211016_UCLA@WASH,Washington,Huskies,UCLA,Bruins,2-4,5-2,1,10,17,17,24,3,7,7,0,7,10,0,7,-3,-7,-4,-7,-7,0.7817228495618866,12.968631108078625,,
3305,2021,7,NCAAF_20211016_AF@BOISE,Boise St.,Broncos,Air Force,Falcons,3-4,6-1,1,14,21,17,24,7,7,0,3,7,14,0,3,-3,-7,0,-7,-7,0.6806629924113917,7.82682710614074,,
3306,2021,7,NCAAF_20211016_LATECH@UTEP,UTEP,Miners,Louisiana Tech,Bulldogs,6-1,2-4,1,16,3,19,3,14,2,3,0,0,3,0,0,4,13,14,13,16,0.13962755248375236,-18.03539016497473,,
3307,2021,7,NCAAF_20211016_ARIZST@UTAH,Utah,Utes,Arizona St.,Sun Devils,4-2,5-2,0,7,21,35,21,7,0,14,14,7,14,0,0,-1,-14,0,-14,14,0.6685532459850381,7.2662300223792045,,
3308,2021,7,NCAAF_20211016_HAWAII@NEVADA,Nevada,Wolf Pack,Hawaii,Rainbow Warriors,5-1,3-4,1,20,17,34,17,3,17,14,0,7,10,0,0,2,3,-4,3,17,0.5988214913458496,4.172129037524428,0.7049266841235687,8.291806485296263
3309,2021,7,NCAAF_20211015_CLEM@CUSE,Syracuse,Orange,Clemson,Tigers,3-4,4-2,1,7,14,14,17,0,7,0,7,0,14,0,3,-1,-7,0,-7,-3,0.032745649812298105,-30.701825972139545,,
3310,2021,7,NCAAF_20211015_MRSHL@NTEXAS,North Texas,Mean Green,Marshall,Thundering Herd,1-5,4-3,0,7,42,21,49,0,7,0,14,14,28,0,7,-3,-35,-14,-35,-28,0.2959185260156092,-8.937330602451084,,
3311,2021,7,NCAAF_20211015_CAL@OREG,Oregon,Ducks,California,Golden Bears,5-1,1-5,1,10,7,24,17,3,7,0,14,7,0,3,7,4,3,-4,3,7,0.7749982553633903,12.59165697667811,,
3312,2021,7,NCAAF_20211014_GAS@SALA,South Alabama,Jaguars,Ga. Southern,Eagles,4-2,2-5,1,31,8,41,14,10,21,7,3,0,8,3,3,2,23,10,23,27,0.2961418718319706,-8.92655802530794,0.33671820311807255,-6.487776995542333
3313,2021,7,NCAAF_20211014_NAVY@MEMP,Memphis,Tigers,Navy,Midshipmen,4-3,1-5,1,28,10,35,17,14,14,7,0,7,3,7,0,3,18,7,18,18,0.6772933692150768,7.669973246168638,0.641256282475025,5.569996949905487
3314,2021,7,NCAAF_20211012_APLST@UL,Louisiana,Ragin' Cajuns,App. St.,Mountaineers,5-1,4-2,1,20,6,41,13,20,0,7,14,3,3,7,0,1,14,17,14,28,0.3110054299672693,-8.217688634201636,0.45516081805819497,-1.733919417752304
3315,2021,8,NCAAF_20211023_ARPB@ARK,Arkansas,Razorbacks,Ark.-Pine Bluff,Golden Lions,5-3,1-6,1,45,0,45,3,17,28,0,0,0,0,0,3,4,45,17,45,42,0.998180835641607,48.58751565737771,,
3316,2021,8,NCAAF_20211023_CINCY@NAVY,Navy,Midshipmen,Cincinnati,Bearcats,1-6,7-0,0,10,13,20,27,7,3,0,10,7,6,14,0,-6,-3,0,-3,-7,0.25135358238371885,-11.198738197075272,0.004131933139513766,-40.79730903087727
3317,2021,8,NCAAF_20211023_EMICH@BGREEN,Bowling Green,Falcons,E. Michigan,Eagles,2-6,5-3,0,10,24,24,55,3,7,7,7,0,24,21,10,-3,-14,3,-14,-31,0.13409304204965533,-18.50063459561204,0.0950757835514141,-20.237751324998385
3318,2021,8,NCAAF_20211023_KSTATE@TXTECH,Texas Tech,Red Raiders,Kansas State,Wildcats,5-3,4-3,1,24,10,24,25,14,10,0,0,0,10,9,6,1,14,14,14,-1,0.43903967538141386,-2.5631796621877356,0.36895920495316004,-5.16877971310214
3319,2021,8,NCAAF_20211023_NILL@CMICH,C. Michigan,Chippewas,N. Illinois,Huskies,4-4,6-2,1,28,18,38,39,14,14,7,3,7,11,11,10,-2,10,7,10,-1,0.46663546373151354,-1.399018280169571,0.5870325118186044,3.3971009832440586
3320,2021,8,NCAAF_20211023_NWEST@MICH,Michigan,Wolverines,Northwestern,Wildcats,7-0,3-4,0,10,7,33,7,0,10,17,6,0,7,0,0,4,3,0,3,26,0.8307330531779409,15.991274450024093,0.6910041055185855,7.70345682578818
3321,2021,8,NCAAF_20211023_OKLA@KANSAS,Kansas,Jayhawks,Oklahoma,Sooners,1-6,8-0,1,10,0,23,35,7,3,7,6,0,0,14,21,-7,10,7,10,-12,0.013442395200799817,-36.97934008477955,0.0008584635662925999,-48.430984959043485
3322,2021,8,NCAAF_20211023_UMASS@FSU,Florida State,Seminoles,UMass,Minutemen,3-4,1-6,0,38,3,59,3,10,28,14,7,3,0,0,0,2,35,7,35,56,0.9554735283962654,28.411620322891395,,
3323,2021,8,NCAAF_20211023_WAKE@ARMY,Army,Black Knights,Wake Forest,Demon Deacons,4-3,7-0,0,21,28,56,70,7,14,14,21,14,14,21,21,-3,-7,-7,-7,-14,0.3501530867579957,-6.4312764132730535,,
3324,2021,8,NCAAF_20211023_CUSE@VATECH,Virginia Tech,Hokies,Syracuse,Orange,3-4,4-4,1,19,13,36,41,7,12,7,10,7,6,7,21,-1,6,0,6,-5,0.6348445097484965,5.75966738891691,0.6618883300105939,6.451061540873241
3325,2021,8,NCAAF_20211023_KENTST@OHIO,Ohio,Bobcats,Kent St.,Golden Flashes,1-7,4-4,1,7,17,27,34,0,7,10,10,10,7,14,3,-3,-10,-10,-10,-7,0.8157410500904068,15.025296603847437,,
3326,2021,8,NCAAF_20211023_TXSTSM@GAST,Georgia St.,Panthers,Texas St.,Bobcats,3-4,2-5,0,14,13,28,16,7,7,7,7,6,7,3,0,1,1,1,1,12,0.6652281316963701,7.130818615428211,,
3327,2021,8,NCAAF_20211023_WISC@PURDUE,Purdue,Boilermakers,Wisconsin,Badgers,4-3,4-3,0,13,13,13,30,0,13,0,0,7,6,7,10,0,0,-7,0,-17,0.24628618326211082,-11.465857617013512,0.42786057820903534,-2.8086514562401135
3328,2021,8,NCAAF_20211023_BUFF@AKRON,Akron,Zips,Buffalo,Bulls,2-6,4-4,1,10,24,10,45,0,10,0,0,3,21,21,0,-2,-14,-3,-14,-35,0.11137166754084449,-20.37227484070729,0.02206128115300976,-31.093891773576274
3329,2021,8,NCAAF_20211023_BYU@WASHST,Washington St.,Cougars,BYU,Cougars,4-4,6-2,1,7,7,19,21,7,0,6,6,7,0,7,7,-2,0,0,0,-2,0.6394853914016243,5.966381999140367,,
3330,2021,8,NCAAF_20211023_CLEM@PITT,Pittsburgh,Panthers,Clemson,Tigers,6-1,4-3,1,14,7,27,17,0,14,10,3,7,0,3,7,2,7,-7,7,10,0.07527337087404551,-24.020392587824063,,
3331,2021,8,NCAAF_20211023_COLO@CAL,California,Golden Bears,Colorado,Buffaloes,2-5,2-5,0,23,3,26,3,10,13,0,3,0,3,0,0,0,20,10,20,23,0.5697438123151141,2.9360753996116955,,
3332,2021,8,NCAAF_20211023_LSU@MISS,Ole Miss,Rebels,LSU,Tigers,6-1,4-4,1,17,7,31,17,0,17,14,0,7,0,0,10,2,10,-7,10,14,0.2288072466139508,-12.410855662780705,,
3333,2021,8,NCAAF_20211023_MD@MINN,Minnesota,Golden Gophers,Maryland,Terrapins,5-2,4-3,0,17,10,34,16,3,14,14,3,3,7,0,6,1,7,0,7,18,0.7283262170120737,10.154821271080095,,
3334,2021,8,NCAAF_20211023_MIAOH@BALLST,Ball St.,Cardinals,Miami-OH,RedHawks,4-4,4-4,1,10,16,17,24,7,3,7,0,10,6,0,8,0,-6,-3,-6,-7,0.37003525965842365,-5.543258308416739,,
3335,2021,8,NCAAF_20211023_NMEX@WYO,Wyoming,Cowboys,New Mexico,Lobos,4-3,3-5,0,3,14,3,14,0,3,0,0,7,7,0,0,1,-11,-7,-11,-11,0.8127956457830829,14.84137574220506,0.8032164125848567,13.178961493842621
3336,2021,8,NCAAF_20211023_OKLAST@IOWAST,Iowa St.,Cyclones,Oklahoma State,Cowboys,5-2,6-1,1,7,14,24,21,0,7,10,7,7,7,0,7,-1,-7,-7,-7,3,0.5628735212982665,2.644287757445227,0.6798272414163317,7.217138869983955
3337,2021,8,NCAAF_20211023_OREG@UCLA,UCLA,Bruins,Oregon,Ducks,5-3,6-1,1,17,14,31,34,14,3,0,14,0,14,13,7,-1,3,14,3,-3,0.24703092395168125,-11.426417344041397,,
3338,2021,8,NCAAF_20211023_RICE@UAB,UAB,Blazers,Rice,Owls,5-3,3-4,0,14,20,24,30,14,0,7,3,13,7,7,3,2,-6,1,-6,-6,0.8441017507058792,16.900116299484807,,
3339,2021,8,NCAAF_20211023_WMICH@TOLEDO,Toledo,Rockets,W. Michigan,Broncos,4-4,5-3,1,13,15,34,15,3,10,21,0,0,15,0,0,-1,-2,3,-2,19,0.5336312397947496,1.4102279915733789,0.5372391328449584,1.444006751228926
3340,2021,8,NCAAF_20211023_BC@LVILLE,Louisville,Cardinals,Boston College,Eagles,4-3,4-3,0,21,7,28,14,7,14,0,7,7,0,0,7,0,14,0,14,14,0.4171211995686839,-3.4965119212964737,0.6430216615139993,5.662101829384653
3341,2021,8,NCAAF_20211023_LIB@NTEXAS,North Texas,Mean Green,Liberty,Flames,1-6,6-2,1,20,14,26,35,7,13,6,0,0,14,14,7,-5,6,7,6,-9,0.35200867760349364,-6.347664544666486,,
3342,2021,8,NCAAF_20211023_MISSST@VANDY,Vanderbilt,Commodores,Miss. State,Bulldogs,2-6,4-3,0,3,24,6,45,0,3,3,0,10,14,7,14,-2,-21,-10,-21,-39,0.13096119204458123,-18.744740435163635,0.09975508981241421,-19.81785929654359
3343,2021,8,NCAAF_20211023_NEVADA@FRESNO,Fresno St.,Bulldogs,Nevada,Wolf Pack,6-2,5-2,0,14,10,34,32,7,7,14,6,3,7,6,16,1,4,4,4,2,0.7223081189688824,9.853286136647284,0.43406047264064174,-2.564928976894521
3344,2021,8,NCAAF_20211023_SALA@LAMON,UL-Monroe,Warhawks,South Alabama,Jaguars,4-3,4-3,1,24,17,41,31,7,17,14,3,7,10,14,0,0,7,0,7,10,0.4515399588718406,-2.0346377861184237,0.14404354465167268,-16.409900581619013
3345,2021,8,NCAAF_20211023_SDGST@AF,Air Force,Falcons,San Diego St.,Aztecs,6-2,7-0,1,0,13,14,20,0,0,7,7,3,10,7,0,-1,-13,-3,-13,-6,0.4964891698414564,-0.1470437278873078,0.5214112498826753,0.8294461308536256
3346,2021,8,NCAAF_20211023_TEMPLE@SFLA,South Florida,Bulls,Temple,Owls,2-5,3-4,1,17,7,34,14,0,17,10,7,0,7,7,0,-1,10,0,10,20,0.44363391214354375,-2.368654180598128,,
3347,2021,8,NCAAF_20211023_TENN@BAMA,Alabama,Crimson Tide,Tennessee,Volunteers,7-1,4-4,0,21,14,52,24,7,14,3,28,14,0,3,7,3,7,-7,7,28,0.968736255672095,31.120456893847177,0.9720515444689491,29.532402581737756
3348,2021,8,NCAAF_20211023_TXSA@LATECH,Louisiana Tech,Bulldogs,UTSA,Roadrunners,2-5,8-0,1,10,21,16,45,10,0,0,6,7,14,7,17,-6,-11,3,-11,-29,0.6150468849823363,4.887236800070468,,
3349,2021,8,NCAAF_20211023_WKY@FIU,FIU,Panthers,W. Kentucky,Hilltoppers,1-6,3-4,1,12,17,19,34,6,6,0,7,0,17,7,10,-2,-5,6,-5,-15,0.45216782598739935,-2.008148088289886,,
3350,2021,8,NCAAF_20211023_GATECH@UVA,Virginia,Cavaliers,Georgia Tech,Yellow Jackets,6-2,3-4,0,24,16,48,40,7,17,17,7,13,3,8,16,3,8,-6,8,8,0.6039476476990945,4.404039189130572,0.7194513500736204,8.978059094199637
3351,2021,8,NCAAF_20211023_NCST@MIAMI,Miami (Fla.),Hurricanes,NC State,Wolfpack,3-4,5-2,0,14,17,31,30,7,7,10,7,3,14,3,10,-2,-3,4,-3,1,0.5989351700236089,4.187049923711697,0.4619618761439833,-1.47508224948848
3352,2021,8,NCAAF_20211023_OHIOST@IND,Indiana,Hoosiers,Ohio State,Buckeyes,2-5,6-1,0,7,44,7,54,7,0,0,0,14,30,7,3,-4,-37,-7,-37,-47,0.07351046147130269,-24.22978324701785,0.13561367683961634,-16.995549018841984
3353,2021,8,NCAAF_20211023_SC@TXAM,Texas A&M,Aggies,South Carolina,Gamecocks,6-2,4-4,0,31,0,44,14,14,17,10,3,0,0,0,14,2,31,14,31,30,0.704244295706995,8.966643941635766,0.964203784272072,27.83109795182287
3354,2021,8,NCAAF_20211023_USC@ND,Notre Dame,Fighting Irish,USC,Trojans,6-1,3-4,1,17,3,31,16,7,10,7,7,0,3,0,13,3,14,7,14,15,0.7111031039364287,9.300200138918854,,
3355,2021,8,NCAAF_20211023_UTAH@OREGST,Oregon State,Beavers,Utah,Utes,5-2,4-3,0,14,24,42,34,7,7,21,7,14,10,7,3,1,-10,-7,-10,8,0.11339931283652471,-20.19484374067781,,
3356,2021,8,NCAAF_20211023_WVU@TCU,TCU,Horned Frogs,West Virginia,Mountaineers,3-4,3-4,0,17,20,17,29,7,10,0,0,10,10,3,6,0,-3,-3,-3,-12,0.596009992685382,4.060747390550773,0.628004798194413,5.04462243605866
3357,2021,8,NCAAF_20211023_NMEXST@HAWAII,Hawaii,,New Mexico St.,,4-4,1-7,,24,13,48,34,10,14,10,14,3,10,14,7,3,11,7,11,14,0.741433079633304,10.82335370795488,,
3358,2021,8,NCAAF_20211022_MTSU@UCONN,UConn,Huskies,Middle Tenn.,Blue Raiders,1-8,3-4,1,13,24,13,44,0,13,0,0,3,21,10,10,-2,-11,-3,-11,-31,0.17837124006059812,-15.398516920039356,,
3359,2021,8,NCAAF_20211022_MEMP@UCF,UCF,Knights,Memphis,Tigers,4-3,4-4,1,14,7,24,7,14,0,7,3,0,7,0,0,0,7,14,7,17,0.6716492868880524,7.426522018998867,0.7833946537240905,12.106053448123134
3360,2021,8,NCAAF_20211022_COLOST@UTAHST,Utah St.,Aggies,Colorado St.,Rams,5-2,3-4,0,20,14,26,24,0,20,3,3,0,14,0,10,2,6,0,6,2,0.6280935549339552,5.460522570533499,,
3361,2021,8,NCAAF_20211022_WASH@ARIZ,Arizona,Wildcats,Washington,Huskies,0-7,3-4,0,13,0,16,21,3,10,3,0,0,0,7,14,-3,13,3,13,-5,0.12968301966637275,-18.845523183465502,,
3362,2021,8,NCAAF_20211021_FAU@CHARLO,Charlotte,49ers,FAU,Owls,4-3,4-3,1,9,7,9,38,3,6,0,0,0,7,21,10,0,2,3,2,-29,0.16231806573779184,-16.457601754564052,,
3363,2021,8,NCAAF_20211021_TULANE@SMU,SMU,Mustangs,Tulane,Green Wave,7-0,1-6,1,31,7,55,26,17,14,7,17,7,0,12,7,6,24,10,24,29,0.5730535963668748,3.076959731751799,0.4894235375632525,-0.40957064706731217
3364,2021,8,NCAAF_20211021_UL@ARKST,Arkansas St.,Red Wolves,Louisiana,Ragin' Cajuns,1-6,6-1,0,10,14,27,28,0,10,17,0,0,14,14,0,-5,-4,0,-4,-1,0.37684469592008674,-5.242809931301281,0.058176250714866984,-24.256139513924552
3365,2021,8,NCAAF_20211021_SJST@UNLV,UNLV,Rebels,San Jose St.,Spartans,0-7,4-4,1,17,13,20,27,7,10,3,0,3,10,0,14,-4,4,4,4,-7,0.4893626907846267,-0.44556834866568806,0.13921213051383097,-16.742608743539222
3366,2021,8,NCAAF_20211020_CSTCAR@APLST,App. St.,Mountaineers,C. Carolina,Chanticleers,5-2,6-1,1,14,20,30,27,0,14,13,3,14,6,7,0,-1,-6,-14,-6,3,0.7603644920014075,11.820955037053068,0.25134680664020237,-10.353550352200557
3367,2021,9,NCAAF_20211030_BGREEN@BUFF,Buffalo,Bulls,Bowling Green,Falcons,4-5,3-6,0,10,28,44,56,0,10,13,21,14,14,0,28,1,-18,-14,-18,-12,0.9257211197722768,24.109270053338264,0.9734207982956644,29.71306830006415
3368,2021,9,NCAAF_20211030_CINCY@TULANE,Tulane,Green Wave,Cincinnati,Bearcats,1-7,8-0,1,12,14,12,31,0,12,0,0,7,7,7,10,-7,-2,-7,-2,-19,0.2737614215052473,-10.037869180081543,0.04883811374958125,-25.450310315823117
3369,2021,9,NCAAF_20211030_IND@MD,Maryland,Terrapins,Indiana,Hoosiers,5-3,2-6,0,14,10,38,35,14,0,14,10,0,10,7,18,3,4,14,4,3,0.2887900049459018,-9.294333552844364,,
3370,2021,9,NCAAF_20211030_IOWA@WISC,Wisconsin,Badgers,Iowa,Hawkeyes,5-3,6-2,0,20,0,27,7,7,13,0,7,0,0,7,0,-1,20,7,20,20,0.5067649022414483,0.2830058028508802,0.19393415473223685,-13.268775185263507
3371,2021,9,NCAAF_20211030_MIAMI@PITT,Pittsburgh,Panthers,Miami (Fla.),Hurricanes,6-2,4-4,1,17,31,34,38,10,7,14,3,21,10,7,0,2,-14,-11,-14,-4,0.4135331969735947,-3.645910785130809,0.7837616846083089,12.062063107925042
3372,2021,9,NCAAF_20211030_MICH@MICHST,Michigan St.,Spartans,Michigan,Wolverines,8-0,7-1,1,14,23,37,33,0,14,8,15,10,13,7,3,1,-9,-10,-9,4,0.2024861323290622,-13.89793145103522,0.32639351428468977,-6.913272816735798
3373,2021,9,NCAAF_20211030_RUT@ILL,Illinois,Fighting Illini,Rutgers,Scarlet Knights,3-6,4-4,0,14,10,14,20,0,14,0,0,7,3,0,10,-1,4,-7,4,-6,0.5418881918928268,1.7555166741736912,0.4196253214097402,-3.1171175935036217
3374,2021,9,NCAAF_20211030_TEXAS@BAYLOR,Baylor,Bears,Texas,Longhorns,7-1,4-4,1,10,14,31,24,10,0,7,14,14,0,7,3,3,-4,-4,-4,7,0.2899807588429629,-9.236221553818154,,
3375,2021,9,NCAAF_20211030_TXSTSM@UL,Louisiana,Ragin' Cajuns,Texas St.,Bobcats,7-1,2-6,0,17,0,45,0,0,17,18,10,0,0,0,0,5,17,0,17,45,0.8697379408203079,18.777368472257308,,
3376,2021,9,NCAAF_20211030_UCF@TEMPLE,Temple,Owls,UCF,Knights,3-5,5-3,1,0,21,7,49,0,0,0,7,7,14,21,7,-2,-21,-7,-21,-42,0.12865627789235068,-18.904415369048365,0.022476967783206625,-30.811052951561805
3377,2021,9,NCAAF_20211030_UMASS@LIB,Liberty,Flames,UMass,Minutemen,7-2,1-7,0,41,3,62,17,21,20,7,14,3,0,7,7,6,38,18,38,45,0.911080527334257,22.487031158513673,,
3378,2021,9,NCAAF_20211030_VATECH@GATECH,Georgia Tech,Yellow Jackets,Virginia Tech,Hokies,3-5,4-4,0,7,20,17,26,7,0,10,0,14,6,3,3,-1,-13,-7,-13,-9,0.3755078858610944,-5.295335847909428,0.4395483790659461,-2.33745815114969
3379,2021,9,NCAAF_20211030_IOWAST@WVU,West Virginia,Mountaineers,Iowa St.,Cyclones,4-4,5-3,1,17,17,38,31,14,3,7,14,14,3,14,0,-1,0,0,0,7,0.3267941172936919,-7.48961376720797,0.17630476785963556,-14.283728170323911
3380,2021,9,NCAAF_20211030_HAWAII@UTAHST,Utah St.,Aggies,Hawaii,Rainbow Warriors,6-2,4-5,0,20,10,51,31,14,6,21,10,0,10,15,6,2,10,14,10,20,0.7448472100504729,10.987219196563615,0.4979126755207388,-0.08039991382281642
3381,2021,9,NCAAF_20211030_MIZZOU@VANDY,Vanderbilt,Commodores,Missouri,Tigers,2-7,4-4,0,14,17,28,37,7,7,7,7,10,7,7,13,-2,-3,-3,-3,-9,0.16592681889185146,-16.19451797749332,0.1652726065462765,-14.951811251689378
3382,2021,9,NCAAF_20211030_WASHST@ARIZST,Arizona St.,Sun Devils,Washington St.,Cougars,5-3,5-4,1,7,28,21,34,0,7,0,14,14,14,0,6,0,-21,-14,-21,-13,0.4615480725118801,-1.6110359082991863,,
3383,2021,9,NCAAF_20211030_BC@CUSE,Syracuse,Orange,Boston College,Eagles,5-4,4-4,1,0,3,21,6,0,0,21,0,0,3,3,0,1,-3,0,-3,15,0.4015196836626047,-4.162426444556786,0.4435205826660199,-2.1827922824945745
3384,2021,9,NCAAF_20211030_COLO@OREG,Oregon,Ducks,Colorado,Buffaloes,7-1,2-6,1,31,14,52,29,14,17,14,7,0,14,0,15,5,17,14,17,23,0.8243976137650417,15.558143560844997,0.7959488063635417,12.71171018009045
3385,2021,9,NCAAF_20211030_FIU@MRSHL,Marshall,Thundering Herd,FIU,Panthers,5-3,1-7,0,24,0,38,0,3,21,7,7,0,0,0,0,4,24,3,24,38,0.7348053003345512,10.470699138360828,,
3386,2021,9,NCAAF_20211030_FSU@CLEM,Clemson,Tigers,Florida State,Seminoles,5-3,3-5,1,17,13,30,20,3,14,0,13,6,7,0,7,2,4,-3,4,10,0.953006831602782,27.949177484763595,,
3387,2021,9,NCAAF_20211030_LAMON@APLST,App. St.,Mountaineers,UL-Monroe,Warhawks,6-2,4-4,1,49,7,59,28,21,28,3,7,0,7,14,7,2,42,21,42,31,0.9257915477465983,24.117637660958735,0.9666417651872334,28.175614383937386
3388,2021,9,NCAAF_20211030_LATECH@ODU,Old Dominion,Monarchs,Louisiana Tech,Bulldogs,2-6,2-6,1,10,10,23,20,0,10,7,6,0,10,3,7,0,0,0,0,3,0.2512639488568359,-11.190081288749184,,
3389,2021,9,NCAAF_20211030_MINN@NWEST,Northwestern,Wildcats,Minnesota,Golden Gophers,3-5,6-2,0,7,20,14,41,0,7,0,7,13,7,0,21,-3,-13,-13,-13,-27,0.43370136858486397,-2.7863231739916046,0.33196717083927396,-6.676535528453201
3390,2021,9,NCAAF_20211030_PURDUE@NEB,Nebraska,Cornhuskers,Purdue,Boilermakers,3-6,5-3,0,17,14,23,28,7,10,0,6,0,14,7,7,-2,3,7,3,-5,0.42667223364808016,-3.0849574405661997,0.6112786876847791,4.343379211387401
3391,2021,9,NCAAF_20211030_TCU@KSTATE,Kansas State,Wildcats,TCU,Horned Frogs,5-3,3-5,0,21,5,31,12,7,14,0,10,0,5,0,7,2,16,7,16,19,0.39799530308030073,-4.314692886216335,0.29603216023587864,-8.234068518381719
3392,2021,9,NCAAF_20211030_TXTECH@OKLA,Oklahoma,Sooners,Texas Tech,Red Raiders,9-0,5-4,0,28,7,52,21,14,14,10,14,7,0,7,7,4,21,7,21,31,0.8669149461914567,18.556617924540546,0.9277658102452424,22.42506026086312
3393,2021,9,NCAAF_20211030_UGA@FLA,Florida,Gators,Georgia,Bulldogs,4-4,8-0,0,0,24,7,34,0,0,0,7,0,24,3,7,-4,-24,0,-24,-27,0.24991743359206087,-11.260708112907764,0.3113105112591872,-7.562433346574494
3394,2021,9,NCAAF_20211030_USM@MTSU,Middle Tenn.,Blue Raiders,So. Miss,Golden Eagles,4-4,1-7,1,21,7,35,10,14,7,14,0,7,0,3,0,3,14,7,14,25,0.5466671963343327,1.9566754808349742,,
3395,2021,9,NCAAF_20211030_CHARLO@WKY,W. Kentucky,Hilltoppers,Charlotte,49ers,4-4,4-4,0,28,13,45,13,14,14,7,10,3,10,0,0,0,15,11,15,32,0.6688977355579382,7.290827082623537,,
3396,2021,9,NCAAF_20211030_DUKE@WAKE,Wake Forest,Demon Deacons,Duke,Blue Devils,8-0,3-5,1,28,0,45,7,14,14,10,7,0,0,0,7,5,28,14,28,38,0.6768816296186384,7.660063322855308,,
3397,2021,9,NCAAF_20211030_WYO@SJST,San Jose St.,Spartans,Wyoming,Cowboys,5-4,4-4,1,17,7,27,21,0,17,10,0,0,7,7,7,1,10,0,10,6,0.23576291063108934,-12.015857082521507,0.5184520005237861,0.710987602498335
3398,2021,9,NCAAF_20211030_ARKST@SALA,South Alabama,Jaguars,Arkansas St.,Red Wolves,5-3,1-7,1,28,7,31,13,14,14,0,3,0,7,3,3,4,21,14,21,18,0.25987942574954614,-10.742816620001122,0.5540656285122764,2.0889153817496435
3399,2021,9,NCAAF_20211030_GAST@GAS,Ga. Southern,Eagles,Georgia St.,Panthers,2-6,4-4,1,7,0,14,21,0,7,0,7,0,0,7,14,-2,7,0,7,-7,0.5806590319462651,3.3974853787008215,0.47239544608475126,-1.0641218696935084
3400,2021,9,NCAAF_20211030_UTEP@FAU,FAU,Owls,UTEP,Miners,5-3,6-2,1,14,10,28,25,7,7,7,7,3,7,0,15,-1,4,4,4,3,0.9348351061594039,25.246742589144105,,
3401,2021,9,NCAAF_20211030_ARIZ@USC,USC,Trojans,Arizona,Wildcats,4-4,0-8,1,35,14,41,34,14,21,3,3,7,7,7,13,4,21,7,21,7,0.7866747007471266,13.26646931908715,0.9308637406195923,22.777001857732785
3402,2021,9,NCAAF_20211030_BOISE@COLOST,Colorado St.,Rams,Boise St.,Broncos,3-5,4-4,1,16,7,19,28,13,3,3,0,0,7,14,7,-1,9,13,9,-9,0.19367110765533624,-14.426520322784086,0.2548439043374907,-10.131471084780287
3403,2021,9,NCAAF_20211030_KANSAS@OKLAST,Oklahoma State,Cowboys,Kansas,Jayhawks,7-1,1-7,0,38,0,55,3,17,21,7,10,0,0,3,0,6,38,17,38,52,0.9379616259235214,25.665333566229606,0.9837732715761524,32.86547386846223
3404,2021,9,NCAAF_20211030_MISS@AUBURN,Auburn,Tigers,Ole Miss,Rebels,6-2,6-2,1,28,17,31,20,14,14,0,3,3,14,3,0,0,11,11,11,11,0.7861150636196608,13.234383853914892,,
3405,2021,9,NCAAF_20211030_OREGST@CAL,California,Golden Bears,Oregon State,Beavers,3-5,5-3,0,17,10,39,25,10,7,14,8,0,10,7,8,-2,7,10,7,14,0.6882684838991543,8.193299015250318,,
3406,2021,9,NCAAF_20211030_SMU@HOU,Houston,Cougars,SMU,Mustangs,7-1,7-1,1,23,20,44,37,17,6,7,14,7,13,14,3,0,3,10,3,7,0.48552453538194074,-0.6056766668320961,,
3407,2021,9,NCAAF_20211030_UK@MISSST,Miss. State,Bulldogs,Kentucky,Wildcats,5-3,6-2,0,14,10,31,17,0,14,17,0,7,3,0,7,-1,4,-7,4,14,0.5867241071670273,3.6569351854348042,0.49556321905682144,-0.17089941461472336
3408,2021,9,NCAAF_20211030_LVILLE@NCST,NC State,Wolfpack,Louisville,Cardinals,6-2,4-4,1,7,7,28,13,7,0,0,21,7,0,3,3,2,0,0,0,15,0.5995888672450547,4.210282054278537,0.4986288371511681,-0.05281454322926038
3409,2021,9,NCAAF_20211030_PSU@OHIOST,Ohio State,Buckeyes,Penn State,Nittany Lions,7-1,5-3,1,17,10,33,24,3,14,10,6,7,3,14,0,2,7,-4,7,9,0.7007423507334196,8.787225804627042,0.8209995256216831,14.124552672370669
3410,2021,9,NCAAF_20211030_UNC@ND,Notre Dame,Fighting Irish,North Carolina,Tar Heels,7-1,4-4,1,17,13,44,34,7,10,14,13,0,13,14,7,3,4,7,4,10,0.8258549789387337,15.65253894298337,,
3411,2021,9,NCAAF_20211030_UCLA@UTAH,Utah,Utes,UCLA,Bruins,5-3,5-4,1,28,10,44,24,7,21,0,16,3,7,7,7,0,18,4,18,20,0.7313885041971145,10.297238045168001,,
3412,2021,9,NCAAF_20211030_UVA@BYU,BYU,Cougars,Virginia,Cavaliers,7-2,6-3,0,38,42,66,49,21,17,7,21,7,35,7,0,1,-4,14,-4,17,0.456299353925707,-1.83177525578094,0.5757728529885513,2.936391429583864
3413,2021,9,NCAAF_20211030_FRESNO@SDGST,San Diego St.,Aztecs,Fresno St.,Bulldogs,7-1,7-2,0,7,20,20,30,0,7,6,7,7,13,3,7,0,-13,-7,-13,-10,0.4705769972686822,-1.231953411978452,0.5672278940824149,2.6018625680834475
3414,2021,9,NCAAF_20211030_WASH@STNFRD,Stanford,Cardinal,Washington,Huskies,3-5,4-4,1,3,9,13,20,3,0,0,10,0,9,3,8,-1,-6,3,-6,-7,0.3164475157160672,-7.971468755911815,,
3415,2021,9,NCAAF_20211029_NAVY@TULSA,Tulsa,Golden Hurricane,Navy,Midshipmen,3-5,2-6,0,3,3,17,20,0,3,7,7,0,3,7,10,1,0,0,0,-3,0.436045409131523,-2.686938875947817,,
3416,2021,9,NCAAF_20211029_UNLV@NEVADA,Nevada,Wolf Pack,UNLV,Rebels,6-2,0-8,1,20,0,51,20,10,10,21,10,0,0,7,13,6,20,10,20,31,0.7187183606362646,9.663410193810591,0.8831661874562456,18.30089887828092
3417,2021,9,NCAAF_20211028_SFLA@ECU,East Carolina,Pirates,South Florida,Bulls,4-4,2-6,0,6,14,29,14,0,6,13,10,0,14,0,0,2,-8,0,-8,15,0.3523164195580254,-6.326262065374635,,
3418,2021,9,NCAAF_20211028_TROY@CSTCAR,C. Carolina,Chanticleers,Troy,Trojans,7-1,4-4,0,21,14,35,28,7,14,7,7,7,7,7,7,3,7,0,7,7,0.46047929732782444,-1.655960059994868,0.9365033192257237,23.45022933275868
3419,2021,10,NCAAF_20211106_ILL@MINN,Minnesota,Golden Gophers,Illinois,Fighting Illini,6-3,4-6,1,0,14,6,14,0,0,0,6,7,7,0,0,2,-14,-7,-14,-8,0.8059480787493403,14.398981241686897,0.7987181854685153,12.752518489190948
3420,2021,10,NCAAF_20211106_KSTATE@KANSAS,Kansas,Jayhawks,Kansas State,Wildcats,1-8,6-3,1,3,21,10,35,3,0,7,0,14,7,7,7,-5,-18,-11,-18,-25,0.10478966419804892,-20.93331738450229,0.020679678410322033,-31.0781140498907
3421,2021,10,NCAAF_20211106_LATECH@UAB,UAB,Blazers,Louisiana Tech,Bulldogs,6-3,2-7,1,24,21,52,38,7,17,7,21,7,14,0,17,4,3,0,3,14,0.5939793719718275,3.967255616676084,,
3422,2021,10,NCAAF_20211106_LIB@MISS,Ole Miss,Rebels,Liberty,Flames,7-2,7-3,1,24,0,27,14,10,14,3,0,0,0,14,0,0,24,10,24,13,0.7546028065466697,11.495777347317585,,
3423,2021,10,NCAAF_20211106_MIZZOU@UGA,Georgia,Bulldogs,Missouri,Tigers,9-0,4-5,0,26,3,43,6,7,19,14,3,3,0,0,3,5,23,4,23,37,0.8786938480817081,19.494509202943618,0.981819586010976,31.884960817301703
3424,2021,10,NCAAF_20211106_OHIOST@NEB,Nebraska,Cornhuskers,Ohio State,Buckeyes,3-7,8-1,0,10,17,17,26,0,10,7,0,0,17,6,3,-5,-7,0,-7,-9,0.04990157855319044,-27.458040405532415,0.08824222466707521,-20.59258695555809
3425,2021,10,NCAAF_20211106_PITT@DUKE,Duke,Blue Devils,Pittsburgh,Panthers,3-6,7-2,1,19,30,29,54,12,7,3,7,7,23,14,10,-4,-11,5,-11,-25,0.30063604446770653,-8.718391743473944,0.010556333916814653,-35.13146280127512
3426,2021,10,NCAAF_20211106_SMU@MEMP,Memphis,Tigers,SMU,Mustangs,5-4,7-2,1,7,10,28,25,0,7,14,7,0,10,0,15,-2,-3,0,-3,3,0.5719634507501767,3.0259939346432247,0.3627637079279896,-5.34873880871055
3427,2021,10,NCAAF_20211106_WAKE@UNC,North Carolina,Tar Heels,Wake Forest,Demon Deacons,5-4,8-1,1,24,31,58,55,14,10,10,24,10,21,17,7,-3,-7,4,-7,3,0.4517120840921318,-2.024338831443856,,
3428,2021,10,NCAAF_20211106_GATECH@MIAMI,Miami (Fla.),Hurricanes,Georgia Tech,Yellow Jackets,5-4,3-6,0,17,21,33,30,14,3,7,9,7,14,7,2,2,-4,7,-4,3,0.7198050905069386,9.71424568870691,0.6624626785536099,6.386434214500582
3429,2021,10,NCAAF_20211106_APLST@ARKST,Arkansas St.,Red Wolves,App. St.,Mountaineers,1-8,7-2,1,14,24,14,48,0,14,0,0,14,10,14,10,-6,-10,-14,-10,-34,0.2262607402049086,-12.533032593975463,0.0879921038217758,-20.61642480236742
3430,2021,10,NCAAF_20211106_CAL@ARIZ,Arizona,Wildcats,California,Golden Bears,1-8,3-6,0,0,0,10,3,0,0,3,7,0,0,3,0,-2,0,0,0,7,0.3566974101176942,-6.12790199022038,0.13450722674855375,-16.839830519379575
3431,2021,10,NCAAF_20211106_LAMON@TXSTSM,Texas St.,Bobcats,UL-Monroe,Warhawks,3-6,4-5,1,20,16,27,19,10,10,0,7,6,10,3,0,-1,4,4,4,8,0.4557449518770045,-1.8545416753840982,,
3432,2021,10,NCAAF_20211106_NTEXAS@USM,So. Miss,Golden Eagles,North Texas,Mean Green,1-8,3-6,0,14,7,14,38,14,0,0,0,0,7,21,10,-2,7,14,7,-24,0.48435283325897427,-0.6545264980734373,0.510633104036438,0.40611143471426203
3433,2021,10,NCAAF_20211106_TEMPLE@ECU,East Carolina,Pirates,Temple,Owls,5-4,3-6,0,21,0,45,3,7,14,14,10,0,0,0,3,2,21,7,21,42,0.3407411916223646,-6.847642274076179,0.9434717431418459,24.141504056086774
3434,2021,10,NCAAF_20211106_AUBURN@TXAM,Texas A&M,Aggies,Auburn,Tigers,7-2,6-3,0,3,3,20,3,3,0,3,14,3,0,0,0,1,0,0,0,17,0.357007524653972,-6.114030240073362,0.6314915187597226,5.11602420094016
3435,2021,10,NCAAF_20211106_BAYLOR@TCU,TCU,Horned Frogs,Baylor,Bears,4-5,7-2,1,16,14,30,28,7,9,7,7,7,7,7,7,-3,2,0,2,2,0.6318797335483332,5.6196426032878435,0.4305637104052764,-2.6652066400350805
3436,2021,10,NCAAF_20211106_COLOST@WYO,Wyoming,Cowboys,Colorado St.,Rams,5-4,3-6,0,17,10,31,17,7,10,7,7,7,3,0,7,2,7,0,7,14,0.5393256617595823,1.6472569058572617,0.32799007421609905,-6.7867559889003815
3437,2021,10,NCAAF_20211106_IDST@BYU,BYU,Cougars,Idaho State,Bengals,8-2,1-8,0,42,7,59,14,21,21,7,10,0,7,7,0,7,35,21,35,45,0.9458246722984045,26.78806206661477,,
3438,2021,10,NCAAF_20211106_MICHST@PURDUE,Purdue,Boilermakers,Michigan St.,Spartans,6-3,8-1,0,21,14,40,29,7,14,10,9,7,7,7,8,-2,7,0,7,11,0.48895228056230455,-0.4620705448692206,0.5186660089542402,0.7130890144850355
3439,2021,10,NCAAF_20211106_MTSU@WKY,W. Kentucky,Hilltoppers,Middle Tenn.,Blue Raiders,5-4,4-5,0,31,14,48,21,21,10,17,0,7,7,0,7,1,17,14,17,27,0.5001628751319434,0.006811377042026834,,
3440,2021,10,NCAAF_20211106_NAVY@ND,Notre Dame,Fighting Irish,Navy,Midshipmen,8-1,2-7,1,17,3,34,6,0,17,0,17,3,0,3,0,6,14,-3,14,28,0.9189764871317538,23.327365327037683,,
3441,2021,10,NCAAF_20211106_OKLAST@WVU,West Virginia,Mountaineers,Oklahoma State,Cowboys,4-5,8-1,1,3,10,3,24,3,0,0,0,0,10,7,7,-4,-7,3,-7,-21,0.38070576293106684,-5.0656084950579725,0.32503100818580233,-6.911775633976845
3442,2021,10,NCAAF_20211106_PSU@MD,Maryland,Terrapins,Penn State,Nittany Lions,5-4,6-3,0,6,7,14,31,0,6,0,8,7,0,7,17,-1,-1,-7,-1,-17,0.06485732713718906,-25.27948397280636,,
3443,2021,10,NCAAF_20211106_RI@UMASS,UMass,Minutemen,Rhode Island,Rams,1-8,6-3,1,16,21,22,35,6,10,0,6,7,14,14,0,-5,-5,-1,-5,-13,0.36811897536856486,-5.619699747437494,,
3444,2021,10,NCAAF_20211106_SALA@TROY,Troy,Trojans,South Alabama,Jaguars,5-4,5-4,0,31,14,31,24,10,21,0,0,7,7,7,3,0,17,3,17,7,0.7655221035671335,12.08192613792312,0.5389742951973092,1.490749207429758
3445,2021,10,NCAAF_20211106_TULSA@CINCY,Cincinnati,Bearcats,Tulsa,Golden Hurricane,9-0,3-6,0,14,12,28,20,14,0,14,0,0,12,0,8,6,2,14,2,8,0.798031463208207,13.924320634560104,,
3446,2021,10,NCAAF_20211106_WISC@RUT,Rutgers,Scarlet Knights,Wisconsin,Badgers,4-5,6-3,0,3,31,3,52,3,0,0,0,7,24,21,0,-2,-28,-4,-28,-49,0.052358819474490614,-27.067506201114156,0.25892829790625427,-9.851787549866344
3447,2021,10,NCAAF_20211106_MISSST@ARK,Arkansas,Razorbacks,Miss. State,Bulldogs,6-3,5-4,1,13,7,31,28,10,3,3,15,0,7,7,14,1,6,10,6,3,0.19368990178949175,-14.420965233633524,0.5018355437020392,0.07009708953376048
3448,2021,10,NCAAF_20211106_NCST@FSU,Florida State,Seminoles,NC State,Wolfpack,3-6,7-2,1,0,14,14,28,0,0,14,0,7,7,7,7,-4,-14,-7,-14,-14,0.38972627353019385,-4.671955307325334,,
3449,2021,10,NCAAF_20211106_TULANE@UCF,UCF,Knights,Tulane,Green Wave,6-3,1-8,1,7,0,14,10,7,0,0,7,0,0,10,0,5,7,7,7,4,0.8191567145064582,15.218061754197038,0.6889186950307327,7.507643480313618
3450,2021,10,NCAAF_20211106_UTAHST@NMEXST,New Mexico St.,Aggies,Utah St.,Aggies,1-8,7-2,1,13,7,13,35,10,3,0,0,0,7,21,7,-6,6,10,6,-22,0.0926944385679952,-22.094844530270052,,
3451,2021,10,NCAAF_20211106_CSTCAR@GAS,Ga. Southern,Eagles,C. Carolina,Chanticleers,2-7,8-1,0,0,21,8,28,0,0,0,8,0,21,7,0,-6,-21,0,-21,-20,0.41251517739378774,-3.6884093575133647,0.07304647680689214,-22.143702576708506
3452,2021,10,NCAAF_20211106_MRSHL@FAU,FAU,Owls,Marshall,Thundering Herd,5-4,6-3,1,13,21,13,28,10,3,0,0,7,14,7,0,-1,-8,3,-8,-15,0.515333234894177,0.6413880806273937,,
3453,2021,10,NCAAF_20211106_BOISE@FRESNO,Fresno St.,Bulldogs,Boise St.,Broncos,7-3,5-4,0,7,16,14,40,0,7,0,7,10,6,7,17,2,-9,-10,-9,-26,0.3697252057190251,-5.548657699673754,0.3333611597039754,-6.560984611815684
3454,2021,10,NCAAF_20211106_IOWA@NWEST,Northwestern,Wildcats,Iowa,Hawkeyes,3-6,7-2,1,3,14,12,17,0,3,3,6,7,7,3,0,-4,-11,-7,-11,-5,0.20122703068475478,-13.96829830884667,0.06098944933631689,-23.561312999713095
3455,2021,10,NCAAF_20211106_LSU@BAMA,Alabama,Crimson Tide,LSU,Tigers,8-1,4-5,1,14,7,20,14,0,14,6,0,7,0,7,0,4,7,-7,7,6,0.8412256040917705,16.675403662831854,0.9815809203673207,31.803970239966702
3456,2021,10,NCAAF_20211106_ODU@FIU,FIU,Panthers,Old Dominion,Monarchs,1-8,3-6,1,10,24,24,47,10,0,7,7,24,0,6,17,-2,-14,-14,-14,-23,0.6678858833517487,7.2420727800571285,,
3457,2021,10,NCAAF_20211106_TENN@UK,Kentucky,Wildcats,Tennessee,Volunteers,6-3,5-4,0,21,24,42,45,7,14,14,7,14,10,14,7,1,-3,-7,-3,-3,0.6105902520243731,4.685723198866526,0.38860481000494984,-4.310866685661381
3458,2021,10,NCAAF_20211106_UNLV@NMEX,New Mexico,Lobos,UNLV,Rebels,3-6,1-8,1,17,21,17,31,7,10,0,0,7,14,3,7,2,-4,0,-4,-14,0.4851012734257356,-0.6232040503265353,0.6203698333252443,4.668814301502266
3459,2021,10,NCAAF_20211106_CLEM@LVILLE,Louisville,Cardinals,Clemson,Tigers,4-5,6-3,1,17,17,24,30,14,3,7,0,7,10,0,13,-2,0,7,0,-6,0.051228811282341136,-27.245247799273784,,
3460,2021,10,NCAAF_20211106_FLA@SC,South Carolina,Gamecocks,Florida,Gators,5-4,4-5,0,30,10,40,17,10,20,10,0,7,3,0,7,1,20,3,20,23,0.2289457311418287,-12.384637580326398,0.04049759729158442,-26.58425286652107
3461,2021,10,NCAAF_20211106_HOU@SFLA,South Florida,Bulls,Houston,Cougars,2-7,8-1,0,28,26,42,54,14,14,7,7,9,17,21,7,-6,2,5,2,-12,0.27966456417501684,-9.74053369349599,,
3462,2021,10,NCAAF_20211106_IND@MICH,Michigan,Wolverines,Indiana,Hoosiers,8-1,2-7,0,17,7,29,7,3,14,6,6,0,7,0,0,6,10,3,10,22,0.811376581393213,14.731306986081336,0.63720780206134,5.347581669296346
3463,2021,10,NCAAF_20211106_OREG@WASH,Washington,Huskies,Oregon,Ducks,4-5,8-1,0,9,10,16,26,9,0,0,7,3,7,7,9,-4,-1,6,-1,-10,0.5074814030789473,0.31288780775264513,0.28950324621308265,-8.452960148629018
3464,2021,10,NCAAF_20211106_TEXAS@IOWAST,Iowa St.,Cyclones,Texas,Longhorns,6-3,4-5,0,3,7,30,7,3,0,21,6,0,7,0,0,2,-4,3,-4,23,0.5267600842984637,1.119937211230308,0.6144225729418514,4.431336218046454
3465,2021,10,NCAAF_20211106_SJST@NEVADA,Nevada,Wolf Pack,San Jose St.,Spartans,7-2,5-5,1,7,7,27,24,7,0,10,10,7,0,7,10,2,0,0,0,3,0.7074805953818397,9.109912953584171,0.701116090968253,8.038212007696302
3466,2021,10,NCAAF_20211106_TXSA@UTEP,UTEP,Miners,UTSA,Roadrunners,6-3,9-0,0,9,30,23,44,6,3,7,7,16,14,7,7,-3,-21,-10,-21,-21,0.2341933479221192,-12.097398692703905,,
3467,2021,10,NCAAF_20211106_USC@ARIZST,Arizona St.,Sun Devils,USC,Trojans,6-3,4-5,0,14,10,31,16,7,7,3,14,0,10,6,0,2,4,7,4,15,0.4203068896525146,-3.3552161292232086,0.5696350557844415,2.6729146272940625
3468,2021,10,NCAAF_20211106_SDGST@HAWAII,Hawaii,Rainbow Warriors,San Diego St.,Aztecs,4-6,8-1,0,7,14,10,17,7,0,0,3,7,7,0,3,-4,-7,0,-7,-7,0.2159109131471868,-13.114622800668599,0.23383096336288167,-11.065039265798305
3469,2021,10,NCAAF_20211105_VATECH@BC,Boston College,Eagles,Virginia Tech,Hokies,5-4,4-5,0,10,0,17,3,7,3,7,0,0,0,3,0,1,10,7,10,14,0.46071408429686755,-1.6455866272850699,0.3642538255708502,-5.288257959467728
3470,2021,10,NCAAF_20211105_UTAH@STNFRD,Stanford,Cardinal,Utah,Utes,3-6,6-3,0,0,38,7,52,0,0,7,0,14,24,0,14,-3,-38,-14,-38,-45,0.3416545510146497,-6.80611040950464,0.25451127663942863,-10.060622147132335
3471,2021,10,NCAAF_20211104_GAST@UL,Louisiana,Ragin' Cajuns,Georgia St.,Panthers,8-1,4-5,1,0,3,21,17,0,0,7,14,3,0,7,7,4,-3,-3,-3,4,0.76025973218663,11.797624136080003,0.8426347042641023,15.316483191168686
3472,2021,10,NCAAF_20211103_CMICH@WMICH,W. Michigan,Broncos,C. Michigan,Chippewas,5-4,5-4,0,14,21,30,42,7,7,10,6,0,21,7,14,0,-7,7,-7,-12,0.5833627155621668,3.511962870619186,0.7279094721520523,9.240095470216602
3473,2021,10,NCAAF_20211103_NILL@KENTST,Kent St.,Golden Flashes,N. Illinois,Huskies,5-4,6-3,0,31,21,52,47,0,31,14,7,7,14,6,20,-1,10,-7,10,5,0.2715773788549606,-10.144461723848622,0.6207759198301492,4.685070399629012
3474,2021,10,NCAAF_20211102_BALLST@AKRON,Akron,Zips,Ball St.,Cardinals,2-7,5-4,0,10,21,25,31,3,7,0,15,7,14,7,3,-3,-11,-4,-11,-6,0.2893057531683436,-9.266314396113785,0.03286930902939855,-28.035560190197657
3475,2021,10,NCAAF_20211102_EMICH@TOLEDO,Toledo,Rockets,E. Michigan,Eagles,4-5,6-3,1,28,24,49,52,14,14,8,13,14,10,21,7,-2,4,0,4,-3,0.5973278863661535,4.111454760103811,0.7481833910019418,10.188956845655298
3476,2021,10,NCAAF_20211102_MIAOH@OHIO,Ohio,Bobcats,Miami-OH,RedHawks,2-7,4-5,1,14,0,35,33,7,7,14,7,0,0,13,20,-2,14,7,14,2,0.6136204542029777,4.817690821580413,0.3365208551046851,-6.4288413037251075
3477,2021,11,NCAAF_20211113_BUCK@ARMY,Army,Black Knights,Bucknell,Bison,6-3,1-9,0,42,0,63,10,21,21,7,14,0,0,10,0,5,42,21,42,53,0.9989289960833566,51.19344828112628,,
3478,2021,11,NCAAF_20211113_CUSE@LVILLE,Louisville,Cardinals,Syracuse,Orange,5-5,5-5,0,35,3,41,3,14,21,3,3,3,0,0,0,0,32,11,32,38,0.5309456928795055,1.2948826192583738,0.6838613011681377,7.264724395677604
3479,2021,11,NCAAF_20211113_HOU@TEMPLE,Temple,Owls,Houston,Cougars,3-7,9-1,1,0,10,8,37,0,0,0,8,7,3,14,13,-6,-10,-7,-10,-29,0.2861663527902438,-9.415855458601186,,
3480,2021,11,NCAAF_20211113_ME@UMASS,UMass,Minutemen,Maine,Black Bears,1-9,5-5,1,10,14,10,35,10,0,0,0,0,14,7,14,-4,-4,10,-4,-25,0.3879854000950791,-4.745682909357811,,
3481,2021,11,NCAAF_20211113_MICH@PSU,Penn State,Nittany Lions,Michigan,Wolverines,6-4,9-1,1,6,7,17,21,3,3,0,11,0,7,7,7,-3,-1,3,-1,-4,0.5352929368102213,1.477234474411489,0.5191829822702932,0.7302794300389905
3482,2021,11,NCAAF_20211113_MISSST@AUBURN,Auburn,Tigers,Miss. State,Bulldogs,6-4,6-4,1,28,10,34,43,14,14,0,6,3,7,13,20,0,18,11,18,-9,0.6746134165211324,7.549242082552041,0.6044975348342388,4.023194803403385
3483,2021,11,NCAAF_20211113_NMEXST@BAMA,Alabama,Crimson Tide,New Mexico St.,Aggies,9-1,1-9,0,49,3,59,3,14,35,0,10,3,0,0,0,8,46,11,46,56,0.9995929899686605,55.832525627538416,,
3484,2021,11,NCAAF_20211113_NWEST@WISC,Wisconsin,Badgers,Northwestern,Wildcats,7-3,3-7,1,21,0,35,7,0,21,14,0,0,0,0,7,4,21,0,21,28,0.8197250496447586,15.24758934030126,0.8465861971082413,15.514025801634261
3485,2021,11,NCAAF_20211113_OKLA@BAYLOR,Baylor,Bears,Oklahoma,Sooners,8-2,9-1,0,7,7,27,14,0,7,3,17,0,7,0,7,-1,0,0,0,13,0.14150717026141102,-17.903395184068074,0.26133848937848625,-9.70440411483446
3486,2021,11,NCAAF_20211113_RUT@IND,Indiana,Hoosiers,Rutgers,Scarlet Knights,2-8,5-5,1,3,17,3,38,0,3,0,0,14,3,14,7,-3,-14,-14,-14,-35,0.8034256008936713,14.240383734569036,0.6317212537193959,5.1073034809210185
3487,2021,11,NCAAF_20211113_SAMF@FLA,Florida,Gators,Samford,Bulldogs,5-5,4-6,0,35,42,70,52,14,21,21,14,21,21,0,10,1,-7,-7,-7,18,0.9589137783049797,28.987330632808153,,
3488,2021,11,NCAAF_20211113_UCF@SMU,SMU,Mustangs,UCF,Knights,8-2,6-4,1,38,14,55,28,21,17,7,10,14,0,7,7,2,24,7,24,27,0.2556547010179616,-10.953106245088406,0.45966265442574894,-1.5376405226363659
3489,2021,11,NCAAF_20211113_UCONN@CLEM,Clemson,Tigers,UConn,Huskies,7-3,1-9,1,30,7,44,7,10,20,7,7,7,0,0,0,6,23,3,23,37,0.9995776331618295,55.66112581925984,,
3490,2021,11,NCAAF_20211113_WVU@KSTATE,Kansas State,Wildcats,West Virginia,Mountaineers,7-3,4-6,0,17,3,34,17,14,3,7,10,0,3,7,7,3,14,14,14,17,0.49224182113539217,-0.3243255245694172,0.5079765536560907,0.3035636122692722
3491,2021,11,NCAAF_20211113_GAST@CSTCAR,C. Carolina,Chanticleers,Georgia St.,Panthers,8-2,5-5,1,23,28,40,42,14,9,3,14,14,14,0,14,3,-5,0,-5,-2,0.6592041274565617,6.842221054018751,0.8738813547918269,17.381821063460393
3492,2021,11,NCAAF_20211113_UTAH@ARIZ,Arizona,Wildcats,Utah,Utes,1-9,7-3,0,17,21,29,38,14,3,3,9,7,14,10,7,-6,-4,7,-4,-9,0.1483238169107337,-17.40438387231984,0.04864930608456941,-25.172395288055213
3493,2021,11,NCAAF_20211113_WKY@RICE,Rice,Owls,W. Kentucky,Hilltoppers,3-7,6-4,0,0,28,21,42,0,0,7,14,7,21,0,14,-3,-28,-7,-28,-21,0.22316824466222307,-12.699743294473024,,
3494,2021,11,NCAAF_20211113_SALA@APLST,App. St.,Mountaineers,South Alabama,Jaguars,8-2,5-5,1,14,7,31,7,14,0,3,14,0,7,0,0,3,7,14,7,24,0.9124197743820988,22.610076697920363,0.901556371610227,19.59132084510952
3495,2021,11,NCAAF_20211113_GAS@TXSTSM,Texas St.,Bobcats,Ga. Southern,Eagles,3-7,3-7,1,17,17,30,38,0,17,7,6,3,14,14,7,0,0,-3,0,-8,0.2658841194580901,-10.42794537238035,,
3496,2021,11,NCAAF_20211113_BC@GATECH,Georgia Tech,Yellow Jackets,Boston College,Eagles,3-7,6-4,0,21,28,30,41,14,7,3,6,7,21,0,13,-3,-7,7,-7,-11,0.4047873430834308,-4.018607308875289,0.4962577422886769,-0.1424116581142698
3497,2021,11,NCAAF_20211113_CHARLO@LATECH,Louisiana Tech,Bulldogs,Charlotte,49ers,3-7,5-5,0,14,7,42,32,7,7,14,14,0,7,10,15,-2,7,7,7,10,0.6821425165096261,7.899616054362809,,
3498,2021,11,NCAAF_20211113_DUKE@VATECH,Virginia Tech,Hokies,Duke,Blue Devils,5-5,3-7,1,17,3,48,17,7,10,10,21,0,3,7,7,2,14,7,14,31,0.6894761734970478,8.244279561925282,0.908336006488325,20.20020631333182
3499,2021,11,NCAAF_20211113_FAU@ODU,Old Dominion,Monarchs,FAU,Owls,4-6,5-5,0,11,3,30,16,2,9,6,13,3,0,7,6,-1,8,-1,8,14,0.13392271176734938,-18.478157670607857,,
3500,2021,11,NCAAF_20211113_FIU@MTSU,Middle Tenn.,Blue Raiders,FIU,Panthers,5-5,1-9,1,34,3,50,10,7,27,9,7,3,0,0,7,4,31,4,31,40,0.5855838480642834,3.6054423827757773,,
3501,2021,11,NCAAF_20211113_IOWAST@TXTECH,Texas Tech,Red Raiders,Iowa St.,Cyclones,6-4,6-4,1,31,14,41,38,14,17,0,10,7,7,7,17,0,17,7,17,3,0.2517509561481377,-11.156387755045898,0.04831429125629505,-25.222938831585907
3502,2021,11,NCAAF_20211113_MIAMI@FSU,Florida State,Seminoles,Miami (Fla.),Hurricanes,4-6,5-5,0,20,7,31,28,14,6,0,11,0,7,7,14,-1,13,14,13,3,0.3062920673298587,-8.444766281977536,,
3503,2021,11,NCAAF_20211113_MINN@IOWA,Iowa,Hawkeyes,Minnesota,Golden Gophers,8-2,6-4,0,10,13,27,22,3,7,7,10,3,10,3,6,2,-3,0,-3,5,0.735704659007333,10.508822257085853,0.7838816573259539,11.92311783370883
3504,2021,11,NCAAF_20211113_PURDUE@OHIOST,Ohio State,Buckeyes,Purdue,Boilermakers,9-1,6-4,0,45,17,59,31,21,24,7,7,7,10,14,0,3,28,14,28,28,0.9218766746282571,23.644037470288367,0.9119306467533289,20.53666316770591
3505,2021,11,NCAAF_20211113_UAB@MRSHL,Marshall,Thundering Herd,UAB,Blazers,6-4,7-3,0,7,14,14,21,0,7,7,0,14,0,7,0,-1,-7,-14,-7,-7,0.605874339298333,4.4789996295045285,,
3506,2021,11,NCAAF_20211113_UGA@TENN,Tennessee,Volunteers,Georgia,Bulldogs,5-5,10-0,1,10,24,17,41,10,0,0,7,7,17,3,14,-5,-14,3,-14,-24,0.06988477581943553,-24.625299621692193,0.053907288489379646,-24.413328727929866
3507,2021,11,NCAAF_20211113_UL@TROY,Troy,Trojans,Louisiana,Ragin' Cajuns,5-5,9-1,1,13,14,21,35,10,3,0,8,14,0,14,7,-4,-1,-4,-1,-14,0.4144280005615577,-3.6049353798557604,0.14441425720198742,-16.102973786710663
3508,2021,11,NCAAF_20211113_USM@TXSA,UTSA,Roadrunners,So. Miss,Golden Eagles,10-0,1-9,0,10,10,27,17,0,10,7,10,0,10,7,0,9,0,0,0,10,0.4986812119933052,-0.05512768364553722,0.9621013230462101,26.95646455387714
3509,2021,11,NCAAF_20211113_HAWAII@UNLV,UNLV,Rebels,Hawaii,Rainbow Warriors,2-8,4-7,0,10,10,27,13,7,3,10,7,10,0,0,3,-2,0,-3,0,14,0.38210118628267453,-5.002388582714389,0.3242905582449609,-6.918742711003233
3510,2021,11,NCAAF_20211113_MD@MICHST,Michigan St.,Spartans,Maryland,Terrapins,9-1,5-5,1,27,14,40,21,13,14,7,6,7,7,7,0,4,13,6,13,19,0.724470973299464,9.942099083965559,,
3511,2021,11,NCAAF_20211113_SC@MIZZOU,Missouri,Tigers,South Carolina,Gamecocks,5-5,5-5,0,17,14,31,28,0,17,7,7,7,7,0,14,0,3,-7,3,3,0.5883007805978914,3.7217890032787864,0.5106391457628203,0.4049148729141052
3512,2021,11,NCAAF_20211113_UTEP@NTEXAS,North Texas,Mean Green,UTEP,Miners,4-6,6-4,0,3,7,20,17,0,3,14,3,0,7,0,10,-2,-4,0,-4,3,0.7993951863411817,13.999273956424418,0.39960305895714776,-3.861796732255243
3513,2021,11,NCAAF_20211113_ARKST@LAMON,UL-Monroe,Warhawks,Arkansas St.,Red Wolves,4-6,2-8,0,7,10,24,27,0,7,17,0,7,3,7,10,2,-3,-7,-3,-3,0.24188341302645155,-11.677812121039665,0.3283760315655204,-6.746700376004355
3514,2021,11,NCAAF_20211113_STNFRD@OREGST,Oregon State,Beavers,Stanford,Cardinal,6-4,3-7,0,14,0,35,14,7,7,14,7,0,0,7,7,3,14,7,14,21,0.24138056124081197,-11.704687801729506,0.6752757497334699,6.900437792448884
3515,2021,11,NCAAF_20211113_AF@COLOST,Colorado St.,Rams,Air Force,Falcons,3-7,7-3,1,14,21,21,35,7,7,7,0,21,0,14,0,-4,-7,-14,-7,-14,0.33320888351696953,-7.188717597014488,,
3516,2021,11,NCAAF_20211113_ARIZST@WASH,Washington,Huskies,Arizona St.,Sun Devils,4-6,7-3,1,17,7,30,35,14,3,7,6,0,7,7,21,-3,10,14,10,-5,0.6819361797023638,7.889968063152651,0.3159485888139265,-7.27283754582686
3517,2021,11,NCAAF_20211113_NMEX@FRESNO,Fresno St.,Bulldogs,New Mexico,Lobos,8-3,3-7,0,24,0,34,7,7,17,10,0,0,0,7,0,5,24,7,24,27,0.8877995928403712,20.26038842422986,0.8224828289979944,14.04091822836017
3518,2021,11,NCAAF_20211113_TXAM@MISS,Ole Miss,Rebels,Texas A&M,Aggies,8-2,7-3,1,15,0,29,19,10,5,0,14,0,0,10,9,1,15,10,15,10,0.32692389072949724,-7.478114850938823,0.46531466876797745,-1.3215986362774856
3519,2021,11,NCAAF_20211113_UK@VANDY,Vanderbilt,Commodores,Kentucky,Wildcats,2-8,7-3,1,3,31,17,34,3,0,8,6,7,24,0,3,-5,-28,-4,-28,-17,0.17765760337630065,-15.414536358036685,0.06665396716156868,-22.79027273105953
3520,2021,11,NCAAF_20211113_NCST@WAKE,Wake Forest,Demon Deacons,NC State,Wolfpack,9-1,7-3,1,24,20,45,42,7,17,7,14,6,14,7,15,2,4,1,4,3,0.4995535320127049,-0.018663125648117784,,
3521,2021,11,NCAAF_20211113_ND@UVA,Virginia,Cavaliers,Notre Dame,Fighting Irish,6-4,9-1,0,0,21,3,28,0,0,0,3,7,14,7,0,-3,-21,-7,-21,-25,0.1781108931351496,-15.385512993842212,0.19624235908064958,-12.982030107562196
3522,2021,11,NCAAF_20211113_TCU@OKLAST,Oklahoma State,Cowboys,TCU,Horned Frogs,9-1,4-6,1,28,3,63,17,7,21,14,21,3,0,0,14,5,25,4,25,46,0.5641442075450245,2.6929957678778464,0.7330331621319789,9.443100922585018
3523,2021,11,NCAAF_20211113_COLO@UCLA,UCLA,Bruins,Colorado,Buffaloes,6-4,3-7,0,10,20,44,20,0,10,20,14,7,13,0,0,3,-10,-7,-10,24,0.6023296340012012,4.32557052803304,0.787411209160195,12.10682893967828
3524,2021,11,NCAAF_20211113_NEVADA@SDGST,San Diego St.,Aztecs,Nevada,Wolf Pack,9-1,7-3,1,10,7,23,21,7,3,7,6,0,7,7,7,2,3,7,3,2,0.6794228614944343,7.772659718286263,0.5220343232060505,0.8389308864086615
3525,2021,11,NCAAF_20211113_UTAHST@SJST,San Jose St.,Spartans,Utah St.,Aggies,5-6,8-2,1,14,24,17,48,7,7,3,0,0,24,7,17,-3,-10,7,-10,-31,0.18498252001542093,-14.95109995513144,0.42848611031760886,-2.736163063632148
3526,2021,11,NCAAF_20211113_WASHST@OREG,Oregon,Ducks,Washington St.,Cougars,9-1,5-5,0,14,14,38,24,14,0,10,14,0,14,0,10,4,0,14,0,14,0.6463729721496327,6.262788893770448,0.7663838265701497,11.036814061837049
3527,2021,11,NCAAF_20211112_CINCY@SFLA,South Florida,Bulls,Cincinnati,Bearcats,2-8,10-0,1,7,24,28,45,7,0,14,7,7,17,7,14,-8,-17,0,-17,-17,0.16437782387863475,-16.286626638164307,0.020606612570927774,-30.991248512614675
3528,2021,11,NCAAF_20211112_WYO@BOISE,Boise St.,Broncos,Wyoming,Cowboys,6-4,5-5,0,10,7,23,13,7,3,3,10,0,7,0,6,1,3,7,3,10,0.77912626417484,12.828299830700871,0.8587395236980537,16.315187491608413
3529,2021,11,NCAAF_20211110_BALLST@NILL,N. Illinois,Huskies,Ball St.,Cardinals,7-3,5-5,0,17,17,30,29,0,17,3,10,10,7,9,3,2,0,-10,0,1,0.6480869583707557,6.3397381569512845,0.27940669604440393,-8.875197392435666
3530,2021,11,NCAAF_20211110_TOLEDO@BGREEN,Bowling Green,Falcons,Toledo,Rockets,3-7,5-5,1,10,35,17,49,7,3,0,7,14,21,7,7,-2,-25,-7,-25,-32,0.09134122931139044,-22.222076088143922,0.0419167811314598,-26.24679051380417
3531,2021,11,NCAAF_20211110_KENTST@CMICH,C. Michigan,Chippewas,Kent St.,Golden Flashes,6-4,5-5,1,26,17,54,30,0,26,14,14,14,3,13,0,1,9,-14,9,24,0.6987799729951624,8.686684683027124,0.5254449954693301,0.9689528260246334
3532,2021,11,NCAAF_20211109_AKRON@WMICH,W. Michigan,Broncos,Akron,Zips,6-4,2-8,0,24,14,45,40,7,17,7,14,7,7,10,16,4,10,0,10,5,0.8534293411492697,17.531224808943534,0.9476856092599638,24.63682746344466
3533,2021,11,NCAAF_20211109_BUFF@MIAOH,Miami-OH,RedHawks,Buffalo,Bulls,5-5,4-6,0,24,10,45,18,10,14,14,7,7,3,0,8,1,14,3,14,27,0.37278137970787695,-5.411442002512445,0.3083955138381892,-7.596890017346595
3534,2021,11,NCAAF_20211109_OHIO@EMICH,E. Michigan,Eagles,Ohio,Bobcats,6-4,3-7,0,13,20,26,34,7,6,7,6,14,6,7,7,3,-7,-7,-7,-8,0.41458267338067845,-3.5983172325121586,0.6765835653310048,6.955667627845287
3535,2021,12,NCAAF_20211120_CHARSO@UGA,Georgia,Bulldogs,Charleston So.,Buccaneers,11-0,4-6,1,49,0,56,7,28,21,7,0,0,0,7,0,7,49,28,49,49,0.9998555542289052,60.51181692348291,,
3536,2021,12,NCAAF_20211120_FAU@WKY,W. Kentucky,Hilltoppers,FAU,Owls,7-4,5-6,0,31,10,52,17,14,17,7,14,3,7,7,0,2,21,11,21,35,0.3340001281064664,-7.159370130564639,0.7736668462469802,11.276260934421998
3537,2021,12,NCAAF_20211120_FSU@BC,Boston College,Eagles,Florida State,Seminoles,6-5,5-6,1,3,19,23,26,0,3,7,13,7,12,7,0,1,-16,-7,-16,-3,0.569786381801856,2.935070222208765,,
3538,2021,12,NCAAF_20211120_IOWAST@OKLA,Oklahoma,Sooners,Iowa St.,Cyclones,10-1,6-5,0,14,7,28,21,7,7,7,7,7,0,0,14,4,7,0,7,7,0.6740219962334036,7.529151660081936,0.38108156267808657,-4.544296933904889
3539,2021,12,NCAAF_20211120_KENTST@AKRON,Akron,Zips,Kent St.,Golden Flashes,2-9,6-5,1,0,29,0,38,0,0,0,0,7,22,3,6,-4,-29,-7,-29,-38,0.3730324231780259,-5.4056152227960865,0.20391681988112897,-12.428466115149831
3540,2021,12,NCAAF_20211120_MICHST@OHIOST,Ohio State,Buckeyes,Michigan St.,Spartans,10-1,9-2,1,49,0,56,7,21,28,0,7,0,0,0,7,1,49,21,49,49,0.9218837243164438,23.667756264625154,0.8822021710782036,17.809334489536695
3541,2021,12,NCAAF_20211120_NMEXST@UK,Kentucky,Wildcats,New Mexico St.,Aggies,8-3,1-10,0,35,16,56,16,21,14,14,7,7,9,0,0,7,19,14,19,40,0.9608748197624539,29.394537037583632,,
3542,2021,12,NCAAF_20211120_PRARIE@TXAM,Texas A&M,Aggies,Prairie View,Panthers,8-3,7-3,0,38,0,52,3,21,17,7,7,0,0,3,0,1,38,21,38,49,0.9962481725880155,44.62980696615966,,
3543,2021,12,NCAAF_20211120_PURDUE@NWEST,Northwestern,Wildcats,Purdue,Boilermakers,3-8,7-4,0,7,13,14,32,0,7,7,0,0,13,13,6,-4,-6,0,-6,-18,0.4248350813212438,-3.1639087150294927,0.23385929091613122,-10.904159393281589
3544,2021,12,NCAAF_20211120_RUT@PSU,Penn State,Nittany Lions,Rutgers,Scarlet Knights,7-4,5-6,1,7,0,28,0,0,7,14,7,0,0,0,0,2,7,0,7,28,0.9624973645223036,29.72008920146743,0.8519526826375836,15.68881518971159
3545,2021,12,NCAAF_20211120_SFLA@TULANE,Tulane,Green Wave,South Florida,Bulls,2-9,2-9,0,35,7,45,14,28,7,7,3,7,0,0,7,0,28,21,28,31,0.645833450876752,6.244640444329093,,
3546,2021,12,NCAAF_20211120_TEXAS@WVU,West Virginia,Mountaineers,Texas,Longhorns,5-6,4-7,1,21,10,31,23,7,14,7,3,0,10,7,6,1,11,7,11,8,0.3614475747363761,-5.91907470823503,0.1515972668666421,-15.460010311158612
3547,2021,12,NCAAF_20211120_TNST@MISSST,Miss. State,Bulldogs,Tennessee St.,Tigers,7-4,5-6,0,35,0,55,10,21,14,14,6,0,0,0,10,2,35,21,35,45,0.9537307796058635,28.079615940576446,,
3548,2021,12,NCAAF_20211120_UMASS@ARMY,Army,Black Knights,UMass,Minutemen,7-3,1-10,0,19,10,33,17,8,11,0,14,3,7,0,7,6,9,5,9,16,0.9572951491638167,28.713407024977755,,
3549,2021,12,NCAAF_20211120_WAKE@CLEM,Clemson,Tigers,Wake Forest,Demon Deacons,8-3,9-2,0,17,10,48,27,10,7,21,10,0,10,3,14,-1,7,10,7,21,0.9027691695560645,21.65856440096661,,
3550,2021,12,NCAAF_20211120_WOFF@UNC,North Carolina,Tar Heels,Wofford,Terriers,6-5,1-10,1,20,7,34,14,10,10,14,0,0,7,0,7,5,13,10,13,20,0.8598074764402797,18.018935883336894,,
3551,2021,12,NCAAF_20211120_TXSTSM@CSTCAR,C. Carolina,Chanticleers,Texas St.,Bobcats,9-2,3-8,1,14,14,35,21,7,7,14,7,0,14,7,0,6,0,7,0,14,0.8066122586074126,14.44713200656588,,
3552,2021,12,NCAAF_20211120_ARKST@GAST,Georgia St.,Panthers,Arkansas St.,Red Wolves,6-5,2-9,1,14,13,28,20,7,7,0,14,3,10,0,7,4,1,4,1,8,0.38193075742217697,-5.014696050288535,0.7908330532425303,12.152229665624873
3553,2021,12,NCAAF_20211120_ILL@IOWA,Iowa,Hawkeyes,Illinois,Fighting Illini,9-2,4-7,0,17,13,33,23,7,10,3,13,10,3,3,7,5,4,-3,4,10,0.9235497060751374,23.85978510957102,0.873318823231587,17.150953507347367
3554,2021,12,NCAAF_20211120_GATECH@ND,Notre Dame,Fighting Irish,Georgia Tech,Yellow Jackets,10-1,3-8,1,45,0,55,0,24,21,10,0,0,0,0,0,7,45,24,45,55,0.8852381242673822,20.057636323798647,0.9271391408243305,21.844632253061036
3555,2021,12,NCAAF_20211120_WASH@COLO,Colorado,Buffaloes,Washington,Huskies,4-7,4-7,1,10,10,20,17,10,0,0,10,0,10,0,7,0,0,10,0,3,0.16683954208166285,-16.137261415800822,0.2629908935950963,-9.52207283149346
3556,2021,12,NCAAF_20211120_APLST@TROY,Troy,Trojans,App. St.,Mountaineers,5-6,9-2,1,7,10,7,45,7,0,0,0,3,7,21,14,-4,-3,4,-3,-38,0.25812819456246106,-10.83563240311355,0.14174371057794344,-16.104338805336965
3557,2021,12,NCAAF_20211120_ARK@BAMA,Alabama,Crimson Tide,Arkansas,Razorbacks,10-1,7-4,0,24,14,42,35,3,21,10,8,0,14,7,14,3,10,3,10,7,0.9854148219070562,36.40956770825255,0.9657558347842768,27.354847352110482
3558,2021,12,NCAAF_20211120_ECU@NAVY,Navy,Midshipmen,East Carolina,Pirates,2-8,7-4,0,21,24,35,38,7,14,0,14,14,10,0,14,-5,-3,-7,-3,-3,0.7196950932204103,9.714040055125679,,
3559,2021,12,NCAAF_20211120_MICH@MD,Maryland,Terrapins,Michigan,Wolverines,5-6,10-1,0,3,24,18,59,0,3,15,0,14,10,28,7,-5,-21,-14,-21,-41,0.07549904893567061,-23.970861399067985,0.036497280726684234,-26.92066685055852
3560,2021,12,NCAAF_20211120_MINN@IND,Indiana,Hoosiers,Minnesota,Golden Gophers,2-9,7-4,0,7,21,14,35,7,0,0,7,0,21,7,7,-5,-14,7,-14,-21,0.43412132601489617,-2.7691582571865183,0.251938233968825,-10.036368527326658
3561,2021,12,NCAAF_20211120_MRSHL@CHARLO,Charlotte,49ers,Marshall,Thundering Herd,5-6,7-4,1,14,21,28,49,7,7,0,14,7,14,21,7,-2,-7,0,-7,-21,0.16026487703263959,-16.58195226940518,,
3562,2021,12,NCAAF_20211120_NEB@WISC,Wisconsin,Badgers,Nebraska,Cornhuskers,8-3,3-8,0,14,14,35,28,14,0,14,7,7,7,7,7,5,0,7,0,7,0.8247835489328388,15.586739375563297,0.5840932582667577,3.1889251315708407
3563,2021,12,NCAAF_20211120_ODU@MTSU,Middle Tenn.,Blue Raiders,Old Dominion,Monarchs,5-6,5-6,1,10,10,17,24,7,3,0,7,7,3,0,14,0,0,0,0,-7,0.7146626779928006,9.465690978834573,,
3564,2021,12,NCAAF_20211120_SMU@CINCY,Cincinnati,Bearcats,SMU,Mustangs,11-0,8-3,0,27,0,48,14,14,13,14,7,0,0,0,14,3,27,14,27,34,0.6310291701625126,5.585025231275495,0.7114140769241006,8.371420378503444
3565,2021,12,NCAAF_20211120_UAB@TXSA,UTSA,Roadrunners,UAB,Blazers,11-0,7-4,0,17,24,34,31,7,10,10,7,14,10,0,7,4,-7,-7,-7,3,0.3297297392037575,-7.3557656726359255,0.6396066595046973,5.366635417847419
3566,2021,12,NCAAF_20211120_UVA@PITT,Pittsburgh,Panthers,Virginia,Cavaliers,9-2,6-5,0,24,21,48,38,0,24,10,14,7,14,10,7,3,3,-7,3,10,0.5491063988404022,2.0599366853670062,0.6909118046951938,7.484247943678611
3567,2021,12,NCAAF_20211120_BYU@GAS,Ga. Southern,Eagles,BYU,Cougars,3-8,9-2,1,17,20,17,34,3,14,0,0,7,13,7,7,-6,-3,-4,-3,-17,0.15401388757881684,-17.015948051749433,0.06260703340759977,-23.022448161044622
3568,2021,12,NCAAF_20211120_CUSE@NCST,NC State,Wolfpack,Syracuse,Orange,8-3,5-6,1,28,7,41,17,0,28,10,3,0,7,3,7,3,21,0,21,24,0.6474853816860026,6.318832626997278,0.7919956175831668,12.213041408800564
3569,2021,12,NCAAF_20211120_KANSAS@TCU,TCU,Horned Frogs,Kansas,Jayhawks,5-6,2-9,0,7,14,31,28,7,0,14,10,7,7,0,14,3,-7,0,-7,3,0.9212476551351515,23.595259679109745,0.9733833713124007,29.02521963913864
3570,2021,12,NCAAF_20211120_RICE@UTEP,UTEP,Miners,Rice,Owls,7-4,3-8,1,14,21,38,28,7,7,10,14,0,21,0,7,4,-7,7,-7,10,0.42370443464434504,-3.2120881798846312,0.6317992826829719,5.054538840453006
3571,2021,12,NCAAF_20211120_TEMPLE@TULSA,Tulsa,Golden Hurricane,Temple,Owls,5-6,3-8,0,27,0,44,10,10,17,7,10,0,0,10,0,2,27,10,27,34,0.5645736249281477,2.7138106725434454,,
3572,2021,12,NCAAF_20211120_UCLA@USC,USC,Trojans,UCLA,Bruins,4-6,7-4,1,17,28,33,62,10,7,9,7,7,21,14,20,-3,-11,3,-11,-29,0.6410235096891601,6.029309042815157,0.4937314276184086,-0.23594715725107562
3573,2021,12,NCAAF_20211120_UCONN@UCF,UCF,Knights,UConn,Huskies,7-4,1-10,0,35,14,49,17,21,14,0,14,0,14,0,3,6,21,21,21,32,0.9893011252311485,38.40792820201773,,
3574,2021,12,NCAAF_20211120_UL@LIB,Liberty,Flames,Louisiana,Ragin' Cajuns,7-4,10-1,1,7,21,14,42,0,7,7,0,7,14,7,14,-3,-14,-7,-14,-28,0.4586123491149685,-1.7348689637516372,0.500111109417753,0.004181952632961838
3575,2021,12,NCAAF_20211120_BAYLOR@KSTATE,Kansas State,Wildcats,Baylor,Bears,7-4,9-2,0,7,17,10,20,0,7,3,0,7,10,0,3,-2,-10,-7,-10,-10,0.5448242112134654,1.8795078539019414,0.3647354497966604,-5.192784000394113
3576,2021,12,NCAAF_20211120_AUBURN@SC,South Carolina,Gamecocks,Auburn,Tigers,6-5,6-5,0,14,14,21,17,0,14,7,0,14,0,3,0,0,0,-14,0,4,0.187467893829947,-14.81079791955915,0.15206333851700493,-15.430236560812318
3577,2021,12,NCAAF_20211120_CAL@STNFRD,Stanford,Cardinal,California,Golden Bears,3-8,4-6,1,3,14,11,41,0,3,0,8,0,14,13,14,-1,-11,0,-11,-30,0.5715579498688603,3.010381424393472,0.37029409615483777,-4.971232382215021
3578,2021,12,NCAAF_20211120_NTEXAS@FIU,FIU,Panthers,North Texas,Mean Green,1-10,5-6,0,0,35,7,49,0,0,7,0,7,28,14,0,-4,-35,-7,-35,-42,0.42974755219684235,-2.9548773199530842,,
3579,2021,12,NCAAF_20211120_OREG@UTAH,Utah,Utes,Oregon,Ducks,8-3,9-2,1,28,0,38,7,7,21,7,3,0,0,7,0,-1,28,7,28,31,0.4836467056394096,-0.684449733680367,0.5002012635469659,0.007575187252314208
3580,2021,12,NCAAF_20211120_SALA@TENN,Tennessee,Volunteers,South Alabama,Jaguars,6-5,5-6,0,35,7,60,14,14,21,14,11,0,7,0,7,1,28,14,28,46,0.9107244769827121,22.455418827340964,0.938179032177359,23.11876589527742
3581,2021,12,NCAAF_20211120_VANDY@MISS,Ole Miss,Rebels,Vanderbilt,Commodores,9-2,2-9,1,24,9,31,17,10,14,0,7,3,6,0,8,7,15,7,15,14,0.8064515816530785,14.43735708047052,0.9944453830609447,38.1278854051875
3582,2021,12,NCAAF_20211120_VATECH@MIAMI,Miami (Fla.),Hurricanes,Virginia Tech,Hokies,6-5,5-6,0,28,13,38,26,14,14,3,7,3,10,13,0,1,15,11,15,12,0.5850517702213183,3.5861499240626245,0.5775747953897962,2.938419134249216
3583,2021,12,NCAAF_20211120_OKLAST@TXTECH,Texas Tech,Red Raiders,Oklahoma State,Cowboys,6-5,10-1,1,0,13,0,23,0,0,0,0,3,10,3,7,-4,-13,-3,-13,-23,0.27926774064823934,-9.765490586779777,0.09647796738029846,-19.548376410174342
3584,2021,12,NCAAF_20211120_WYO@UTAHST,Utah St.,Aggies,Wyoming,Cowboys,8-3,6-5,0,17,24,17,44,14,3,0,0,14,10,17,3,2,-7,0,-7,-27,0.590606740339305,3.8243812493919904,0.610821402393439,4.226256029597607
3585,2021,12,NCAAF_20211120_LAMON@LSU,LSU,Tigers,UL-Monroe,Warhawks,5-6,4-7,0,17,7,27,14,7,10,7,3,0,7,0,7,1,10,7,10,13,0.990701914873759,39.286577548521905,0.991077993211866,35.56918087175222
3586,2021,12,NCAAF_20211120_NMEX@BOISE,Boise St.,Broncos,New Mexico,Lobos,7-4,3-8,0,24,0,37,0,10,14,6,7,0,0,0,0,4,24,10,24,37,0.9450927281944381,26.6919658726855,0.9526211962385387,25.088082867298453
3587,2021,12,NCAAF_20211120_ARIZST@OREGST,Oregon State,Beavers,Arizona St.,Sun Devils,7-4,7-4,0,17,0,24,10,3,14,0,7,0,0,3,7,0,17,3,17,14,0.23559011440621702,-12.028040521047956,0.36924208152631244,-5.013078241779567
3588,2021,12,NCAAF_20211120_COLOST@HAWAII,Hawaii,Rainbow Warriors,Colorado St.,Rams,5-7,3-8,1,29,10,50,45,9,20,7,14,7,3,7,28,2,19,2,19,5,0.36677934846429383,-5.682095361200254,0.27798699954793027,-8.841575860461262
3589,2021,12,NCAAF_20211119_USM@LATECH,Louisiana Tech,Bulldogs,So. Miss,Golden Eagles,3-8,2-9,0,9,21,19,35,3,6,0,10,7,14,0,14,1,-12,-4,-12,-16,0.5763067238210962,3.212563800564112,0.7232978739556429,8.899155621166301
3590,2021,12,NCAAF_20211119_ARIZ@WASHST,Washington St.,Cougars,Arizona,Wildcats,6-5,1-10,1,21,7,44,18,7,14,16,7,0,7,3,8,5,14,7,14,26,0.7468729318854894,11.09528281704388,0.8185688797474722,13.66292661876605
3591,2021,12,NCAAF_20211119_MEMP@HOU,Houston,Cougars,Memphis,Tigers,10-1,5-6,0,21,3,31,13,0,21,0,10,0,3,7,3,5,18,0,18,18,0.43445153750006715,-2.7551510199768927,,
3592,2021,12,NCAAF_20211119_SDGST@UNLV,UNLV,Rebels,San Diego St.,Aztecs,2-9,10-1,1,10,21,20,28,3,7,10,0,7,14,0,7,-8,-11,-4,-11,-8,0.1488631563596654,-17.38239321285812,0.15704652137010844,-15.11561180151989
3593,2021,12,NCAAF_20211118_LVILLE@DUKE,Duke,Blue Devils,Louisville,Cardinals,3-8,6-5,0,9,35,22,62,3,6,7,6,14,21,13,14,-3,-26,-11,-26,-40,0.36515609275540095,-5.754120227197291,0.01284961500853432,-33.49536282998224
3594,2021,12,NCAAF_20211117_CMICH@BALLST,Ball St.,Cardinals,C. Michigan,Chippewas,5-6,7-4,1,17,28,17,37,7,10,0,0,7,21,6,3,-2,-11,0,-11,-20,0.36652142880524274,-5.69353231598393,0.6470293142392461,5.665516519791026
3595,2021,12,NCAAF_20211116_TOLEDO@OHIO,Ohio,Bobcats,Toledo,Rockets,3-8,6-5,0,6,14,23,35,0,6,3,14,0,14,14,7,-3,-8,0,-8,-12,0.4942929164901879,-0.2388051377948841,0.15726996908332325,-15.10165920530585
3596,2021,12,NCAAF_20211116_WMICH@EMICH,E. Michigan,Eagles,W. Michigan,Broncos,7-4,6-5,1,6,7,22,21,0,6,10,6,0,7,14,0,1,-1,0,-1,1,0.4679940068484293,-1.3406413677637374,0.5054475940462544,0.20504371689617074
3597,2021,12,NCAAF_20211116_BGREEN@MIAOH,Miami-OH,RedHawks,Bowling Green,Falcons,6-5,3-8,0,20,7,34,7,6,14,14,0,7,0,0,0,3,13,-1,13,27,0.8609267013454296,18.103024837834823,0.9092705027625783,20.064786796758654
3598,2021,13,NCAAF_20211127_AKRON@TOLEDO,Toledo,Rockets,Akron,Zips,7-5,2-10,0,21,7,49,14,7,14,14,14,0,7,0,7,5,14,7,14,35,0.8909400491941433,20.62763602468948,0.976674409380818,29.88187004177962
3599,2021,13,NCAAF_20211127_ARMY@LIB,Liberty,Flames,Army,Black Knights,7-5,8-3,1,3,24,16,31,0,3,13,0,10,14,7,0,-1,-21,-10,-21,-15,0.3806710514900108,-5.087116303087498,,
3600,2021,13,NCAAF_20211127_FSU@FLA,Florida,Gators,Florida State,Seminoles,6-6,5-7,1,7,7,24,21,7,0,10,7,0,7,0,14,1,0,7,0,3,0.7843909348687405,13.183622128516049,0.7758551062115762,11.389311493403056
3601,2021,13,NCAAF_20211127_HOU@UCONN,UConn,Huskies,Houston,Cougars,1-11,11-1,1,10,21,17,45,0,10,0,7,7,14,17,7,-10,-11,-7,-11,-28,0.043230389872417674,-28.714715137540054,0.007170153168931992,-36.77867705786775
3602,2021,13,NCAAF_20211127_MD@RUT,Rutgers,Scarlet Knights,Maryland,Terrapins,5-7,6-6,0,2,20,16,40,2,0,14,0,13,7,6,14,-1,-18,-11,-18,-24,0.40154785904572776,-4.176346851156154,0.7274312343061772,9.088122535347622
3603,2021,13,NCAAF_20211127_NAVY@TEMPLE,Temple,Owls,Navy,Midshipmen,3-9,3-8,0,7,17,14,38,0,7,7,0,7,10,7,14,0,-10,-7,-10,-24,0.3685782360914214,-5.62146391638089,0.08267371769840293,-20.837582619811997
3604,2021,13,NCAAF_20211127_OHIOST@MICH,Michigan,Wolverines,Ohio State,Buckeyes,11-1,10-2,1,14,13,42,27,7,7,14,14,3,10,0,14,1,1,4,1,15,0.27052539608886106,-10.237664045556244,0.24264795751254353,-10.48120706420815
3605,2021,13,NCAAF_20211127_TXTECH@BAYLOR,Baylor,Bears,Texas Tech,Red Raiders,10-2,6-6,1,17,10,27,24,10,7,0,10,3,7,0,14,4,7,7,7,3,0.5434270785071663,1.8268837026776623,0.7819591354013666,11.698088667622699
3606,2021,13,NCAAF_20211127_UGA@GATECH,Georgia Tech,Yellow Jackets,Georgia,Bulldogs,3-9,12-0,1,0,24,0,45,0,0,0,0,10,14,14,7,-9,-24,-10,-24,-45,0.04601277991756958,-28.21957254888224,0.0020990855314863,-43.00077467596026
3607,2021,13,NCAAF_20211127_WAKE@BC,Boston College,Eagles,Wake Forest,Demon Deacons,6-6,10-2,0,10,24,10,41,7,3,0,0,14,10,10,7,-4,-14,-7,-14,-31,0.4492854453241488,-2.1349969844143857,0.23003873790760165,-11.09566758431265
3608,2021,13,NCAAF_20211127_MIAMI@DUKE,Duke,Blue Devils,Miami (Fla.),Hurricanes,3-9,7-5,1,10,30,10,47,10,0,0,0,10,20,17,0,-4,-20,0,-20,-37,0.21103704177296723,-13.446910430941784,0.04236590936976126,-25.892728114852787
3609,2021,13,NCAAF_20211127_LATECH@RICE,Rice,Owls,Louisiana Tech,Bulldogs,4-8,3-9,0,14,10,35,31,7,7,7,14,10,0,14,7,1,4,-3,4,4,0.2367568071231807,-12.005551656062494,0.4214710617783888,-2.9759641044004184
3610,2021,13,NCAAF_20211127_CHARLO@ODU,Old Dominion,Monarchs,Charlotte,49ers,6-6,5-7,0,28,14,56,34,14,14,7,21,0,14,14,6,1,14,14,14,22,0.48417845235758383,-0.6644353388699074,,
3611,2021,13,NCAAF_20211127_TROY@GAST,Georgia St.,Panthers,Troy,Trojans,7-5,5-7,0,17,3,37,10,7,10,13,7,0,3,0,7,2,14,7,14,27,0.3394090124246223,-6.935545094340114,0.5526755761657713,1.9890287350991116
3612,2021,13,NCAAF_20211127_TXSA@NTEXAS,North Texas,Mean Green,UTSA,Roadrunners,6-6,11-1,1,31,13,45,23,17,14,14,0,3,10,0,10,-5,18,14,18,22,0.5394371267876403,1.6584573855993767,0.07794527417670594,-21.314016027636
3613,2021,13,NCAAF_20211127_TXSTSM@ARKST,Arkansas St.,Red Wolves,Texas St.,Bobcats,2-10,4-8,0,10,17,22,24,7,3,3,9,14,3,7,0,-2,-7,-7,-7,-2,0.7752642744196495,12.66753226582324,,
3614,2021,13,NCAAF_20211127_GAS@APLST,App. St.,Mountaineers,Ga. Southern,Eagles,10-2,3-9,0,7,0,27,3,7,0,10,10,0,0,3,0,7,7,7,7,24,0.8401648941740502,16.667953955232463,0.9409899733569531,23.478558311681127
3615,2021,13,NCAAF_20211127_FIU@USM,So. Miss,Golden Eagles,FIU,Panthers,3-9,1-11,0,21,14,37,17,21,0,3,13,7,7,3,0,2,7,14,7,20,0.5619788601181375,2.6127137488834364,,
3616,2021,13,NCAAF_20211127_HAWAII@WYO,Wyoming,Cowboys,Hawaii,Rainbow Warriors,6-6,6-7,0,7,31,14,38,0,7,7,0,14,17,0,7,0,-24,-14,-24,-24,0.6928644966133257,8.441481274192938,0.7089877256190098,8.267534511305826
3617,2021,13,NCAAF_20211127_UMASS@NMEXST,New Mexico St.,Aggies,UMass,Minutemen,2-10,1-11,1,27,13,44,27,7,20,7,10,0,13,14,0,1,14,7,14,17,0.6653379536048324,7.153275186325061,0.7322683808035584,9.307800524450329
3618,2021,13,NCAAF_20211127_IND@PURDUE,Purdue,Boilermakers,Indiana,Hoosiers,8-4,2-10,1,17,7,44,7,7,10,14,13,7,0,0,0,6,10,0,10,37,0.5718326493990384,3.0323476588655467,0.8022779810465888,12.763906342797497
3619,2021,13,NCAAF_20211127_NWEST@ILL,Illinois,Fighting Illini,Northwestern,Wildcats,5-7,3-9,1,37,7,47,14,14,23,3,7,0,7,0,7,2,30,14,30,33,0.2866630285931363,-9.432603920000076,0.5621693585535883,2.350225850857157
3620,2021,13,NCAAF_20211127_OREGST@OREG,Oregon,Ducks,Oregon State,Beavers,10-2,7-5,1,24,3,38,29,14,10,0,14,3,0,6,20,3,21,11,21,9,0.8708620745400226,18.934818552521563,0.5648877752746319,2.4538913865649192
3621,2021,13,NCAAF_20211127_PSU@MICHST,Michigan St.,Spartans,Penn State,Nittany Lions,10-2,7-5,1,17,14,30,27,14,3,6,7,7,7,6,7,3,3,7,3,3,0.1821334401476602,-15.196161745813413,0.20104176870130308,-12.585465045036415
3622,2021,13,NCAAF_20211127_WKY@MRSHL,Marshall,Thundering Herd,W. Kentucky,Hilltoppers,7-5,8-4,0,14,6,21,53,7,7,0,7,0,6,23,24,-1,8,7,8,-32,0.6621184887603228,7.005477744582947,0.4361339196026497,-2.4149160899016238
3623,2021,13,NCAAF_20211127_VANDY@TENN,Tennessee,Volunteers,Vanderbilt,Commodores,7-5,2-10,0,24,7,45,21,7,17,14,7,0,7,6,8,5,17,7,17,24,0.7523332546651675,11.42060455697117,0.971640148981172,28.62034686464193
3624,2021,13,NCAAF_20211127_VATECH@UVA,Virginia,Cavaliers,Virginia Tech,Hokies,6-6,6-6,0,21,17,24,29,14,7,3,0,7,10,7,5,0,4,7,4,-5,0.46423201708638173,-1.5037214878256577,0.5267323801114139,1.0072260711597778
3625,2021,13,NCAAF_20211127_ARIZ@ARIZST,Arizona St.,Sun Devils,Arizona,Wildcats,8-4,1-11,0,14,9,38,15,7,7,17,7,3,6,6,0,7,5,4,5,23,0.7152188386774178,9.525335137501315,0.9389923402431669,23.226689844115867
3626,2021,13,NCAAF_20211127_LAMON@UL,Louisiana,Ragin' Cajuns,UL-Monroe,Warhawks,11-1,4-8,1,14,10,21,16,14,0,7,0,3,7,0,6,7,4,11,4,5,0.8583815394248235,17.97341088486519,0.9815711058740724,31.352077996925004
3627,2021,13,NCAAF_20211127_TULSA@SMU,SMU,Mustangs,Tulsa,Golden Hurricane,8-4,6-6,1,17,14,31,34,10,7,0,14,0,14,14,6,2,3,10,3,-3,0.660455610504777,6.929353055280558,0.6258044900650775,4.817885216584159
3628,2021,13,NCAAF_20211127_WISC@MINN,Minnesota,Golden Gophers,Wisconsin,Badgers,8-4,8-4,1,6,10,23,13,3,3,14,3,0,10,3,0,0,-4,3,-4,10,0.2434247786286663,-11.646350724345837,0.3682393437266531,-5.054579465061806
3629,2021,13,NCAAF_20211127_MTSU@FAU,FAU,Owls,Middle Tenn.,Blue Raiders,5-7,6-6,1,14,3,17,27,7,7,3,0,0,3,7,17,-1,11,7,11,-10,0.6706284528613485,7.397370242766215,0.4359612665574445,-2.421501255471753
3630,2021,13,NCAAF_20211127_TXAM@LSU,LSU,Tigers,Texas A&M,Aggies,6-6,8-4,1,17,7,27,24,3,14,3,7,0,7,3,14,-2,10,3,10,3,0.5883440767196584,3.739935535997404,0.24672760317977183,-10.286147709018792
3631,2021,13,NCAAF_20211127_WVU@KANSAS,Kansas,Jayhawks,West Virginia,Mountaineers,2-10,6-6,1,13,21,28,34,6,7,8,7,7,14,10,3,-4,-8,-1,-8,-6,0.10621067054517952,-20.88544533580813,0.05797126111907969,-23.61218132021679
3632,2021,13,NCAAF_20211127_CLEM@SC,South Carolina,Gamecocks,Clemson,Tigers,6-6,9-3,0,0,17,0,30,0,0,0,0,10,7,3,10,-3,-17,-10,-17,-30,0.07724283023651135,-23.848915637850553,0.1703992858007577,-14.3080143990789
3633,2021,13,NCAAF_20211127_OKLA@OKLAST,Oklahoma State,Cowboys,Oklahoma,Sooners,11-1,10-2,1,24,24,37,33,14,10,0,13,7,17,9,0,1,0,7,0,4,0.31194306525112236,-8.2130839963408,0.655923086770584,6.0285095804255775
3634,2021,13,NCAAF_20211127_PITT@CUSE,Syracuse,Orange,Pittsburgh,Panthers,5-7,10-2,1,7,14,14,31,7,0,7,0,0,14,14,3,-5,-7,7,-7,-17,0.3443904776262102,-6.708311872889453,0.28232643990908557,-8.650763381574905
3635,2021,13,NCAAF_20211127_TULANE@MEMP,Memphis,Tigers,Tulane,Green Wave,6-6,2-10,1,14,14,33,28,7,7,6,13,7,7,7,7,4,0,0,0,5,0.6421784047353092,6.101609792800957,0.5278262974362791,1.0485085226245587
3636,2021,13,NCAAF_20211127_UK@LVILLE,Louisville,Cardinals,Kentucky,Wildcats,6-6,9-3,0,7,24,21,52,7,0,0,14,14,10,14,14,-3,-17,-7,-17,-31,0.39161832190830614,-4.607827488172859,0.48585452874408075,-0.5326873576886442
3637,2021,13,NCAAF_20211127_ND@STNFRD,Stanford,Cardinal,Notre Dame,Fighting Irish,3-9,11-1,1,0,24,14,45,0,0,7,7,7,17,7,14,-8,-24,-7,-24,-31,0.18399418509368726,-15.078634817084264,0.05352327357681752,-24.20662881488977
3638,2021,13,NCAAF_20211127_NEVADA@COLOST,Colorado St.,Rams,Nevada,Wolf Pack,3-9,8-4,0,0,31,10,52,0,0,7,3,14,17,7,14,-5,-31,-14,-31,-42,0.4998045645993261,-0.008205274574436316,0.4040593230369762,-3.647698466323959
3639,2021,13,NCAAF_20211127_BYU@USC,USC,Trojans,BYU,Cougars,4-7,10-2,1,13,21,31,35,3,10,10,8,7,14,7,7,-6,-8,-4,-8,-4,0.6269589574227054,5.4236272647418104,0.4378012425582767,-2.3513463560521473
3640,2021,13,NCAAF_20211127_CAL@UCLA,UCLA,Bruins,California,Golden Bears,8-4,4-7,0,17,14,42,14,3,14,10,15,0,14,0,0,4,3,3,3,28,0.5182753497087824,0.7675515342801873,0.6179130753245334,4.5061073388404225
3641,2021,13,NCAAF_20211126_BOISE@SDGST,San Diego St.,Aztecs,Boise St.,Broncos,11-1,7-5,0,13,16,27,16,3,10,14,0,7,9,0,0,4,-3,-4,-3,11,0.31383954376810563,-8.123406958275666,0.2117540674733387,-12.021367248233446
3642,2021,13,NCAAF_20211126_EMICH@CMICH,C. Michigan,Chippewas,E. Michigan,Eagles,8-4,7-5,0,10,3,31,10,7,3,7,14,0,3,7,0,1,7,7,7,21,0.4797737807629491,-0.8495535540354808,0.4473032962758279,-1.9898311938363236
3643,2021,13,NCAAF_20211126_KSTATE@TEXAS,Texas,Longhorns,Kansas State,Wildcats,5-7,7-5,1,16,17,22,17,7,9,3,3,7,10,0,0,-2,-1,0,-1,5,0.6300606624019283,5.561044263518625,0.6744898675751687,6.794289702158494
3644,2021,13,NCAAF_20211126_OHIO@BGREEN,Bowling Green,Falcons,Ohio,Bobcats,4-8,3-9,1,10,10,21,10,3,7,3,8,0,10,0,0,1,0,3,0,11,0.09162153624709957,-22.290734629686085,0.21017712055144044,-12.103331979383881
3645,2021,13,NCAAF_20211126_UTAHST@NMEX,New Mexico,Lobos,Utah St.,Aggies,3-9,9-3,1,0,28,10,35,0,0,3,7,7,21,7,0,-6,-28,-7,-28,-25,0.1496515794339347,-17.384713460656542,0.19088779087489915,-13.137056822399302
3646,2021,13,NCAAF_20211126_IOWA@NEB,Nebraska,Cornhuskers,Iowa,Hawkeyes,3-9,10-2,1,14,6,21,28,7,7,7,0,0,6,3,19,-7,8,7,8,-7,0.21395212817680465,-13.278660529149306,0.44089841818604203,-2.2333716846363245
3647,2021,13,NCAAF_20211126_UTEP@UAB,UAB,Blazers,UTEP,Miners,8-4,7-5,1,14,17,42,25,7,7,14,14,7,10,8,0,1,-3,0,-3,17,0.8762356062306558,19.368577374544657,0.7867345233860092,11.943143551585763
3648,2021,13,NCAAF_20211126_MIZZOU@ARK,Arkansas,Razorbacks,Missouri,Tigers,8-4,6-6,0,10,6,34,17,3,7,14,10,0,6,3,8,2,4,3,4,17,0.2794904340896599,-9.787626568970893,0.7416933590963906,9.741684022109325
3649,2021,13,NCAAF_20211126_SFLA@UCF,UCF,Knights,South Florida,Bulls,8-4,2-10,1,14,7,17,13,7,7,0,3,7,0,6,0,6,7,0,7,4,0.8888366705724218,20.440408206866834,0.8197164775165324,13.732691280572737
3650,2021,13,NCAAF_20211126_UNLV@AF,Air Force,Falcons,UNLV,Rebels,9-3,2-10,1,24,0,48,14,14,10,17,7,0,0,7,7,7,24,14,24,34,0.8483752532885159,17.243366167972397,,
3651,2021,13,NCAAF_20211126_CINCY@ECU,East Carolina,Pirates,Cincinnati,Bearcats,7-5,12-0,1,3,21,13,35,3,0,3,7,0,21,0,14,-5,-18,3,-18,-22,0.10343959196459473,-21.141016084366242,,
3652,2021,13,NCAAF_20211126_COLO@UTAH,Utah,Utes,Colorado,Buffaloes,9-3,4-8,1,14,6,28,13,0,14,14,0,3,3,7,0,5,8,-3,8,15,0.8321221457888592,16.12275040438459,0.9098189699998558,20.121597684320875
3653,2021,13,NCAAF_20211126_TCU@IOWAST,Iowa St.,Cyclones,TCU,Horned Frogs,7-5,5-7,1,17,7,48,14,3,14,10,21,0,7,0,7,2,10,3,10,34,0.6276670067641676,5.454963994610694,0.8113529117913121,13.261174640462627
3654,2021,13,NCAAF_20211126_UNC@NCST,NC State,Wolfpack,North Carolina,Tar Heels,9-3,6-6,0,14,10,34,30,14,0,7,13,0,10,14,6,3,4,14,4,4,0.5523795150985776,2.2054889653818464,0.6128668134675314,4.307758522944823
3655,2021,13,NCAAF_20211126_WASHST@WASH,Washington,Huskies,Washington St.,Cougars,4-8,7-5,0,7,13,13,40,0,7,0,6,10,3,10,17,-3,-6,-10,-6,-27,0.6274721489327946,5.446338109310943,0.5494991678283014,1.8684468730607477
3656,2021,13,NCAAF_20211125_FRESNO@SJST,San Jose St.,Spartans,Fresno St.,Bulldogs,5-7,9-3,1,9,23,9,40,3,6,0,0,7,16,10,7,-4,-14,-4,-14,-31,0.13714374255826933,-18.3111790829538,0.25418231776424316,-9.934114725462678
3657,2021,13,NCAAF_20211125_MISS@MISSST,Miss. State,Bulldogs,Ole Miss,Rebels,7-5,10-2,0,6,10,21,31,6,0,0,15,3,7,7,14,-3,-4,3,-4,-10,0.6261854033400545,5.3894131193162025,0.3066656626885338,-7.590036835312219
3658,2021,13,NCAAF_20211123_BUFF@BALLST,Ball St.,Cardinals,Buffalo,Bulls,6-6,4-8,1,17,3,20,3,14,3,3,0,0,3,0,0,2,14,14,14,17,0.2654343552862457,-10.496538220579964,0.5821147473238595,3.113772675747157
3659,2021,13,NCAAF_20211123_WMICH@NILL,N. Illinois,Huskies,W. Michigan,Broncos,8-4,7-5,1,7,28,21,42,0,7,0,14,7,21,7,7,1,-21,-7,-21,-21,0.4578110751997463,-1.7745990161884606,0.4581936226384915,-1.5768982991890539
3660,2021,14,NCAAF_20211204_BAYLOR@OKLAST,Oklahoma State,Cowboys,Baylor,Bears,11-2,11-2,0,6,21,16,21,3,3,7,3,7,14,0,0,0,-15,-4,-15,-5,0.6965734723290576,8.646915346283777,0.7512240961220515,10.268365329118097
3661,2021,14,NCAAF_20211204_KENTST@NILL,N. Illinois,Huskies,Kent St.,Golden Flashes,9-4,7-6,1,17,0,41,23,10,7,7,17,0,0,10,13,2,17,10,17,18,0.7050564404346062,9.05742243456649,0.5929762802564769,3.560420205064048
3662,2021,14,NCAAF_20211204_UTAHST@SDGST,San Diego St.,Aztecs,Utah St.,Aggies,11-2,10-3,1,3,14,13,46,0,3,3,7,0,14,15,17,1,-11,0,-11,-33,0.5449871298458475,1.8989693342745113,0.6547566115746694,6.027605596709549
3663,2021,14,NCAAF_20211204_APLST@UL,Louisiana,Ragin' Cajuns,App. St.,Mountaineers,12-1,10-3,1,17,7,24,16,7,10,0,7,0,7,3,6,2,10,7,10,8,0.3328404497782602,-7.260785552751258,0.4200494719435115,-3.0542140495367107
3664,2021,14,NCAAF_20211204_HOU@CINCY,Cincinnati,Bearcats,Houston,Cougars,13-0,11-2,0,14,13,35,20,14,0,21,0,10,3,0,7,2,1,4,1,15,0.6437642346944484,6.192975576547894,0.8011677119236634,12.803153631544149
3665,2021,14,NCAAF_20211204_UGA@BAMA,Alabama,Crimson Tide,Georgia,Bulldogs,12-1,12-1,0,24,17,41,24,0,24,7,10,3,14,0,7,0,7,-3,7,17,0.6330417683348236,5.7120685879952475,0.3700853820287602,-5.019953280872599
3666,2021,14,NCAAF_20211204_MICH@IOWA,Iowa,Hawkeyes,Michigan,Wolverines,10-3,12-1,0,3,14,3,42,3,0,0,0,14,0,7,21,-2,-11,-11,-11,-39,0.4079685718877073,-3.9115605674121525,0.2585175306988956,-9.80782221516536
3667,2021,14,NCAAF_20211204_PITT@WAKE,Wake Forest,Demon Deacons,Pittsburgh,Panthers,10-3,11-2,0,21,24,21,45,21,0,0,0,14,10,7,14,-1,-3,7,-3,-24,0.5107600933296679,0.4532886091261048,0.48699512752919216,-0.4935401377296387
3668,2021,14,NCAAF_20211204_USC@CAL,California,Golden Bears,USC,Trojans,5-7,4-8,0,17,7,24,14,3,14,0,7,0,7,0,7,1,10,3,10,10,0.36052388860354534,-6.000064572605538,0.4720876703992969,-1.059962050936349
3669,2021,14,NCAAF_20211203_WKY@TXSA,UTSA,Roadrunners,W. Kentucky,Hilltoppers,12-1,8-5,0,28,13,49,41,14,14,14,7,10,3,13,15,4,15,4,15,8,0.3805392367349134,-5.109547114195038,0.44923376888283206,-1.9314859408711413
3670,2021,14,NCAAF_20211203_OREG@UTAH,Utah,Utes,Oregon,Ducks,10-3,10-3,1,23,0,38,10,14,9,8,7,0,0,3,7,0,23,14,23,28,0.5127348677011496,0.5365056696685429,0.6383914051167283,5.361075741434092
3671,2021,15,NCAAF_20211211_ARMY@NAVY,Navy,Midshipmen,Army,Black Knights,4-8,8-4,0,7,13,17,13,7,0,7,3,10,3,0,0,-4,-6,-3,-6,4,0.44259440275831174,-2.428489916589058,0.24003338830194032,-10.567011764112465
3672,2022,1,NCAAF_20220905_CLEM@GATECH,Georgia Tech,Yellow Jackets,Clemson,Tigers,0-1,1-0,1,3,14,10,41,0,3,7,0,0,14,10,17,-1,-11,0,-11,-31,0.041374773559372136,-29.17546958484286,0.08878492396643423,-19.743588707361596
3673,2022,1,NCAAF_20220904_FSU@LSU,LSU,Tigers,Florida State,Seminoles,1-1,2-0,1,3,7,23,24,3,0,7,13,0,7,10,7,-1,-4,3,-4,-1,0.8207392060247036,15.440498367032433,0.6778304406776625,6.7600740036785965
3674,2022,1,NCAAF_20220903_BUFF@MD,Maryland,Terrapins,Buffalo,Bulls,1-0,0-1,0,17,7,31,10,7,10,7,7,0,7,0,3,1,10,7,10,21,0.5832118943434559,3.533395960707594,0.8036995532123428,12.51895223554311
3675,2022,1,NCAAF_20220903_CCTST@UCONN,UConn,,CCSU,,1-1,0-1,,7,3,28,3,0,7,7,14,0,3,0,0,1,4,0,4,25,0.75982339954491,11.867852453978571,,
3676,2022,1,NCAAF_20220903_COLOST@MICH,Michigan,Wolverines,Colorado St.,Rams,1-0,0-1,1,23,0,51,7,10,13,14,14,0,0,0,7,1,23,10,23,44,0.9666463907185638,30.83508667994039,0.9804549757484086,30.2132037358881
3677,2022,1,NCAAF_20220903_DE@NAVY,Navy,Midshipmen,Delaware,Fightin' Blue Hens,0-1,1-0,1,0,7,7,14,0,0,7,0,7,0,7,0,-1,-7,-7,-7,-7,0.8198242349928618,15.38180323630661,,
3678,2022,1,NCAAF_20220903_NCST@ECU,East Carolina,Pirates,NC State,Wolfpack,0-1,1-0,1,7,21,20,21,7,0,7,6,14,7,0,0,-1,-14,-7,-14,-1,0.12403036821323576,-19.424058425802173,,
3679,2022,1,NCAAF_20220903_RUT@BC,Boston College,Eagles,Rutgers,Scarlet Knights,0-1,1-0,0,14,6,21,22,7,7,7,0,0,6,9,7,-1,8,7,8,-1,0.7204646714377141,9.824466440547496,0.4437713193581977,-2.0708131521595305
3680,2022,1,NCAAF_20220903_SAMST@TXAM,Texas A&M,Aggies,Sam Houston,Bearkats,1-0,0-1,0,17,0,31,0,7,10,7,7,0,0,0,0,1,17,7,17,31,0.9898838701625868,39.04768515301362,,
3681,2022,1,NCAAF_20220903_SDST@IOWA,Iowa,Hawkeyes,S. Dakota St.,Jackrabbits,1-0,0-1,1,3,3,7,3,3,0,2,2,0,3,0,0,1,0,3,0,4,0.7449952065386298,11.078968482952803,,
3682,2022,1,NCAAF_20220903_UNC@APLST,App. St.,Mountaineers,North Carolina,Tar Heels,0-1,2-0,1,21,28,61,63,14,7,0,40,7,21,13,22,-2,-7,7,-7,-2,0.47874717575104786,-0.8962783207356324,0.48982980040931057,-0.37334812132309025
3683,2022,1,NCAAF_20220903_RICH@UVA,Virginia,Cavaliers,Richmond,Spiders,1-0,0-1,0,28,10,34,17,14,14,0,6,7,3,7,0,1,18,7,18,17,0.8919323308852951,20.799591031408056,,
3684,2022,1,NCAAF_20220903_NOIOWA@AF,Air Force,Falcons,Northern Iowa,Panthers,1-0,0-1,0,27,3,48,17,14,13,14,7,3,0,0,14,1,24,11,24,31,0.5187496734946029,0.7906319301027906,,
3685,2022,1,NCAAF_20220903_SEMOST@IOWAST,Iowa St.,Cyclones,SE Missouri St.,Redhawks,1-0,0-1,0,21,10,42,10,7,14,7,14,0,10,0,0,1,11,7,11,32,0.9984819902380786,49.84467619475595,,
3686,2022,1,NCAAF_20220903_BGREEN@UCLA,UCLA,Bruins,Bowling Green,Falcons,1-0,0-1,1,24,17,45,17,7,17,7,14,10,7,0,0,1,7,-3,7,28,0.9667961586256794,30.869060574170476,0.9887933577272444,33.435560588206386
3687,2022,1,NCAAF_20220903_ARIZ@SDGST,San Diego St.,Aztecs,Arizona,Wildcats,0-1,1-0,1,10,24,20,38,0,10,10,0,10,14,7,7,-1,-14,-10,-14,-18,0.5943350753757588,4.014234876925798,0.7671146203879659,10.680704282142187
3688,2022,1,NCAAF_20220903_BTHN@MIAMI,Miami (Fla.),Hurricanes,Bethune-Cook.,Wildcats,1-0,0-1,0,42,10,70,13,14,28,14,14,3,7,3,0,1,32,11,32,57,0.9964235926923143,45.2299003272758,,
3689,2022,1,NCAAF_20220903_CINCY@ARK,Arkansas,Razorbacks,Cincinnati,Bearcats,1-0,0-1,1,14,0,31,24,7,7,10,7,0,0,17,7,1,14,7,14,7,0.27544489870263755,-10.0297071908318,0.37864084249941743,-4.52563577539064
3690,2022,1,NCAAF_20220903_NDK@NEB,Nebraska,,North Dakota,,1-1,0-1,,7,7,38,17,7,0,17,14,0,7,10,0,1,0,7,0,21,0.9335846920948475,25.275465003508145,,
3691,2022,1,NCAAF_20220903_NRFST@MRSHL,Marshall,,Norfolk St.,,1-0,0-1,,38,0,55,3,10,28,17,0,0,0,3,0,1,38,10,38,52,0.9698009990612964,31.578962539451027,,
3692,2022,1,NCAAF_20220903_OREG@UGA,Georgia,Bulldogs,Oregon,Ducks,1-0,0-1,0,28,3,49,3,7,21,14,7,0,3,0,0,1,25,7,25,46,0.7859167979928352,13.324121881655742,0.9343979090834247,22.10259713324774
3693,2022,1,NCAAF_20220903_UTEP@OKLA,Oklahoma,Sooners,UTEP,Miners,1-0,0-1,1,28,10,45,13,21,7,14,3,0,10,0,3,1,18,21,18,32,0.9981263746258454,48.745274022276874,0.9554909411407959,24.902886828883823
3694,2022,1,NCAAF_20220903_DAVIS@CAL,California,Golden Bears,UC-Davis,Aggies,1-0,0-1,1,17,7,34,13,0,17,10,7,7,0,6,0,1,10,-7,10,21,0.8216023718651388,15.496043163421064,,
3695,2022,1,NCAAF_20220903_TROY@MISS,Ole Miss,Rebels,Troy,Trojans,1-0,0-1,0,21,3,28,10,7,14,7,0,0,3,0,7,1,18,7,18,18,0.8227091493804422,15.567512742283157,0.987929316085408,33.01941649653088
3696,2022,1,NCAAF_20220903_NICHST@SALA,South Alabama,,Nicholls St.,,1-0,0-1,,27,0,48,7,10,17,14,7,0,0,0,7,1,27,10,27,41,0.5080432056088584,0.3390621093907953,,
3697,2022,1,NCAAF_20220903_TXSTSM@NEVADA,Nevada,,Texas St.,,2-0,0-1,,14,7,38,14,14,0,24,0,0,7,0,7,2,7,14,7,24,0.8569584147508791,17.938858231831432,,
3698,2022,1,NCAAF_20220903_FAU@OHIO,Ohio,,FAU,,1-0,1-1,,13,17,41,38,3,10,14,14,10,7,0,21,0,-4,-7,-4,3,0.46870949551009744,-1.3203201342761304,0.24419390567413246,-10.146180668757665
3699,2022,1,NCAAF_20220903_MRGNST@GAS,Ga. Southern,,Morgan St.,,1-0,0-1,,17,7,59,7,0,17,14,28,0,7,0,0,1,10,0,10,52,0.9948242161204082,43.114645105960335,,
3700,2022,1,NCAAF_20220903_MTSU@JMAD,James Madison,Dukes,Middle Tenn.,Blue Raiders,1-0,0-1,1,21,0,44,7,0,21,16,7,0,0,7,0,1,21,0,21,37,0.8069427557028848,14.574448690033535,,
3701,2022,1,NCAAF_20220903_RICE@USC,USC,Trojans,Rice,Owls,1-0,0-1,1,31,14,66,14,7,24,28,7,7,7,0,0,1,17,0,17,52,0.968882471636929,31.35598546740505,,
3702,2022,1,NCAAF_20220903_BYU@SFLA,South Florida,Bulls,BYU,Cougars,0-1,1-0,0,7,38,21,50,0,7,14,0,28,10,9,3,-1,-31,-28,-31,-29,0.22200507918327528,-12.871860772452862,0.06403246302059062,-22.28427828499116
3703,2022,1,NCAAF_20220903_ALBANY@BAYLOR,Baylor,Bears,Albany,Great Danes,1-0,0-1,0,35,7,69,10,21,14,14,20,7,0,3,0,1,28,14,28,59,0.9902441707712385,39.27631775584433,,
3704,2022,1,NCAAF_20220903_ARMY@CSTCAR,C. Carolina,Chanticleers,Army,Black Knights,1-0,0-1,0,14,14,38,28,7,7,10,14,7,7,7,7,1,0,0,0,10,0.3206293583807154,-7.835385626122331,0.5475138389723779,1.7481882411815945
3705,2022,1,NCAAF_20220903_ELON@VANDY,Vanderbilt,,Elon,,2-0,0-1,,28,10,42,31,21,7,7,7,7,3,14,7,2,18,14,18,11,0.940833825621432,26.263911630723726,,
3706,2022,1,NCAAF_20220903_GRAM@ARKST,Arkansas St.,Red Wolves,Grambling,Tigers,1-0,0-1,1,30,0,58,3,16,14,21,7,0,0,3,0,1,30,16,30,55,0.9393851424641977,26.059104279066446,,
3707,2022,1,NCAAF_20220903_ILST@WISC,Wisconsin,Badgers,Illinois St.,Redbirds,1-0,0-1,0,17,0,38,0,7,10,14,7,0,0,0,0,1,17,7,17,38,0.9858202022873435,36.86599217372071,,
3708,2022,1,NCAAF_20220903_MERCER@AUBURN,Auburn,Tigers,Mercer,Bears,1-0,1-0,1,28,7,42,16,14,14,14,0,0,7,0,9,0,21,14,21,26,0.9917922841545528,40.35150624669683,,
3709,2022,1,NCAAF_20220903_MIAOH@UK,Kentucky,Wildcats,Miami-OH,RedHawks,1-0,0-1,0,13,10,37,13,7,6,17,7,7,3,3,0,1,3,0,3,24,0.8347901162777873,16.36678934068584,0.9309865046262114,21.719055447710502
3710,2022,1,NCAAF_20220903_SD@KSTATE,Kansas State,Wildcats,South Dakota,Coyotes,1-0,0-1,1,27,0,34,0,20,7,7,0,0,0,0,0,1,27,20,27,34,0.964161315922187,30.288898324676893,,
3711,2022,1,NCAAF_20220903_SELOU@UL,Louisiana,Ragin' Cajuns,SE Louisiana,Lions,1-0,0-1,0,17,0,24,7,10,7,0,7,0,0,7,0,1,17,10,17,17,0.6465379270372353,6.32276892871522,,
3712,2022,1,NCAAF_20220903_UMASS@TULANE,Tulane,Green Wave,UMass,Minutemen,1-0,0-1,0,21,10,42,10,7,14,21,0,0,10,0,0,1,11,7,11,32,0.9512991191353042,27.874422973164428,0.9632656838295179,26.210682308118066
3713,2022,1,NCAAF_20220903_UTAH@FLA,Florida,Gators,Utah,Utes,1-0,0-1,1,14,13,29,26,7,7,0,15,7,6,6,7,1,1,0,1,3,0.47574711155689997,-1.0229441115771465,0.24921746942947565,-9.91304035786186
3714,2022,1,NCAAF_20220903_GAST@SC,South Carolina,Gamecocks,Georgia St.,Panthers,1-0,0-1,0,12,7,35,14,0,12,16,7,0,7,7,0,1,5,0,5,21,0.867142791500175,18.716319658203417,0.726363410070512,8.813261443691431
3715,2022,1,NCAAF_20220903_MEMP@MISSST,Miss. State,Bulldogs,Memphis,Tigers,1-0,0-1,1,28,3,49,23,14,14,7,14,0,3,7,13,1,25,14,25,26,0.6730731634157073,7.540687128826221,0.8474366664489119,15.017020280699512
3716,2022,1,NCAAF_20220903_ND@OHIOST,Ohio State,Buckeyes,Notre Dame,Fighting Irish,1-0,0-1,0,7,10,21,10,7,0,7,7,3,7,0,0,1,-3,4,-3,11,0.7626265176554952,12.019909160332759,0.6720245274912059,6.523870911812708
3717,2022,1,NCAAF_20220903_SMU@NTEXAS,North Texas,Mean Green,SMU,Mustangs,1-1,1-0,0,10,31,10,48,0,10,0,0,14,17,7,10,0,-21,-14,-21,-38,0.2235188533621949,-12.786498586996458,0.18504548906154028,-13.125091586093049
3718,2022,1,NCAAF_20220903_UTAHST@BAMA,Alabama,Crimson Tide,Utah St.,Aggies,1-0,1-1,0,41,0,55,0,17,24,14,0,0,0,0,0,0,41,17,41,55,0.9753527672280774,33.06147080006241,0.9694578517110146,27.4257538020355
3719,2022,1,NCAAF_20220903_COLG@STNFRD,Stanford,Cardinal,Colgate,Raiders,1-0,0-1,1,28,7,41,10,7,21,0,13,0,7,3,0,1,21,7,21,31,0.9867928056694995,37.33329520474285,,
3720,2022,1,NCAAF_20220903_LAMON@TEXAS,Texas,Longhorns,UL-Monroe,Warhawks,1-0,0-1,0,24,3,52,10,14,10,21,7,3,0,0,7,1,21,11,21,42,0.9808763231704499,34.8466585045561,0.9787011670367063,29.691830471164508
3721,2022,1,NCAAF_20220903_LVILLE@CUSE,Syracuse,Orange,Louisville,Cardinals,1-0,0-1,1,17,7,31,7,10,7,0,14,7,0,0,0,1,10,3,10,24,0.42233298586736234,-3.294797977561018,0.25037026546774266,-9.85989458683349
3722,2022,1,NCAAF_20220903_ME@NMEX,New Mexico,Lobos,Maine,Black Bears,1-0,0-1,1,21,0,41,0,0,21,13,7,0,0,0,0,1,21,0,21,41,0.5932117517415485,3.965532550968817,,
3723,2022,1,NCAAF_20220903_MURYST@TXTECH,Texas Tech,Red Raiders,Murray St.,Racers,1-0,0-1,0,42,10,63,10,14,28,14,7,3,7,0,0,1,32,11,32,53,0.990735779639594,39.60047779635363,,
3724,2022,1,NCAAF_20220903_IDAHO@WASHST,Washington St.,Cougars,Idaho,Vandals,1-0,0-1,1,10,10,24,17,0,10,7,7,10,0,0,7,1,0,-10,0,7,0.9690012694336572,31.384514896059954,,
3725,2022,1,NCAAF_20220903_BOISE@OREGST,Oregon State,Beavers,Boise St.,Broncos,1-0,0-1,0,24,0,34,17,14,10,3,7,0,0,10,7,1,24,14,24,17,0.21805165454286768,-13.096378244529205,0.4425169216534054,-2.1173303433152455
3726,2022,1,NCAAF_20220903_KENTST@WASH,Washington,Huskies,Kent St.,Golden Flashes,1-0,0-1,0,31,13,45,20,21,10,7,7,7,6,0,7,1,18,14,18,25,0.970619307477814,31.782397077862925,0.9058652568283304,19.26679891907304
3727,2022,1,NCAAF_20220903_WKY@HAWAII,Hawaii,,W. Kentucky,,0-2,2-0,,10,21,17,49,3,7,0,7,0,21,7,21,-2,-11,3,-11,-32,0.4545768376987861,-1.9188438998238553,0.23004158764902194,-10.81736361891069
3728,2022,1,NCAAF_20220902_EKY@EMICH,E. Michigan,Eagles,E. Kentucky,Colonels,1-0,0-1,0,14,10,42,34,0,14,14,14,0,10,7,17,1,4,0,4,8,0.882104512507893,19.936964026081455,,
3729,2022,1,NCAAF_20220902_VATECH@ODU,Old Dominion,Monarchs,Virginia Tech,Hokies,1-0,0-1,0,10,7,20,17,0,10,0,10,7,0,10,0,1,3,-7,3,3,0.07120293371896191,-24.66768541761894,0.1667914346289443,-14.159212365217684
3730,2022,1,NCAAF_20220902_WMICH@MICHST,Michigan St.,Spartans,W. Michigan,Broncos,1-0,0-1,1,21,3,35,13,7,14,0,14,3,0,10,0,1,18,4,18,22,0.8138873791236387,15.00541119927442,0.8881561470114744,17.818034093531935
3731,2022,1,NCAAF_20220902_WMMARY@CHARLO,Charlotte,,William & Mary,,0-2,1-0,,17,17,24,41,3,14,7,0,10,7,3,21,-1,0,-7,0,-17,0.7319127471221514,10.402707669496635,,
3732,2022,1,NCAAF_20220902_TEMPLE@DUKE,Duke,Blue Devils,Temple,Owls,1-0,0-1,1,24,0,30,0,10,14,3,3,0,0,0,0,1,24,10,24,30,0.6208764231237572,5.1757813614368615,0.7308082254253557,9.009602628690686
3733,2022,1,NCAAF_20220902_ILL@IND,Indiana,,Illinois,,1-0,1-1,,16,10,23,20,3,13,0,7,7,3,7,3,0,6,-4,6,3,0.7020714015646499,8.918823782426728,0.267778198471355,-9.07238394209628
3734,2022,1,NCAAF_20220902_TNTECH@KANSAS,Kansas,Jayhawks,Tenn. Tech,Golden Eagles,1-0,0-1,0,35,3,56,10,21,14,7,14,0,3,0,7,1,32,21,32,46,0.9750756271120166,32.9811515514678,,
3735,2022,1,NCAAF_20220902_TCU@COLO,Colorado,Buffaloes,TCU,Horned Frogs,0-1,1-0,1,6,7,13,38,3,3,0,7,0,7,10,21,-1,-1,3,-1,-25,0.2613589151201072,-10.748339694647143,0.45153231771875313,-1.7834555367242046
3736,2022,1,NCAAF_20220901_BALLST@TENN,Tennessee,Volunteers,Ball St.,Cardinals,1-0,0-1,0,38,0,59,10,17,21,14,7,0,0,7,3,1,38,17,38,49,0.8558056800066164,17.85325744154602,0.9478927789048814,23.792266092698355
3737,2022,1,NCAAF_20220901_CMICH@OKLAST,Oklahoma State,Cowboys,C. Michigan,Chippewas,1-0,0-1,0,44,15,58,44,16,28,7,7,7,8,7,22,1,29,9,29,14,0.9169865334394891,23.291995029590964,0.9708302289506643,27.72233108984915
3738,2022,1,NCAAF_20220901_LIUPOST@TOLEDO,Toledo,Rockets,LIU,Sharks,1-0,0-1,1,20,0,37,0,3,17,0,17,0,0,0,0,1,20,3,20,37,0.9980911265064636,48.64691118754223,,
3739,2022,1,NCAAF_20220901_SCST@UCF,UCF,Knights,SC State,Bulldogs,1-0,0-1,1,28,3,56,10,21,7,14,14,0,3,7,0,1,25,21,25,46,0.9934923546784357,41.76079640895887,,
3740,2022,1,NCAAF_20220901_WVU@PITT,Pittsburgh,Panthers,West Virginia,Mountaineers,1-0,0-1,0,10,10,38,31,3,7,14,14,0,10,7,14,1,0,3,0,7,0.4702198336080068,-1.2564688334547895,0.7851926578606188,11.56625555667108
3741,2022,1,NCAAF_20220901_VMI@WAKE,Wake Forest,Demon Deacons,VMI,Keydets,1-0,0-1,0,23,3,44,10,17,6,14,7,0,3,7,0,1,20,17,20,34,0.9999470788503773,65.19335788028428,,
3742,2022,1,NCAAF_20220901_ALAM@UAB,UAB,Blazers,Alabama A&M,Bulldogs,1-0,0-1,1,38,0,59,0,28,10,21,0,0,0,0,0,1,38,28,38,59,0.9953349129104775,43.717583077911115,,
3743,2022,1,NCAAF_20220901_EIL@NILL,N. Illinois,Huskies,E. Illinois,Panthers,1-0,0-1,1,21,6,34,27,7,14,7,6,3,3,7,14,1,15,4,15,7,0.9755108856804069,33.10763590643592,,
3744,2022,1,NCAAF_20220901_LATECH@MIZZOU,Missouri,Tigers,Louisiana Tech,Bulldogs,1-0,0-1,0,24,10,52,24,0,24,14,14,3,7,0,14,1,14,-3,14,28,0.8636307492812674,18.443757905576092,,
3745,2022,1,NCAAF_20220901_PSU@PURDUE,Purdue,Boilermakers,Penn State,Nittany Lions,0-1,1-0,0,10,21,31,35,3,7,14,7,0,21,0,14,-1,-11,3,-11,-4,0.20993092281518888,-13.565061440599322,0.38626839791283807,-4.232850138155641
3746,2022,1,NCAAF_20220901_NMEXST@MINN,Minnesota,Golden Gophers,New Mexico St.,Aggies,1-0,0-2,0,24,0,38,0,7,17,14,0,0,0,0,0,1,24,7,24,38,0.97265496759939,32.30968974334229,0.9878616012566652,32.98790701217018
3747,2022,1,NCAAF_20220901_NAZ@ARIZST,Arizona St.,Sun Devils,N. Arizona,Lumberjacks,1-0,0-1,0,24,3,40,3,3,21,13,3,0,3,0,0,1,21,3,21,37,0.9628889207991381,30.02117565921924,,
3748,2022,1,NCAAF_20220901_CPOLY@FRESNO,Fresno St.,Bulldogs,Cal-Poly,Mustangs,1-0,0-1,0,21,7,35,7,21,0,7,7,0,7,0,0,1,14,21,14,28,0.9968973115226318,46.02165191466952,,
3749,2022,1,NCAAF_20220901_PORTST@SJST,San Jose St.,Spartans,Portland St.,Vikings,1-0,0-1,1,14,7,21,17,7,7,0,7,7,0,3,7,1,7,0,7,4,0.5438883621603892,1.8537403078065608,,
3750,2022,1,NCAAF_20220827_AP@WKY,W. Kentucky,Hilltoppers,Austin Peay,Governors,2-0,2-1,1,21,17,38,27,7,14,0,17,10,7,3,7,0,4,-3,4,11,0.8712935024304135,19.04492398058943,,
3751,2022,1,NCAAF_20220827_NEB@NWEST,Northwestern,Wildcats,Nebraska,Cornhuskers,1-0,0-1,0,17,14,31,28,3,14,7,7,7,7,14,0,1,3,-4,3,3,0.46364473546892027,-1.5345830934905393,0.07381694961782204,-21.203033753042916
3752,2022,1,NCAAF_20220827_IDST@UNLV,UNLV,Rebels,Idaho State,Bengals,1-0,0-1,1,45,7,52,21,10,35,0,7,7,0,7,7,1,38,3,38,31,0.7082219526835577,9.218664620755192,,
3753,2022,1,NCAAF_20220827_UCONN@UTAHST,Utah St.,,UConn,,1-0,0-1,,24,14,31,20,0,24,0,7,14,0,0,6,1,10,-14,10,11,0.9478803605132706,27.32045221230902,0.9878242228192896,32.97057905793588
3754,2022,1,NCAAF_20220827_WYO@ILL,Illinois,Fighting Illini,Wyoming,Cowboys,1-0,0-1,1,17,3,38,6,7,10,7,14,3,0,3,0,1,14,4,14,32,0.5091356820880265,0.3851231316501753,0.6444838331719743,5.425010009749144
3755,2022,1,NCAAF_20220827_DUQ@FSU,Florida State,,Duquesne,,1-0,0-1,,26,0,47,7,20,6,14,7,0,0,7,0,1,26,20,26,40,0.9225324462574166,23.9180750238923,,
3756,2022,1,NCAAF_20220827_CHARLO@FAU,FAU,Owls,Charlotte,49ers,1-1,0-2,0,26,7,43,13,10,16,7,10,7,0,6,0,1,19,3,19,30,0.8236969135211877,15.631535387757708,0.7670932654427208,10.679681588983499
3757,2022,1,NCAAF_20220827_FAMU@UNC,North Carolina,,Florida A&M,,1-0,0-1,,28,14,56,24,14,14,7,21,7,7,10,0,1,14,7,14,32,0.9986909071251209,50.60594580765053,,
3758,2022,1,NCAAF_20220827_NTEXAS@UTEP,UTEP,,North Texas,,0-2,1-1,,13,14,13,31,0,13,0,0,0,14,14,3,-1,-1,0,-1,-18,0.19849268073910142,-14.243709841380905,0.43740806210087846,-2.307009660079757
3759,2022,1,NCAAF_20220827_NEVADA@NMEXST,New Mexico St.,Aggies,Nevada,Wolf Pack,0-2,1-0,1,2,17,12,23,0,2,7,3,0,17,0,6,-1,-15,0,-15,-11,0.15724204338431025,-16.91481376158606,0.014929435832404025,-31.805250946760225
3760,2022,1,NCAAF_20220827_VANDY@HAWAII,Hawaii,Rainbow Warriors,Vanderbilt,Commodores,0-1,1-0,1,10,21,10,63,7,3,0,0,14,7,35,7,-1,-11,-7,-11,-53,0.44185272490374383,-2.4597814057022447,0.7135834550551249,8.257284946229106
3761,2022,2,NCAAF_20220910_ARKST@OHIOST,Ohio State,Buckeyes,Arkansas St.,Red Wolves,2-0,1-1,0,24,9,45,12,14,10,21,0,3,6,3,0,1,15,11,15,33,0.9948335590183153,43.134856858963246,0.9996726330662842,50.739253096102516
3762,2022,2,NCAAF_20220910_BAMA@TEXAS,Texas,Longhorns,Alabama,Crimson Tide,1-1,2-0,0,10,10,19,20,3,7,3,6,10,0,0,10,-1,0,-7,0,-1,0.1101149318685889,-20.62002470670808,0.07698138370573748,-21.226659611828495
3763,2022,2,NCAAF_20220910_DUKE@NWEST,Northwestern,Wildcats,Duke,Blue Devils,1-1,2-0,1,10,21,23,31,0,10,6,7,14,7,0,10,-1,-11,-14,-11,-8,0.7067413061259318,9.148268271222378,0.771229741441658,11.06098372631675
3764,2022,2,NCAAF_20220910_MIZZOU@KSTATE,Kansas State,Wildcats,Missouri,Tigers,2-0,1-1,0,20,3,40,12,7,13,6,14,3,0,3,6,1,17,4,17,28,0.4994919312371454,-0.021421043123609707,,
3765,2022,2,NCAAF_20220910_OHIO@PSU,Penn State,Nittany Lions,Ohio,Bobcats,2-0,1-1,0,26,7,46,10,14,12,14,6,0,7,0,3,1,19,14,19,36,0.9570711150562465,28.89126049867923,0.991924358572275,35.81486383548133
3766,2022,2,NCAAF_20220910_SC@ARK,Arkansas,Razorbacks,South Carolina,Gamecocks,2-0,1-1,0,21,9,44,30,7,14,0,23,3,6,7,14,1,12,4,12,14,0.36758594467509975,-5.689457183072761,0.8292759773317417,14.163901434003037
3767,2022,2,NCAAF_20220910_UNC@GAST,Georgia St.,Panthers,North Carolina,Tar Heels,0-2,3-0,0,10,21,28,35,3,7,18,0,7,14,7,7,-3,-11,-4,-11,-7,0.13401970485912795,-18.629734038323818,0.15718382743736514,-14.979686599026081
3768,2022,2,NCAAF_20220910_USM@MIAMI,Miami (Fla.),Hurricanes,So. Miss,Golden Eagles,2-0,0-2,1,10,7,30,7,3,7,14,6,0,7,0,0,2,3,3,3,23,0.916164593860824,23.20711395075034,0.9816696397751333,31.110628445491557
3769,2022,2,NCAAF_20220910_WAKE@VANDY,Vanderbilt,Commodores,Wake Forest,Demon Deacons,2-1,2-0,1,10,21,25,45,3,7,8,7,14,7,14,10,0,-11,-11,-11,-20,0.2207411232296843,-12.946291883637684,0.14849564331894372,-15.527709602326695
3770,2022,2,NCAAF_20220910_WIL@MINN,Minnesota,,W. Illinois,,2-0,0-2,,31,3,62,10,14,17,21,10,3,0,0,7,2,28,11,28,52,0.9067070450491339,22.21506211841637,,
3771,2022,2,NCAAF_20220910_CHARSO@NCST,NC State,Wolfpack,Charleston So.,Buccaneers,2-0,0-2,1,38,0,55,3,10,28,10,7,0,0,3,0,2,38,10,38,52,0.9846732219776683,36.35729737213097,,
3772,2022,2,NCAAF_20220910_SALA@CMICH,C. Michigan,,South Alabama,,0-2,2-0,,10,31,24,38,7,3,0,14,20,11,0,7,-2,-21,-13,-21,-14,0.7374013596652114,10.686712675351714,,
3773,2022,2,NCAAF_20220910_SUT@UTAH,Utah,Utes,So. Utah,Thunderbirds,1-1,1-1,1,45,7,73,7,7,38,14,14,7,0,0,0,0,38,0,38,66,0.998954013022124,51.75294011389417,,
3774,2022,2,NCAAF_20220910_LAF@TEMPLE,Temple,,Lafayette,,1-1,1-1,,21,7,30,14,7,14,0,9,7,0,7,0,0,14,0,14,16,0.7061004888027822,9.116959338305321,,
3775,2022,2,NCAAF_20220910_WMICH@BALLST,Ball St.,Cardinals,W. Michigan,Broncos,0-2,1-1,1,16,14,30,37,10,6,7,7,7,7,7,16,-1,2,3,2,-7,0.3027060932275454,-8.689813178244492,0.35580690978848106,-5.504259731144771
3776,2022,2,NCAAF_20220910_MRSHL@ND,Notre Dame,Fighting Irish,Marshall,Thundering Herd,0-2,2-0,1,7,9,21,26,0,7,0,14,0,9,3,14,-2,-2,0,-2,-5,0.9162175274796082,23.21289656223348,0.9466785039941195,24.022707345133995
3777,2022,2,NCAAF_20220910_APLST@TXAM,Texas A&M,Aggies,App. St.,Mountaineers,1-1,1-1,0,7,7,14,17,0,7,7,0,0,7,7,3,0,0,0,0,-3,0.7218408776783684,9.89557168067762,0.7528529920527804,10.176470558704182
3778,2022,2,NCAAF_20220910_COLO@AF,Air Force,Falcons,Colorado,Buffaloes,2-0,0-2,0,20,10,41,10,13,7,7,14,0,10,0,0,2,10,13,10,31,0.5796688144374534,3.3816149429225106,,
3779,2022,2,NCAAF_20220910_FUR@CLEM,Clemson,Tigers,Furman,Paladins,2-0,1-1,1,28,9,35,12,14,14,7,0,3,6,3,0,1,19,11,19,23,0.9979388068898497,48.25078265705258,,
3780,2022,2,NCAAF_20220910_KENSAW@CINCY,Cincinnati,Bearcats,Kennesaw St.,Owls,1-1,0-2,1,21,3,63,10,7,14,21,21,0,3,0,7,1,18,7,18,53,0.9862407275951731,37.072844521790955,,
3781,2022,2,NCAAF_20220910_MD@CHARLO,Charlotte,49ers,Maryland,Terrapins,0-3,2-0,0,14,35,21,56,7,7,0,7,21,14,14,7,-2,-21,-14,-21,-35,0.12686192128568474,-19.197617470377452,0.06959356452844989,-22.0180315093163
3782,2022,2,NCAAF_20220910_MEMP@NAVY,Navy,Midshipmen,Memphis,Tigers,0-2,1-1,0,7,13,13,37,7,0,0,6,10,3,10,14,-1,-6,-3,-6,-24,0.3316411660732286,-7.323226135129005,0.5231031002481292,0.8627101472274035
3783,2022,2,NCAAF_20220910_WASHST@WISC,Wisconsin,Badgers,Washington St.,Cougars,1-1,2-0,1,14,7,14,17,0,14,0,0,0,7,10,0,-1,7,0,7,-3,0.7731709680909171,12.603798346559643,0.7427370105822367,9.704663080604405
3784,2022,2,NCAAF_20220910_AKRON@MICHST,Michigan St.,Spartans,Akron,Zips,2-0,1-1,0,24,0,52,0,14,10,28,0,0,0,0,0,1,24,14,24,52,0.9790146816563841,34.20886776702184,0.9982206509255742,43.39868922674157
3785,2022,2,NCAAF_20220910_INST@PURDUE,Purdue,Boilermakers,Indiana St.,Sycamores,1-1,1-1,0,35,0,56,0,21,14,14,7,0,0,0,0,0,35,21,35,56,0.9688141952942946,31.346654632385935,,
3786,2022,2,NCAAF_20220910_IOWAST@IOWA,Iowa,Hawkeyes,Iowa St.,Cyclones,1-1,2-0,0,7,3,7,10,7,0,0,0,0,3,0,7,-1,4,7,4,-3,0.571340621690015,3.0240539453278075,0.26436248579141364,-9.379296756941017
3787,2022,2,NCAAF_20220910_MTSU@COLOST,Colorado St.,Rams,Middle Tenn.,Blue Raiders,0-2,1-1,1,0,27,19,34,0,0,19,0,10,17,7,0,-1,-27,-10,-27,-15,0.5727578896722376,3.0848018004193136,0.5810402272107904,3.045598020341572
3788,2022,2,NCAAF_20220910_NCO@WYO,Wyoming,,N. Colorado,,2-1,0-2,,9,0,33,10,3,6,7,17,0,0,3,7,2,9,3,9,23,0.9285059307861356,24.63727448432536,,
3789,2022,2,NCAAF_20220910_NRFST@JMAD,James Madison,,Norfolk St.,,2-0,0-2,,35,0,63,7,21,14,21,7,0,0,7,0,2,35,21,35,56,0.9983944868748142,49.565059579850754,,
3790,2022,2,NCAAF_20220910_PORTST@WASH,Washington,Huskies,Portland St.,Vikings,2-0,0-2,0,31,3,52,6,14,17,14,7,0,3,3,0,2,28,14,28,46,0.9692483309702392,31.45118644965686,,
3791,2022,2,NCAAF_20220910_SAMF@UGA,Georgia,Bulldogs,Samford,Bulldogs,2-0,1-1,1,30,0,33,0,13,17,0,3,0,0,0,0,1,30,13,30,33,0.9904263150320819,39.40355027588225,,
3792,2022,2,NCAAF_20220910_UNLV@CAL,California,Golden Bears,UNLV,Rebels,2-0,1-1,0,17,7,20,14,14,3,3,0,0,7,7,0,1,10,14,10,6,0.8719558427365394,19.102317362632505,0.9006532621845798,19.136408967183684
3793,2022,2,NCAAF_20220910_UVA@ILL,Illinois,Fighting Illini,Virginia,Cavaliers,2-1,1-1,1,21,3,24,3,14,7,3,0,3,0,0,0,1,18,11,18,21,0.3511565606624214,-6.428632504453674,0.40243823558977343,-3.678161831532293
3794,2022,2,NCAAF_20220910_WAG@RUT,Rutgers,Scarlet Knights,Wagner,Seahawks,2-0,0-2,0,38,7,66,7,28,10,14,14,0,7,0,0,2,31,28,31,59,0.9911473747651812,39.89260977763439,,
3795,2022,2,NCAAF_20220910_ALST@UCLA,UCLA,Bruins,Alabama St.,Hornets,2-0,2-1,0,31,7,45,7,14,17,7,7,0,7,0,0,0,24,14,24,38,0.9919263388102234,40.46185656034692,,
3796,2022,2,NCAAF_20220910_UIW@NEVADA,Nevada,,Incarnate Word,,2-1,2-0,,17,24,41,55,17,0,14,10,9,15,14,17,0,-7,8,-7,-14,0.9835048792426049,35.863809781648115,,
3797,2022,2,NCAAF_20220910_GRDWB@CSTCAR,C. Carolina,Chanticleers,Gardner-Webb,Runnin' Bulldogs,2-0,1-1,1,17,10,31,27,3,14,7,7,0,10,10,7,1,7,3,7,4,0.9766515196454247,33.45578657205101,,
3798,2022,2,NCAAF_20220910_HOLY@BUFF,Buffalo,,Holy Cross,,0-2,2-0,,21,14,31,37,7,14,7,3,0,14,14,9,-2,7,7,7,-6,0.9599165509316631,29.430406157426887,,
3799,2022,2,NCAAF_20220910_ODU@ECU,East Carolina,Pirates,Old Dominion,Monarchs,1-1,1-1,1,16,7,39,21,9,7,6,17,7,0,7,7,0,9,2,9,18,0.643502090178094,6.187024454688242,,
3800,2022,2,NCAAF_20220910_ROB@MIAOH,Miami-OH,,Robert Morris,,1-1,0-2,,24,7,31,14,10,14,0,7,7,0,0,7,1,17,3,17,17,0.9807701762510175,34.81625497130591,,
3801,2022,2,NCAAF_20220910_SELOU@FAU,FAU,,SE Louisiana,,2-1,0-2,,28,3,42,9,7,21,7,7,0,3,0,6,2,25,7,25,33,0.6833830514620466,8.026207292238439,,
3802,2022,2,NCAAF_20220910_UAB@LIB,Liberty,Flames,UAB,Blazers,2-0,1-1,1,7,7,21,14,0,7,7,7,7,0,0,7,1,0,-7,0,7,0.48574603925693793,-0.6010989870790695,0.5568902240759853,2.130439973577836
3803,2022,2,NCAAF_20220910_ALAM@TROY,Troy,,Alabama A&M,,1-1,0-2,,7,3,38,17,0,7,21,10,3,0,0,14,1,4,-3,4,21,0.9956409035079935,44.11758158771357,,
3804,2022,2,NCAAF_20220910_ALCORN@TULANE,Tulane,,Alcorn St.,,2-0,0-2,,31,0,52,0,17,14,14,7,0,0,0,0,2,31,17,31,52,0.9549880357188292,28.514603082556278,,
3805,2022,2,NCAAF_20220910_CAR@MISS,Ole Miss,Rebels,Cent. Ark.,Bears,2-0,0-2,1,31,0,59,3,28,3,21,7,0,0,0,3,2,31,28,31,56,0.9649811583622354,30.47238282188232,,
3806,2022,2,NCAAF_20220910_CUSE@UCONN,UConn,Huskies,Syracuse,Orange,1-2,2-0,0,7,27,14,48,0,7,7,0,17,10,14,7,-1,-20,-17,-20,-34,0.060855180867800396,-26.031333947626365,0.029288759335793446,-28.160078109468486
3807,2022,2,NCAAF_20220910_EMICH@UL,Louisiana,Ragin' Cajuns,E. Michigan,Eagles,2-0,1-1,0,0,14,49,21,0,0,21,28,7,7,7,0,1,-14,-7,-14,28,0.6297721087282856,5.571648829742458,0.8146350971407685,13.327134399668012
3808,2022,2,NCAAF_20220910_FIU@TXSTSM,Texas St.,,FIU,,1-1,1-1,,20,6,41,12,10,10,0,21,3,3,0,6,0,14,7,14,29,0.3450870181078869,-6.704801912913183,,
3809,2022,2,NCAAF_20220910_HOW@SFLA,South Florida,Bulls,Howard,Bison,1-1,0-3,1,14,7,42,20,0,14,14,14,7,0,7,6,1,7,-7,7,22,0.9890362003680829,38.54522733405764,,
3810,2022,2,NCAAF_20220910_KENTST@OKLA,Oklahoma,Sooners,Kent St.,Golden Flashes,2-0,0-2,0,7,3,33,3,0,7,24,2,0,3,0,0,2,4,0,4,30,0.9923331598719507,40.7786132620389,0.9847773082842746,32.22319559360744
3811,2022,2,NCAAF_20220910_LAMAR@SMU,SMU,Mustangs,Lamar,Cardinals,2-0,0-2,0,24,10,45,16,14,10,14,7,0,10,3,3,2,14,14,14,29,0.9998903796416587,62.16277170383785,,
3812,2022,2,NCAAF_20220910_NILL@TULSA,Tulsa,Golden Hurricane,N. Illinois,Huskies,1-1,1-1,1,24,7,38,35,7,17,0,14,0,7,14,14,0,17,7,17,3,0.5905608417795686,3.851594999612587,,
3813,2022,2,NCAAF_20220910_SFA@LATECH,Louisiana Tech,,S.F. Austin,,1-1,1-2,,38,7,52,17,21,17,14,0,7,0,3,7,0,31,14,31,35,0.8783364737497821,19.62417485934583,,
3814,2022,2,NCAAF_20220910_UK@FLA,Florida,Gators,Kentucky,Wildcats,1-1,2-0,1,16,13,16,26,3,13,0,0,0,13,10,3,-1,3,3,3,-10,0.6498591769834572,6.474726852358572,0.46198720731787324,-1.420823773604866
3815,2022,2,NCAAF_20220910_UMASS@TOLEDO,Toledo,,UMass,,2-0,0-2,,28,7,55,10,14,14,17,10,0,7,0,3,2,21,14,21,45,0.9411121333587431,26.309602640956996,0.990782719071467,35.08967242116603
3816,2022,2,NCAAF_20220910_WBRST@UTAHST,Utah St.,,Weber St.,,1-2,2-0,,7,13,7,35,7,0,0,0,13,0,15,7,-1,-6,-6,-6,-28,0.6860276269082053,8.15137532661953,,
3817,2022,2,NCAAF_20220910_WCAR@GATECH,Georgia Tech,Yellow Jackets,W. Carolina,Catamounts,1-1,1-1,1,28,14,35,17,14,14,7,0,14,0,0,3,0,14,0,14,18,0.9869590879682941,37.4245322725784,,
3818,2022,2,NCAAF_20220910_ARIZST@OKLAST,Oklahoma State,Cowboys,Arizona St.,Sun Devils,2-0,1-1,1,17,3,34,17,0,17,3,14,3,0,7,7,1,14,-3,14,17,0.6847534152675594,8.0910108302524,0.7625772720818194,10.63984657281594
3819,2022,2,NCAAF_20220910_GAS@NEB,Nebraska,Cornhuskers,Ga. Southern,Eagles,1-2,2-0,1,28,28,42,45,7,21,7,7,14,14,7,10,-1,0,-7,0,-3,0.8749297797463162,19.34323266232576,0.9635895156129979,26.709905675309187
3820,2022,2,NCAAF_20220910_MCN@RICE,Rice,,McNeese St.,,1-1,0-2,,31,0,52,10,10,21,14,7,0,0,10,0,1,31,10,31,42,0.42890196020785476,-3.0136602177791474,,
3821,2022,2,NCAAF_20220910_SJST@AUBURN,Auburn,Tigers,San Jose St.,Spartans,2-0,1-1,0,7,10,24,16,0,7,10,7,0,10,0,6,1,-3,0,-3,8,0.9801237275673554,34.587317186497614,,
3822,2022,2,NCAAF_20220910_SO@LSU,LSU,Tigers,Southern U.,Jaguars,1-1,1-1,1,51,0,65,17,37,14,7,7,0,0,7,10,0,51,37,51,48,0.9999522470698152,65.6274890720926,,
3823,2022,2,NCAAF_20220910_TXSO@NTEXAS,North Texas,Mean Green,Texas Southern,Tigers,2-1,0-2,0,45,17,59,27,10,35,7,7,3,14,7,3,2,28,7,28,32,0.9906743298165841,39.568014824249644,,
3824,2022,2,NCAAF_20220910_USC@STNFRD,Stanford,Cardinal,USC,Trojans,1-1,2-0,1,14,35,28,41,7,7,0,14,21,14,6,0,-1,-21,-14,-21,-13,0.4001024479452816,-4.256858568848884,0.286600751548858,-8.38753733079443
3825,2022,2,NCAAF_20220910_BC@VATECH,Virginia Tech,Hokies,Boston College,Eagles,1-1,0-2,0,17,3,27,10,10,7,7,3,0,3,7,0,1,14,10,14,17,0.5441178346849913,1.8638900628111514,0.6509681861001266,5.775924110518872
3826,2022,2,NCAAF_20220910_HAWAII@MICH,Michigan,Wolverines,Hawaii,Rainbow Warriors,2-0,0-3,0,42,0,56,10,21,21,0,14,0,0,3,7,2,42,21,42,46,0.9866160176298102,37.25454253950954,0.9976163939388534,42.02170274301852
3827,2022,2,NCAAF_20220910_IDAHO@IND,Indiana,Hoosiers,Idaho,Vandals,2-0,0-2,1,0,10,35,22,0,0,23,12,0,10,0,12,2,-10,0,-10,13,0.9413525913928393,26.344112112080495,,
3828,2022,2,NCAAF_20220910_IDST@SDGST,San Diego St.,Aztecs,Idaho State,Bengals,1-1,0-2,0,21,7,38,7,14,7,3,14,7,0,0,0,1,14,7,14,31,0.9530318590468729,28.173459047998904,,
3829,2022,2,NCAAF_20220910_NICHST@LAMON,UL-Monroe,,Nicholls St.,,1-1,0-2,,21,7,35,7,0,21,7,7,7,0,0,0,1,14,-7,14,28,0.6171411363026378,5.01206302899368,,
3830,2022,2,NCAAF_20220910_TRLST@TCU,TCU,,Tarleton St.,,2-0,1-1,,38,7,59,17,21,17,14,7,0,7,10,0,1,31,21,31,42,,,,
3831,2022,2,NCAAF_20220910_EWASH@OREG,Oregon,Ducks,E. Washington,Eagles,1-1,1-1,0,42,7,70,14,14,28,21,7,0,7,7,0,0,35,14,35,56,0.9938401387683269,42.098163613947406,,
3832,2022,2,NCAAF_20220910_NMEXST@UTEP,UTEP,Miners,New Mexico St.,Aggies,1-2,0-3,1,17,0,20,13,3,14,3,0,0,0,6,7,1,17,3,17,7,0.4219388718085839,-3.3124767426994026,0.7044704275674474,7.999817162903696
3833,2022,2,NCAAF_20220910_OREGST@FRESNO,Fresno St.,Bulldogs,Oregon State,Beavers,1-1,2-0,0,13,14,32,35,7,6,10,9,7,7,7,14,-1,-1,0,-1,-3,0.6468383413123866,6.33778195998849,0.2247973325299777,-11.257340117587773
3834,2022,2,NCAAF_20220910_MISSST@ARIZ,Arizona,Wildcats,Miss. State,Bulldogs,1-1,2-0,1,10,18,17,39,7,3,7,0,15,3,7,14,-1,-8,-8,-8,-22,0.1801683198834937,-15.385728156666346,0.05338142269083801,-24.0144911062996
3835,2022,2,NCAAF_20220909_LVILLE@UCF,UCF,Knights,Louisville,Cardinals,1-1,1-1,0,14,7,14,20,7,7,0,0,7,0,10,3,0,7,0,7,-6,0.6976700420408946,8.707940840541028,0.30982946190457583,-7.389849532880362
3836,2022,2,NCAAF_20220909_BOISE@NMEX,New Mexico,Lobos,Boise St.,Broncos,1-1,1-1,1,0,10,14,31,0,0,0,14,0,10,7,14,0,-10,0,-10,-17,0.06327959409137607,-25.697923093018915,0.02470802758714319,-29.25639623189545
3837,2022,3,NCAAF_20220917_WOFF@VATECH,Virginia Tech,Hokies,Wofford,Terriers,2-1,0-3,1,20,0,27,7,3,17,0,7,0,0,0,7,2,20,3,20,20,0.8834079326753873,20.092634956306938,,
3838,2022,3,NCAAF_20220917_ABIL@MIZZOU,Missouri,Tigers,Abil Christian,Wildcats,2-1,2-1,0,17,3,34,17,14,3,14,3,3,0,7,7,0,14,11,14,17,0.9940768526153959,42.41492860057349,,
3839,2022,3,NCAAF_20220917_CINCY@MIAOH,Miami-OH,RedHawks,Cincinnati,Bearcats,1-2,2-1,1,17,24,17,38,10,7,0,0,7,17,7,7,-1,-7,3,-7,-21,0.15231479483078159,-17.3010166551843,0.05087868325261724,-24.084502968627476
3840,2022,3,NCAAF_20220917_LIUPOST@KENTST,Kent St.,,LIU,,1-2,0-3,,35,10,63,10,7,28,14,14,7,3,0,0,1,25,0,25,53,0.969124063553382,31.483489978301463,,
3841,2022,3,NCAAF_20220917_NOVA@ARMY,Army,Black Knights,Villanova,Wildcats,1-2,2-2,0,21,7,49,10,14,7,7,21,7,0,3,0,-1,14,7,14,39,0.58764388449726,3.7328437570462256,,
3842,2022,3,NCAAF_20220917_OKLA@NEB,Nebraska,Cornhuskers,Oklahoma,Sooners,1-3,3-1,0,7,35,14,49,7,0,0,7,14,21,14,0,-2,-28,-7,-28,-35,0.15722701510117265,-16.953229868046947,0.2672602295481614,-9.14167585765449
3843,2022,3,NCAAF_20220917_PURDUE@CUSE,Syracuse,Orange,Purdue,Boilermakers,3-0,1-2,1,3,9,32,29,3,0,7,22,6,3,0,20,2,-6,-3,-6,3,0.2579825207581563,-10.947629541891388,0.2566550428920542,-9.621071169596462
3844,2022,3,NCAAF_20220917_SIL@NWEST,Northwestern,Wildcats,S. Illinois,Salukis,1-2,1-2,0,14,14,24,31,7,7,0,10,0,14,3,14,0,0,7,0,-7,0.8523624386735393,17.639155607336193,,
3845,2022,3,NCAAF_20220917_TXSTSM@BAYLOR,Baylor,Bears,Texas St.,Bobcats,2-1,1-2,1,21,7,42,7,7,14,7,14,0,7,0,0,1,14,7,14,35,0.9606034359429968,29.62385911682486,0.9964404024295288,39.60944305903945
3846,2022,3,NCAAF_20220917_UCONN@MICH,Michigan,Wolverines,UConn,Huskies,3-0,1-3,1,38,0,59,0,17,21,7,14,0,0,0,0,2,38,17,38,59,0.9987955666339101,51.142828526048675,0.9999084777937483,55.06514956049023
3847,2022,3,NCAAF_20220917_UGA@SC,South Carolina,Gamecocks,Georgia,Bulldogs,1-2,3-0,1,0,24,7,48,0,0,0,7,14,10,21,3,-2,-24,-14,-24,-41,0.077486013446044,-23.968763603009393,0.008823849939345263,-34.924858458602785
3848,2022,3,NCAAF_20220917_YST@UK,Kentucky,Wildcats,Youngstown St.,Penguins,4-0,2-1,1,21,0,31,0,0,21,7,3,0,0,0,0,2,21,0,21,31,0.9681197165492774,31.24378701575131,,
3849,2022,3,NCAAF_20220917_BUCK@CMICH,C. Michigan,Chippewas,Bucknell,Bison,1-3,0-3,0,7,0,41,0,0,7,13,21,0,0,0,0,1,7,0,7,41,0.9963494736014458,45.21430726588653,,
3850,2022,3,NCAAF_20220917_BUFF@CSTCAR,C. Carolina,Chanticleers,Buffalo,Bulls,3-0,0-3,1,14,16,38,26,7,7,3,21,6,10,3,7,3,-2,1,-2,12,0.4419616487048068,-2.46056390132037,0.9521281792101753,24.518026958455494
3851,2022,3,NCAAF_20220917_TWST@WVU,West Virginia,Mountaineers,Towson,Tigers,1-2,2-1,1,45,7,65,7,21,24,6,14,7,0,0,0,-1,38,14,38,58,0.9893903027939785,38.83133946042631,,
3852,2022,3,NCAAF_20220917_MURYST@BALLST,Ball St.,Cardinals,Murray St.,Racers,1-2,0-3,0,14,0,31,0,7,7,10,7,0,0,0,0,1,14,7,14,31,0.8952707616671165,21.1520296747683,,
3853,2022,3,NCAAF_20220917_ODU@UVA,Virginia,Cavaliers,Old Dominion,Monarchs,2-1,1-2,1,10,7,16,14,7,3,0,6,0,7,0,7,1,3,7,3,2,0.907200070684604,22.309064488473837,0.773124571714471,11.02641162401369
3854,2022,3,NCAAF_20220917_OHIO@IOWAST,Iowa St.,Cyclones,Ohio,Bobcats,3-0,1-2,1,30,3,43,10,14,16,7,6,0,3,7,0,2,27,14,27,33,0.901964672235341,21.788615575065023,0.9964589624863934,39.635103185042794
3855,2022,3,NCAAF_20220917_RUT@TEMPLE,Temple,Owls,Rutgers,Scarlet Knights,1-2,3-0,0,7,10,14,16,7,0,0,7,3,7,3,3,-2,-3,4,-3,-2,0.3840711980617385,-4.96849319710293,0.030519940927743905,-27.569933847059474
3856,2022,3,NCAAF_20220917_SALA@UCLA,UCLA,Bruins,South Alabama,Jaguars,3-0,2-1,0,13,17,32,31,6,7,10,9,10,7,14,0,1,-4,-4,-4,1,0.9086576366535872,22.457806432629354,,
3857,2022,3,NCAAF_20220917_CAL@ND,Notre Dame,Fighting Irish,California,Golden Bears,1-2,2-1,1,7,10,24,17,0,7,7,10,0,10,7,0,-1,-3,0,-3,7,0.8490776682765291,17.40095215495444,0.8763857501828252,17.030356359704797
3858,2022,3,NCAAF_20220917_NTEXAS@UNLV,UNLV,Rebels,North Texas,Mean Green,2-1,2-2,1,23,20,58,27,9,14,14,21,10,10,7,0,0,3,-1,3,31,0.39037790563616614,-4.690893649842906,0.4063180347214397,-3.4885693971908722
3859,2022,3,NCAAF_20220917_TULANE@KSTATE,Kansas State,Wildcats,Tulane,Green Wave,2-1,3-0,0,10,7,10,17,0,10,0,0,7,0,3,7,-1,3,-7,3,-7,0.7376725934679863,10.721943038241989,0.9345429210517966,22.231704506992173
3860,2022,3,NCAAF_20220917_BYU@OREG,Oregon,Ducks,BYU,Cougars,2-1,2-1,0,24,7,41,20,10,14,14,3,0,7,0,13,0,17,10,17,21,0.7177185155078039,9.708892874139337,0.4903330833002817,-0.3566732149346308
3861,2022,3,NCAAF_20220917_COLO@MINN,Minnesota,Golden Gophers,Colorado,Buffaloes,3-0,0-3,1,35,0,49,7,14,21,7,7,0,0,0,7,3,35,14,35,42,0.7844792250456816,13.270590151559645,0.9117919076734018,19.896914519383017
3862,2022,3,NCAAF_20220917_GAS@UAB,UAB,Blazers,Ga. Southern,Eagles,2-1,3-1,0,21,7,35,21,7,14,0,14,0,7,7,7,-1,14,7,14,14,0.6478362718312832,6.395640421243684,0.746438163174199,9.762817519289001
3863,2022,3,NCAAF_20220917_MISS@GATECH,Georgia Tech,Yellow Jackets,Ole Miss,Rebels,1-2,3-0,0,0,21,0,42,0,0,0,0,14,7,21,0,-2,-21,-14,-21,-42,0.29548133044613945,-9.05774752318132,0.04597947774949618,-24.80216268480831
3864,2022,3,NCAAF_20220917_NMEXST@WISC,Wisconsin,Badgers,New Mexico St.,Aggies,2-1,0-4,1,35,0,66,7,7,28,21,10,0,0,0,7,2,35,7,35,59,0.9948894396978168,43.284015769606185,0.9970441143785893,40.51340581791703
3865,2022,3,NCAAF_20220917_PSU@AUBURN,Auburn,Tigers,Penn State,Nittany Lions,2-1,3-0,0,6,14,12,41,3,3,0,6,7,7,17,10,-1,-8,-4,-8,-29,0.36442883974121,-5.842174409409267,0.3367049219569316,-6.2032554699391085
3866,2022,3,NCAAF_20220917_STONYBRK@UMASS,UMass,,Stony Brook,,1-2,0-2,,17,3,20,3,7,10,3,0,0,3,0,0,1,14,7,14,17,0.62441556449472,5.344205614243037,,
3867,2022,3,NCAAF_20220917_TROY@APLST,App. St.,Mountaineers,Troy,Trojans,2-1,1-2,0,14,21,32,28,7,7,10,8,7,14,0,7,1,-7,0,-7,4,0.7771993616681159,12.855291240530278,0.9478845410399511,23.91209992412837
3868,2022,3,NCAAF_20220917_VANDY@NILL,N. Illinois,Huskies,Vanderbilt,Commodores,1-2,3-1,0,21,14,28,38,7,14,7,0,7,7,21,3,-2,7,0,7,-10,0.45163306514508905,-2.048309608197883,0.4017462374198202,-3.662287111757223
3869,2022,3,NCAAF_20220917_KANSAS@HOU,Houston,Cougars,Kansas,Jayhawks,1-2,3-0,0,14,28,30,48,14,0,13,3,14,14,14,6,-2,-14,0,-14,-18,0.7903381107393556,13.610766875960508,,
3870,2022,3,NCAAF_20220917_LAMON@BAMA,Alabama,Crimson Tide,UL-Monroe,Warhawks,3-0,1-2,1,35,7,63,7,28,7,14,14,0,7,0,0,2,28,28,28,56,0.9993488666810888,54.19194894105601,0.9995025750251564,48.45149167638249
3871,2022,3,NCAAF_20220917_TNMART@BOISE,Boise St.,Broncos,UT Martin,Skyhawks,2-1,1-2,0,20,7,30,7,7,13,0,10,7,0,0,0,1,13,0,13,23,0.9905366103865894,39.554556718317485,,
3872,2022,3,NCAAF_20220917_COLOST@WASHST,Washington St.,Cougars,Colorado St.,Rams,3-0,0-3,0,28,0,38,7,21,7,3,7,0,0,0,7,3,28,21,28,31,0.8436071617720478,17.01177926893581,0.9052891309135364,19.31436590805197
3873,2022,3,NCAAF_20220917_LIB@WAKE,Wake Forest,Demon Deacons,Liberty,Flames,3-0,2-1,0,20,8,37,36,3,17,0,17,0,8,15,13,1,12,3,12,1,0.770061395008212,12.455531146553426,0.7460580931437136,9.745352179370684
3874,2022,3,NCAAF_20220917_CAMP@ECU,East Carolina,,Campbell,,2-2,1-2,,21,10,49,10,7,14,21,7,10,0,0,0,1,11,-3,11,39,0.9147335660401552,23.09755455150571,,
3875,2022,3,NCAAF_20220917_MISSST@LSU,LSU,Tigers,Miss. State,Bulldogs,2-1,2-1,1,7,13,31,16,0,7,3,21,6,7,3,0,0,-6,-6,-6,15,0.5986916299842099,4.2127236083046,0.4283469974248365,-2.6578454127206896
3876,2022,3,NCAAF_20220917_NCAT@DUKE,Duke,Blue Devils,NC A&T,Aggies,3-0,0-3,1,28,6,49,20,21,7,14,7,0,6,0,14,3,22,21,22,29,0.9227083447650757,23.991358025000523,,
3877,2022,3,NCAAF_20220917_AKRON@TENN,Tennessee,Volunteers,Akron,Zips,3-0,1-2,1,35,0,63,6,14,21,14,14,0,0,3,3,2,35,14,35,57,0.961763012836407,29.85626532480876,0.9996046517191587,49.394212441334844
3878,2022,3,NCAAF_20220917_ARKST@MEMP,Memphis,Tigers,Arkansas St.,Red Wolves,2-1,1-2,1,21,17,44,32,7,14,0,23,7,10,0,15,1,4,0,4,12,0.7929312551177948,13.76310944262957,0.827705533660276,13.910567534313714
3879,2022,3,NCAAF_20220917_ARPB@OKLAST,Oklahoma State,Cowboys,Ark.-Pine Bluff,Golden Lions,3-0,2-2,1,49,7,63,7,28,21,7,7,0,7,0,0,1,42,28,42,56,0.9999606868632908,66.54670157012129,,
3880,2022,3,NCAAF_20220917_CHARLO@GAST,Georgia St.,Panthers,Charlotte,49ers,0-3,1-3,1,20,21,41,42,14,6,7,14,7,14,7,14,-1,-1,7,-1,-1,0.6399135536334607,6.037375575056103,0.9426313087114737,23.214074248436646
3881,2022,3,NCAAF_20220917_JAXST@TULSA,Tulsa,,Jacksonville St.,,2-1,3-1,,40,3,54,17,12,28,7,7,0,3,7,7,-1,37,12,37,37,0.7511947560866366,11.43092887789146,,
3882,2022,3,NCAAF_20220917_MOST@ARK,Arkansas,Razorbacks,Missouri St.,Bears,3-0,2-1,0,14,17,38,27,0,14,3,21,7,10,7,3,1,-3,-7,-3,11,0.9066246426437427,22.250818855593252,,
3883,2022,3,NCAAF_20220917_NWST@USM,So. Miss,,Northwestern St.,,1-2,0-3,,41,0,64,10,13,28,16,7,0,0,10,0,1,41,13,41,54,0.9339476806205081,25.37884618245016,,
3884,2022,3,NCAAF_20220917_TNST@MTSU,Middle Tenn.,,Tennessee St.,,3-1,0-3,,42,0,49,6,21,21,7,0,0,0,6,0,3,42,21,42,43,0.7211075204361732,9.878396706734065,,
3885,2022,3,NCAAF_20220917_TOLEDO@OHIOST,Ohio State,Buckeyes,Toledo,Rockets,3-0,2-1,1,42,14,77,21,28,14,14,21,7,7,7,0,1,28,21,28,56,0.9852621852627531,36.691090384401946,0.9898773965567162,34.171943470587735
3886,2022,3,NCAAF_20220917_TXTECH@NCST,NC State,Wolfpack,Texas Tech,Red Raiders,3-0,2-1,0,20,7,27,14,6,14,0,7,0,7,0,7,1,13,6,13,13,0.5322252462261463,1.3628506776962013,0.7795078630880592,11.340726066569687
3887,2022,3,NCAAF_20220917_ME@BC,Boston College,Eagles,Maine,Black Bears,1-3,0-3,1,28,10,38,17,14,14,3,7,10,0,7,0,1,18,4,18,21,0.9617566383369875,29.85497212278449,,
3888,2022,3,NCAAF_20220917_MICHST@WASH,Washington,Huskies,Michigan St.,Spartans,3-0,2-1,1,29,8,39,28,9,20,7,3,0,8,6,14,1,21,9,21,11,0.5880003347336167,3.748277616454857,0.2461225008110629,-10.10750611407957
3889,2022,3,NCAAF_20220917_NEVADA@IOWA,Iowa,Hawkeyes,Nevada,Wolf Pack,2-1,2-2,1,17,0,27,0,14,3,3,7,0,0,0,0,0,17,14,17,27,0.9342829791740777,25.422949252909802,0.6695683577671614,6.457123337427333
3890,2022,3,NCAAF_20220917_PITT@WMICH,W. Michigan,Broncos,Pittsburgh,Panthers,1-2,2-1,0,6,13,13,34,3,3,7,0,10,3,7,14,-1,-7,-7,-7,-21,0.20640980936214093,-13.80200007476003,0.05968183529657545,-22.922617459921184
3891,2022,3,NCAAF_20220917_SFLA@FLA,Florida,Gators,South Florida,Bulls,2-1,1-2,0,24,13,31,28,3,21,0,7,7,6,8,7,1,11,-4,11,3,0.9243927010220218,24.188998783363104,0.9697606442842468,27.629997728770945
3892,2022,3,NCAAF_20220917_SMU@MD,Maryland,Terrapins,SMU,Mustangs,3-0,2-1,0,17,20,34,27,3,14,3,14,6,14,7,0,1,-3,-3,-3,7,0.46316289393266397,-1.5584144719239248,0.2967124174960717,-7.857663164331939
3893,2022,3,NCAAF_20220917_UCF@FAU,FAU,Owls,UCF,Knights,2-2,2-1,1,14,16,14,40,14,0,0,0,7,9,14,10,0,-2,7,-2,-26,0.20359050019167713,-13.969234365192165,0.25271282325808064,-9.801881962748098
3894,2022,3,NCAAF_20220917_UL@RICE,Rice,Owls,Louisiana,Ragin' Cajuns,2-1,2-1,0,13,14,33,21,3,10,6,14,7,7,0,7,0,-1,-4,-1,12,0.12203677969024562,-19.632005138289742,,
3895,2022,3,NCAAF_20220917_LATECH@CLEM,Clemson,Tigers,Louisiana Tech,Bulldogs,3-0,1-2,1,13,6,48,20,10,3,21,14,0,6,0,14,2,7,10,7,28,0.9889767078542623,38.58707308401165,0.9790709041105389,29.950147855695604
3896,2022,3,NCAAF_20220917_MTST@OREGST,Oregon State,Beavers,Montana St.,Bobcats,3-0,2-1,1,34,14,68,28,7,27,20,14,7,7,7,7,1,20,0,20,40,0.8303415925938304,16.103747494890854,,
3897,2022,3,NCAAF_20220917_TXSA@TEXAS,Texas,Longhorns,UTSA,Roadrunners,2-1,1-2,1,17,17,41,20,0,17,14,10,3,14,3,0,1,0,-3,0,21,0.9478304263812968,27.372908888401753,0.8621878790383044,16.045638034294143
3898,2022,3,NCAAF_20220917_UTEP@NMEX,New Mexico,Lobos,UTEP,Miners,2-1,1-3,1,20,3,27,10,10,10,0,7,3,0,0,7,1,17,7,17,17,0.6694073754735661,7.3864881334556,0.3056592763304049,-7.479595019531757
3899,2022,3,NCAAF_20220917_MIAMI@TXAM,Texas A&M,Aggies,Miami (Fla.),Hurricanes,2-1,2-1,1,10,3,17,9,10,0,7,0,3,0,3,3,0,7,7,7,8,0.5777969266588474,3.3076706053600446,0.7746210908668131,11.099645247631202
3900,2022,3,NCAAF_20220917_SDGST@UTAH,Utah,Utes,San Diego St.,Aztecs,2-1,1-2,1,21,0,35,7,0,21,14,0,0,0,0,7,1,21,0,21,28,0.8171856557857062,15.247183879134582,0.9688003371553917,27.426301884628174
3901,2022,3,NCAAF_20220917_FRESNO@USC,USC,Trojans,Fresno St.,Bulldogs,4-0,1-2,1,21,10,45,17,14,7,14,10,0,10,7,0,3,11,14,11,28,0.6487193320256106,6.435748967703148,0.6257111609826727,4.717359181454299
3902,2022,3,NCAAF_20220917_EMICH@ARIZST,Arizona St.,Sun Devils,E. Michigan,Eagles,1-2,2-1,0,14,24,21,30,0,14,0,7,10,14,3,3,-1,-10,-10,-10,-9,0.8281783051852718,15.960070858010226,0.9304634147661188,21.771684446899485
3903,2022,3,NCAAF_20220917_NDST@ARIZ,Arizona,Wildcats,N. Dakota St.,Bison,2-1,2-1,1,17,14,31,28,7,10,7,7,7,7,14,0,0,3,0,3,3,,,,
3904,2022,3,NCAAF_20220917_DUQ@HAWAII,Hawaii,,Duquesne,,1-3,1-3,,14,6,24,14,7,7,0,10,3,3,0,8,0,8,4,8,10,0.7930316054571123,13.769027425192348,,
3905,2022,3,NCAAF_20220916_FSU@LVILLE,Louisville,Cardinals,Florida State,Seminoles,1-2,3-0,1,21,14,31,35,14,7,0,10,14,0,7,14,-2,7,0,7,-4,0.5072745443589792,0.307332710097171,0.5116278585987504,0.4290434343755578
3906,2022,3,NCAAF_20220916_AF@WYO,Wyoming,Cowboys,Air Force,Falcons,3-1,2-1,1,10,0,17,14,3,7,0,7,0,0,7,7,1,10,3,10,3,0.34135568533168015,-6.889120543953936,,
3907,2022,4,NCAAF_20220924_BAYLOR@IOWAST,Iowa St.,Cyclones,Baylor,Bears,3-1,3-1,0,14,17,24,31,7,7,0,10,7,10,7,7,0,-3,0,-3,-7,0.6964765772120809,8.662582347833904,0.5233331732449913,0.8644045063003887
3908,2022,4,NCAAF_20220924_BGREEN@MISSST,Miss. State,Bulldogs,Bowling Green,Falcons,3-1,1-3,1,31,7,45,14,17,14,7,7,0,7,0,7,2,24,17,24,31,0.9893357646956519,38.77610031181257,,
3909,2022,4,NCAAF_20220924_BUFF@EMICH,E. Michigan,Eagles,Buffalo,Bulls,2-2,1-3,0,24,30,31,50,14,10,7,0,13,17,10,10,1,-6,1,-6,-19,0.44205128863332366,-2.4553080351611243,0.7780971576391114,11.31125856183337
3910,2022,4,NCAAF_20220924_CMICH@PSU,Penn State,Nittany Lions,C. Michigan,Chippewas,4-0,1-3,0,21,14,33,14,14,7,6,6,0,14,0,0,3,7,14,7,19,0.9762684983541163,33.386572169256624,0.9198864010272025,20.74281881899833
3911,2022,4,NCAAF_20220924_DUKE@KANSAS,Kansas,Jayhawks,Duke,Blue Devils,4-0,3-1,1,21,13,35,27,7,14,7,7,7,6,0,14,1,8,0,8,8,0.33624225922514295,-7.120497940483119,,
3912,2022,4,NCAAF_20220924_KENTST@UGA,Georgia,Bulldogs,Kent St.,Golden Flashes,4-0,1-3,1,26,13,39,22,12,14,6,7,3,10,3,6,3,13,9,13,17,0.9967653841325489,45.865255703474304,0.9998836699253537,54.36600073749713
3913,2022,4,NCAAF_20220924_MD@MICH,Michigan,Wolverines,Maryland,Terrapins,4-0,3-1,1,17,13,34,27,10,7,0,17,10,3,0,14,1,4,0,4,7,0.9303220737925146,24.898193162712914,0.9696791441659984,27.711571887306036
3914,2022,4,NCAAF_20220924_RI@PITT,Pittsburgh,Panthers,Rhode Island,Rams,3-1,2-2,0,24,14,45,24,14,10,7,14,7,7,3,7,1,10,7,10,21,0.9591649383873054,29.326099877279603,,
3915,2022,4,NCAAF_20220924_SFLA@LVILLE,Louisville,Cardinals,South Florida,Bulls,2-2,1-3,1,28,0,41,3,14,14,3,10,0,0,0,3,1,28,14,28,38,0.7454468957449867,11.120688574545284,0.8568664632294699,15.750841643131764
3916,2022,4,NCAAF_20220924_TCU@SMU,SMU,Mustangs,TCU,Horned Frogs,2-2,3-0,0,14,28,34,42,0,14,7,13,14,14,0,14,-1,-14,-14,-14,-8,0.2930696205584524,-9.17034801760019,0.5884449650802024,3.301973947858073
3917,2022,4,NCAAF_20220924_FORD@OHIO,Ohio,Bobcats,Fordham,Rams,2-2,3-1,1,31,21,59,52,14,17,7,21,0,21,28,3,-1,10,14,10,7,0.9878579191020943,37.94208030709865,,
3918,2022,4,NCAAF_20220924_UCLA@COLO,Colorado,Buffaloes,UCLA,Bruins,0-4,4-0,1,10,21,17,45,0,10,0,7,14,7,17,7,-4,-11,-14,-11,-28,0.3515435030811488,-6.420072049392047,0.08582215054243503,-20.190855103024433
3919,2022,4,NCAAF_20220924_UMASS@TEMPLE,Temple,Owls,UMass,Minutemen,2-2,1-3,0,7,0,28,0,0,7,14,7,0,0,0,0,1,7,0,7,28,0.8823063833197649,19.986606683382888,0.7630740401599347,10.579263311646741
3920,2022,4,NCAAF_20220924_FIU@WKY,W. Kentucky,Hilltoppers,FIU,Panthers,3-1,1-2,0,42,0,73,0,14,28,17,14,0,0,0,0,2,42,14,42,73,0.6995026768226151,8.808739016318441,,
3921,2022,4,NCAAF_20220924_FLA@TENN,Tennessee,Volunteers,Florida,Gators,4-0,3-2,0,17,14,38,33,3,14,14,7,0,14,7,12,1,3,3,3,5,0.28486506098967657,-9.574760090945801,0.7102085318971305,8.182961915079147
3922,2022,4,NCAAF_20220924_IND@CINCY,Cincinnati,Bearcats,Indiana,Hoosiers,3-1,3-1,0,38,10,45,24,10,28,0,7,3,7,7,7,0,28,7,28,21,0.5527831830449366,2.23508958396701,0.9600428547866053,25.866467982237396
3923,2022,4,NCAAF_20220924_JMAD@APLST,App. St.,,James Madison,,2-2,3-0,,28,10,28,32,0,28,0,0,3,7,7,15,-1,18,-3,18,-4,0.28322241587145647,-9.656387788881375,,
3924,2022,4,NCAAF_20220924_MINN@MICHST,Michigan St.,Spartans,Minnesota,Golden Gophers,2-2,4-0,0,0,17,7,34,0,0,0,7,14,3,7,10,-2,-17,-14,-17,-27,0.4533929461500329,-1.9722842021790257,0.45366728397497647,-1.7193448243892817
3925,2022,4,NCAAF_20220924_MTSU@MIAMI,Miami (Fla.),Hurricanes,Middle Tenn.,Blue Raiders,2-2,3-2,0,10,24,31,45,3,7,7,14,17,7,7,14,-1,-14,-14,-14,-14,0.8726012996084234,19.181119792680875,0.8498464822162213,15.29927862702209
3926,2022,4,NCAAF_20220924_ND@UNC,North Carolina,Tar Heels,Notre Dame,Fighting Irish,4-1,2-2,1,14,24,32,45,7,7,6,12,0,24,14,7,2,-10,7,-10,-13,0.16947242564937592,-16.10678346011605,0.14469702236594872,-15.64900308393851
3927,2022,4,NCAAF_20220924_NTEXAS@MEMP,Memphis,Tigers,North Texas,Mean Green,3-1,2-3,1,20,13,44,34,6,14,7,17,10,3,7,14,1,7,-4,7,10,0.8278588370658793,15.9296835047262,0.6819211781248162,6.987761260744833
3928,2022,4,NCAAF_20220924_TOLEDO@SDGST,San Diego St.,Aztecs,Toledo,Rockets,2-2,2-2,1,7,0,17,14,0,7,3,7,0,0,0,14,0,7,0,7,3,0.5949320486049874,4.046700574727083,0.34234733834149644,-5.997928006136021
3929,2022,4,NCAAF_20220924_TXSO@TXSA,UTSA,Roadrunners,Texas Southern,Tigers,2-2,1-3,0,21,17,52,24,14,7,14,17,7,10,7,0,1,4,7,4,28,0.9859894714879207,37.00537038266771,,
3930,2022,4,NCAAF_20220924_GATECH@UCF,UCF,Knights,Georgia Tech,Yellow Jackets,3-1,1-3,1,13,7,27,10,3,10,3,11,0,7,3,0,2,6,3,6,17,0.7917093710365097,13.683225766308396,0.7623372363411308,10.544036870380467
3931,2022,4,NCAAF_20220924_OREG@WASHST,Washington St.,Cougars,Oregon,Ducks,3-1,3-1,1,17,9,41,44,10,7,10,14,3,6,6,29,0,8,7,8,-3,0.3998496796640979,-4.273845656699677,0.5536463612638481,1.9922822742553308
3932,2022,4,NCAAF_20220924_SACST@COLOST,Colorado St.,,Sacramento St.,,0-4,4-0,,10,24,10,41,0,10,0,0,7,17,7,10,-4,-14,-7,-14,-31,0.6840637394506504,8.069676940154295,,
3933,2022,4,NCAAF_20220924_TULSA@MISS,Ole Miss,Rebels,Tulsa,Golden Hurricane,4-0,2-2,1,35,17,35,27,7,28,0,0,14,3,3,7,2,18,-7,18,8,0.7747849052412759,12.71187473953023,,
3934,2022,4,NCAAF_20220924_ARIZ@CAL,California,Golden Bears,Arizona,Wildcats,3-1,2-2,1,21,24,49,31,7,14,14,14,14,10,0,7,1,-3,-7,-3,18,0.645906426731917,6.304444636321932,0.7798722567637378,11.399577656052656
3935,2022,4,NCAAF_20220924_AKRON@LIB,Liberty,Flames,Akron,Zips,3-1,1-3,0,14,3,21,12,7,7,0,7,0,3,3,6,2,11,7,11,9,0.879934517954089,19.78556190064728,0.9794813534418355,30.17910414352491
3936,2022,4,NCAAF_20220924_ARKST@ODU,Old Dominion,Monarchs,Arkansas St.,Red Wolves,2-2,1-3,0,0,12,29,26,0,0,21,8,0,12,7,7,1,-12,0,-12,3,0.30505018926386485,-8.589089021548034,0.6828559728125636,7.026494123291116
3937,2022,4,NCAAF_20220924_BALLST@GAS,Ga. Southern,Eagles,Ball St.,Cardinals,3-1,1-3,1,13,10,34,23,3,10,7,14,3,7,10,3,2,3,0,3,11,0.5713702351205769,3.0295634107753813,0.48250388840289626,-0.6480018035771309
3938,2022,4,NCAAF_20220924_RICE@HOU,Houston,Cougars,Rice,Owls,2-2,2-2,0,10,14,34,27,7,3,14,10,0,14,10,3,0,-4,7,-4,7,0.9106909915560304,22.65509513646475,,
3939,2022,4,NCAAF_20220924_ARK@TXAM,Texas A&M,Aggies,Arkansas,Razorbacks,3-1,3-1,0,13,14,23,21,0,13,10,0,14,0,0,7,0,-1,-14,-1,2,0.7994774598158215,14.144565874371665,0.533223521964397,1.2315271359294115
3940,2022,4,NCAAF_20220924_HOUBP@TXSTSM,Texas St.,Bobcats,Houston Christian,Huskies,2-2,1-2,1,24,0,34,0,7,17,3,7,0,0,0,0,1,24,7,24,34,0.6275631366104619,5.481029016355478,,
3941,2022,4,NCAAF_20220924_IOWA@RUT,Rutgers,Scarlet Knights,Iowa,Hawkeyes,3-1,3-1,1,3,17,10,27,3,0,0,7,7,10,7,3,0,-14,-4,-14,-17,0.07587325795686217,-24.1435235377337,0.127594632646717,-16.806792980560658
3942,2022,4,NCAAF_20220924_LATECH@SALA,South Alabama,Jaguars,Louisiana Tech,Bulldogs,4-1,1-3,1,17,7,38,14,14,3,14,7,0,7,0,7,3,10,14,10,24,0.33425613893827755,-7.212297485436466,,
3943,2022,4,NCAAF_20220924_MRSHL@TROY,Troy,Trojans,Marshall,Thundering Herd,2-2,2-2,1,10,0,16,7,10,0,0,6,0,0,7,0,0,10,10,10,9,0.3443681684687724,-6.747072830309207,,
3944,2022,4,NCAAF_20220924_NILL@UK,Kentucky,Wildcats,N. Illinois,Huskies,4-0,1-3,0,14,14,31,23,7,7,10,7,7,7,0,9,3,0,0,0,8,0.8639230573359835,18.49628749009139,0.9705969785814749,27.911595523550773
3945,2022,4,NCAAF_20220924_UNLV@UTAHST,Utah St.,Aggies,UNLV,Rebels,1-3,3-1,0,16,27,24,34,7,9,0,8,14,13,7,0,-2,-11,-7,-11,-10,0.7941961225358682,13.82978129931962,0.5968086645374866,3.620265050638295
3946,2022,4,NCAAF_20220924_USM@TULANE,Tulane,Green Wave,So. Miss,Golden Eagles,4-1,2-2,0,17,10,24,27,7,10,0,7,0,10,7,10,2,7,7,7,-3,0.7423586926391379,10.959060166221889,0.8775170806749963,17.173534603072426
3947,2022,4,NCAAF_20220924_CHARLO@SC,South Carolina,Gamecocks,Charlotte,49ers,2-2,1-4,1,20,14,56,20,3,17,22,14,7,7,0,6,1,6,-4,6,36,0.9173974402463322,23.375230995928177,0.9644981615295007,26.668087047380823
3948,2022,4,NCAAF_20220924_FAU@PURDUE,Purdue,Boilermakers,FAU,Owls,2-2,2-3,1,14,13,28,26,7,7,7,7,0,13,7,6,0,1,7,1,2,0.7938184119442984,13.807453829753968,0.9516388483130136,24.53372840380257
3949,2022,4,NCAAF_20220924_MIAOH@NWEST,Northwestern,Wildcats,Miami-OH,RedHawks,1-3,2-2,0,7,7,14,17,7,0,0,7,0,7,0,10,-1,0,7,0,-3,0.7947417102018159,13.862075398826164,0.37651409233662037,-4.647632513122858
3950,2022,4,NCAAF_20220924_NMEX@LSU,LSU,Tigers,New Mexico,Lobos,3-1,2-2,0,17,0,38,0,10,7,14,7,0,0,0,0,1,17,10,17,38,0.9785243816960215,34.09465881705637,0.9896468824398726,34.16938168393142
3951,2022,4,NCAAF_20220924_UCONN@NCST,NC State,Wolfpack,UConn,Huskies,4-0,1-4,1,31,3,41,10,17,14,7,3,0,3,0,7,3,28,17,28,31,0.975414091581254,33.13313817499284,0.9981896147424848,42.97489594720355
3952,2022,4,NCAAF_20220924_VANDY@BAMA,Alabama,Crimson Tide,Vanderbilt,Commodores,5-0,3-2,1,31,3,55,3,14,17,10,14,3,0,0,0,2,28,11,28,52,0.9930177395789147,41.40465219744124,0.9975755311170157,41.60802757494986
3953,2022,4,NCAAF_20220924_WISC@OHIOST,Ohio State,Buckeyes,Wisconsin,Badgers,4-0,2-2,1,31,7,52,21,21,10,14,7,0,7,0,14,2,24,21,24,31,0.7589115663587644,11.837817536574448,0.8537856430159991,15.550876857711842
3954,2022,4,NCAAF_20220924_BC@FSU,Florida State,Seminoles,Boston College,Eagles,4-0,1-3,0,31,0,44,14,21,10,6,7,0,0,7,7,3,31,21,31,30,0.47202095963315305,-1.1822671684237775,0.8171399929891153,13.360520299200743
3955,2022,4,NCAAF_20220924_HAWAII@NMEXST,New Mexico St.,Aggies,Hawaii,Rainbow Warriors,1-5,1-4,0,35,10,45,26,14,21,7,3,7,3,7,9,0,25,7,25,19,0.2889290854452925,-9.373764345127256,0.2809513486668427,-8.567353367933833
3956,2022,4,NCAAF_20220924_KSTATE@OKLA,Oklahoma,Sooners,Kansas State,Wildcats,3-1,3-1,0,17,24,34,41,7,10,3,14,14,10,3,14,0,-7,-7,-7,-7,0.8092712724483286,14.74180510146698,0.6945176950843905,7.513886770423937
3957,2022,4,NCAAF_20220924_UL@LAMON,UL-Monroe,Warhawks,Louisiana,Ragin' Cajuns,2-2,2-2,1,7,17,21,17,7,0,0,14,14,3,0,0,0,-10,-7,-10,4,0.15253434441085822,-17.275264638907174,0.0834485203434967,-20.416905177428873
3958,2022,4,NCAAF_20220924_USC@OREGST,Oregon State,Beavers,USC,Trojans,3-1,4-0,0,7,3,14,17,0,7,0,7,0,3,0,14,-1,4,0,4,-3,0.22822418422754254,-12.54360315121994,0.670512665119895,6.518807262552059
3959,2022,4,NCAAF_20220924_WYO@BYU,BYU,Cougars,Wyoming,Cowboys,3-1,3-2,1,14,10,38,24,7,7,14,10,3,7,0,14,0,4,4,4,14,0.6842094160865336,8.076576170808039,0.9236055118759086,21.118611098164024
3960,2022,4,NCAAF_20220924_STNFRD@WASH,Washington,Huskies,Stanford,Cardinal,4-0,1-2,0,17,7,40,22,7,10,13,10,0,7,0,15,3,10,7,10,18,0.7088204991774952,9.263038203325777,,
3961,2022,4,NCAAF_20220924_UTAH@ARIZST,Arizona St.,Sun Devils,Utah,Utes,1-3,3-1,0,6,24,13,34,0,6,0,7,14,10,7,3,-2,-18,-14,-18,-21,0.29032900263126216,-9.304837571783992,0.19616225893371753,-12.635123485994768
3962,2022,4,NCAAF_20220924_WMICH@SJST,San Jose St.,Spartans,W. Michigan,Broncos,2-1,1-3,1,17,0,34,6,3,14,7,10,0,0,6,0,1,17,3,17,28,0.30219601437863164,-8.726613506625654,,
3963,2022,4,NCAAF_20220923_UVA@CUSE,Syracuse,Orange,Virginia,Cavaliers,4-0,2-2,1,16,0,22,20,10,6,3,3,0,0,13,7,2,16,10,16,2,0.4250155788593841,-3.1847762878521735,0.6149923164234936,4.318328459566715
3964,2022,4,NCAAF_20220923_NEVADA@AF,Air Force,,Nevada,,4-1,2-3,,24,7,48,20,10,14,17,7,0,7,0,13,2,17,10,17,28,0.6966115397105929,8.669086901860283,,
3965,2022,4,NCAAF_20220923_BOISE@UTEP,UTEP,Miners,Boise St.,Broncos,2-3,2-2,1,10,3,27,10,0,10,10,7,3,0,7,0,0,7,-3,7,17,0.02748219005743957,-32.32563388970311,0.1358674982915865,-16.234282660617396
3966,2022,4,NCAAF_20220922_CSTCAR@GAST,Georgia St.,Panthers,C. Carolina,Chanticleers,0-4,4-0,0,17,27,24,41,7,10,0,7,21,6,7,7,-4,-10,-14,-10,-17,0.3692274742009599,-5.624098667099361,0.23764474557528792,-10.54489759554366
3967,2022,4,NCAAF_20220922_WVU@VATECH,Virginia Tech,Hokies,West Virginia,Mountaineers,2-2,2-2,0,7,13,10,33,0,7,3,0,3,10,3,17,0,-6,-3,-6,-23,0.41747331562176127,-3.5095714487069927,0.24324919114966415,-10.278870314228243
3968,2022,4,NCAAF_20220922_TNCHAT@ILL,Illinois,Fighting Illini,Chattanooga,Mocs,3-1,3-1,0,24,0,31,0,10,14,7,0,0,0,0,0,0,24,10,24,31,0.8654678789803175,18.615947786662673,,
3969,2022,5,NCAAF_20221002_EWASH@FLA,Florida,Gators,E. Washington,Eagles,3-2,1-3,0,35,3,52,17,14,21,10,7,3,0,0,14,2,32,11,32,35,0.9968510314617874,46.15143793965967,,
3970,2022,5,NCAAF_20221001_GAST@ARMY,Army,Black Knights,Georgia St.,Panthers,1-3,1-4,0,0,17,14,31,0,0,7,7,3,14,0,14,0,-17,-3,-17,-17,0.7850417374438563,13.334880000149724,,
3971,2022,5,NCAAF_20221001_ILL@WISC,Wisconsin,Badgers,Illinois,Fighting Illini,2-3,4-1,1,10,14,10,34,7,3,0,0,7,7,17,3,-2,-4,0,-4,-24,0.9113585911351301,22.792619981523785,,
3972,2022,5,NCAAF_20221001_LVILLE@BC,Boston College,Eagles,Louisville,Cardinals,2-3,2-3,0,21,23,34,33,7,14,7,6,7,16,10,0,0,-2,0,-2,1,0.49803744849129516,-0.08310760638278225,0.15696047574991523,-14.749074925029618
3973,2022,5,NCAAF_20221001_MICH@IOWA,Iowa,Hawkeyes,Michigan,Wolverines,3-2,5-0,0,0,13,14,27,0,0,0,14,7,6,7,7,-2,-13,-7,-13,-13,0.36613561838125586,-5.779476767325377,0.16092032552623792,-14.509665033893953
3974,2022,5,NCAAF_20221001_NAVY@AF,Air Force,Falcons,Navy,Midshipmen,4-1,1-3,1,10,3,13,10,10,0,0,3,0,3,0,7,3,7,10,7,3,0.6328388829792135,5.733454784116475,,
3975,2022,5,NCAAF_20221001_OKLA@TCU,TCU,Horned Frogs,Oklahoma,Sooners,4-0,3-2,0,41,17,55,24,27,14,14,0,10,7,0,7,1,24,17,24,31,0.22572352330985412,-12.72113181158079,0.11762770176507709,-17.38392559826832
3976,2022,5,NCAAF_20221001_PURDUE@MINN,Minnesota,Golden Gophers,Purdue,Boilermakers,4-1,4-2,1,3,10,10,20,0,3,7,0,10,0,0,10,0,-7,-10,-7,-10,0.5410105396324695,1.739724603442255,0.6723844555901003,6.539599250999686
3977,2022,5,NCAAF_20221001_TEMPLE@MEMP,Memphis,Tigers,Temple,Owls,4-2,2-3,1,0,3,24,3,0,0,7,17,0,3,0,0,2,-3,0,-3,21,0.8010663207864621,14.28265174997614,0.9494041992412388,24.006531494605497
3978,2022,5,NCAAF_20221001_TXTECH@KSTATE,Kansas State,Wildcats,Texas Tech,Red Raiders,4-1,3-2,1,13,10,37,28,13,0,7,17,0,10,10,8,1,3,13,3,9,0.5947249920304434,4.0497294938734285,,
3979,2022,5,NCAAF_20221001_UK@MISS,Ole Miss,Rebels,Kentucky,Wildcats,5-0,4-1,1,19,12,22,19,14,5,3,0,6,6,7,0,1,7,8,7,3,0.48505146761998263,-0.6331668666280166,0.46439208910364926,-1.3089926411249735
3980,2022,5,NCAAF_20221001_TXSTSM@JMAD,James Madison,Dukes,Texas St.,Bobcats,4-0,2-3,0,19,0,40,13,7,12,7,14,0,0,7,6,2,19,7,19,27,0.9794315458103163,34.499684104845755,,
3981,2022,5,NCAAF_20221001_OREGST@UTAH,Utah,Utes,Oregon State,Beavers,4-1,3-2,0,21,13,42,16,14,7,14,7,7,6,3,0,1,8,7,8,26,0.8687705110265913,18.931189495323224,0.8123190243097685,12.983419720073925
3982,2022,5,NCAAF_20221001_UMASS@EMICH,E. Michigan,Eagles,UMass,Minutemen,3-2,1-4,1,0,10,20,13,0,0,14,6,7,3,3,0,2,-10,-7,-10,7,0.8957480612853224,21.247196986575545,0.9777899106791823,29.440246524707163
3983,2022,5,NCAAF_20221001_ECU@SFLA,South Florida,Bulls,East Carolina,Pirates,1-4,3-2,0,7,41,28,48,0,7,14,7,14,27,7,0,-2,-34,-14,-34,-20,0.5554631952268547,2.356292087043812,,
3984,2022,5,NCAAF_20221001_BAMA@ARK,Arkansas,Razorbacks,Alabama,Crimson Tide,3-2,5-0,0,7,28,26,49,0,7,16,3,14,14,0,21,-2,-21,-14,-21,-23,0.019442959663974135,-34.8923746741018,0.061629869641449786,-22.57312102255571
3985,2022,5,NCAAF_20221001_BGREEN@AKRON,Akron,Zips,Bowling Green,Falcons,1-4,2-3,0,14,24,28,31,7,7,7,7,10,14,0,7,-1,-10,-3,-10,-3,0.5172514710530658,0.7307679839893808,,
3986,2022,5,NCAAF_20221001_CIT@APLST,App. St.,Mountaineers,The Citadel,Bulldogs,3-2,1-3,1,35,0,49,0,14,21,7,7,0,0,0,0,2,35,14,35,49,0.9433091024450773,26.74586771139684,,
3987,2022,5,NCAAF_20221001_CMICH@TOLEDO,Toledo,Rockets,C. Michigan,Chippewas,3-2,1-4,0,31,3,38,17,3,28,0,7,3,0,8,6,2,28,0,28,21,0.6062338562113705,4.553164035988857,0.40644817813736234,-3.4666103712301037
3988,2022,5,NCAAF_20221001_FRESNO@UCONN,UConn,Huskies,Fresno St.,Bulldogs,2-4,1-3,1,6,7,19,14,3,3,6,7,0,7,7,0,1,-1,3,-1,5,0.04611680174436783,-28.444664626141503,,
3989,2022,5,NCAAF_20221001_GRDWB@MRSHL,Marshall,Thundering Herd,Gardner-Webb,Runnin' Bulldogs,3-2,2-4,1,14,7,28,7,7,7,7,7,7,0,0,0,1,7,0,7,21,0.9822536061475413,35.52249681194735,,
3990,2022,5,NCAAF_20221001_IOWAST@KANSAS,Kansas,Jayhawks,Iowa St.,Cyclones,5-0,3-2,0,14,8,14,11,0,14,0,0,0,8,3,0,2,6,0,6,3,0.053355144057319115,-27.25240306370756,,
3991,2022,5,NCAAF_20221001_MIAOH@BUFF,Buffalo,Bulls,Miami-OH,RedHawks,2-3,2-3,0,14,10,24,20,7,7,3,7,7,3,10,0,0,4,0,4,4,0.5689095418817289,2.932744939669192,0.2105931261854761,-11.780833823174362
3992,2022,5,NCAAF_20221001_MICHST@MD,Maryland,Terrapins,Michigan St.,Spartans,4-1,2-3,1,21,13,27,13,14,7,3,3,7,6,0,0,2,8,7,8,14,0.30199661859041205,-8.762263922913007,0.2629860591064669,-9.288086566833726
3993,2022,5,NCAAF_20221001_NWEST@PSU,Penn State,Nittany Lions,Northwestern,Wildcats,5-0,1-5,0,14,0,17,7,7,7,0,3,0,0,7,0,4,14,7,14,10,0.878311993925329,19.708167625100486,0.9751606064723092,28.74624497638979
3994,2022,5,NCAAF_20221001_OKLAST@BAYLOR,Baylor,Bears,Oklahoma State,Cowboys,3-2,5-0,1,3,16,25,36,3,0,22,0,7,9,17,3,-2,-13,-4,-13,-11,0.33567002505238186,-7.168212418041776,0.3537361832798537,-5.496003513659957
3995,2022,5,NCAAF_20221001_RUT@OHIOST,Ohio State,Buckeyes,Rutgers,Scarlet Knights,5-0,3-2,0,28,7,49,10,14,14,14,7,7,0,3,0,2,21,7,21,39,0.9890100678285623,38.69895243733254,0.9987409012266586,44.24810189126572
3996,2022,5,NCAAF_20221001_VATECH@UNC,North Carolina,Tar Heels,Virginia Tech,Hokies,4-1,2-3,1,24,10,41,10,7,17,17,0,3,7,0,0,2,14,4,14,31,0.46977311810752476,-1.2812311014877196,0.7360109908431643,9.243108646555697
3997,2022,5,NCAAF_20221001_WAKE@FSU,Florida State,Seminoles,Wake Forest,Demon Deacons,4-1,4-1,1,7,21,21,31,7,0,6,8,7,14,7,3,0,-14,0,-14,-10,0.4226175718097698,-3.2977015539968306,0.5363714965370647,1.3371403267925643
3998,2022,5,NCAAF_20221001_FAU@NTEXAS,North Texas,Mean Green,FAU,Owls,3-3,2-4,0,28,21,45,28,7,21,14,3,7,14,0,7,1,7,0,7,17,0.3043115608757505,-8.650312241689335,0.5060389365714871,0.2217123550275346
3999,2022,5,NCAAF_20221001_TXAM@MISSST,Miss. State,Bulldogs,Texas A&M,Aggies,4-1,3-2,1,14,0,42,24,0,14,7,21,0,0,10,14,1,14,0,14,18,0.47420775570984075,-1.0929743642843732,0.3926290175036782,-3.990681158733878
4000,2022,5,NCAAF_20221001_SALA@UL,Louisiana,Ragin' Cajuns,South Alabama,Jaguars,2-3,4-1,0,7,7,17,20,7,0,0,10,0,7,3,10,-2,0,7,0,-3,0.8008099370121465,14.267136863213182,0.6804719589895223,6.869313034098809
4001,2022,5,NCAAF_20221001_WAG@CUSE,Syracuse,Orange,Wagner,Seahawks,5-0,0-5,1,49,0,59,0,21,28,7,3,0,0,0,0,5,49,21,49,59,0.9978434849150811,48.220232315360136,,
4002,2022,5,NCAAF_20221001_CAL@WASHST,Washington St.,Cougars,California,Golden Bears,4-2,3-2,0,7,3,28,9,0,7,7,14,0,3,0,6,1,4,0,4,19,0.6333443747024626,5.7561347329494765,0.6735701809561615,6.587728448608345
4003,2022,5,NCAAF_20221001_LIB@ODU,Old Dominion,Monarchs,Liberty,Flames,2-3,5-1,1,17,21,24,38,14,3,7,0,14,7,10,7,-3,-4,0,-4,-14,0.24621048974151916,-11.596992285237548,0.30921474645404756,-7.2949066308046895
4004,2022,5,NCAAF_20221001_NH@WMICH,W. Michigan,Broncos,New Hamp.,Wildcats,2-3,3-2,1,28,7,44,7,21,7,3,13,0,7,0,0,-1,21,21,21,37,0.9302635609936644,24.964967133480968,,
4005,2022,5,NCAAF_20221001_UTEP@CHARLO,Charlotte,49ers,UTEP,Miners,1-5,3-4,1,7,24,35,41,7,0,14,14,7,17,10,7,-2,-17,0,-17,-6,0.6041543937829215,4.461914979447101,0.16222762092138088,-14.431473597720583
4006,2022,5,NCAAF_20221001_CINCY@TULSA,Tulsa,Golden Hurricane,Cincinnati,Bearcats,2-3,4-1,0,14,24,21,31,7,7,7,0,14,10,7,0,-2,-10,-7,-10,-10,0.21519033517757835,-13.321464738156465,,
4007,2022,5,NCAAF_20221001_GAS@CSTCAR,C. Carolina,Chanticleers,Ga. Southern,Eagles,5-0,3-2,0,7,7,34,30,7,0,7,20,0,7,10,13,2,0,7,0,4,0.5954151354131763,4.079812993733867,0.8655857559921725,16.195170608662124
4008,2022,5,NCAAF_20221001_LAMON@ARKST,Arkansas St.,Red Wolves,UL-Monroe,Warhawks,2-3,2-3,1,24,14,45,28,10,14,14,7,7,7,7,7,0,10,3,10,17,0.724459366424661,10.071096662138643,0.48621700211802243,-0.5061077112920884
4009,2022,5,NCAAF_20221001_LSU@AUBURN,Auburn,Tigers,LSU,Tigers,3-2,4-1,1,17,14,17,21,7,10,0,0,0,14,7,0,-1,3,7,3,-4,0.52637334183469,1.117634562577905,,
4010,2022,5,NCAAF_20221001_TROY@WKY,W. Kentucky,Hilltoppers,Troy,Trojans,3-2,3-2,1,17,13,27,34,7,10,3,7,10,3,7,14,0,4,-3,4,-7,0.5184386074840726,0.7810894774802364,0.8722515462510629,16.654100402404765
4011,2022,5,NCAAF_20221001_IND@NEB,Nebraska,Cornhuskers,Indiana,Hoosiers,2-3,3-2,0,21,21,35,21,7,14,0,14,0,21,0,0,-1,0,7,0,14,0.5057940082349394,0.24536484299210315,0.8586934487670097,15.736794764518322
4012,2022,5,NCAAF_20221001_NCST@CLEM,Clemson,Tigers,NC State,Wolfpack,5-0,4-1,1,13,10,30,20,3,10,7,10,3,7,3,7,1,3,0,3,10,0.888120080526256,20.552878345098406,0.510708772601145,0.3931920256560488
4013,2022,5,NCAAF_20221001_SJST@WYO,Wyoming,Cowboys,San Jose St.,Spartans,3-3,3-1,0,10,19,16,33,3,7,6,0,2,17,7,7,0,-9,1,-9,-17,0.7249260342334826,10.094711091982617,,
4014,2022,5,NCAAF_20221001_UAB@RICE,Rice,Owls,UAB,Blazers,3-2,3-2,1,7,17,28,24,7,0,14,7,7,10,7,0,0,-10,0,-10,4,0.17937820589138853,-15.504094627457789,,
4015,2022,5,NCAAF_20221001_UGA@MIZZOU,Missouri,Tigers,Georgia,Bulldogs,2-3,5-0,0,16,6,22,26,3,13,3,3,0,6,6,14,-3,10,3,10,-4,0.1109428021342822,-20.636307139233395,,
4016,2022,5,NCAAF_20221001_UVA@DUKE,Duke,Blue Devils,Virginia,Cavaliers,4-1,2-3,1,21,7,38,17,14,7,7,10,0,7,3,7,2,14,14,14,21,0.33404137775189446,-7.243748288949291,0.07249356430182075,-21.34627267780786
4017,2022,5,NCAAF_20221001_WVU@TEXAS,Texas,Longhorns,West Virginia,Mountaineers,4-2,2-3,0,28,7,38,20,14,14,7,3,0,7,0,13,2,21,14,21,18,0.6296648038693367,5.591277089736195,,
4018,2022,5,NCAAF_20221001_FIU@NMEXST,New Mexico St.,Aggies,FIU,Panthers,1-5,2-3,0,7,21,7,21,0,7,0,0,7,14,0,0,-1,-14,-7,-14,-14,0.4071233761676152,-3.969221657292792,,
4019,2022,5,NCAAF_20221001_GATECH@PITT,Pittsburgh,Panthers,Georgia Tech,Yellow Jackets,3-2,2-3,0,7,6,21,26,0,7,0,14,3,3,3,17,1,1,-3,1,-5,0.7138299881001265,9.538399380332066,0.9814027251029401,30.51700251078887
4020,2022,5,NCAAF_20221001_COLO@ARIZ,Arizona,Wildcats,Colorado,Buffaloes,3-3,0-5,1,26,13,43,20,13,13,10,7,7,6,7,0,3,13,6,13,23,0.49034151283336547,-0.40904350223513575,0.5856425657737577,3.168691678226992
4021,2022,5,NCAAF_20221001_ARIZST@USC,USC,Trojans,Arizona St.,Sun Devils,5-0,1-4,1,21,17,42,25,14,7,7,14,7,10,0,8,4,4,7,4,17,0.5677919857678488,2.884713593816059,0.46477857443355597,-1.2947476697521552
4022,2022,5,NCAAF_20221001_STNFRD@OREG,Oregon,Ducks,Stanford,Cardinal,4-1,1-3,0,31,3,45,27,10,21,7,7,0,3,14,10,3,28,10,28,18,0.705337162942675,9.119515056879663,,
4023,2022,5,NCAAF_20220930_TXSA@MTSU,Middle Tenn.,Blue Raiders,UTSA,Roadrunners,3-2,3-2,1,20,31,30,45,0,20,0,10,10,21,7,7,0,-11,-10,-11,-15,0.5787820733430827,3.358132939235702,0.32410562982647995,-6.682275847598817
4024,2022,5,NCAAF_20220930_SDGST@BOISE,Boise St.,Broncos,San Diego St.,Aztecs,3-2,2-3,1,0,13,35,13,0,0,21,14,6,7,0,0,1,-13,-6,-13,22,0.6529529238245653,6.644428029252822,0.6162246935830633,4.329107851059348
4025,2022,5,NCAAF_20220930_WASH@UCLA,UCLA,Bruins,Washington,Huskies,5-0,4-1,0,26,10,40,32,9,17,14,0,7,3,6,16,1,16,2,16,8,0.28212920850479273,-9.739762202309294,0.7162215163600709,8.372507037038872
4026,2022,5,NCAAF_20220930_NMEX@UNLV,UNLV,Rebels,New Mexico,Lobos,4-1,2-3,0,9,17,31,20,0,9,8,14,14,3,0,3,2,-8,-14,-8,11,0.5649581008143096,2.7630198467923037,0.8072458629022914,12.709793362861546
4027,2022,5,NCAAF_20220929_SCST@SC,South Carolina,Gamecocks,SC State,Bulldogs,3-2,1-3,1,22,0,50,10,8,14,14,14,0,0,7,3,2,22,8,22,40,0.9825990043143319,35.657036021329986,,
4028,2022,5,NCAAF_20220929_UTAHST@BYU,BYU,Cougars,Utah St.,Aggies,4-1,1-4,0,17,17,38,26,14,3,14,7,7,10,3,6,3,0,7,0,12,0.6268039398760479,5.4634680926833425,0.798429918793788,12.244549049949228
4029,2022,6,NCAAF_20221008_ARK@MISSST,Miss. State,Bulldogs,Arkansas,Razorbacks,5-1,3-3,1,21,10,40,17,14,7,13,6,0,10,7,0,2,11,14,11,23,0.7743316394619638,12.724426967657791,0.48122301426424274,-0.6988804435136444
4030,2022,6,NCAAF_20221008_BUFF@BGREEN,Bowling Green,Falcons,Buffalo,Bulls,2-4,3-3,0,0,31,7,38,0,0,7,0,17,14,7,0,-1,-31,-17,-31,-31,0.11432735273855532,-20.33762950379878,,
4031,2022,6,NCAAF_20221008_EMICH@WMICH,W. Michigan,Broncos,E. Michigan,Eagles,2-4,4-2,0,7,35,23,45,0,7,9,7,14,21,7,3,-2,-28,-14,-28,-22,0.5461189756465276,1.9573793337594907,0.49838813150745365,-0.059971837580178544
4032,2022,6,NCAAF_20221008_LVILLE@UVA,Virginia,Cavaliers,Louisville,Cardinals,2-4,3-3,0,10,13,17,34,10,0,7,0,0,13,14,7,-1,-3,10,-3,-17,0.49792519662402257,-0.087862480558897,0.2515246111237204,-9.940466353956708
4033,2022,6,NCAAF_20221008_MICH@IND,Indiana,Hoosiers,Michigan,Wolverines,3-3,6-0,0,10,10,10,31,7,3,0,0,10,0,7,14,-3,0,-3,0,-21,0.12884611381708866,-19.121779723504233,0.01604609344408703,-31.812777920079725
4034,2022,6,NCAAF_20221008_MIZZOU@FLA,Florida,Gators,Missouri,Tigers,4-3,2-4,0,10,10,24,17,10,0,7,7,0,10,0,7,2,0,10,0,7,0.6506389870307068,6.538790144117229,,
4035,2022,6,NCAAF_20221008_PURDUE@MD,Maryland,Terrapins,Purdue,Boilermakers,4-2,4-2,0,17,17,29,31,7,10,0,12,3,14,0,14,0,0,4,0,-2,0.2805403785962959,-9.819465510889813,0.2647175417434816,-9.334402972805947
4036,2022,6,NCAAF_20221008_TCU@KANSAS,Kansas,Jayhawks,TCU,Horned Frogs,5-1,5-0,0,3,10,31,38,0,3,21,7,3,7,21,7,0,-7,-3,-7,-7,0.09964538940939094,-21.684818806843623,,
4037,2022,6,NCAAF_20221008_TENN@LSU,LSU,Tigers,Tennessee,Volunteers,4-2,5-0,0,7,23,13,40,0,7,0,6,13,10,14,3,-1,-16,-13,-16,-27,0.7549546347010324,11.659696705334909,,
4038,2022,6,NCAAF_20221008_TEXAS@OKLA,Oklahoma,Sooners,Texas,Longhorns,3-3,4-2,0,0,28,0,49,0,0,0,0,7,21,14,7,-1,-28,-7,-28,-49,0.674397367041448,7.6376197304684865,,
4039,2022,6,NCAAF_20221008_AKRON@OHIO,Ohio,Bobcats,Akron,Zips,3-3,1-5,1,28,13,55,34,14,14,20,7,0,13,7,14,2,15,14,15,21,0.8754049120820426,19.467366041379137,0.8499019017156983,15.37771233319927
4040,2022,6,NCAAF_20221008_GAS@GAST,Georgia St.,Panthers,Ga. Southern,Eagles,2-4,4-3,0,27,17,41,33,13,14,7,7,7,10,13,3,-2,10,6,10,8,0.4668679735076934,-1.4046648554128751,0.728364784072414,9.022790272932752
4041,2022,6,NCAAF_20221008_SFLA@CINCY,Cincinnati,Bearcats,South Florida,Bulls,5-1,1-6,0,14,17,28,24,7,7,7,7,10,7,0,7,4,-3,-3,-3,4,0.8617261063009601,18.382573226437216,0.9753765564306104,29.188319648554398
4042,2022,6,NCAAF_20221008_AUBURN@UGA,Georgia,Bulldogs,Auburn,Tigers,6-0,3-3,0,14,0,42,10,0,14,7,21,0,0,3,7,3,14,0,14,32,0.7206687944228114,9.880156962262845,,
4043,2022,6,NCAAF_20221008_BALLST@CMICH,C. Michigan,Chippewas,Ball St.,Cardinals,1-5,3-3,0,10,7,16,17,10,0,6,0,0,7,7,3,-2,3,10,3,-1,0.6428230210658561,6.183486069244964,0.7595328179507075,10.461473773516673
4044,2022,6,NCAAF_20221008_ECU@TULANE,Tulane,Green Wave,East Carolina,Pirates,5-1,3-3,0,14,9,24,9,0,14,7,3,3,6,0,0,2,5,-3,5,15,0.718959313204019,9.794390840250799,,
4045,2022,6,NCAAF_20221008_KENTST@MIAOH,Miami-OH,RedHawks,Kent St.,Golden Flashes,3-3,2-4,1,17,7,27,24,17,0,10,0,0,7,7,10,1,10,17,10,3,0.6854079150711775,8.157738010577077,0.6130120460751474,4.262633986460969
4046,2022,6,NCAAF_20221008_LIB@UMASS,UMass,Minutemen,Liberty,Flames,1-5,5-1,1,10,21,24,42,7,3,0,14,0,21,14,7,-4,-11,7,-11,-18,0.07905345031227395,-23.845443949515357,0.006455406730407565,-36.90338334794501
4047,2022,6,NCAAF_20221008_MTSU@UAB,UAB,Blazers,Middle Tenn.,Blue Raiders,3-2,3-3,1,38,7,41,14,21,17,3,0,7,0,7,0,0,31,14,31,27,0.588303239297271,3.7704625835572187,0.640369799762706,5.3353389294366025
4048,2022,6,NCAAF_20221008_TOLEDO@NILL,N. Illinois,Huskies,Toledo,Rockets,1-5,4-2,0,7,35,32,52,7,0,0,25,21,14,10,7,-3,-28,-14,-28,-20,0.3758545451148205,-5.345061385183499,0.3639588881231196,-5.163889287640586
4049,2022,6,NCAAF_20221008_TULSA@NAVY,Navy,Midshipmen,Tulsa,Golden Hurricane,2-4,2-4,0,36,14,53,21,10,26,10,7,7,7,0,7,0,22,3,22,32,0.5223106010578815,0.9452841907370839,,
4050,2022,6,NCAAF_20221008_TXTECH@OKLAST,Oklahoma State,Cowboys,Texas Tech,Red Raiders,5-1,3-3,0,20,24,41,31,17,3,14,7,14,10,7,0,2,-4,3,-4,10,0.7299386686333763,10.349780001979525,,
4051,2022,6,NCAAF_20221008_UTAH@UCLA,UCLA,Bruins,Utah,Utes,6-0,5-2,0,14,10,42,32,7,7,14,14,0,10,8,14,1,4,7,4,10,0.2475759858331602,-11.524088543694006,0.3041431629337993,-7.60743799728948
4052,2022,6,NCAAF_20221008_VATECH@PITT,Pittsburgh,Panthers,Virginia Tech,Hokies,4-2,2-5,0,17,16,45,29,7,10,14,14,6,10,7,6,2,1,1,1,16,0.5465743855775579,1.976795837947293,0.8391422020869553,14.708668165377048
4053,2022,6,NCAAF_20221008_WISC@NWEST,Northwestern,Wildcats,Wisconsin,Badgers,1-5,3-4,0,0,28,7,42,0,0,0,7,7,21,0,14,-2,-28,-7,-28,-35,0.17197607415978278,-15.988310171932653,0.060556767732288797,-23.008642580517062
4054,2022,6,NCAAF_20221008_MISS@VANDY,Vanderbilt,Commodores,Ole Miss,Rebels,3-3,6-0,0,20,17,28,52,3,17,0,8,3,14,21,14,-3,3,0,3,-24,0.17717069304011424,-15.647321299240275,0.062329915284677795,-22.791760275189972
4055,2022,6,NCAAF_20221008_OHIOST@MICHST,Michigan St.,Spartans,Ohio State,Buckeyes,3-4,6-0,1,13,35,20,49,7,6,0,7,14,21,14,0,-3,-22,-7,-22,-29,0.07146232167716027,-24.74960083093947,0.02295148032246286,-29.631188828403765
4056,2022,6,NCAAF_20221008_UNC@MIAMI,Miami (Fla.),Hurricanes,North Carolina,Tar Heels,2-3,5-1,1,17,21,24,27,0,17,0,7,7,14,3,3,-3,-4,-7,-4,-3,0.608077584219831,4.634250382908476,0.3960906231899549,-3.9108664451916866
4057,2022,6,NCAAF_20221008_WASH@ARIZST,Arizona St.,Sun Devils,Washington,Huskies,2-4,5-2,0,24,17,45,38,3,21,14,7,7,10,14,7,-3,7,-4,7,7,0.32610727813713325,-7.613957551490103,0.5093258789427082,0.3470131255412525
4058,2022,6,NCAAF_20221008_WKY@TXSA,UTSA,Roadrunners,W. Kentucky,Hilltoppers,4-2,3-3,1,17,14,31,28,7,10,7,7,7,7,0,14,1,3,0,3,3,0.39001562126211997,-4.718151109781047,0.37098641819374856,-4.88699355342078
4059,2022,6,NCAAF_20221008_AF@UTAHST,Utah St.,Aggies,Air Force,Falcons,2-4,4-2,0,13,14,34,27,10,3,7,14,7,7,3,10,-2,-1,3,-1,7,0.40167448196619127,-4.20688475223983,,
4060,2022,6,NCAAF_20221008_APLST@TXSTSM,Texas St.,Bobcats,App. St.,Mountaineers,3-4,3-3,1,24,3,36,24,7,17,9,3,0,3,7,14,0,21,7,21,12,0.06012296464403,-26.249049141294563,0.04436773899026247,-25.264648822593244
4061,2022,6,NCAAF_20221008_JMAD@ARKST,Arkansas St.,Red Wolves,James Madison,Dukes,2-4,5-0,0,3,14,20,42,0,3,10,7,0,14,7,21,-3,-11,0,-11,-22,0.10758726288281706,-20.939570523377824,,
4062,2022,6,NCAAF_20221008_UCONN@FIU,FIU,Panthers,UConn,Huskies,2-3,3-4,1,0,20,12,33,0,0,10,2,7,13,6,7,-1,-20,-7,-20,-21,0.6835145354174205,8.067759732484546,,
4063,2022,6,NCAAF_20221008_USM@TROY,Troy,Trojans,So. Miss,Golden Eagles,4-2,2-3,0,10,7,27,10,3,7,7,10,0,7,3,0,2,3,3,3,17,0.5993317644733799,4.250852591370858,,
4064,2022,6,NCAAF_20221008_UTEP@LATECH,Louisiana Tech,Bulldogs,UTEP,Miners,2-4,3-4,1,30,10,41,31,20,10,0,11,3,7,0,21,-1,20,17,20,10,0.7775749178195288,12.907563536234875,0.3042058382657309,-7.604778907135142
4065,2022,6,NCAAF_20221008_WYO@NMEX,New Mexico,Lobos,Wyoming,Cowboys,2-5,4-3,1,14,7,14,27,14,0,0,0,0,7,10,10,-2,7,14,7,-13,0.22867741678175602,-12.555843475924803,0.3105562925922233,-7.336594637413782
4066,2022,6,NCAAF_20221008_ARMY@WAKE,Wake Forest,Demon Deacons,Army,Black Knights,5-1,2-4,0,21,0,45,10,14,7,17,7,0,0,0,10,3,21,14,21,35,0.655136456877756,6.744548009167374,,
4067,2022,6,NCAAF_20221008_BYU@ND,Notre Dame,Fighting Irish,BYU,Cougars,3-2,4-2,0,18,6,28,20,3,15,7,3,6,0,7,7,-1,12,-3,12,8,0.8324343452833964,16.2830190484417,0.8086231689626711,12.95561997454547
4068,2022,6,NCAAF_20221008_CLEM@BC,Boston College,Eagles,Clemson,Tigers,2-4,7-0,0,3,10,3,31,0,3,0,0,3,7,7,14,-5,-7,-3,-7,-28,0.07414688814629944,-24.42182447893174,0.05074669124347664,-24.308011395839685
4069,2022,6,NCAAF_20221008_IOWA@ILL,Illinois,Fighting Illini,Iowa,Hawkeyes,6-1,3-3,1,6,6,9,6,3,3,0,3,3,3,0,0,3,0,0,0,3,0.1229803739165296,-19.600790593311785,,
4070,2022,6,NCAAF_20221008_KSTATE@IOWAST,Iowa St.,Cyclones,Kansas State,Wildcats,3-4,5-1,1,6,7,9,10,3,3,3,0,7,0,0,3,-2,-1,-4,-1,-1,0.6519384951856397,6.5981413266035815,0.559710128957178,2.2299535550516794
4071,2022,6,NCAAF_20221008_SC@UK,Kentucky,Wildcats,South Carolina,Gamecocks,5-2,4-2,1,7,7,14,24,0,7,0,7,7,0,10,7,1,0,-7,0,-10,0.6074851020738016,4.6082039738739695,0.8224859579466478,13.728157252741084
4072,2022,6,NCAAF_20221008_WASHST@USC,USC,Trojans,Washington St.,Cougars,6-0,4-2,0,17,14,30,14,10,7,7,6,0,14,0,0,2,3,10,3,16,0.49747282024172523,-0.10701966703732069,0.3584502491248076,-5.38219691776294
4073,2022,6,NCAAF_20221008_CSTCAR@LAMON,UL-Monroe,Warhawks,C. Carolina,Chanticleers,2-4,6-0,0,14,28,21,28,7,7,7,0,14,14,0,0,-4,-14,-7,-14,-7,0.24326483692927547,-11.75556147427119,0.13651575173305242,-16.26971672003583
4074,2022,6,NCAAF_20221008_TXAM@BAMA,Alabama,Crimson Tide,Texas A&M,Aggies,6-1,3-3,0,17,14,24,20,0,17,7,0,0,14,3,3,3,3,0,3,4,0.8957199684074884,21.24489641844866,0.8991721775414767,18.95248211209514
4075,2022,6,NCAAF_20221008_FSU@NCST,NC State,Wolfpack,Florida State,Seminoles,5-1,4-2,0,3,17,19,17,3,0,10,6,0,17,0,0,1,-14,3,-14,2,0.6089412530657112,4.672238328638514,0.6514789297719383,5.778688453795894
4076,2022,6,NCAAF_20221008_OREG@ARIZ,Arizona,Wildcats,Oregon,Ducks,3-4,5-1,1,13,28,22,49,3,10,3,6,7,21,21,0,-2,-15,-4,-15,-27,0.16217388560687163,-16.65017725348025,0.15804873286654275,-14.880421533001481
4077,2022,6,NCAAF_20221008_FRESNO@BOISE,Boise St.,Broncos,Fresno St.,Bulldogs,4-2,2-4,0,20,17,40,20,7,13,7,13,7,10,3,0,2,3,0,3,20,0.6188358170939903,5.109187127319956,,
4078,2022,6,NCAAF_20221008_HAWAII@SDGST,San Diego St.,Aztecs,Hawaii,Rainbow Warriors,3-3,2-5,0,3,0,16,14,0,3,7,6,0,0,7,7,1,3,0,3,2,0.7798869692555235,13.039048018875974,0.814756871059559,13.292991530501695
4079,2022,6,NCAAF_20221008_OREGST@STNFRD,Stanford,Cardinal,Oregon State,Beavers,1-4,4-2,0,17,7,27,28,7,10,7,3,0,7,3,18,-3,10,7,10,-1,0.6708155047631423,7.469991348643589,0.11198908040859012,-18.049557037440536
4080,2022,6,NCAAF_20221007_NEB@RUT,Rutgers,Scarlet Knights,Nebraska,Cornhuskers,3-3,3-4,1,13,0,13,14,10,3,0,0,0,0,7,7,0,13,10,13,-1,0.24993702741214596,-11.398233850102542,0.18494470567494825,-13.309580747839618
4081,2022,6,NCAAF_20221007_HOU@MEMP,Memphis,Tigers,Houston,Cougars,4-3,3-3,0,17,7,32,33,14,3,3,12,0,7,0,26,1,10,14,10,-1,0.5745517382855232,3.1756593270335998,,
4082,2022,6,NCAAF_20221007_COLOST@NEVADA,Nevada,Wolf Pack,Colorado St.,Rams,2-4,1-4,0,7,14,14,17,0,7,0,7,14,0,0,3,1,-7,-14,-7,-3,0.5514811150557625,2.186166455191369,0.8125254378843544,13.169469231506355
4083,2022,6,NCAAF_20221007_UNLV@SJST,San Jose St.,Spartans,UNLV,Rebels,4-1,4-2,0,23,0,40,7,7,16,10,7,0,0,7,0,0,23,7,23,33,0.5050828018765648,0.215248180008075,,
4084,2022,6,NCAAF_20221005_SMU@UCF,UCF,Knights,SMU,Mustangs,4-1,2-3,0,10,13,41,19,3,7,14,17,7,6,0,6,2,-3,-4,-3,22,0.7132641401425461,9.510454826667,0.38342979831276214,-4.400779390423168
4085,2022,7,NCAAF_20221015_AUBURN@MISS,Ole Miss,Rebels,Auburn,Tigers,7-1,3-4,1,28,17,48,34,14,14,10,10,0,17,14,3,4,11,14,11,14,0.29438411304923007,-9.134885611631944,,
4086,2022,7,NCAAF_20221015_CMICH@AKRON,Akron,Zips,C. Michigan,Chippewas,1-6,2-5,1,7,14,21,28,7,0,7,7,7,7,7,7,-1,-7,0,-7,-7,0.16594338201799275,-16.395500970948433,0.02789005148878332,-28.570689879453084
4087,2022,7,NCAAF_20221015_COLG@ARMY,Army,Black Knights,Colgate,Raiders,2-4,1-5,0,28,17,42,17,14,14,14,0,10,7,0,0,1,11,4,11,25,0.9636238124538445,30.31964777669714,,
4088,2022,7,NCAAF_20221015_IOWAST@TEXAS,Texas,Longhorns,Iowa St.,Cyclones,5-3,3-4,0,14,7,24,21,0,14,3,7,7,0,7,7,2,7,-7,7,3,0.5057976726398667,0.24556609146225128,,
4089,2022,7,NCAAF_20221015_KANSAS@OKLA,Oklahoma,Sooners,Kansas,Jayhawks,4-3,5-3,1,35,21,52,42,14,21,14,3,14,7,7,14,-1,14,0,14,10,0.9711735433388728,32.07603622324086,0.8372344702374199,14.685362290944113
4090,2022,7,NCAAF_20221015_MIAOH@BGREEN,Bowling Green,Falcons,Miami-OH,RedHawks,3-4,3-4,0,7,10,17,13,0,7,3,7,3,7,3,0,0,-3,-3,-3,4,0.15133060746669935,-17.416464767518846,,
4091,2022,7,NCAAF_20221015_MINN@ILL,Illinois,Fighting Illini,Minnesota,Golden Gophers,6-1,4-3,1,13,7,26,14,7,6,7,6,0,7,7,0,2,6,7,6,12,0.2304927241246918,-12.456889791860931,,
4092,2022,7,NCAAF_20221015_ODU@CSTCAR,C. Carolina,Chanticleers,Old Dominion,Monarchs,6-1,3-4,0,7,14,21,49,0,7,7,7,7,7,21,14,3,-7,-7,-7,-28,0.731447185584404,10.428753496523086,0.7460711278294431,9.890920824235991
4093,2022,7,NCAAF_20221015_PSU@MICH,Michigan,Wolverines,Penn State,Nittany Lions,7-0,6-1,1,16,14,41,17,6,10,15,10,0,14,3,0,1,2,6,2,24,0.5234385822764447,0.9933009197229694,,
4094,2022,7,NCAAF_20221015_MIAMI@VATECH,Virginia Tech,Hokies,Miami (Fla.),Hurricanes,2-5,3-4,1,0,17,14,20,0,0,0,14,10,7,3,0,-1,-17,-10,-17,-6,0.3943294571892527,-4.529281716723062,0.22843124995557873,-11.113452658049027
4095,2022,7,NCAAF_20221015_BUFF@UMASS,UMass,Minutemen,Buffalo,Bulls,1-6,5-3,1,7,24,7,34,0,7,0,0,3,21,3,7,-4,-17,-3,-17,-27,0.07711218942707454,-24.074292308835766,0.03716993474344987,-26.65526545542889
4096,2022,7,NCAAF_20221015_UCONN@BALLST,Ball St.,Cardinals,UConn,Huskies,4-4,3-5,1,10,21,25,21,7,3,3,12,7,14,0,0,1,-11,0,-11,4,0.7210503557948907,9.901041552820516,0.6893690598635437,7.379801410981827
4097,2022,7,NCAAF_20221015_ARK@BYU,BYU,Cougars,Arkansas,Razorbacks,4-4,4-3,0,21,31,35,52,13,8,14,0,7,24,14,7,0,-10,6,-10,-17,0.5982908445904583,4.206095195701437,0.32086733869666517,-6.949796961294851
4098,2022,7,NCAAF_20221015_BAMA@TENN,Tennessee,Volunteers,Alabama,Crimson Tide,6-0,6-1,0,28,20,52,49,21,7,6,18,7,13,15,14,0,8,14,8,3,0.04858687677530693,-28.027256315136583,,
4099,2022,7,NCAAF_20221015_CHARLO@UAB,UAB,Blazers,Charlotte,49ers,4-2,1-6,1,10,14,34,20,7,3,9,15,14,0,0,6,3,-4,-7,-4,14,0.8070357876255696,14.650113971237033,0.9723860144000438,28.63534764264682
4100,2022,7,NCAAF_20221015_GRDWB@LIB,Liberty,Flames,Gardner-Webb,Runnin' Bulldogs,6-1,2-5,0,14,10,21,20,7,7,0,7,0,10,7,3,4,4,7,4,1,0.9574062558374355,29.085628444200893,,
4101,2022,7,NCAAF_20221015_KENTST@TOLEDO,Toledo,Rockets,Kent St.,Golden Flashes,5-2,2-5,0,28,31,52,31,7,21,10,14,21,10,0,0,3,-3,-14,-3,21,0.7804322150529373,13.072424077161713,0.7752023220223986,11.29369264588695
4102,2022,7,NCAAF_20221015_MD@IND,Indiana,Hoosiers,Maryland,Terrapins,3-4,5-2,1,17,14,33,38,3,14,3,13,7,7,10,14,-2,3,-4,3,-5,0.6059752279175614,4.5426599655756945,0.2268755600517982,-11.190421686372247
4103,2022,7,NCAAF_20221015_NCST@CUSE,Syracuse,Orange,NC State,Wolfpack,6-1,5-2,1,10,3,24,9,7,3,7,7,3,0,3,3,1,7,4,7,15,0.3457059990040776,-6.707086678399264,0.19625212509574286,-12.772376966964885
4104,2022,7,NCAAF_20221015_NILL@EMICH,E. Michigan,Eagles,N. Illinois,Huskies,4-3,2-5,0,7,20,10,39,7,0,3,0,14,6,9,10,2,-13,-7,-13,-29,0.5188597208637461,0.7990915570421748,0.4691060294171502,-1.1578732303116794
4105,2022,7,NCAAF_20221015_OHIO@WMICH,W. Michigan,Broncos,Ohio,Bobcats,2-5,4-3,0,14,20,14,33,7,7,0,0,7,13,0,13,-2,-6,0,-6,-19,0.46269629498635423,-1.5822887583653937,0.5062417748752176,0.23371056143878377
4106,2022,7,NCAAF_20221015_TXSTSM@TROY,Troy,Trojans,Texas St.,Bobcats,5-2,3-4,1,10,7,17,14,0,10,0,7,0,7,7,0,2,3,0,3,3,0.7858310424545552,13.383079965303068,0.6608065298126251,6.193844170070179
4107,2022,7,NCAAF_20221015_VANDY@UGA,Georgia,Bulldogs,Vanderbilt,Commodores,7-0,3-5,1,28,0,55,0,14,14,6,21,0,0,0,0,4,28,14,28,55,0.9821671507272411,35.49582813264283,0.9867156336937546,33.12716077343248
4108,2022,7,NCAAF_20221015_WKY@MTSU,Middle Tenn.,Blue Raiders,W. Kentucky,Hilltoppers,3-4,5-3,1,10,14,17,35,7,3,0,7,0,14,14,7,-2,-4,7,-4,-18,0.444900277760957,-2.3411899155978517,0.17418315181450283,-14.007337784332776
4109,2022,7,NCAAF_20221015_JMAD@GAS,Ga. Southern,Eagles,James Madison,Dukes,4-3,5-1,1,14,17,45,38,0,14,17,14,7,10,7,14,-1,-3,-7,-3,7,0.07902816204381091,-23.852455346468787,,
4110,2022,7,NCAAF_20221015_LATECH@NTEXAS,North Texas,Mean Green,Louisiana Tech,Bulldogs,4-3,2-4,0,27,17,47,27,14,13,7,13,3,14,10,0,2,10,11,10,20,0.49919783279717744,-0.03397540282594491,0.7799919322442895,11.533821886782562
4111,2022,7,NCAAF_20221015_TULANE@SFLA,South Florida,Bulls,Tulane,Green Wave,1-6,7-1,1,14,17,31,45,7,7,10,7,3,14,14,14,-6,-3,4,-3,-14,0.31926115926748055,-7.937631338802021,,
4112,2022,7,NCAAF_20221015_ARIZ@WASH,Washington,Huskies,Arizona,Wildcats,6-2,3-4,0,21,14,49,39,7,14,21,7,7,7,10,15,3,7,0,7,10,0.8348878810644105,16.451967557394255,0.7130710876866839,8.400239690255603
4113,2022,7,NCAAF_20221015_RICE@FAU,FAU,Owls,Rice,Owls,3-4,3-3,1,7,14,17,14,0,7,3,7,14,0,0,0,0,-7,-14,-7,3,0.8426150271110233,16.985934150014373,,
4114,2022,7,NCAAF_20221015_ARKST@USM,So. Miss,Golden Eagles,Arkansas St.,Red Wolves,3-3,2-5,0,7,10,20,19,0,7,0,13,7,3,9,0,1,-3,-7,-3,1,0.43436435058998824,-2.792625887628901,,
4115,2022,7,NCAAF_20221015_LAMON@SALA,South Alabama,Jaguars,UL-Monroe,Warhawks,5-1,2-5,0,17,20,41,34,10,7,17,7,7,13,0,14,3,-3,3,-3,7,0.5629520991236345,2.6774664982979175,0.7077723880354451,8.168860990260328
4116,2022,7,NCAAF_20221015_LSU@FLA,Florida,Gators,LSU,Tigers,4-3,6-2,1,21,28,35,45,14,7,0,14,7,21,14,3,-2,-7,7,-7,-10,0.4514292429372251,-2.0622982194299766,0.28570753795528814,-8.453858569298745
4117,2022,7,NCAAF_20221015_UTAHST@COLOST,Colorado St.,Rams,Utah St.,Aggies,1-5,3-4,0,10,7,13,17,3,7,0,3,7,0,10,0,-2,3,-4,3,-4,0.3364350383786101,-7.1341190106450085,0.2185215987887137,-11.608953937326078
4118,2022,7,NCAAF_20221015_CLEM@FSU,Florida State,Seminoles,Clemson,Tigers,4-3,8-0,1,14,24,28,34,7,7,0,14,7,17,10,0,-4,-10,0,-10,-6,0.07132503207118335,-24.770885045317073,0.27138345768662897,-9.091152699329541
4119,2022,7,NCAAF_20221015_MISSST@UK,Kentucky,Wildcats,Miss. State,Bulldogs,5-2,5-3,0,3,3,27,17,0,3,10,14,0,3,7,7,0,0,0,0,10,0.4087840306195262,-3.897697793689076,0.3784125007769418,-4.625275350572565
4120,2022,7,NCAAF_20221015_NEB@PURDUE,Purdue,Boilermakers,Nebraska,Cornhuskers,5-3,3-4,1,27,13,43,37,10,17,7,9,0,13,17,7,2,14,10,14,6,0.603812310948767,4.447750745932353,0.7507426978113368,10.10977272965306
4121,2022,7,NCAAF_20221015_STNFRD@ND,Notre Dame,Fighting Irish,Stanford,Cardinal,3-3,2-4,1,0,10,14,16,0,0,7,7,7,3,3,3,1,-10,-7,-10,-2,0.8232869761774841,15.679809848258401,0.9804818668288321,30.826989658540924
4122,2022,7,NCAAF_20221015_NMEX@NMEXST,New Mexico St.,Aggies,New Mexico,Lobos,2-5,2-5,0,7,6,21,9,7,0,14,0,3,3,0,3,0,1,4,1,12,0.4090827426486435,-3.8847060281339054,0.40173701333398504,-3.7171194309339626
4123,2022,7,NCAAF_20221015_UNC@DUKE,Duke,Blue Devils,North Carolina,Tar Heels,5-3,6-1,0,21,17,35,38,7,14,0,14,10,7,14,7,-1,4,-3,4,-3,0.30985344866655595,-8.38540082365921,0.025662228895296568,-29.10852906304558
4124,2022,7,NCAAF_20221015_USC@UTAH,Utah,Utes,USC,Trojans,5-2,6-1,0,21,28,43,42,7,14,7,15,14,14,7,7,-1,-7,-7,-7,1,0.6380143966307337,5.9672817458263125,0.7694059541331459,11.00693407553399
4125,2022,7,NCAAF_20221015_WASHST@OREGST,Oregon State,Beavers,Washington St.,Cougars,6-2,4-3,1,10,3,24,10,7,3,7,7,0,3,7,0,2,7,7,7,14,0.2325823298351719,-12.341041706828719,0.37013245349645185,-4.95164466452502
4126,2022,7,NCAAF_20221015_AF@UNLV,UNLV,Rebels,Air Force,Falcons,4-3,5-2,1,7,28,7,42,0,7,0,0,14,14,14,0,-1,-21,-14,-21,-35,0.1534866770442176,-17.261860017035815,,
4127,2022,7,NCAAF_20221015_SJST@FRESNO,Fresno St.,Bulldogs,San Jose St.,Spartans,2-4,4-2,1,7,10,17,10,0,7,7,3,0,10,0,0,-2,-3,0,-3,7,0.8196914216400545,15.447059769146335,,
4128,2022,7,NCAAF_20221015_NEVADA@HAWAII,Hawaii,,Nevada,,2-5,2-5,,21,13,31,16,14,7,0,10,7,6,3,0,0,8,7,8,15,0.3550284869333944,-6.281957735699052,0.13170606829723286,-16.704952349793302
4129,2022,7,NCAAF_20221014_NAVY@SMU,SMU,Mustangs,Navy,Midshipmen,3-3,2-4,1,13,7,40,34,10,3,20,7,0,7,7,20,1,6,10,6,6,0.6080517841703249,4.63391467296492,0.6448506415263568,5.548412150503964
4130,2022,7,NCAAF_20221014_TXSA@FIU,FIU,Panthers,UTSA,Roadrunners,2-4,5-2,1,3,17,10,30,0,3,0,7,0,17,7,6,-3,-14,0,-14,-20,0.3484873502362613,-6.5798172982601955,,
4131,2022,7,NCAAF_20221013_BAYLOR@WVU,West Virginia,Mountaineers,Baylor,Bears,3-3,3-3,0,17,24,43,40,7,10,14,12,3,21,7,9,0,-7,4,-7,3,0.5189774597946373,0.804083943591877,,
4132,2022,7,NCAAF_20221013_TEMPLE@UCF,UCF,Knights,Temple,Owls,5-1,2-4,0,35,13,70,13,14,21,21,14,10,3,0,0,3,22,4,22,57,0.8987455077833018,21.534137162788966,0.9856220111357331,32.66440681531844
4133,2022,7,NCAAF_20221012_UL@MRSHL,Marshall,Thundering Herd,Louisiana,Ragin' Cajuns,3-3,3-3,0,7,3,13,23,0,7,0,6,3,0,13,7,0,4,-3,4,-10,0.5205119490285353,0.8691562016385888,,
4134,2022,8,NCAAF_20221022_AKRON@KENTST,Kent St.,Golden Flashes,Akron,Zips,3-5,1-7,1,21,17,33,27,0,21,9,3,7,10,7,3,2,4,-7,4,6,0.6915795710183198,8.455467484497376,0.9236576542187037,21.113391397596388
4135,2022,8,NCAAF_20221022_CINCY@SMU,SMU,Mustangs,Cincinnati,Bearcats,3-4,6-1,1,14,20,27,29,0,14,0,13,10,10,9,0,-3,-6,-10,-6,-2,0.34243492835749123,-6.85834777554669,0.2847551110777238,-8.397049225486626
4136,2022,8,NCAAF_20221022_CUSE@CLEM,Clemson,Tigers,Syracuse,Orange,8-0,6-1,0,10,21,27,21,7,3,0,17,7,14,0,0,2,-11,0,-11,6,0.9401776731810609,26.30042887512809,0.8427714210340711,14.850750781024544
4137,2022,8,NCAAF_20221022_HOU@NAVY,Navy,Midshipmen,Houston,Cougars,2-5,4-3,0,7,21,20,38,0,7,7,6,14,7,10,7,-2,-14,-14,-14,-18,0.3947166644236021,-4.5130040257340625,,
4138,2022,8,NCAAF_20221022_IND@RUT,Rutgers,Scarlet Knights,Indiana,Hoosiers,4-3,3-5,1,7,14,24,17,0,7,10,7,14,0,0,3,1,-7,-14,-7,7,0.27113888341483317,-10.298201796756075,0.5173494450091343,0.6422442665452763
4139,2022,8,NCAAF_20221022_IOWA@OHIOST,Ohio State,Buckeyes,Iowa,Hawkeyes,7-0,3-4,0,26,10,54,10,16,10,14,14,7,3,0,0,4,16,9,16,44,0.8167269325350937,15.259776615247802,0.9460598722275485,23.736583757745393
4140,2022,8,NCAAF_20221022_KANSAS@BAYLOR,Baylor,Bears,Kansas,Jayhawks,4-3,5-3,0,28,3,35,23,14,14,0,7,3,0,7,13,-1,25,11,25,12,0.8583598264556831,18.133020894045103,0.8987260330163355,18.813442439572555
4141,2022,8,NCAAF_20221022_LAMON@ARMY,Army,Black Knights,UL-Monroe,Warhawks,3-4,2-6,0,14,17,48,24,7,7,17,17,3,14,0,7,1,-3,4,-3,24,0.8538885511356792,17.79972989306998,,
4142,2022,8,NCAAF_20221022_TNMART@TENN,Tennessee,Volunteers,UT Martin,Skyhawks,7-0,4-3,0,52,7,65,24,21,31,6,7,7,0,7,10,3,45,14,45,41,0.9816579075344363,35.30787499656299,,
4143,2022,8,NCAAF_20221022_DUKE@MIAMI,Miami (Fla.),Hurricanes,Duke,Blue Devils,3-4,5-3,0,7,17,21,45,7,0,14,0,0,17,7,21,-2,-10,7,-10,-24,0.7738766867904294,12.703072570327322,0.8926534376789002,18.317945600918847
4144,2022,8,NCAAF_20221022_BGREEN@CMICH,C. Michigan,Chippewas,Bowling Green,Falcons,2-6,4-4,0,3,17,18,34,3,0,7,8,7,10,0,17,-2,-14,-4,-14,-16,0.8368485184564932,16.588530538094574,,
4145,2022,8,NCAAF_20221022_TOLEDO@BUFF,Buffalo,Bulls,Toledo,Rockets,5-3,5-3,0,7,20,34,27,0,7,3,24,7,13,7,0,0,-13,-7,-13,7,0.4537150121870429,-1.965109121990281,0.20933327200239915,-11.939742713723717
4146,2022,8,NCAAF_20221022_EMICH@BALLST,Ball St.,Cardinals,E. Michigan,Eagles,4-4,5-3,0,7,10,16,20,0,7,9,0,0,10,0,10,-1,-3,0,-3,-4,0.3632197081132599,-5.9126239181546225,0.47839696115525987,-0.7998433648322134
4147,2022,8,NCAAF_20221022_NILL@OHIO,Ohio,Bobcats,N. Illinois,Huskies,5-3,2-6,1,10,6,24,17,7,3,7,7,0,6,11,0,3,4,7,4,7,0.5796080631764552,3.3949943716313555,0.3952056795254617,-3.9237768034959117
4148,2022,8,NCAAF_20221022_UNLV@ND,Notre Dame,Fighting Irish,UNLV,Rebels,4-3,4-4,1,30,7,44,21,23,7,0,14,7,0,7,7,0,23,16,23,23,0.981675332323276,35.3144238118939,0.9836982088002751,31.54847025690424
4149,2022,8,NCAAF_20221022_WVU@TXTECH,Texas Tech,Red Raiders,West Virginia,Mountaineers,4-3,3-4,1,17,3,48,10,14,3,14,17,3,0,7,0,1,14,11,14,38,0.40849864677921666,-3.9107358459511943,,
4150,2022,8,NCAAF_20221022_BC@WAKE,Wake Forest,Demon Deacons,Boston College,Eagles,6-1,2-5,0,21,9,43,15,7,14,15,7,3,6,6,0,4,12,4,12,28,0.5862516036356383,3.682664676361128,0.8803742889475978,17.374508348627387
4151,2022,8,NCAAF_20221022_BYU@LIB,Liberty,Flames,BYU,Cougars,7-1,4-4,0,20,14,41,14,3,17,14,7,14,0,0,0,3,6,-11,6,27,0.27648895803936613,-10.026649451486492,0.19474863407863174,-12.704380117221262
4152,2022,8,NCAAF_20221022_FIU@CHARLO,Charlotte,49ers,FIU,Panthers,1-7,3-4,1,0,27,15,34,0,0,0,15,14,13,7,0,-2,-27,-14,-27,-19,0.4740845346833855,-1.0985845835568853,0.7258675486210139,8.863414527092573
4153,2022,8,NCAAF_20221022_GAS@ODU,Old Dominion,Monarchs,Ga. Southern,Eagles,3-4,5-3,0,3,14,23,28,3,0,13,7,7,7,7,7,-2,-11,-4,-11,-5,0.36497357261337005,-5.833703091811913,0.5683208101488759,2.540799138173952
4154,2022,8,NCAAF_20221022_MEMP@TULANE,Tulane,Green Wave,Memphis,Tigers,7-1,4-4,1,35,0,38,28,21,14,0,3,0,0,14,14,3,35,21,35,10,0.3647600038471086,-5.843306477261422,,
4155,2022,8,NCAAF_20221022_MISS@LSU,LSU,Tigers,Ole Miss,Rebels,6-2,7-1,0,17,20,45,20,3,14,7,21,14,6,0,0,-1,-3,-11,-3,25,0.675604832486683,7.69685145264657,0.4184339060236786,-3.0398165492729277
4156,2022,8,NCAAF_20221022_MRSHL@JMAD,James Madison,Dukes,Marshall,Thundering Herd,5-2,4-3,0,12,9,12,26,12,0,0,0,2,7,10,7,1,3,10,3,-14,0.7259521851733013,10.150228667184592,,
4157,2022,8,NCAAF_20221022_NTEXAS@TXSA,UTSA,Roadrunners,North Texas,Mean Green,6-2,4-4,1,3,6,31,27,0,3,7,21,6,0,7,14,2,-3,-6,-3,4,0.47895319503896105,-0.8919828121513547,0.6733047858351531,6.6296312129816215
4158,2022,8,NCAAF_20221022_NWEST@MD,Maryland,Terrapins,Northwestern,Wildcats,6-2,1-6,1,10,17,31,24,0,10,14,7,7,10,0,7,5,-7,-7,-7,7,0.43051956677842584,-2.9583170036200954,0.7919524353219083,12.005847612312664
4159,2022,8,NCAAF_20221022_PURDUE@WISC,Wisconsin,Badgers,Purdue,Boilermakers,4-4,5-3,1,21,3,35,24,21,0,14,0,0,3,7,14,-1,18,21,18,11,0.7257200209391212,10.138452422262617,0.7124608023142935,8.276211731902094
4160,2022,8,NCAAF_20221022_TEXAS@OKLAST,Oklahoma State,Cowboys,Texas,Longhorns,6-1,5-3,0,24,31,41,34,10,14,3,14,14,17,3,0,1,-7,-4,-7,7,0.48582248718093535,-0.6007035449717932,,
4161,2022,8,NCAAF_20221022_UCLA@OREG,Oregon,Ducks,UCLA,Bruins,6-1,6-1,1,31,13,45,30,3,28,7,7,3,10,3,14,0,18,0,18,15,0.7046127468026598,9.087200662891973,0.3935619807439644,-3.986826986041251
4162,2022,8,NCAAF_20221022_WMICH@MIAOH,Miami-OH,RedHawks,W. Michigan,Broncos,3-5,3-5,0,3,6,10,16,3,0,0,7,0,6,10,0,0,-3,3,-3,-6,0.4694461077813983,-1.2955687859366662,0.7864702682063704,11.725624881366457
4163,2022,8,NCAAF_20221022_ARIZST@STNFRD,Stanford,Cardinal,Arizona St.,Sun Devils,3-4,2-5,0,6,14,15,14,6,0,3,6,7,7,0,0,1,-8,-1,-8,1,0.4565141609500981,-1.8457773529423775,0.22710621962710298,-11.049122029211958
4164,2022,8,NCAAF_20221022_FAU@UTEP,UTEP,Miners,FAU,Owls,4-4,3-5,1,6,7,24,21,0,6,8,10,0,7,7,7,1,-1,0,-1,3,0.11473498106853586,-20.308786975457906,0.3438216389752142,-5.935722894712853
4165,2022,8,NCAAF_20221022_HAWAII@COLOST,Colorado St.,Rams,Hawaii,Rainbow Warriors,2-5,2-6,0,3,13,17,13,0,3,7,7,3,10,0,0,0,-10,-3,-10,4,0.5939231996616732,4.016189072754969,0.5252120681107588,0.9336316249118681
4166,2022,8,NCAAF_20221022_VANDY@MIZZOU,Missouri,Tigers,Vanderbilt,Commodores,3-4,3-5,1,17,0,17,14,7,10,0,0,0,0,7,7,0,17,7,17,3,0.8186351451502452,15.381692930714507,,
4167,2022,8,NCAAF_20221022_ARKST@UL,Louisiana,Ragin' Cajuns,Arkansas St.,Red Wolves,4-3,2-6,0,24,9,38,18,10,14,14,0,0,9,3,6,2,15,10,15,20,0.649625174333332,6.494698537858312,0.7947513497884207,12.15059400511609
4168,2022,8,NCAAF_20221022_USM@TXSTSM,Texas St.,Bobcats,So. Miss,Golden Eagles,3-5,4-3,1,7,13,14,20,0,7,0,7,3,10,0,7,-1,-6,-3,-6,-6,0.3018154612439692,-8.774085909057703,,
4169,2022,8,NCAAF_20221022_FRESNO@NMEX,New Mexico,Lobos,Fresno St.,Bulldogs,2-6,3-4,0,6,13,9,41,3,3,3,0,10,3,14,14,-1,-7,-7,-7,-32,0.12614152809220824,-19.34713182877408,0.17179184330435338,-13.982580002015766
4170,2022,8,NCAAF_20221022_BOISE@AF,Air Force,Falcons,Boise St.,Broncos,5-3,5-2,0,7,19,14,19,0,7,0,7,10,9,0,0,0,-12,-10,-12,-5,0.38999133014424714,-4.720787285614506,,
4171,2022,8,NCAAF_20221022_MISSST@BAMA,Alabama,Crimson Tide,Miss. State,Bulldogs,7-1,5-3,0,24,0,30,6,7,17,0,6,0,0,0,6,2,24,7,24,24,0.8950002986701064,21.184896478068822,0.8809623652112588,17.418081076741146
4172,2022,8,NCAAF_20221022_MINN@PSU,Penn State,Nittany Lions,Minnesota,Golden Gophers,6-1,4-3,1,17,10,45,17,0,17,21,7,3,7,0,7,2,7,-3,7,28,0.7572544763538206,11.787504633988647,0.5255047737199441,0.9444855616584391
4173,2022,8,NCAAF_20221022_TXAM@SC,South Carolina,Gamecocks,Texas A&M,Aggies,5-2,3-4,0,17,14,30,24,17,0,7,6,3,11,7,3,2,3,14,3,6,0.30507503488583565,-8.616463909895174,0.24881855691183985,-10.0127505065293
4174,2022,8,NCAAF_20221022_UCF@ECU,East Carolina,Pirates,UCF,Knights,5-3,5-2,1,17,3,34,13,3,14,7,10,0,3,7,3,0,14,3,14,21,0.08340815313225525,-23.36392896647635,,
4175,2022,8,NCAAF_20221022_COLO@OREGST,Oregon State,Beavers,Colorado,Buffaloes,6-2,1-6,0,21,3,42,9,7,14,14,7,0,3,6,0,5,18,7,18,33,0.5171595900661333,0.7271258597111228,,
4176,2022,8,NCAAF_20221022_KSTATE@TCU,TCU,Horned Frogs,Kansas State,Wildcats,7-0,5-2,0,17,28,38,28,10,7,14,7,7,21,0,0,2,-11,3,-11,10,0.5387282710871787,1.6431630660090377,0.21465845807904194,-11.668453673907152
4177,2022,8,NCAAF_20221022_PITT@LVILLE,Louisville,Cardinals,Pittsburgh,Panthers,4-3,4-3,1,7,7,24,10,0,7,0,17,7,0,3,0,0,0,-7,0,14,0.4112322983075041,-3.79188829481177,0.4235370349768073,-2.8471753941435054
4178,2022,8,NCAAF_20221022_UTAHST@WYO,Wyoming,Cowboys,Utah St.,Aggies,5-3,3-5,1,17,7,28,14,7,10,3,8,0,7,7,0,2,10,7,10,14,0.4251889643929674,-3.1878941593502077,0.3138511570094965,-7.159731043189822
4179,2022,8,NCAAF_20221022_SDGST@NEVADA,Nevada,Wolf Pack,San Diego St.,Aztecs,2-6,4-3,1,7,13,7,23,0,7,0,0,10,3,10,0,-2,-6,-10,-6,-16,0.34498298313736075,-6.741307958052403,0.5806002257810979,3.0033166635334965
4180,2022,8,NCAAF_20221022_WASH@CAL,California,Golden Bears,Washington,Huskies,3-4,6-2,0,0,6,21,28,0,0,14,7,6,0,8,14,-3,-6,-6,-6,-7,0.2778852109907871,-9.956206947741975,0.5812759187735642,3.028848967982867
4181,2022,8,NCAAF_20221021_TULSA@TEMPLE,Temple,Owls,Tulsa,Golden Hurricane,2-5,3-4,1,10,14,16,27,10,0,0,6,0,14,0,13,-1,-4,10,-4,-11,0.36853349636402566,-5.673901101393085,,
4182,2022,8,NCAAF_20221021_UAB@WKY,W. Kentucky,Hilltoppers,UAB,Blazers,5-3,4-3,1,10,17,20,17,0,10,10,0,7,10,0,0,1,-7,-7,-7,3,0.4515917610640968,-2.055691469465046,0.7675563753438384,10.789466770998388
4183,2022,8,NCAAF_20221020_TROY@SALA,South Alabama,Jaguars,Troy,Trojans,5-2,6-2,1,3,7,6,10,0,3,0,3,0,7,0,3,-1,-4,0,-4,-4,0.294728276018801,-9.119474266965653,0.5857042302147507,3.196408998547213
4184,2022,8,NCAAF_20221020_UVA@GATECH,Georgia Tech,Yellow Jackets,Virginia,Cavaliers,3-4,3-4,1,9,13,9,16,6,3,0,0,7,6,3,0,0,-4,-1,-4,-7,0.38976455029047574,-4.730777008288214,0.38255487860623705,-4.410986817998946
4185,2022,8,NCAAF_20221019_GAST@APLST,App. St.,Mountaineers,Georgia St.,Panthers,4-3,2-5,1,7,14,42,17,0,7,21,14,14,0,0,3,2,-7,-14,-7,25,0.8506710831163746,17.564118012191102,0.7998120296385818,12.415320395600702
4186,2022,9,NCAAF_20221029_ARK@AUBURN,Auburn,Tigers,Arkansas,Razorbacks,3-5,5-3,0,13,17,27,41,3,10,0,14,7,10,14,10,-2,-4,-4,-4,-14,0.8473059945188675,17.321144967039345,,
4187,2022,9,NCAAF_20221029_BC@UCONN,UConn,Huskies,Boston College,Eagles,4-5,2-6,1,10,3,13,3,10,0,0,3,0,3,0,0,2,7,10,7,10,0.05328890892149474,-27.27194088139413,0.22347267677468463,-11.417744922200654
4188,2022,9,NCAAF_20221029_GATECH@FSU,Florida State,Seminoles,Georgia Tech,Yellow Jackets,5-3,3-5,0,24,3,41,16,7,17,7,10,3,0,7,6,2,21,4,21,25,0.620516213372794,5.185402932479974,0.9374064305585469,23.020531110354796
4189,2022,9,NCAAF_20221029_MIAOH@AKRON,Akron,Zips,Miami-OH,RedHawks,1-8,4-5,0,3,17,9,27,0,3,0,6,7,10,0,10,-3,-14,-7,-14,-18,0.17192583126375094,-15.996810671355888,0.09213051779758108,-19.933664802586236
4190,2022,9,NCAAF_20221029_ND@CUSE,Syracuse,Orange,Notre Dame,Fighting Irish,6-2,5-3,1,7,21,24,41,7,0,10,7,7,14,3,17,1,-14,0,-14,-17,0.1387457726369692,-18.352426788700086,0.2563419130757947,-9.828560468345131
4191,2022,9,NCAAF_20221029_OHIOST@PSU,Penn State,Nittany Lions,Ohio State,Buckeyes,6-2,8-0,0,14,13,31,44,0,14,0,17,10,3,3,28,-2,1,-10,1,-13,0.26823468385989957,-10.44663596268856,0.1509914097167816,-15.496409332831945
4192,2022,9,NCAAF_20221029_OKLA@IOWAST,Iowa St.,Cyclones,Oklahoma,Sooners,3-5,5-3,0,6,13,13,27,3,3,0,7,3,10,7,7,-2,-7,0,-7,-14,0.3632705185878575,-5.910284755479552,0.6034543909640454,3.9379226919575103
4193,2022,9,NCAAF_20221029_SFLA@HOU,Houston,Cougars,South Florida,Bulls,5-3,1-7,0,28,14,42,27,14,14,7,7,14,0,7,6,4,14,0,14,15,0.7454797776650399,11.15931993365507,,
4194,2022,9,NCAAF_20221029_TCU@WVU,West Virginia,Mountaineers,TCU,Horned Frogs,3-5,8-0,0,21,28,31,41,7,14,3,7,7,21,0,13,-5,-7,0,-7,-10,0.4340888946845307,-2.8048770266168503,0.4825017170652238,-0.6587124265106468
4195,2022,9,NCAAF_20221029_TOLEDO@EMICH,E. Michigan,Eagles,Toledo,Rockets,5-4,6-3,1,17,10,24,27,7,10,7,0,0,10,7,10,-1,7,7,7,-3,0.37049778772327036,-5.585895160140581,0.1631659334241038,-14.73582195328413
4196,2022,9,NCAAF_20221029_CHARLO@RICE,Rice,Owls,Charlotte,49ers,4-4,2-7,1,17,28,23,56,14,3,0,6,7,21,21,7,2,-11,7,-11,-33,0.499459154887262,-0.022910681000666955,,
4197,2022,9,NCAAF_20221029_RUT@MINN,Minnesota,Golden Gophers,Rutgers,Scarlet Knights,5-3,4-4,0,14,0,31,0,0,14,0,17,0,0,0,0,1,14,0,14,31,0.8251015847882486,15.800795178733324,0.8710493151486949,16.98533115033797
4198,2022,9,NCAAF_20221029_ODU@GAST,Georgia St.,Panthers,Old Dominion,Monarchs,3-5,3-5,1,14,14,31,17,7,7,14,3,7,7,0,3,0,0,0,0,14,0.5934483364765872,3.9954656878289825,0.5312955278676486,1.1789341272078673
4199,2022,9,NCAAF_20221029_CINCY@UCF,UCF,Knights,Cincinnati,Bearcats,6-2,6-2,1,10,6,25,21,10,0,2,13,0,6,7,8,0,4,10,4,4,0.5685768655683551,2.9194323965787135,0.3211796045832118,-6.972137777873968
4200,2022,9,NCAAF_20221029_FLA@UGA,Georgia,Bulldogs,Florida,Gators,8-0,4-4,1,28,3,42,20,14,14,7,7,0,3,17,0,4,25,14,25,22,0.7988356724161115,14.152855586962914,0.9605029490513093,26.371347259030244
4201,2022,9,NCAAF_20221029_ILL@NEB,Nebraska,Cornhuskers,Illinois,Fighting Illini,3-5,7-1,0,9,20,9,26,3,6,0,0,6,14,3,3,-4,-11,-3,-11,-17,0.6434945416970538,6.215912331726258,0.2005056378406328,-12.608272051150607
4202,2022,9,NCAAF_20221029_NMEXST@UMASS,UMass,Minutemen,New Mexico St.,Aggies,1-7,3-5,0,13,10,13,23,3,10,0,0,0,10,6,7,-2,3,3,3,-10,0.312093097060717,-8.279528337096735,0.18220924941015104,-13.616574142203945
4203,2022,9,NCAAF_20221029_NTEXAS@WKY,W. Kentucky,Hilltoppers,North Texas,Mean Green,5-4,5-4,1,13,20,13,40,7,6,0,0,17,3,0,20,0,-7,-10,-7,-27,0.5850323467535162,3.6297610886642815,0.8549924887166713,15.885219658399365
4204,2022,9,NCAAF_20221029_NWEST@IOWA,Iowa,Hawkeyes,Northwestern,Wildcats,4-4,1-7,1,20,0,33,13,10,10,3,10,0,0,7,6,3,20,10,20,20,0.794219742515696,13.87707111358236,0.8482620155736467,15.448626267093687
4205,2022,9,NCAAF_20221029_OKLAST@KSTATE,Kansas State,Wildcats,Oklahoma State,Cowboys,6-2,6-2,1,35,0,48,0,14,21,3,10,0,0,0,0,0,35,14,35,48,0.35465668281741136,-6.299785818418513,0.24251697773568903,-10.482601679123718
4206,2022,9,NCAAF_20221029_OREG@CAL,California,Golden Bears,Oregon,Ducks,3-5,7-1,1,10,21,24,42,3,7,0,14,0,21,7,14,-4,-11,3,-11,-18,0.2652754818563282,-10.598806454908981,0.30530997269376947,-7.644515085461535
4207,2022,9,NCAAF_20221029_ROB@APLST,App. St.,Mountaineers,Robert Morris,Colonials,5-3,0-8,1,21,3,42,3,14,7,14,7,3,0,0,0,5,18,11,18,39,0.9945036316138555,42.97435455459981,,
4208,2022,9,NCAAF_20221029_SMU@TULSA,Tulsa,Golden Hurricane,SMU,Mustangs,3-5,4-4,0,7,24,34,45,7,0,13,14,14,10,21,0,-1,-17,-7,-17,-11,0.34939286888504617,-6.5394499761412135,,
4209,2022,9,NCAAF_20221029_WAKE@LVILLE,Louisville,Cardinals,Wake Forest,Demon Deacons,5-3,6-2,1,13,14,48,21,6,7,35,0,0,14,0,7,-1,-1,6,-1,27,0.4184078663003896,-3.48076934926803,0.43433001114479697,-2.4825824083306998
4210,2022,9,NCAAF_20221029_MIZZOU@SC,South Carolina,Gamecocks,Missouri,Tigers,5-3,4-4,0,7,17,10,23,0,7,3,0,7,10,3,3,1,-10,-7,-10,-13,0.4334403198257548,-2.8327360876476178,,
4211,2022,9,NCAAF_20221029_SALA@ARKST,Arkansas St.,Red Wolves,South Alabama,Jaguars,2-7,6-2,0,3,16,3,31,3,0,0,0,14,2,8,7,-4,-13,-11,-13,-28,0.6601211415583833,6.976027033482524,0.2563311830127448,-9.82906077268899
4212,2022,9,NCAAF_20221029_COLOST@BOISE,Boise St.,Broncos,Colorado St.,Rams,6-2,2-6,0,28,10,49,10,14,14,21,0,3,7,0,0,4,18,11,18,39,0.8270547942016374,15.929350572776684,0.8909768773928289,18.492268362030245
4213,2022,9,NCAAF_20221029_CSTCAR@MRSHL,Marshall,Thundering Herd,C. Carolina,Chanticleers,4-4,7-1,0,10,21,13,24,0,10,3,0,21,0,0,3,-3,-11,-21,-11,-11,0.6498172011336676,6.503401255889003,0.5890437819403495,3.3792435047560048
4214,2022,9,NCAAF_20221029_UAB@FAU,FAU,Owls,UAB,Blazers,4-5,4-4,0,10,14,24,17,10,0,14,0,0,14,3,0,0,-4,10,-4,7,0.5310820633414617,1.3179983968877877,0.18550258186479374,-13.430625324038829
4215,2022,9,NCAAF_20221029_UK@TENN,Tennessee,Volunteers,Kentucky,Wildcats,8-0,5-3,1,27,6,44,6,7,20,10,7,6,0,0,0,3,21,1,21,38,0.4442888973174851,-2.367694452721935,,
4216,2022,9,NCAAF_20221029_USC@ARIZ,Arizona,Wildcats,USC,Trojans,3-5,7-1,0,13,17,37,45,10,3,16,8,10,7,14,14,-4,-4,0,-4,-8,0.22599074582024004,-12.710413163017392,0.19510921234167133,-12.899598904669347
4217,2022,9,NCAAF_20221029_ARIZST@COLO,Colorado,Buffaloes,Arizona St.,Sun Devils,1-7,3-5,1,17,28,34,42,3,14,3,14,14,14,7,7,-2,-11,-11,-11,-8,0.27201433509193873,-10.253497813440163,,
4218,2022,9,NCAAF_20221029_BAYLOR@TXTECH,Texas Tech,Red Raiders,Baylor,Bears,4-4,5-3,0,3,17,17,45,0,3,14,0,3,14,7,21,-1,-14,-3,-14,-28,0.44463181378849026,-2.353025829201215,,
4219,2022,9,NCAAF_20221029_MICHST@MICH,Michigan,Wolverines,Michigan St.,Spartans,8-0,3-5,0,13,7,29,7,3,10,6,10,7,0,0,0,5,6,-4,6,22,0.8331597246991909,16.337245968898287,0.9292214073493079,22.069550204850202
4220,2022,9,NCAAF_20221029_MISS@TXAM,Texas A&M,Aggies,Ole Miss,Rebels,3-5,8-1,0,14,10,28,31,14,0,0,14,7,3,14,7,-5,4,7,4,-3,0.6040313892202276,4.458030178404897,0.4572731281906326,-1.6109980254734637
4221,2022,9,NCAAF_20221029_PITT@UNC,North Carolina,Tar Heels,Pittsburgh,Panthers,7-1,4-4,0,14,17,42,24,7,7,7,21,7,10,7,0,3,-3,0,-3,18,0.45131193411292947,-2.0676159914871732,0.49752118905042986,-0.09328402959545201
4222,2022,9,NCAAF_20221029_MTSU@UTEP,UTEP,Miners,Middle Tenn.,Blue Raiders,4-5,4-4,0,10,10,13,24,0,10,0,3,10,0,7,7,0,0,-10,0,-11,0.21399366135122533,-13.395263595460392,0.27860248427040046,-8.812677445399686
4223,2022,9,NCAAF_20221029_NEVADA@SJST,San Jose St.,Spartans,Nevada,Wolf Pack,5-2,2-7,1,7,14,35,28,0,7,14,14,7,7,7,7,3,-7,-7,-7,7,0.3511139125634598,-6.460947519687807,,
4224,2022,9,NCAAF_20221029_SDGST@FRESNO,Fresno St.,Bulldogs,San Diego St.,Aztecs,4-4,4-4,1,10,21,32,28,3,7,7,15,7,14,7,0,0,-11,-4,-11,4,0.5456498234577709,1.9380060484095338,0.6451021566315223,5.586842562400079
4225,2022,9,NCAAF_20221029_STNFRD@UCLA,UCLA,Bruins,Stanford,Cardinal,7-1,3-5,0,24,6,38,13,14,10,7,7,3,3,0,7,4,18,11,18,25,0.503458506637269,0.14650721379825882,0.9252670400882997,21.64022940627956
4226,2022,9,NCAAF_20221029_WYO@HAWAII,Hawaii,,Wyoming,,2-7,6-3,,10,10,20,27,7,3,3,7,0,10,3,14,-4,0,7,0,-7,0.3168629865631659,-8.052449115304853,0.24481382937072693,-10.37258694199204
4227,2022,9,NCAAF_20221028_ECU@BYU,BYU,Cougars,East Carolina,Pirates,4-5,6-3,0,17,17,24,27,3,14,7,0,7,10,7,3,-2,0,-4,0,-3,0.7846047329854176,13.314131084694964,,
4228,2022,9,NCAAF_20221027_UL@USM,So. Miss,Golden Eagles,Louisiana,Ragin' Cajuns,5-3,4-4,1,29,11,39,24,20,9,0,10,5,6,6,7,1,18,15,18,15,0.2929156655447974,-9.208340288684894,0.12352492364622547,-17.378367278146243
4229,2022,9,NCAAF_20221027_VATECH@NCST,NC State,Wolfpack,Virginia Tech,Hokies,6-2,2-6,1,3,0,22,21,0,3,7,12,0,0,21,0,4,3,0,3,1,0.5580324326169991,2.467039352090751,0.9206165726643651,21.156965207173016
4230,2022,9,NCAAF_20221027_UTAH@WASHST,Washington St.,Cougars,Utah,Utes,4-4,6-2,0,7,14,17,21,0,7,0,10,0,14,7,0,-2,-7,0,-7,-4,0.346977228647918,-6.649874224686755,0.2401318971376445,-10.597441391628763
4231,2022,10,NCAAF_20221105_AF@ARMY,Army,Black Knights,Air Force,Falcons,3-5,6-3,0,7,3,7,13,0,7,0,0,3,0,7,3,-3,4,-3,4,-6,0.4226238126481824,-3.3031550821021938,,
4232,2022,10,NCAAF_20221105_FLA@TXAM,Texas A&M,Aggies,Florida,Gators,3-6,5-4,0,24,20,24,41,14,10,0,0,17,3,14,7,-2,4,-3,4,-17,0.46818399580965164,-1.3510699476219088,0.5744894002321245,2.859458776780002
4233,2022,10,NCAAF_20221105_IOWA@PURDUE,Purdue,Boilermakers,Iowa,Hawkeyes,5-4,5-4,1,3,17,3,24,0,3,0,0,0,17,7,0,0,-14,0,-14,-21,0.33021804922787346,-7.434526909229589,0.5198805865029248,0.7590163910485899
4234,2022,10,NCAAF_20221105_MD@WISC,Wisconsin,Badgers,Maryland,Terrapins,5-4,6-3,0,17,0,23,10,7,10,3,3,0,0,3,7,-1,17,7,17,13,0.8731076609437942,19.3127772397645,0.7370200738898586,9.65535795110759
4235,2022,10,NCAAF_20221105_MINN@NEB,Nebraska,Cornhuskers,Minnesota,Golden Gophers,3-6,6-3,1,10,0,13,20,10,0,0,3,0,0,10,10,-3,10,10,10,-7,0.36522156939868655,-5.830635203534484,0.19381212743930476,-13.153236408081966
4236,2022,10,NCAAF_20221105_OHIOST@NWEST,Northwestern,Wildcats,Ohio State,Buckeyes,1-8,9-0,0,7,7,7,21,7,0,0,0,0,7,7,7,-8,0,7,0,-14,0.037215600345844146,-30.190108640016206,0.0033975757528568185,-41.209325969981364
4237,2022,10,NCAAF_20221105_TULANE@TULSA,Tulsa,Golden Hurricane,Tulane,Green Wave,3-6,8-1,0,10,17,13,27,3,7,3,0,10,7,7,3,-5,-7,-7,-7,-14,0.40759038088833055,-3.9557485908785566,,
4238,2022,10,NCAAF_20221105_TXTECH@TCU,TCU,Horned Frogs,Texas Tech,Red Raiders,9-0,4-5,0,13,10,34,24,7,6,0,21,10,0,7,7,5,3,-3,3,10,0.6360482640395075,5.8878288713654,,
4239,2022,10,NCAAF_20221105_UK@MIZZOU,Missouri,Tigers,Kentucky,Wildcats,4-5,6-3,1,3,7,17,21,3,0,0,14,7,0,7,7,-2,-4,-4,-4,-4,0.48648377865628956,-0.5734683511564072,,
4240,2022,10,NCAAF_20221105_UNC@UVA,Virginia,Cavaliers,North Carolina,Tar Heels,3-6,8-1,1,14,10,28,31,7,7,7,7,3,7,14,7,-5,4,4,4,-3,0.44546520222887565,-2.320620457306859,,
4241,2022,10,NCAAF_20221105_WKY@CHARLO,Charlotte,49ers,W. Kentucky,Hilltoppers,2-8,6-4,0,0,35,7,59,0,0,7,0,21,14,7,17,-4,-35,-21,-35,-52,0.24162985918331814,-11.864299842136461,0.023232144741315297,-30.31491487534322
4242,2022,10,NCAAF_20221105_GATECH@VATECH,Virginia Tech,Hokies,Georgia Tech,Yellow Jackets,2-7,4-5,0,20,13,27,28,0,20,7,0,10,3,3,12,-2,7,-10,7,-1,0.6615501039426525,7.051830331613246,0.7414961273384999,9.86514658410897
4243,2022,10,NCAAF_20221105_MRSHL@ODU,Old Dominion,Monarchs,Marshall,Thundering Herd,3-6,5-4,1,0,6,0,12,0,0,0,0,0,6,3,3,-2,-6,0,-6,-12,0.1815182828761257,-15.393195697074589,0.4100784206557342,-3.46126005638439
4244,2022,10,NCAAF_20221105_SFLA@TEMPLE,Temple,Owls,South Florida,Bulls,3-6,1-8,0,16,14,54,28,3,13,17,21,7,7,14,0,2,2,-4,2,26,0.47258558026250796,-1.1638374753570133,0.12899246952709142,-17.221808890524017
4245,2022,10,NCAAF_20221105_BAYLOR@OKLA,Oklahoma,Sooners,Baylor,Bears,5-4,6-3,1,21,24,35,38,14,7,7,7,14,10,7,7,-1,-3,0,-3,-3,0.7827162848907292,13.223742119390863,0.28640505168117314,-8.585546198929023
4246,2022,10,NCAAF_20221105_GAST@USM,So. Miss,Golden Eagles,Georgia St.,Panthers,5-4,4-5,0,0,28,14,42,0,0,14,0,14,14,7,7,1,-28,-14,-28,-28,0.5396126141944617,1.6831393668512646,0.3678148212205419,-5.140606142356319
4247,2022,10,NCAAF_20221105_MTSU@LATECH,Louisiana Tech,Bulldogs,Middle Tenn.,Blue Raiders,3-6,4-5,1,27,21,40,24,14,13,13,0,7,14,0,3,-1,6,7,6,16,0.47520272647507766,-1.052579539861199,,
4248,2022,10,NCAAF_20221105_CUSE@PITT,Pittsburgh,Panthers,Syracuse,Orange,5-4,6-3,0,10,6,19,9,0,10,7,2,3,3,0,3,-1,4,-3,4,10,0.6194729789499036,5.146276984831275,0.5577049483789234,2.209927676441339
4249,2022,10,NCAAF_20221105_MICHST@ILL,Illinois,Fighting Illini,Michigan St.,Spartans,7-2,4-5,0,7,9,15,23,7,0,0,8,3,6,14,0,3,-2,4,-2,-8,0.3086738573652188,-8.455021307366906,0.8025074834255757,12.950411257217638
4250,2022,10,NCAAF_20221105_NMEX@UTAHST,Utah St.,Aggies,New Mexico,Lobos,4-5,2-7,0,7,10,27,10,7,0,10,10,3,7,0,0,2,-3,4,-3,17,0.8274994859303397,15.981035358839108,0.8514083009186599,15.871760426123956
4251,2022,10,NCAAF_20221105_OKLAST@KANSAS,Kansas,Jayhawks,Oklahoma State,Cowboys,6-3,6-3,0,24,7,37,16,10,14,7,6,0,7,3,6,0,17,10,17,21,0.07328156026913224,-24.568665356193605,,
4252,2022,10,NCAAF_20221105_OREG@COLO,Colorado,Buffaloes,Oregon,Ducks,1-8,8-1,0,7,28,10,49,0,7,3,0,14,14,14,7,-7,-21,-14,-21,-39,0.14302631563253387,-18.053969698033825,,
4253,2022,10,NCAAF_20221105_PSU@IND,Indiana,Hoosiers,Penn State,Nittany Lions,3-6,7-2,0,7,24,14,45,7,0,0,7,7,17,7,14,-4,-17,0,-17,-31,0.13914005809144991,-18.347923354231398,0.05024793829437668,-25.00607152077191
4254,2022,10,NCAAF_20221105_TENN@UGA,Georgia,Bulldogs,Tennessee,Volunteers,9-0,8-1,1,24,6,27,13,14,10,3,0,3,3,0,7,1,18,11,18,14,0.8949299827992724,21.207756787895732,0.5979884355452156,3.7779449799106715
4255,2022,10,NCAAF_20221105_UCF@MEMP,Memphis,Tigers,UCF,Knights,4-5,7-2,0,14,21,28,35,7,7,7,7,7,14,0,14,-3,-7,0,-7,-7,0.3370379131696126,-7.117211973801432,,
4256,2022,10,NCAAF_20221105_WASHST@STNFRD,Stanford,Cardinal,Washington St.,Cougars,3-6,5-4,0,7,42,14,52,7,0,7,0,21,21,3,7,-2,-35,-14,-35,-38,0.3887115902154826,-4.783812290199876,0.12179162796149812,-17.753314285690294
4257,2022,10,NCAAF_20221105_WVU@IOWAST,Iowa St.,Cyclones,West Virginia,Mountaineers,4-5,3-6,0,10,7,31,14,3,7,0,21,0,7,0,7,1,3,3,3,17,0.6683057260536213,7.365622909683452,0.7603942883163382,10.772647845803704
4258,2022,10,NCAAF_20221105_FIU@NTEXAS,North Texas,Mean Green,FIU,Panthers,6-4,4-5,1,45,14,52,14,24,21,0,7,0,14,0,0,2,31,24,31,38,0.6840942845591771,8.109213137050801,,
4259,2022,10,NCAAF_20221105_LIB@ARK,Arkansas,Razorbacks,Liberty,Flames,5-4,8-1,1,3,21,19,21,0,3,2,14,7,14,0,0,-3,-18,-7,-18,-2,0.643999184880835,6.247504046533322,,
4260,2022,10,NCAAF_20221105_NAVY@CINCY,Cincinnati,Bearcats,Navy,Midshipmen,7-2,3-6,1,13,3,20,10,6,7,7,0,0,3,7,0,4,10,6,10,10,0.756489798444463,11.762529255291156,,
4261,2022,10,NCAAF_20221105_SALA@GAS,Ga. Southern,Eagles,South Alabama,Jaguars,5-4,7-2,0,24,17,31,38,21,3,7,0,7,10,7,14,-2,7,14,7,-7,0.6015463440123039,4.355199941759338,0.3704161870095912,-5.035628404172485
4262,2022,10,NCAAF_20221105_TROY@UL,Louisiana,Ragin' Cajuns,Troy,Trojans,4-5,7-2,0,10,0,17,23,0,10,7,0,0,0,7,16,-3,10,0,10,-6,0.6053100066936365,4.520440179807565,0.5967116992765529,3.727717982240165
4263,2022,10,NCAAF_20221105_TXSTSM@LAMON,UL-Monroe,Warhawks,Texas St.,Bobcats,3-6,3-6,0,17,24,31,30,0,17,7,7,21,3,3,3,0,-7,-21,-7,1,0.5263180629173013,1.11722422347043,0.4183226994610091,-3.1391490448986588
4264,2022,10,NCAAF_20221105_BYU@BOISE,Boise St.,Broncos,BYU,Cougars,,5-5,0,7,7,28,31,7,0,7,14,7,0,10,14,,0,0,0,-3,0.6052281363377658,4.516841203084368,0.4956855670762277,-0.16465475586642242
4265,2022,10,NCAAF_20221105_HOU@SMU,SMU,Mustangs,Houston,Cougars,5-4,5-4,1,56,35,77,63,21,35,7,14,14,21,14,14,0,21,7,21,14,0.5029180471769423,0.12378477471361293,,
4266,2022,10,NCAAF_20221105_TEXAS@KSTATE,Kansas State,Wildcats,Texas,Longhorns,6-3,6-3,0,10,31,27,34,7,3,7,10,14,17,0,3,0,-21,-7,-21,-7,0.36477440789236093,-5.850767858729796,,
4267,2022,10,NCAAF_20221105_UNLV@SDGST,San Diego St.,Aztecs,UNLV,Rebels,5-4,4-5,0,7,0,14,10,0,7,7,0,0,0,7,3,1,7,0,7,4,0.8101957612813333,14.868979764032701,0.5146417265001021,0.5588971765359929
4268,2022,10,NCAAF_20221105_ARIZ@UTAH,Utah,Utes,Arizona,Wildcats,7-2,3-6,0,28,10,45,20,14,14,3,14,7,3,0,10,4,18,7,18,25,0.8607579502337075,18.340138014367994,0.9416020231881516,23.87807568311564
4269,2022,10,NCAAF_20221105_CLEM@ND,Notre Dame,Fighting Irish,Clemson,Tigers,6-3,8-1,1,14,0,35,14,7,7,0,21,0,0,0,14,-2,14,7,14,21,0.3334506373107473,-7.283801861156462,0.39401959400713626,-4.09331002849558
4270,2022,10,NCAAF_20221105_FSU@MIAMI,Miami (Fla.),Hurricanes,Florida State,Seminoles,4-5,6-3,0,3,31,3,45,3,0,0,0,14,17,0,14,-2,-28,-11,-28,-42,0.6249378725308358,5.389608025202961,0.31121720316467694,-7.4967484517424055
4271,2022,10,NCAAF_20221105_JMAD@LVILLE,Louisville,Cardinals,James Madison,Dukes,6-3,5-3,0,10,10,34,10,7,3,10,14,3,7,0,0,1,0,4,0,24,0.4562085269356515,-1.8613822592185443,,
4272,2022,10,NCAAF_20221105_MICH@RUT,Rutgers,Scarlet Knights,Michigan,Wolverines,4-5,9-0,0,17,14,17,52,7,10,0,0,14,0,28,10,-5,3,-7,3,-35,0.03825540057072341,-29.97597212886467,0.006079696831983283,-38.1759983935915
4273,2022,10,NCAAF_20221105_SC@VANDY,Vanderbilt,Commodores,South Carolina,Gamecocks,3-6,6-3,1,14,31,27,38,7,7,7,6,17,14,7,0,-3,-17,-10,-17,-11,0.23897221908880262,-12.008877074729753,0.2523434023647759,-10.156988646540412
4274,2022,10,NCAAF_20221105_WAKE@NCST,NC State,Wolfpack,Wake Forest,Demon Deacons,7-2,6-3,1,17,14,30,21,3,14,10,3,0,14,0,7,1,3,3,3,9,0.5119659493081223,0.5076721532939246,0.6153557483710752,4.4655262744356605
4275,2022,10,NCAAF_20221105_CAL@USC,USC,Trojans,California,Golden Bears,8-1,3-6,1,20,7,41,35,6,14,14,7,7,0,7,21,5,13,-1,13,6,0.6464457179397998,6.358740255512657,0.6780863283985266,7.039259208379008
4276,2022,10,NCAAF_20221105_COLOST@SJST,San Jose St.,Spartans,Colorado St.,Rams,6-2,2-7,0,7,10,28,16,0,7,7,14,7,3,0,6,4,-3,-7,-3,12,0.3980770934074327,-4.3717136438162925,,
4277,2022,10,NCAAF_20221105_HAWAII@FRESNO,Fresno St.,Bulldogs,Hawaii,Rainbow Warriors,5-4,2-8,0,31,0,55,13,17,14,10,14,0,0,0,13,3,31,17,31,42,0.8036515339965915,14.4648343068327,0.8309070039787041,14.581656942840254
4278,2022,10,NCAAF_20221105_UCLA@ARIZST,Arizona St.,Sun Devils,UCLA,Bruins,3-6,8-1,0,10,28,36,50,10,0,15,11,14,14,14,8,-5,-18,-4,-18,-14,0.5269706129494267,1.1449673214383438,0.1663805542773502,-14.746263005930814
4279,2022,10,NCAAF_20221104_DUKE@BC,Boston College,Eagles,Duke,Blue Devils,2-7,6-3,0,14,24,31,38,7,7,7,10,10,14,7,7,-4,-10,-3,-10,-7,0.6153920913174268,4.965264656608042,0.4135350670833392,-3.3260255767847866
4280,2022,10,NCAAF_20221104_UMASS@UCONN,UConn,Huskies,UMass,Minutemen,5-5,1-8,0,13,10,27,10,7,6,7,7,3,7,0,0,4,3,4,3,17,0.6296303735270139,5.5994383456895775,0.8960262937509347,19.171543626338234
4281,2022,10,NCAAF_20221104_OREGST@WASH,Washington,Huskies,Oregon State,Beavers,7-2,6-3,0,7,14,24,21,0,7,7,10,7,7,7,0,1,-7,-7,-7,3,0.8180300478348137,15.364241393154543,0.36026159027251314,-5.44682633861953
4282,2022,10,NCAAF_20221103_UTEP@RICE,Rice,Owls,UTEP,Miners,5-5,4-6,0,20,17,37,30,10,10,7,10,7,10,3,10,1,3,3,3,7,0.5657591913613329,2.8022608327910348,,
4283,2022,10,NCAAF_20221103_APLST@CSTCAR,C. Carolina,Chanticleers,App. St.,Mountaineers,8-1,5-4,0,21,14,35,28,14,7,0,14,7,7,0,14,3,7,7,7,7,0.2301883776545528,-12.493117089573161,0.2390842447303151,-10.79822448896789
4284,2022,10,NCAAF_20221102_CMICH@NILL,N. Illinois,Huskies,C. Michigan,Chippewas,2-7,3-6,1,0,21,22,35,0,0,7,15,14,7,7,7,-1,-21,-14,-21,-13,0.5140546648375842,0.5963227921386078,0.4470893930232541,-2.0251819764016545
4285,2022,10,NCAAF_20221102_WMICH@BGREEN,Bowling Green,Falcons,W. Michigan,Broncos,5-4,3-6,0,6,0,13,9,0,6,7,0,0,0,6,3,2,6,0,6,4,0.15202636529231428,-17.393292964000693,,
4286,2022,10,NCAAF_20221101_BALLST@KENTST,Kent St.,Golden Flashes,Ball St.,Cardinals,3-6,5-4,1,13,17,20,27,13,0,0,7,0,17,3,7,-2,-4,13,-4,-7,0.4601684655762118,-1.6924722722944807,0.5822750286024064,3.16245387679146
4287,2022,10,NCAAF_20221101_BUFF@OHIO,Ohio,Bobcats,Buffalo,Bulls,6-3,5-4,0,24,10,45,24,17,7,7,14,0,10,14,0,1,14,17,14,21,0.4940813915940343,-0.251076801732097,,
4288,2022,11,NCAAF_20221112_IND@OHIOST,Ohio State,Buckeyes,Indiana,Hoosiers,10-0,3-7,1,28,7,56,14,21,7,14,14,7,0,0,7,7,21,14,21,42,0.9558102431571922,28.841997260323524,0.9977213075130851,43.54622965394901
4289,2022,11,NCAAF_20221112_LIB@UCONN,UConn,Huskies,Liberty,Flames,6-5,8-2,1,21,17,36,33,14,7,0,15,3,14,10,6,-2,4,11,4,3,0.14049364991331748,-18.247958890092832,,
4290,2022,11,NCAAF_20221112_LSU@ARK,Arkansas,Razorbacks,LSU,Tigers,5-5,8-2,0,3,6,10,13,3,0,0,7,0,6,7,0,-3,-3,3,-3,-3,0.16542278875874805,-16.4590189731764,,
4291,2022,11,NCAAF_20221112_MIZZOU@TENN,Tennessee,Volunteers,Missouri,Tigers,9-1,4-6,0,28,17,66,24,7,21,21,17,7,10,7,0,5,11,0,11,42,0.48983129681707127,-0.4314754932509004,,
4292,2022,11,NCAAF_20221112_ND@NAVY,Navy,Midshipmen,Notre Dame,Fighting Irish,3-7,7-3,0,13,35,32,35,6,7,3,16,14,21,0,0,-4,-22,-8,-22,-3,0.09030085836531654,-22.66226131149847,,
4293,2022,11,NCAAF_20221112_OKLA@WVU,West Virginia,Mountaineers,Oklahoma,Sooners,4-6,5-5,0,6,12,23,20,0,6,7,10,0,12,8,0,-1,-6,0,-6,3,0.21269493257598793,-13.491781633873188,0.3799090597190221,-4.693008011425036
4294,2022,11,NCAAF_20221112_PITT@UVA,Virginia,Cavaliers,Pittsburgh,Panthers,3-7,6-4,1,0,28,7,37,0,0,7,0,28,0,3,6,-3,-28,-28,-28,-30,0.4116891277950401,-3.777911460291307,0.19749630668147644,-13.05727033775861
4295,2022,11,NCAAF_20221112_PURDUE@ILL,Illinois,Fighting Illini,Purdue,Boilermakers,7-3,6-4,0,14,14,24,31,7,7,7,3,0,14,7,10,1,0,7,0,-7,0.27431120454349445,-10.152632305140287,0.6724641591338526,6.857579280827167
4296,2022,11,NCAAF_20221112_RUT@MICHST,Michigan St.,Spartans,Rutgers,Scarlet Knights,5-5,4-6,1,14,7,27,21,7,7,7,6,0,7,7,7,1,7,7,7,6,0.7873356169840648,13.49356252365078,0.7791770530168127,11.811080957505283
4297,2022,11,NCAAF_20221112_SMU@SFLA,South Florida,Bulls,SMU,Mustangs,1-9,6-4,0,17,17,23,41,0,17,0,6,10,7,21,3,-5,0,-10,0,-18,0.23934986988001017,-11.990280274831775,0.10563750174156916,-19.18939644542479
4298,2022,11,NCAAF_20221112_VANDY@UK,Kentucky,Wildcats,Vanderbilt,Commodores,6-4,4-6,0,6,7,21,24,6,0,3,12,7,0,7,10,2,-1,-1,-1,-3,0.8256122526103022,15.859077589568415,0.8470146351625534,15.714706984540953
4299,2022,11,NCAAF_20221112_VATECH@DUKE,Duke,Blue Devils,Virginia Tech,Hokies,7-3,2-8,1,10,7,24,7,3,7,7,7,7,0,0,0,5,3,-4,3,17,0.33698102272971964,-7.121036826743875,0.48521480568958486,-0.56904208086371
4300,2022,11,NCAAF_20221112_JMAD@ODU,Old Dominion,Monarchs,James Madison,Dukes,3-7,6-3,1,3,17,3,37,0,3,0,0,7,10,13,7,-3,-14,-7,-14,-34,0.1186984352605428,-19.998345305219118,,
4301,2022,11,NCAAF_20221112_LAMON@GAST,Georgia St.,Panthers,UL-Monroe,Warhawks,4-6,4-6,0,21,20,28,31,14,7,7,0,3,17,0,11,0,1,11,1,-3,0.6569342782826604,6.839963105020161,0.7708965177573944,11.38718275216388
4302,2022,11,NCAAF_20221112_LAMAR@NMEXST,New Mexico St.,Aggies,Lamar,Cardinals,4-5,1-9,0,37,0,51,14,17,20,14,0,0,0,7,7,3,37,17,37,37,0.9675137685849522,31.235991690098217,,
4303,2022,11,NCAAF_20221112_RICE@WKY,W. Kentucky,Hilltoppers,Rice,Owls,7-4,5-5,1,24,7,45,10,7,17,7,14,0,7,3,0,2,17,7,17,35,0.7865407876366903,13.447276353495909,0.9399752500004416,23.863661719518632
4304,2022,11,NCAAF_20221112_TEMPLE@HOU,Houston,Cougars,Temple,Owls,6-4,3-7,0,14,19,43,36,0,14,14,15,7,12,7,10,3,-5,-7,-5,7,0.7568177360489664,11.782213831020727,,
4305,2022,11,NCAAF_20221112_UMASS@ARKST,Arkansas St.,Red Wolves,UMass,Minutemen,3-7,1-9,0,14,6,35,33,14,0,21,0,3,3,13,14,2,8,11,8,2,0.8838747876803066,20.219458667398385,0.9473611340837828,24.864873357024862
4306,2022,11,NCAAF_20221112_APLST@MRSHL,Marshall,Thundering Herd,App. St.,Mountaineers,6-4,5-5,1,14,7,28,21,7,7,14,0,0,7,7,7,1,7,7,7,7,0.353035164251156,-6.383443371529438,0.29682493690431233,-8.190429052911895
4307,2022,11,NCAAF_20221112_ARIZST@WASHST,Washington St.,Cougars,Arizona St.,Sun Devils,6-4,3-7,1,28,0,28,18,13,15,0,0,0,0,6,12,3,28,13,28,10,0.5826205819328192,3.5307938664536778,0.8083292267623723,13.382056637645974
4308,2022,11,NCAAF_20221112_ARMY@TROY,Troy,Trojans,Army,Black Knights,8-2,3-6,0,0,9,10,9,0,0,3,7,0,9,0,0,5,-9,0,-9,1,0.36496494906818777,-5.843163151635281,0.5276939125517637,1.0664769222451014
4309,2022,11,NCAAF_20221112_BAMA@MISS,Ole Miss,Rebels,Alabama,Crimson Tide,8-2,8-2,1,17,14,24,30,7,10,7,0,0,14,10,6,0,3,7,3,-6,0.06926036895721954,-25.07281654096937,0.08487760243629672,-21.076358997091347
4310,2022,11,NCAAF_20221112_BC@NCST,NC State,Wolfpack,Boston College,Eagles,7-3,3-7,0,17,7,20,21,14,3,3,0,7,0,7,7,4,10,7,10,-1,0.6229464695497405,5.301696668792829,0.9288837086530294,22.527564436775037
4311,2022,11,NCAAF_20221112_CHARLO@MTSU,Middle Tenn.,Blue Raiders,Charlotte,49ers,5-5,2-9,0,7,14,24,14,0,7,7,10,0,14,0,0,3,-7,0,-7,10,0.7152596326227627,9.62777015463098,0.8197815647127734,14.038713697662843
4312,2022,11,NCAAF_20221112_IOWAST@OKLAST,Oklahoma State,Cowboys,Iowa St.,Cyclones,7-3,4-6,1,10,7,20,14,0,10,0,10,0,7,7,0,3,3,0,3,6,0.4615493173880114,-1.633885594597814,0.5167057503944934,0.642999839256845
4313,2022,11,NCAAF_20221112_LATECH@TXSA,UTSA,Roadrunners,Louisiana Tech,Bulldogs,8-2,3-7,0,34,7,51,7,21,13,10,7,7,0,0,0,5,27,14,27,44,0.4871113977957563,-0.5469214007064238,,
4314,2022,11,NCAAF_20221112_LVILLE@CLEM,Clemson,Tigers,Louisville,Cardinals,9-1,6-4,1,17,7,31,16,10,7,7,7,0,7,3,6,3,10,10,10,15,0.9046512963208431,22.14795109155625,0.5873250050889962,3.3874254237282457
4315,2022,11,NCAAF_20221112_MD@PSU,Penn State,Nittany Lions,Maryland,Terrapins,8-2,6-4,0,27,0,30,0,14,13,3,0,0,0,0,0,2,27,14,27,30,0.9061175387863573,22.29522606182104,0.7927466824534234,12.525990239310431
4316,2022,11,NCAAF_20221112_MIAMI@GATECH,Georgia Tech,Yellow Jackets,Miami (Fla.),Hurricanes,4-6,5-5,0,7,14,14,35,0,7,0,7,7,7,0,21,-1,-7,-7,-7,-21,0.2702348066963497,-10.360437652429482,0.20956495220246585,-12.40231061063264
4317,2022,11,NCAAF_20221112_NEB@MICH,Michigan,Wolverines,Nebraska,Cornhuskers,10-0,3-7,0,17,3,34,3,7,10,7,10,0,3,0,0,7,14,7,14,31,0.8764814151838008,19.593095329373227,0.9862857055410188,33.853857665392525
4318,2022,11,NCAAF_20221112_NMEX@AF,Air Force,Falcons,New Mexico,Lobos,7-3,2-8,0,14,0,35,3,14,0,14,7,0,0,3,0,5,14,14,14,32,0.8871647999031331,20.50729150551092,0.9550271478228901,26.02992573312622
4319,2022,11,NCAAF_20221112_NTEXAS@UAB,UAB,Blazers,North Texas,Mean Green,,5-5,0,17,21,41,21,14,3,10,14,0,21,0,0,,-4,14,-4,20,0.6059698942617864,4.550215284086335,0.5052151247823999,0.20067578313160084
4320,2022,11,NCAAF_20221112_NWEST@MINN,Minnesota,Golden Gophers,Northwestern,Wildcats,7-3,1-9,1,14,3,31,3,7,7,3,14,0,3,0,0,6,11,7,11,28,0.668453099239668,7.373726668241034,0.8867654680160255,18.566731836292092
4321,2022,11,NCAAF_20221112_UCF@TULANE,Tulane,Green Wave,UCF,Knights,8-2,8-2,0,14,24,31,38,7,7,3,14,17,7,7,7,0,-10,-10,-10,-7,0.23339362237730876,-12.317305742356893,,
4322,2022,11,NCAAF_20221112_WISC@IOWA,Iowa,Hawkeyes,Wisconsin,Badgers,6-4,5-5,1,14,10,24,10,0,14,0,10,3,7,0,0,1,4,-3,4,14,0.4435403785544818,-2.403471789467403,0.46002626873325914,-1.5407112226803292
4323,2022,11,NCAAF_20221112_SC@FLA,Florida,Gators,South Carolina,Gamecocks,6-4,6-4,1,24,6,38,6,21,3,7,7,0,6,0,0,0,18,21,18,32,0.7191776449258803,9.823838501783257,0.6608607133609258,6.367671403188751
4324,2022,11,NCAAF_20221112_TXSTSM@SALA,South Alabama,Jaguars,Texas St.,Bobcats,8-2,3-7,1,17,0,38,21,10,7,7,14,0,0,7,14,5,17,10,17,17,0.6124578137158667,4.836269930905246,0.7919546358482072,12.483522058602603
4325,2022,11,NCAAF_20221112_FAU@FIU,FIU,Panthers,FAU,Owls,4-6,5-5,1,7,31,7,52,0,7,0,0,21,10,14,7,-1,-24,-21,-24,-45,0.18669336788830648,-15.066609399932759,,
4326,2022,11,NCAAF_20221112_KANSAS@TXTECH,Texas Tech,Red Raiders,Kansas,Jayhawks,5-5,6-4,1,27,21,43,28,17,10,0,16,7,14,0,7,-1,6,10,6,15,0.8025594124271254,14.400594446708055,,
4327,2022,11,NCAAF_20221112_KSTATE@BAYLOR,Baylor,Bears,Kansas State,Wildcats,6-4,7-3,0,3,17,3,31,0,3,0,0,0,17,7,7,-1,-14,0,-14,-28,0.4702246987474613,-1.2644553464974706,0.4818646904324343,-0.6980596329849504
4328,2022,11,NCAAF_20221112_UGA@MISSST,Miss. State,Bulldogs,Georgia,Bulldogs,6-4,10-0,1,12,17,19,45,0,12,7,0,7,10,14,14,-4,-5,-7,-5,-26,0.17097853615516068,-16.084842488601907,0.09366483705429407,-20.240192607429435
4329,2022,11,NCAAF_20221112_WASH@OREG,Oregon,Ducks,Washington,Huskies,8-2,8-2,0,10,13,34,37,3,7,21,3,7,6,14,10,0,-3,-4,-3,-3,0.5348389826880467,1.4800013966280403,0.744717354487584,10.100106518697658
4330,2022,11,NCAAF_20221112_WYO@COLOST,Colorado St.,Rams,Wyoming,Cowboys,2-8,7-3,0,10,7,13,14,7,3,0,3,0,7,0,7,-5,3,7,3,-1,0.38910627758137206,-4.767185225476851,0.2067852263559843,-12.551133610837496
4331,2022,11,NCAAF_20221112_TCU@TEXAS,Texas,Longhorns,TCU,Horned Frogs,6-4,10-0,0,0,3,10,17,0,0,3,7,0,3,7,7,-4,-3,0,-3,-7,0.6060251921911983,4.552647790372248,,
4332,2022,11,NCAAF_20221112_TXAM@AUBURN,Auburn,Tigers,Texas A&M,Aggies,4-6,3-7,0,7,0,13,10,7,0,3,3,0,0,0,10,1,7,7,7,3,0.59970456396506,4.275203703950183,,
4333,2022,11,NCAAF_20221112_UNC@WAKE,Wake Forest,Demon Deacons,North Carolina,Tar Heels,6-4,9-1,1,21,27,34,36,7,14,13,0,14,13,6,3,-3,-6,-7,-6,-2,0.534254462514093,1.455108495914601,0.49916624021787903,-0.032081831309596964
4334,2022,11,NCAAF_20221112_USM@CSTCAR,C. Carolina,Chanticleers,So. Miss,Golden Eagles,9-1,5-5,1,17,17,26,23,17,0,3,6,0,17,3,3,4,0,17,0,3,0.5960533755675899,4.115461370787671,0.7111396190373941,8.545992059524451
4335,2022,11,NCAAF_20221112_FSU@CUSE,Syracuse,Orange,Florida State,Seminoles,6-4,7-3,1,3,24,3,38,0,3,0,0,14,10,14,0,-1,-21,-14,-21,-35,0.4362898229258729,-2.7146323112965547,0.32339613561261416,-7.0340394211687
4336,2022,11,NCAAF_20221112_CAL@OREGST,Oregon State,Beavers,California,Golden Bears,7-3,3-7,0,21,7,38,10,14,7,10,7,0,7,0,3,4,14,14,14,28,0.3771027758264083,-5.299502323627621,0.6100181582227553,4.288466970320542
4337,2022,11,NCAAF_20221112_STNFRD@UTAH,Utah,Utes,Stanford,Cardinal,8-2,3-7,1,14,7,42,7,0,14,21,7,7,0,0,0,5,7,-7,7,35,0.7599514754434233,11.952214893494101,0.9538282235195934,25.837715890219897
4338,2022,11,NCAAF_20221112_ARIZ@UCLA,UCLA,Bruins,Arizona,Wildcats,8-2,4-6,0,14,21,28,34,0,14,7,7,14,7,0,13,4,-7,-14,-7,-6,0.6864024160386569,8.220579323948414,0.9168693881855097,21.250233301630033
4339,2022,11,NCAAF_20221112_BOISE@NEVADA,Nevada,Wolf Pack,Boise St.,Broncos,2-8,7-3,0,3,21,3,41,0,3,0,0,14,7,17,3,-5,-18,-14,-18,-38,0.191337430033525,-14.776006863113935,0.16898156034803846,-14.708996440182545
4340,2022,11,NCAAF_20221112_SJST@SDGST,San Diego St.,Aztecs,San Jose St.,Spartans,6-4,6-3,0,24,14,43,27,7,17,14,5,14,0,6,7,0,10,-7,10,16,0.774239249808099,12.743239942008358,,
4341,2022,11,NCAAF_20221112_UTAHST@HAWAII,Hawaii,Rainbow Warriors,Utah St.,Aggies,2-9,5-5,1,10,24,34,41,0,10,7,17,10,14,10,7,-3,-14,-10,-14,-7,0.25691489772700526,-11.050729012618149,0.16612920321444813,-14.883646369639337
4342,2022,11,NCAAF_20221111_ECU@CINCY,Cincinnati,Bearcats,East Carolina,Pirates,8-2,6-4,1,24,12,27,25,7,17,0,3,5,7,13,0,2,12,2,12,2,0.8673627882421182,18.85571969378202,,
4343,2022,11,NCAAF_20221111_COLO@USC,USC,Trojans,Colorado,Buffaloes,9-1,1-9,0,26,3,55,17,2,24,15,14,3,0,7,7,8,23,-1,23,38,0.7955644728715514,13.978854180540111,0.956155947231581,26.214700606714132
4344,2022,11,NCAAF_20221111_FRESNO@UNLV,UNLV,Rebels,Fresno St.,Bulldogs,4-6,6-4,1,16,14,30,37,10,6,3,11,7,7,10,13,-2,2,3,2,-7,0.15517386927114662,-17.171273108544483,0.2300203059520125,-11.340783897626125
4345,2022,11,NCAAF_20221110_GAS@UL,Louisiana,Ragin' Cajuns,Ga. Southern,Eagles,5-5,5-5,0,27,7,36,17,7,20,3,6,0,7,7,3,0,20,7,20,19,0.6967540652827618,8.718356309095725,0.5874140055016839,3.3909345163845046
4346,2022,11,NCAAF_20221110_TULSA@MEMP,Memphis,Tigers,Tulsa,Golden Hurricane,5-5,3-7,1,20,3,26,10,10,10,3,3,3,0,0,7,2,17,7,17,16,0.7121460295249525,9.472874064350208,,
4347,2022,11,NCAAF_20221109_BUFF@CMICH,C. Michigan,Chippewas,Buffalo,Bulls,4-6,5-5,0,7,24,31,27,7,0,17,7,7,17,0,3,-1,-17,0,-17,4,0.4067513535510383,-3.993001499137563,0.6006489486450017,3.914843770388188
4348,2022,11,NCAAF_20221109_KENTST@BGREEN,Bowling Green,Falcons,Kent St.,Golden Flashes,5-5,4-6,0,0,20,6,40,0,0,6,0,0,20,3,17,1,-20,0,-20,-34,0.32012267911305714,-7.910450320535574,,
4349,2022,11,NCAAF_20221109_NILL@WMICH,W. Michigan,Broncos,N. Illinois,Huskies,3-7,3-7,0,14,10,21,24,7,7,7,0,3,7,7,7,0,4,4,4,-3,0.528426254106739,1.2070663871852503,0.32470035342372006,-6.978346248931757
4350,2022,11,NCAAF_20221108_EMICH@AKRON,Akron,Zips,E. Michigan,Eagles,1-9,6-4,0,14,24,28,34,7,7,0,14,10,14,7,3,-5,-10,-3,-10,-6,0.17426273102653478,-15.86730654038729,0.25636309955759073,-10.048542132179136
4351,2022,11,NCAAF_20221108_OHIO@MIAOH,Miami-OH,RedHawks,Ohio,Bobcats,4-6,7-3,1,7,10,21,37,0,7,7,7,7,3,14,13,-3,-3,-7,-3,-16,0.40699784697941654,-3.9822491998597798,0.5238335502654541,0.9176249595464014
4352,2022,11,NCAAF_20221108_BALLST@TOLEDO,Toledo,Rockets,Ball St.,Cardinals,7-3,5-5,0,14,14,28,21,7,7,7,7,7,7,7,0,2,0,0,0,7,0.7469551712761261,11.254734367312722,0.7919994198689152,12.48592075120564
4353,2022,12,NCAAF_20221119_NAVY@UCF,UCF,Knights,Navy,Midshipmen,8-3,4-7,0,6,14,14,17,0,6,8,0,7,7,3,0,4,-8,-7,-8,-3,0.8012366857732482,14.315413146261562,0.7486718472777728,10.210213518226283
4354,2022,12,NCAAF_20221119_AP@BAMA,Alabama,Crimson Tide,Austin Peay,Governors,9-2,7-4,1,17,0,34,0,7,10,10,7,0,0,0,0,2,17,7,17,34,0.999781193190585,59.496971134083196,,
4355,2022,12,NCAAF_20221119_DUKE@PITT,Pittsburgh,Panthers,Duke,Blue Devils,7-4,7-4,0,20,14,28,26,10,10,0,8,7,7,0,12,0,6,3,6,2,0.7088604459471354,9.307189031217376,0.7041837584528859,8.171506205530477
4356,2022,12,NCAAF_20221119_ETNST@MISSST,Miss. State,Bulldogs,ETSU,Buccaneers,7-4,3-8,1,35,0,56,7,14,21,14,7,0,0,0,7,4,35,14,35,49,0.9907597259420433,39.86176251541838,,
4357,2022,12,NCAAF_20221119_FLA@VANDY,Vanderbilt,Commodores,Florida,Gators,5-6,6-5,1,14,6,31,24,0,14,14,3,3,3,6,12,-1,8,-3,8,7,0.09821227904235097,-21.85780635656465,0.1640524102469253,-14.895896522226394
4358,2022,12,NCAAF_20221119_ILL@MICH,Michigan,Wolverines,Illinois,Fighting Illini,11-0,7-4,1,7,3,19,17,7,0,3,9,0,3,14,0,4,4,7,4,2,0.9317458870617841,25.193069690151333,0.8962328139213824,19.197943463623233
4359,2022,12,NCAAF_20221119_NWEST@PURDUE,Purdue,Boilermakers,Northwestern,Wildcats,7-4,1-10,1,14,3,17,9,7,7,0,3,0,3,0,6,6,11,7,11,8,0.6481594344023878,6.43575977226601,0.8448042222085403,15.451290032848647
4360,2022,12,NCAAF_20221119_TCU@BAYLOR,Baylor,Bears,TCU,Horned Frogs,6-5,11-0,1,14,14,28,29,7,7,0,14,7,7,6,9,-5,0,0,0,-1,0.4262618831049978,-3.1454815442702966,0.47360430256075436,-1.0085454816826314
4361,2022,12,NCAAF_20221119_UCONN@ARMY,Army,Black Knights,UConn,Huskies,4-6,6-6,0,13,10,34,17,7,6,14,7,3,7,7,0,-2,3,4,3,17,0.9066067274490339,22.337326453701053,0.7028191801225989,8.111405385724538
4362,2022,12,NCAAF_20221119_UL@FSU,Florida State,Seminoles,Louisiana,Ragin' Cajuns,8-3,5-6,1,35,3,49,17,21,14,14,0,0,3,0,14,3,32,21,32,32,0.6596419570157863,6.962492274194119,0.8621852298648081,16.60570399988137
4363,2022,12,NCAAF_20221119_UMASS@TXAM,Texas A&M,Aggies,UMass,Minutemen,4-7,1-10,1,10,3,20,3,3,7,3,7,0,3,0,0,3,7,3,7,17,0.9936107172785749,42.12968272571493,0.9927714953104415,37.25279515373131
4364,2022,12,NCAAF_20221119_VATECH@LIB,Liberty,Flames,Virginia Tech,Hokies,8-3,3-8,0,17,17,22,23,7,10,5,0,7,10,0,6,5,0,0,0,-1,0.28034731905490473,-9.844432952276065,0.5999132243758657,3.8555463370094003
4365,2022,12,NCAAF_20221119_WISC@NEB,Nebraska,Cornhuskers,Wisconsin,Badgers,3-8,6-5,1,7,0,14,15,0,7,7,0,0,0,3,12,-3,7,0,7,-1,0.18977545712403288,-14.868323618176873,0.18873214770135738,-13.443374357878383
4366,2022,12,NCAAF_20221119_TXSA@RICE,Rice,Owls,UTSA,Roadrunners,5-6,9-2,0,0,28,7,41,0,0,0,7,21,7,13,0,-4,-28,-21,-28,-34,0.27607798688605767,-10.059702398259105,,
4367,2022,12,NCAAF_20221119_GAST@JMAD,James Madison,Dukes,Georgia St.,Panthers,7-3,4-7,0,14,34,42,40,7,7,21,7,10,24,0,6,3,-20,-3,-20,2,0.8365842636047661,16.5906796950012,,
4368,2022,12,NCAAF_20221119_HOU@ECU,East Carolina,Pirates,Houston,Cougars,6-5,7-4,1,0,21,3,42,0,0,3,0,7,14,14,7,-1,-21,-7,-21,-39,0.24589308980700553,-11.632248282425508,,
4369,2022,12,NCAAF_20221119_KSTATE@WVU,West Virginia,Mountaineers,Kansas State,Wildcats,4-7,8-3,0,25,41,31,48,19,6,0,6,28,13,0,7,-4,-16,-9,-16,-17,0.45050864449888195,-2.1044922864857654,0.17676936374569463,-14.131387884254309
4370,2022,12,NCAAF_20221119_NAL@MEMP,Memphis,Tigers,North Alabama,Lions,6-5,1-10,1,38,0,59,0,14,24,14,7,0,0,0,0,5,38,14,38,59,0.9872102034248873,37.77529463506107,,
4371,2022,12,NCAAF_20221119_WASHST@ARIZ,Arizona,Wildcats,Washington St.,Cougars,4-7,7-4,0,6,21,20,31,0,6,0,14,7,14,10,0,-3,-15,-7,-15,-11,0.23324537731897177,-12.321414468721514,0.13055285278045425,-17.117371456223736
4372,2022,12,NCAAF_20221119_OREGST@ARIZST,Arizona St.,Sun Devils,Oregon State,Beavers,3-8,8-3,1,7,14,7,31,0,7,0,0,7,7,14,3,-5,-7,-7,-7,-24,0.6666724746694894,7.288329440956886,0.21501108986879358,-12.020340487342764
4373,2022,12,NCAAF_20221119_BC@ND,Notre Dame,Fighting Irish,Boston College,Eagles,8-3,3-8,1,37,0,44,0,17,20,7,0,0,0,0,0,5,37,17,37,44,0.8528016603670214,17.74142015238226,0.9589492523312351,26.48256397002433
4374,2022,12,NCAAF_20221119_ODU@APLST,App. St.,Mountaineers,Old Dominion,Monarchs,6-5,3-8,0,24,0,27,14,10,14,3,0,0,0,0,14,3,24,10,24,13,0.9000242217199759,21.686643976837104,0.7888187697402859,12.221031416016103
4375,2022,12,NCAAF_20221119_FAU@MTSU,Middle Tenn.,Blue Raiders,FAU,Owls,6-5,5-6,1,28,14,49,21,14,14,14,7,7,7,7,0,1,14,7,14,28,0.33944926166969525,-7.004463189355647,0.38231597670633044,-4.560500415331262
4376,2022,12,NCAAF_20221119_LAMON@TROY,Troy,Trojans,UL-Monroe,Warhawks,9-2,4-7,1,20,3,34,16,3,17,7,7,0,3,7,6,5,17,3,17,18,0.763350819071799,12.133972022132866,0.6637599717165907,6.439252142321038
4377,2022,12,NCAAF_20221119_LATECH@CHARLO,Charlotte,49ers,Louisiana Tech,Bulldogs,3-9,3-8,0,13,7,26,21,0,13,6,7,0,7,0,14,0,6,0,6,5,0.3078776825901982,-8.491905658048836,,
4378,2022,12,NCAAF_20221119_MIAMI@CLEM,Clemson,Tigers,Miami (Fla.),Hurricanes,10-1,5-6,1,24,0,40,10,14,10,2,14,0,0,3,7,5,24,14,24,30,0.8590224159176452,18.205246884465396,0.8985900011654284,19.39876154701051
4379,2022,12,NCAAF_20221119_NCST@LVILLE,Louisville,Cardinals,NC State,Wolfpack,7-4,7-4,1,13,3,25,10,0,13,0,12,0,3,7,0,0,10,0,10,15,0.4367651383448167,-2.6933131668056376,0.541855323718475,1.6010131421103324
4380,2022,12,NCAAF_20221119_OHIOST@MD,Maryland,Terrapins,Ohio State,Buckeyes,6-5,11-0,0,13,10,30,43,6,7,0,17,7,3,17,16,-5,3,-1,3,-13,0.026787360853975928,-32.66067355282735,0.03502850085652165,-27.59329527425143
4381,2022,12,NCAAF_20221119_PSU@RUT,Rutgers,Scarlet Knights,Penn State,Nittany Lions,4-7,9-2,0,10,28,10,55,10,0,0,0,14,14,20,7,-5,-18,-4,-18,-45,0.0451057821917733,-28.667867192292306,0.0365760272135468,-27.293818601942803
4382,2022,12,NCAAF_20221119_SALA@USM,So. Miss,Golden Eagles,South Alabama,Jaguars,5-6,9-2,0,10,13,20,27,7,3,7,3,3,10,0,14,-4,-3,4,-3,-7,0.589459842192741,3.8266351004872377,0.23078767299604186,-11.214595282292521
4383,2022,12,NCAAF_20221119_TEXAS@KANSAS,Kansas,Jayhawks,Texas,Longhorns,6-5,7-4,0,0,31,14,55,0,0,7,7,14,17,10,14,-1,-31,-14,-31,-41,0.07140013963571268,-24.795805416690882,0.19239040795372242,-13.238401265120501
4384,2022,12,NCAAF_20221119_UGA@UK,Kentucky,Wildcats,Georgia,Bulldogs,6-5,11-0,1,0,9,6,16,0,0,0,6,3,6,7,0,-5,-9,-3,-9,-10,0.11552847593206095,-20.264505574152736,0.0742645967350597,-22.006284733355415
4385,2022,12,NCAAF_20221119_UTTCH@BYU,BYU,Cougars,Utah Tech,Trailblazers,6-5,4-7,1,28,20,52,26,0,28,7,17,6,14,0,6,2,8,-6,8,26,,,,
4386,2022,12,NCAAF_20221119_CINCY@TEMPLE,Temple,Owls,Cincinnati,Bearcats,3-8,9-2,1,3,17,3,23,0,3,0,0,7,10,3,3,-6,-14,-7,-14,-20,0.13919204006618413,-18.340929904338964,0.027475134641923415,-29.23419066884253
4387,2022,12,NCAAF_20221119_FIU@UTEP,UTEP,Miners,FIU,Panthers,5-6,4-7,1,38,0,40,6,14,24,0,2,0,0,0,6,1,38,14,38,34,0.40402752586511825,-4.110561922911302,,
4388,2022,12,NCAAF_20221119_IOWA@MINN,Minnesota,Golden Gophers,Iowa,Hawkeyes,7-4,7-4,1,7,10,10,13,0,7,3,0,10,0,0,3,0,-3,-10,-3,-3,0.34859770030845094,-6.583865369199657,0.5446156561490068,1.7070282763970681
4389,2022,12,NCAAF_20221119_WKY@AUBURN,Auburn,Tigers,W. Kentucky,Hilltoppers,5-6,7-5,0,17,17,41,17,10,7,10,14,0,17,0,0,-2,0,10,0,24,0.9145115094312493,23.165173924303645,,
4390,2022,12,NCAAF_20221119_ARKST@TXSTSM,Texas St.,Bobcats,Arkansas St.,Red Wolves,4-7,3-8,1,3,7,16,13,3,0,0,13,0,7,3,3,1,-4,3,-4,3,0.26561092328903657,-10.594544380910747,0.498436617848352,-0.05969134550286981
4391,2022,12,NCAAF_20221119_GATECH@UNC,North Carolina,Tar Heels,Georgia Tech,Yellow Jackets,9-2,5-6,0,17,7,17,21,7,10,0,0,0,7,7,7,4,10,7,10,-4,0.6732903615208814,7.597530132310567,0.9109300588408894,20.509872948882276
4392,2022,12,NCAAF_20221119_STNFRD@CAL,California,Golden Bears,Stanford,Cardinal,4-7,3-8,0,6,10,27,20,6,0,0,21,10,0,7,3,1,-4,-4,-4,7,0.4885573102339855,-0.4853858486394529,0.7363369191044382,9.628000374219027
4393,2022,12,NCAAF_20221119_MRSHL@GAS,Ga. Southern,Eagles,Marshall,Thundering Herd,5-6,7-4,0,10,20,10,23,3,7,0,0,6,14,3,0,-2,-10,-3,-10,-13,0.27763944087692083,-9.980783190690317,0.3058994924076722,-7.730318401105706
4394,2022,12,NCAAF_20221119_BOISE@WYO,Wyoming,Cowboys,Boise St.,Broncos,7-4,8-3,0,10,6,17,20,7,3,7,0,0,6,7,7,-1,4,7,4,-3,0.2307325053654612,-12.460770054663499,0.16285223195126763,-14.969992881223789
4395,2022,12,NCAAF_20221119_TENN@SC,South Carolina,Gamecocks,Tennessee,Volunteers,7-4,9-2,1,35,24,63,38,21,14,7,21,7,17,7,7,-2,11,14,11,25,0.4122938226510927,-3.750368845436469,0.01893301441879036,-31.62610398724155
4396,2022,12,NCAAF_20221119_TXTECH@IOWAST,Iowa St.,Cyclones,Texas Tech,Red Raiders,4-7,6-5,0,3,7,10,14,0,3,0,7,0,7,0,7,-2,-4,0,-4,-4,0.7296699472758784,10.35212899322255,,
4397,2022,12,NCAAF_20221119_MISS@ARK,Arkansas,Razorbacks,Ole Miss,Rebels,6-5,8-3,0,35,6,42,27,14,21,7,0,3,3,0,21,-2,29,11,29,15,0.3079168558649915,-8.490021263149629,0.4275725602866196,-2.780706784747508
4398,2022,12,NCAAF_20221119_NMEXST@MIZZOU,Missouri,Tigers,New Mexico St.,Aggies,5-6,4-6,0,21,0,45,14,7,14,14,10,0,0,7,7,1,21,7,21,31,0.9552985127498443,28.740162756549353,,
4399,2022,12,NCAAF_20221119_OKLAST@OKLA,Oklahoma,Sooners,Oklahoma State,Cowboys,6-5,7-4,1,28,3,28,13,28,0,0,0,0,3,7,3,-1,25,28,25,15,0.6611858786040576,7.033821930695922,0.479178002003805,-0.7953619832546792
4400,2022,12,NCAAF_20221119_CUSE@WAKE,Wake Forest,Demon Deacons,Syracuse,Orange,7-4,6-5,0,24,21,45,35,3,21,7,14,7,14,0,14,1,3,-4,3,10,0.6294868386112444,5.592085092256184,0.573036197634469,2.8043435668241727
4401,2022,12,NCAAF_20221119_USC@UCLA,UCLA,Bruins,USC,Trojans,8-3,10-1,0,21,20,45,48,14,7,10,14,0,20,14,14,-2,1,14,1,-3,0.38329944200306487,-5.022411958846533,0.5621225157007341,2.3815556506019675
4402,2022,12,NCAAF_20221119_COLO@WASH,Washington,Huskies,Colorado,Buffaloes,9-2,1-10,0,33,0,54,7,14,19,14,7,0,0,7,0,8,33,14,33,47,0.8533662306927952,17.782964277608926,0.9207540784047032,21.479501172531855
4403,2022,12,NCAAF_20221119_COLOST@AF,Air Force,Falcons,Colorado St.,Rams,8-3,2-9,0,17,0,24,12,7,10,7,0,0,0,6,6,6,17,7,17,12,0.7619805540728983,12.058933224159546,0.9667203483216477,27.945097112320582
4404,2022,12,NCAAF_20221119_UAB@LSU,LSU,Tigers,UAB,Blazers,9-2,5-6,1,28,10,41,10,14,14,6,7,7,3,0,0,4,18,7,18,31,0.8939846571449037,21.116621213735243,0.8384309927519318,15.049610222723004
4405,2022,12,NCAAF_20221119_SJST@UTAHST,Utah St.,Aggies,San Jose St.,Spartans,6-5,6-4,0,21,13,35,31,7,14,7,7,6,7,10,8,0,8,1,8,4,0.7465916155714508,11.231773338521407,,
4406,2022,12,NCAAF_20221119_FRESNO@NEVADA,Nevada,Wolf Pack,Fresno St.,Bulldogs,2-9,7-4,1,0,24,14,41,0,0,7,7,17,7,3,14,-5,-24,-17,-24,-27,0.2806503719618797,-9.829213140940738,0.1577362152002455,-15.28990166833546
4407,2022,12,NCAAF_20221119_UTAH@OREG,Oregon,Ducks,Utah,Utes,9-2,8-3,1,17,3,20,17,7,10,0,3,3,0,14,0,1,14,4,14,3,0.46328255647104044,-1.5595036229831294,0.28586769897340325,-8.613623643454048
4408,2022,12,NCAAF_20221119_UNLV@HAWAII,Hawaii,Rainbow Warriors,UNLV,Rebels,3-9,4-7,0,7,13,31,25,7,0,14,10,6,7,3,9,-1,-6,1,-6,6,0.5432480128504236,1.8378873970439145,0.2714603520571809,-9.2671459160606
4409,2022,12,NCAAF_20221118_SFLA@TULSA,Tulsa,Golden Hurricane,South Florida,Bulls,4-7,1-10,0,31,20,48,42,7,24,7,10,10,10,15,7,3,11,-3,11,6,0.6104630933127284,4.746603426793399,0.7203168104624305,8.892145260331745
4410,2022,12,NCAAF_20221118_SDGST@NMEX,New Mexico,Lobos,San Diego St.,Aztecs,2-9,7-4,1,10,21,10,34,7,3,0,0,7,14,10,3,-5,-11,0,-11,-24,0.14681420948673507,-17.769674869749224,0.16493741582297927,-14.841483244580104
4411,2022,12,NCAAF_20221117_SMU@TULANE,Tulane,Green Wave,SMU,Mustangs,9-2,6-5,0,28,7,59,24,21,7,21,10,0,7,7,10,3,21,21,21,35,0.43037220733536596,-2.9682810548695215,0.635076283421333,5.26002221705312
4412,2022,12,NCAAF_20221116_EMICH@KENTST,Kent St.,Golden Flashes,E. Michigan,Eagles,4-7,7-4,0,17,7,24,31,7,10,0,7,7,0,10,14,-3,10,0,10,-7,0.33827599048403667,-7.058713087468959,0.7091018031710178,8.389182669917773
4413,2022,12,NCAAF_20221116_MIAOH@NILL,N. Illinois,Huskies,Miami-OH,RedHawks,3-8,5-6,0,10,16,23,29,10,0,13,0,2,14,10,3,-2,-6,8,-6,-6,0.5004650879037119,0.019725797395949485,0.5359860305262437,1.3758442922426184
4414,2022,12,NCAAF_20221116_WMICH@CMICH,C. Michigan,Chippewas,W. Michigan,Broncos,4-7,4-7,1,7,7,10,12,7,0,3,0,7,0,0,5,0,0,0,0,-2,0.4710286174592593,-1.22984650063745,0.7096610036661011,8.414041309007189
4415,2022,12,NCAAF_20221115_BGREEN@TOLEDO,Toledo,Rockets,Bowling Green,Falcons,7-4,6-5,1,14,21,35,42,0,14,0,21,14,7,6,15,1,-7,-14,-7,-7,0.8967193403200833,21.371721175673883,,
4416,2022,12,NCAAF_20221115_OHIO@BALLST,Ball St.,Cardinals,Ohio,Bobcats,5-6,8-3,1,3,17,18,32,3,0,8,7,0,17,2,13,-3,-14,3,-14,-14,0.27586530858230407,-10.07046852763824,0.3487987102054777,-5.918609273028778
4417,2022,13,NCAAF_20221126_ARMY@UMASS,UMass,Minutemen,Army,Black Knights,1-11,5-6,1,7,28,7,44,7,0,0,0,7,21,0,16,-4,-21,0,-21,-37,0.048764083366819144,-28.0306098481999,0.05438611763740531,-24.21395740202479
4418,2022,13,NCAAF_20221126_CSTCAR@JMAD,James Madison,Dukes,C. Carolina,Chanticleers,8-3,9-2,0,20,7,47,7,3,17,20,7,7,0,0,0,-1,13,-4,13,40,0.7294235021964968,10.337428777224886,,
4419,2022,13,NCAAF_20221126_GAST@MRSHL,Marshall,Thundering Herd,Georgia St.,Panthers,8-4,4-8,0,14,10,28,23,0,14,0,14,7,3,7,6,4,4,-7,4,5,0.736256344296023,10.688893674088831,0.5773709819910398,2.94680316195263
4420,2022,13,NCAAF_20221126_GATECH@UGA,Georgia,Bulldogs,Georgia Tech,Yellow Jackets,12-0,5-7,0,10,7,37,14,3,7,13,14,7,0,0,7,7,3,-4,3,23,0.9669783995310536,31.095504684571097,0.9980649664754265,43.61287207810551
4421,2022,13,NCAAF_20221126_MICH@OHIOST,Ohio State,Buckeyes,Michigan,Wolverines,11-1,12-0,1,20,17,23,45,10,10,0,3,3,14,7,21,-1,3,7,3,-22,0.69519299997302,8.638194423923096,0.5320175353067182,1.2130472590849877
4422,2022,13,NCAAF_20221126_NMEXST@LIB,Liberty,Flames,New Mexico St.,Aggies,,6-6,0,7,28,14,49,7,0,0,7,7,21,14,7,,-21,0,-21,-35,0.8187494241472801,15.404708787919844,0.9074663003564558,20.010193454083037
4423,2022,13,NCAAF_20221126_ODU@SALA,South Alabama,Jaguars,Old Dominion,Monarchs,10-2,3-9,0,13,20,27,20,7,6,7,7,10,10,0,0,7,-7,-3,-7,7,0.5496670093414455,2.111571545819288,0.7792935855518981,11.622945635573387
4424,2022,13,NCAAF_20221126_RUT@MD,Maryland,Terrapins,Rutgers,Scarlet Knights,7-5,4-8,0,17,0,37,0,0,17,13,7,0,0,0,0,3,17,0,17,37,0.6528784997483172,6.650101500076289,0.8785322120396641,17.63018945337717
4425,2022,13,NCAAF_20221126_SC@CLEM,Clemson,Tigers,South Carolina,Gamecocks,10-2,8-4,0,23,14,30,31,14,9,7,0,0,14,14,3,2,9,14,9,-1,0.8988933775378103,21.573662458856916,0.7477131114957125,10.075366948637793
4426,2022,13,NCAAF_20221126_WVU@OKLAST,Oklahoma State,Cowboys,West Virginia,Mountaineers,7-5,5-7,1,10,7,19,24,0,10,9,0,7,0,14,3,2,3,-7,3,-5,0.6410567395957386,6.111826980735714,0.5983363522184596,3.76017202508433
4427,2022,13,NCAAF_20221126_ECU@TEMPLE,Temple,Owls,East Carolina,Pirates,3-9,7-5,0,24,28,46,49,3,21,15,7,7,21,14,7,-4,-4,-4,-4,-3,0.5109057745241572,0.46251077633951354,,
4428,2022,13,NCAAF_20221126_AKRON@NILL,N. Illinois,Huskies,Akron,Zips,3-9,2-9,1,6,20,12,44,6,0,3,3,0,20,7,17,1,-14,6,-14,-32,0.8215579368020882,15.585872976221026,,
4429,2022,13,NCAAF_20221126_RICE@NTEXAS,North Texas,Mean Green,Rice,Owls,7-5,5-7,1,14,14,21,17,7,7,0,7,0,14,0,3,2,0,7,0,4,0.7457415467556233,11.184601240345728,0.8570299165325963,16.11112376783649
4430,2022,13,NCAAF_20221126_LVILLE@UK,Kentucky,Wildcats,Louisville,Cardinals,7-5,7-5,1,13,7,26,13,7,6,10,3,0,7,0,6,0,6,7,6,13,0.5943015196410447,4.036787413549405,0.5621920400573642,2.363350750629934
4431,2022,13,NCAAF_20221126_AUBURN@BAMA,Alabama,Crimson Tide,Auburn,Tigers,10-2,5-7,0,35,14,49,27,14,21,7,7,7,7,7,6,5,21,7,21,22,0.8319142495392362,16.26997271885159,,
4432,2022,13,NCAAF_20221126_HAWAII@SJST,San Jose St.,Spartans,Hawaii,Rainbow Warriors,7-4,3-10,0,14,6,27,14,7,7,7,6,0,6,0,8,4,8,7,8,13,0.4943709921162499,-0.23870279698553531,0.8070721069991634,13.092747506036858
4433,2022,13,NCAAF_20221126_ILL@NWEST,Northwestern,Wildcats,Illinois,Fighting Illini,1-11,8-4,0,0,17,3,41,0,0,0,3,7,10,17,7,-7,-17,-7,-17,-38,0.5766648484772288,3.2712012522165423,0.0896141460863662,-20.279278873756994
4434,2022,13,NCAAF_20221126_MEMP@SMU,SMU,Mustangs,Memphis,Tigers,7-5,6-6,0,14,17,34,31,0,14,10,10,7,10,6,8,1,-3,-7,-3,3,0.42824298065179733,-3.0594111410350706,0.4133407434531996,-3.305955024567311
4435,2022,13,NCAAF_20221126_MINN@WISC,Wisconsin,Badgers,Minnesota,Golden Gophers,6-6,8-4,1,6,10,16,23,3,3,10,0,7,3,3,10,-2,-4,-4,-4,-7,0.6859625571376691,8.195203127524337,0.4351095701026363,-2.466789710092371
4436,2022,13,NCAAF_20221126_OREG@OREGST,Oregon State,Beavers,Oregon,Ducks,9-3,9-3,1,10,14,38,34,10,0,7,21,7,7,17,3,0,-4,3,-4,4,0.18069573603928601,-15.440358531334368,0.406826749638863,-3.558941697492628
4437,2022,13,NCAAF_20221126_PURDUE@IND,Indiana,Hoosiers,Purdue,Boilermakers,4-8,8-4,0,7,3,16,30,7,0,0,9,3,0,14,13,-4,4,4,4,-14,0.3705196477802726,-5.590659215206415,,
4438,2022,13,NCAAF_20221126_TROY@ARKST,Arkansas St.,Red Wolves,Troy,Trojans,3-9,10-2,0,13,7,19,48,3,10,6,0,7,0,7,34,-7,6,-4,6,-29,0.4224231133843779,-3.3106144705154747,0.21885944484529696,-11.717180413341111
4439,2022,13,NCAAF_20221126_UAB@LATECH,Louisiana Tech,Bulldogs,UAB,Blazers,3-9,6-6,1,6,17,27,37,3,3,14,7,0,17,20,0,-3,-11,3,-11,-10,0.34737835392734095,-6.638336456404431,,
4440,2022,13,NCAAF_20221126_UTEP@TXSA,UTSA,Roadrunners,UTEP,Miners,10-2,5-7,1,14,24,34,31,0,14,17,3,14,10,7,0,5,-10,-14,-10,3,0.7684922977777705,12.415169191233872,,
4441,2022,13,NCAAF_20221126_WAKE@DUKE,Duke,Blue Devils,Wake Forest,Demon Deacons,8-4,7-5,1,20,17,34,31,3,17,7,7,7,10,7,7,1,3,-4,3,3,0.3000361191087735,-8.86948440575702,0.3582073357524873,-5.484588441976257
4442,2022,13,NCAAF_20221126_IOWAST@TCU,TCU,Horned Frogs,Iowa St.,Cyclones,12-0,4-8,1,34,7,62,14,24,10,21,7,0,7,0,7,8,27,24,27,48,0.4064780348688798,-4.002784309737763,0.5228589844014591,0.8656006759526917
4443,2022,13,NCAAF_20221126_MICHST@PSU,Penn State,Nittany Lions,Michigan St.,Spartans,10-2,5-7,0,14,3,35,16,7,7,7,14,0,3,7,6,5,11,7,11,19,0.8221664483227251,15.625361235401442,,
4444,2022,13,NCAAF_20221126_UTAH@COLO,Colorado,Buffaloes,Utah,Utes,1-11,9-3,1,0,42,21,63,0,0,14,7,14,28,14,7,-8,-42,-14,-42,-42,0.10634600173334463,-21.081818976269687,0.005729484286295161,-38.17468947974908
4445,2022,13,NCAAF_20221126_UL@TXSTSM,Texas St.,Bobcats,Louisiana,Ragin' Cajuns,4-8,6-6,1,6,20,13,41,3,3,7,0,7,13,7,14,-2,-14,-4,-14,-28,0.15297745214539749,-17.318642394411427,0.2980994727372551,-8.000292969148859
4446,2022,13,NCAAF_20221126_USM@LAMON,UL-Monroe,Warhawks,So. Miss,Golden Eagles,4-8,6-6,0,7,10,10,20,0,7,3,0,10,0,0,10,-2,-3,-10,-3,-10,0.3303097798697896,-7.427508089274852,0.39643680352451793,-3.964569507203123
4447,2022,13,NCAAF_20221126_MTSU@FIU,FIU,Panthers,Middle Tenn.,Blue Raiders,4-8,7-5,0,7,20,28,33,0,7,14,7,6,14,7,6,-3,-13,-6,-13,-5,0.2770582627931608,-10.008099311140086,,
4448,2022,13,NCAAF_20221126_NEVADA@UNLV,UNLV,Rebels,Nevada,Wolf Pack,5-7,2-10,1,17,13,27,22,7,10,0,10,13,0,3,6,3,4,-6,4,5,0.34167069626597346,-6.900543169566845,0.6032391564810482,3.9518770541471895
4449,2022,13,NCAAF_20221126_LSU@TXAM,Texas A&M,Aggies,LSU,Tigers,5-7,9-3,0,17,10,38,23,7,10,7,14,0,10,7,6,-4,7,7,7,15,0.39564011913263586,-4.477037955953392,0.18559294851733243,-13.501868047546168
4450,2022,13,NCAAF_20221126_UCF@SFLA,South Florida,Bulls,UCF,Knights,1-11,9-3,0,7,28,39,46,0,7,22,10,14,14,3,15,-8,-21,-14,-21,-7,0.10576954757471801,-21.1350615976869,0.06675772966257476,-22.653470073085828
4451,2022,13,NCAAF_20221126_CUSE@BC,Boston College,Eagles,Syracuse,Orange,3-9,7-5,0,10,3,23,32,10,0,0,13,0,3,3,26,-4,7,10,7,-9,0.519851949097061,0.8421583221620494,0.10443263676614556,-18.974119704633495
4452,2022,13,NCAAF_20221126_ND@USC,USC,Trojans,Notre Dame,Fighting Irish,11-1,8-4,1,17,7,38,27,10,7,7,14,0,7,7,13,3,10,10,10,11,0.28195057769670817,-9.7620222082694,0.47668483856019395,-0.8828942314437427
4453,2022,13,NCAAF_20221126_TENN@VANDY,Vanderbilt,Commodores,Tennessee,Volunteers,5-7,10-2,0,0,21,0,56,0,0,0,0,14,7,21,14,-5,-21,-14,-21,-56,0.19937836546818177,-14.275237338439865,0.032377435149204103,-27.88606426827596
4454,2022,13,NCAAF_20221126_TULSA@HOU,Houston,Cougars,Tulsa,Golden Hurricane,7-5,5-7,1,24,20,30,37,14,10,3,3,3,17,7,10,2,4,11,4,-7,0.6627872418391094,7.106494569839924,,
4455,2022,13,NCAAF_20221126_KANSAS@KSTATE,Kansas State,Wildcats,Kansas,Jayhawks,9-3,6-6,1,30,21,47,27,23,7,7,10,7,14,0,6,3,9,16,9,20,0.8805798753170515,19.926280391370256,0.86317178059876,16.528004720272065
4456,2022,13,NCAAF_20221126_PITT@MIAMI,Miami (Fla.),Hurricanes,Pittsburgh,Panthers,5-7,8-4,1,0,28,16,42,0,0,3,13,14,14,7,7,-3,-28,-14,-28,-26,0.5268428634564885,1.1391165820398328,0.24784105003921786,-10.28657597681422
4457,2022,13,NCAAF_20221126_AF@SDGST,San Diego St.,Aztecs,Air Force,Falcons,7-5,9-3,0,0,7,3,13,0,0,3,0,7,0,3,3,-2,-7,-7,-7,-10,0.42776573937473283,-3.079984216225739,0.2125199992734761,-12.044167336022383
4458,2022,13,NCAAF_20221126_WASH@WASHST,Washington St.,Cougars,Washington,Huskies,7-5,10-2,1,27,28,33,51,10,17,6,0,7,21,7,16,-3,-1,3,-1,-18,0.40736258555462734,-3.9642209840648093,0.5650845975604589,2.4742372622049515
4459,2022,13,NCAAF_20221126_BYU@STNFRD,Stanford,Cardinal,BYU,Cougars,3-9,7-5,0,12,28,26,35,3,9,0,14,14,14,0,7,-4,-16,-11,-16,-9,0.513939221369208,0.5912050712415748,0.332658425604516,-6.531358884414431
4460,2022,13,NCAAF_20221125_BAYLOR@TEXAS,Texas,Longhorns,Baylor,Bears,8-4,6-6,0,17,19,38,27,14,3,7,14,9,10,0,8,2,-2,5,-2,11,0.672079932661984,7.539258618022814,0.8197377347122206,13.805526232280044
4461,2022,13,NCAAF_20221125_CMICH@EMICH,E. Michigan,Eagles,C. Michigan,Chippewas,8-4,4-8,1,14,13,38,19,14,0,14,10,7,6,0,6,4,1,7,1,19,0.5006671138693585,0.02828859720739274,0.3439512968326509,-6.065100166269076
4462,2022,13,NCAAF_20221125_TOLEDO@WMICH,W. Michigan,Broncos,Toledo,Rockets,5-7,7-5,1,10,7,20,14,0,10,10,0,0,7,0,7,-2,3,0,3,6,0.40804910845912534,-3.9343051814671526,0.23918076597702143,-10.70391192890088
4463,2022,13,NCAAF_20221125_TULANE@CINCY,Cincinnati,Bearcats,Tulane,Green Wave,9-3,10-2,1,10,13,24,27,0,10,7,7,3,10,7,7,-1,-3,-3,-3,-3,0.6937381284963311,8.56798502401739,0.4431134703072467,-2.160289870542556
4464,2022,13,NCAAF_20221125_UTAHST@BOISE,Boise St.,Broncos,Utah St.,Aggies,9-3,6-6,1,21,7,42,23,0,21,7,14,0,7,10,6,3,14,0,14,19,0.718841614734036,9.801727209782484,0.7058813000386563,8.174189972270142
4465,2022,13,NCAAF_20221125_ARIZST@ARIZ,Arizona,Wildcats,Arizona St.,Sun Devils,5-7,3-9,0,10,14,38,35,7,3,21,7,0,14,14,7,2,-4,7,-4,3,0.3160524993121554,-8.099248884974486,0.5036994989277261,0.14001415175835064
4466,2022,13,NCAAF_20221125_ARK@MIZZOU,Missouri,Tigers,Arkansas,Razorbacks,6-6,6-6,0,20,21,29,27,10,10,9,0,7,14,3,3,0,-1,3,-1,2,0.6529293380067368,6.652430500180799,0.3249926522349371,-6.851421932914036
4467,2022,13,NCAAF_20221125_NMEX@COLOST,Colorado St.,Rams,New Mexico,Lobos,3-9,2-10,0,7,0,17,0,0,7,3,7,0,0,0,0,1,7,0,7,17,0.7013858526377446,8.938740878950512,0.538499763069274,1.4593405414670997
4468,2022,13,NCAAF_20221125_NEB@IOWA,Iowa,Hawkeyes,Nebraska,Cornhuskers,7-5,4-8,1,0,17,17,24,0,0,7,10,10,7,7,0,3,-17,-10,-17,-7,0.7735447249064962,12.697359107308557,0.8039514613494567,12.921577940405996
4469,2022,13,NCAAF_20221125_UCLA@CAL,California,Golden Bears,UCLA,Bruins,4-8,9-3,0,21,17,28,35,7,14,0,7,7,10,7,11,-5,4,0,4,-7,0.452514875184994,-2.018358003911544,0.23138055221387133,-11.086923974536148
4470,2022,13,NCAAF_20221125_FLA@FSU,Florida State,Seminoles,Florida,Gators,9-3,6-6,1,21,24,45,38,14,7,17,7,14,10,0,14,3,-3,0,-3,7,0.2807846767679797,-9.820476375958833,0.614721347916291,4.403407590876213
4471,2022,13,NCAAF_20221125_WYO@FRESNO,Fresno St.,Bulldogs,Wyoming,Cowboys,8-4,7-5,1,23,0,30,0,14,9,7,0,0,0,0,0,1,23,14,23,30,0.6581168783923421,6.890755096665089,0.8194363241207402,13.788208025700897
4472,2022,13,NCAAF_20221124_MISSST@MISS,Ole Miss,Rebels,Miss. State,Bulldogs,8-4,8-4,1,16,14,22,24,6,10,0,6,7,7,0,10,0,2,-1,2,-2,0.41393446321590144,-3.6783399442253994,0.4824002467011872,-0.6663007915142316
4473,2022,13,NCAAF_20221122_BALLST@MIAOH,Miami-OH,RedHawks,Ball St.,Cardinals,6-6,5-7,1,3,14,18,17,0,3,3,12,7,7,3,0,1,-11,-7,-11,1,0.6384640438071154,5.994616586887332,0.5107528528227084,0.4070043958754468
4474,2022,13,NCAAF_20221122_BGREEN@OHIO,Ohio,Bobcats,Bowling Green,Falcons,9-3,6-6,0,28,7,38,14,0,28,3,7,7,0,0,7,3,21,-7,21,24,0.8811312795327684,19.973147271140533,,
4475,2022,14,NCAAF_20221203_TOLEDO@OHIO,Ohio,Bobcats,Toledo,Rockets,9-4,8-5,0,7,10,7,17,0,7,0,0,7,3,0,7,1,-3,-7,-3,-10,0.4944554219574776,-0.23555746608394657,0.6658701815677588,6.317590069738799
4476,2022,14,NCAAF_20221203_VALPO@NMEXST,New Mexico St.,,Valparaiso,,6-6,5-7,,35,3,65,3,21,14,17,13,0,3,0,0,1,32,21,32,62,,,,
4477,2022,14,NCAAF_20221203_CSTCAR@TROY,Troy,Trojans,C. Carolina,Chanticleers,11-2,9-3,1,31,7,45,26,17,14,14,0,0,7,6,13,2,24,17,24,19,0.5323066581020635,1.3739848199409153,0.65647863355678,5.939213181070613
4478,2022,14,NCAAF_20221203_FRESNO@BOISE,Boise St.,Broncos,Fresno St.,Bulldogs,9-4,9-4,1,6,14,16,28,0,6,3,7,0,14,0,14,0,-8,0,-8,-12,0.616950382360502,5.041779354930441,0.5826129352581692,3.0749659832658836
4479,2022,14,NCAAF_20221203_LSU@UGA,Georgia,Bulldogs,LSU,Tigers,13-0,9-4,0,35,10,50,30,14,21,7,8,7,3,13,7,4,25,7,25,20,0.7608039974706216,12.014453850494874,0.8543321255260803,15.55590983091463
4480,2022,14,NCAAF_20221203_UCF@TULANE,Tulane,Green Wave,UCF,Knights,11-2,9-4,0,17,7,45,28,10,7,7,21,0,7,7,14,2,10,10,10,17,0.2570766226786506,-11.056763080518976,0.5176803976761493,0.6535616120576151
4481,2022,14,NCAAF_20221203_CLEM@UNC,North Carolina,Tar Heels,Clemson,Tigers,9-4,11-2,0,10,24,10,39,7,3,0,0,14,10,15,0,-2,-14,-7,-14,-29,0.10355132502550746,-21.381426516895317,0.2536635586073611,-9.774158438064433
4482,2022,14,NCAAF_20221203_PURDUE@MICH,Michigan,Wolverines,Purdue,Boilermakers,13-0,8-5,0,14,13,43,22,7,7,14,15,7,6,3,6,5,1,0,1,21,0.811883145403202,14.996765344169035,0.9437151914851577,23.39216547578178
4483,2022,14,NCAAF_20221202_AKRON@BUFF,Buffalo,Bulls,Akron,Zips,6-6,2-10,0,10,16,23,22,0,10,7,6,9,7,0,6,4,-6,-9,-6,1,0.864083810877477,18.6236106940396,,
4484,2022,14,NCAAF_20221202_NTEXAS@TXSA,UTSA,Roadrunners,North Texas,Mean Green,11-2,7-6,1,24,10,48,27,7,17,10,14,7,3,10,7,4,14,0,14,21,0.4898356939527555,-0.4318561596269319,,
4485,2022,14,NCAAF_20221202_UTAH@USC,USC,Trojans,Utah,Utes,11-2,10-3,1,17,17,24,47,14,3,0,7,3,14,7,23,1,0,11,0,-23,0.363132655639669,-5.933539298137248,0.3904328778573115,-4.101147425955105
