,Unnamed: 0,year,week,game_id,home_team,home_team_nickname,away_team,away_team_nickname,home_team_record,away_team_record,home_first_pos,home_team_halftime,away_team_halftime,home_team_final,away_team_final,home_team_q1,home_team_q2,home_team_q3,home_team_q4,away_team_q1,away_team_q2,away_team_q3,away_team_q4,homewins-awaywins,halftime_differential,final_differential,home_win_prob,predicted_diff
0,0,2017,1,NCAAF_20170903_TXAM@UCLA,Texas A&M,,UCLA,,0-1,1-0,,38,10,44,45,17,21,6,0,3,7,7,28,-1.0,28,-1,,
1,1,2017,1,NCAAF_20170903_WVU@VATECH,West Virginia,,Virginia Tech,,0-1,1-0,,7,10,24,31,0,7,10,7,3,7,14,7,-1.0,-3,-7,,
2,2,2017,1,NCAAF_20170902_AKRON@PSU,Akron,,Penn State,,0-1,1-0,,0,35,0,52,0,0,0,0,14,21,10,7,-1.0,-35,-52,,
3,3,2017,1,NCAAF_20170902_BALLST@ILL,Ball St.,,Illinois,,0-1,1-0,,7,16,21,24,7,0,14,0,6,10,0,8,-1.0,-9,-3,,
4,4,2017,1,NCAAF_20170902_BGREEN@MICHST,Bowling Green,,Michigan St.,,0-1,1-0,,3,14,10,35,3,0,0,7,0,14,21,0,-1.0,-11,-25,,
5,5,2017,1,NCAAF_20170902_KENTST@CLEM,Kent St.,,Clemson,,0-1,1-0,,3,28,3,56,0,3,0,0,21,7,21,7,-1.0,-25,-53,,
6,6,2017,1,NCAAF_20170902_MD@TEXAS,Maryland,,Texas,,1-0,0-1,,30,14,51,41,14,16,7,14,7,7,20,7,1.0,16,10,,
7,7,2017,1,NCAAF_20170902_MOST@MIZZOU,Missouri St.,,Missouri,,0-1,1-0,,35,48,43,72,21,14,0,8,20,28,10,14,-1.0,-13,-29,,
8,8,2017,1,NCAAF_20170902_WYO@IOWA,Wyoming,,Iowa,,0-1,1-0,,3,14,3,24,0,3,0,0,0,14,7,3,-1.0,-11,-21,,
9,9,2017,1,NCAAF_20170902_CAL@UNC,California,,North Carolina,,1-0,0-1,,14,17,35,30,7,7,7,14,7,10,7,6,1.0,-3,5,,
10,10,2017,1,NCAAF_20170902_BTHN@MIAMI,Bethune-Cook.,,Miami (Fla.),,0-1,1-0,,6,24,13,41,3,3,7,0,3,21,14,3,-1.0,-18,-28,,
11,11,2017,1,NCAAF_20170902_PORTST@OREGST,Portland St.,,Oregon State,,0-2,1-1,,6,14,32,35,6,0,20,6,7,7,14,7,-1.0,-8,-3,,
12,12,2017,1,NCAAF_20170902_VMI@AF,VMI,,Air Force,,0-1,1-0,,0,35,0,62,0,0,0,0,14,21,14,13,-1.0,-35,-62,,
13,13,2017,1,NCAAF_20170902_NCST@SC,NC State,,South Carolina,,0-1,1-0,,21,21,28,35,14,7,0,7,14,7,14,0,-1.0,0,-7,,
14,14,2017,1,NCAAF_20170902_ALAM@UAB,Alabama A&M,,UAB,,0-1,1-0,,7,10,7,38,0,7,0,0,7,3,14,14,-1.0,-3,-31,,
15,15,2017,1,NCAAF_20170902_MICH@FLA,Michigan,,Florida,,1-0,0-1,,13,17,33,17,10,3,13,7,3,14,0,0,1.0,-4,16,,
16,16,2017,1,NCAAF_20170902_NEVADA@NWEST,Nevada,,Northwestern,,0-1,1-0,,17,7,20,31,7,10,0,3,7,0,10,14,-1.0,10,-11,,
17,17,2017,1,NCAAF_20170902_TEMPLE@ND,Temple,,Notre Dame,,0-1,1-0,,10,28,16,49,3,7,0,6,21,7,7,14,-1.0,-18,-33,,
18,18,2017,1,NCAAF_20170902_UTEP@OKLA,UTEP,,Oklahoma,,0-1,1-0,,7,35,7,56,7,0,0,0,14,21,14,7,-1.0,-28,-49,,
19,19,2017,1,NCAAF_20170902_WMMARY@UVA,William & Mary,,Virginia,,0-1,1-0,,0,14,10,28,0,0,3,7,7,7,7,7,-1.0,-14,-18,,
20,20,2017,1,NCAAF_20170902_TROY@BOISE,Troy,,Boise St.,,0-1,1-0,,10,17,13,24,3,7,0,3,7,10,0,7,-1.0,-7,-11,,
21,21,2017,1,NCAAF_20170902_CHARSO@MISSST,Charleston So.,,Miss. State,,0-1,1-0,,0,35,0,49,0,0,0,0,23,12,7,7,-1.0,-35,-49,,
22,22,2017,1,NCAAF_20170902_EWASH@TXTECH,E. Washington,,Texas Tech,,0-1,1-0,,10,28,10,56,0,10,0,0,7,21,21,7,-1.0,-18,-46,,
23,23,2017,1,NCAAF_20170902_STONYBRK@SFLA,Stony Brook,,South Florida,,0-1,2-0,,10,7,17,31,7,3,0,7,7,0,10,14,-2.0,3,-14,,
24,24,2017,1,NCAAF_20170902_UK@USM,Kentucky,,So. Miss,,1-0,0-1,,14,3,24,17,0,14,10,0,0,3,7,7,1.0,11,7,,
25,25,2017,1,NCAAF_20170902_WMICH@USC,W. Michigan,,USC,,0-1,1-0,,14,14,31,49,7,7,7,10,7,7,7,28,-1.0,0,-18,,
26,26,2017,1,NCAAF_20170902_ALBANY@ODU,Albany,,Old Dominion,,0-1,1-0,,3,21,17,31,3,0,0,14,7,14,3,7,-1.0,-18,-14,,
27,27,2017,1,NCAAF_20170902_JMAD@ECU,James Madison,,East Carolina,,1-0,0-1,,7,0,34,14,7,0,14,13,0,0,7,7,1.0,7,20,,
28,28,2017,1,NCAAF_20170902_NCCEN@DUKE,NC Central,,Duke,,0-1,1-0,,7,47,7,60,0,7,0,0,21,26,6,7,-1.0,-40,-53,,
29,29,2017,1,NCAAF_20170902_APLST@UGA,App. St.,,Georgia,,0-1,1-0,,0,21,10,31,0,0,0,10,7,14,10,0,-1.0,-21,-21,,
30,30,2017,1,NCAAF_20170902_MIAOH@MRSHL,Miami-OH,,Marshall,,0-1,1-0,,13,21,26,31,3,10,7,6,7,14,7,3,-1.0,-8,-5,,
31,31,2017,1,NCAAF_20170902_EKY@WKY,E. Kentucky,,W. Kentucky,,0-1,1-0,,0,17,17,31,0,0,14,3,0,17,7,7,-1.0,-17,-14,,
32,32,2017,1,NCAAF_20170902_HAMP@OHIO,Hampton,,Ohio,,0-1,1-0,,0,20,0,59,0,0,0,0,7,13,26,13,-1.0,-20,-59,,
33,33,2017,1,NCAAF_20170902_HOUBP@TXSTSM,Houston Christian,,Texas St.,,0-1,1-0,,9,10,11,20,9,0,0,2,0,10,7,3,-1.0,-1,-9,,
34,34,2017,1,NCAAF_20170902_LAMAR@NTEXAS,Lamar,,North Texas,,0-1,1-0,,14,38,14,59,7,7,0,0,17,21,14,7,-1.0,-24,-45,,
35,35,2017,1,NCAAF_20170902_LIB@BAYLOR,Liberty,,Baylor,,1-0,0-1,,17,17,48,45,6,11,17,14,0,17,14,14,1.0,0,3,,
36,36,2017,1,NCAAF_20170902_MA@CSTCAR,UMass,,C. Carolina,,0-2,1-0,,14,21,28,38,7,7,7,7,14,7,10,7,-1.0,-7,-10,,
37,37,2017,1,NCAAF_20170902_NWST@LATECH,Northwestern St.,,Louisiana Tech,,0-1,1-0,,10,24,24,52,7,3,14,0,10,14,7,21,-1.0,-14,-28,,
38,38,2017,1,NCAAF_20170902_SELOU@LALAF,SE Louisiana,,Louisiana,,0-1,1-0,,35,35,48,51,21,14,0,13,21,14,7,9,-1.0,0,-3,,
39,39,2017,1,NCAAF_20170902_SEMOST@KANSAS,SE Missouri St.,,Kansas,,0-1,1-0,,7,21,16,38,0,7,3,6,14,7,14,3,-1.0,-14,-22,,
40,40,2017,1,NCAAF_20170902_SFA@SMU,S.F. Austin,,SMU,,0-1,1-0,,7,38,14,58,0,7,0,7,21,17,6,14,-1.0,-31,-44,,
41,41,2017,1,NCAAF_20170902_CAR@KSTATE,Cent. Ark.,,Kansas State,,0-1,1-0,,16,38,19,55,10,6,3,0,10,28,10,7,-1.0,-22,-36,,
42,42,2017,1,NCAAF_20170902_CPOLY@SJST,Cal-Poly,,San Jose St.,,0-2,1-0,,6,7,13,34,3,3,0,7,0,7,13,14,-1.0,-1,-21,,
43,43,2017,1,NCAAF_20170902_GAS@AUBURN,Ga. Southern,,Auburn,,0-1,1-0,,7,24,7,41,7,0,0,0,10,14,10,7,-1.0,-17,-34,,
44,44,2017,1,NCAAF_20170902_LVILLE@PURDUE,Louisville,,Purdue,,1-0,0-1,,10,14,35,28,7,3,15,10,7,7,7,7,1.0,-4,7,,
45,45,2017,1,NCAAF_20170902_SALA@MISS,South Alabama,,Ole Miss,,0-1,1-0,,10,13,27,47,0,10,3,14,10,3,27,7,-1.0,-3,-20,,
46,46,2017,1,NCAAF_20170902_ABIL@NMEX,Abil Christian,,New Mexico,,0-1,1-0,,7,14,14,38,7,0,0,7,7,7,10,14,-1.0,-7,-24,,
47,47,2017,1,NCAAF_20170902_ARKST@NEB,Arkansas St.,,Nebraska,,0-1,1-0,,26,27,36,43,14,12,0,10,17,10,7,9,-1.0,-1,-7,,
48,48,2017,1,NCAAF_20170902_FSU@BAMA,Florida State,,Alabama,,0-1,1-0,,7,10,7,24,0,7,0,0,3,7,11,3,-1.0,-3,-17,,
49,49,2017,1,NCAAF_20170902_GRAM@TULANE,Grambling,,Tulane,,0-1,1-0,,0,24,14,43,0,0,7,7,14,10,7,12,-1.0,-24,-29,,
50,50,2017,1,NCAAF_20170902_JACKST@TCU,Jackson St.,,TCU,,0-1,1-0,,0,35,0,63,0,0,0,0,21,14,21,7,-1.0,-35,-63,,
51,51,2017,1,NCAAF_20170902_NOIOWA@IOWAST,Northern Iowa,,Iowa St.,,0-1,1-0,,10,21,24,42,7,3,7,7,14,7,14,7,-1.0,-11,-18,,
52,52,2017,1,NCAAF_20170902_VANDY@MTSU,Vanderbilt,,Middle Tenn.,,1-0,0-1,,21,0,28,6,14,7,7,0,0,0,0,6,1.0,21,22,,
53,53,2017,1,NCAAF_20170902_SUT@OREG,So. Utah,,Oregon,,0-1,1-0,,21,42,21,77,7,14,0,0,21,21,21,14,-1.0,-21,-56,,
54,54,2017,1,NCAAF_20170902_DAVIS@SDGST,UC-Davis,,San Diego St.,,0-1,1-0,,3,24,17,38,3,0,0,14,10,14,14,0,-1.0,-21,-21,,
55,55,2017,1,NCAAF_20170902_HOW@UNLV,Howard,,UNLV,,1-0,0-1,,21,19,43,40,7,14,7,15,6,13,14,7,1.0,2,3,,
56,56,2017,1,NCAAF_20170902_BYU@LSU,BYU,,LSU,,1-1,1-0,,0,14,0,27,0,0,0,0,0,14,6,7,0.0,-14,-27,,
57,57,2017,1,NCAAF_20170902_UIW@FRESNO,Incarnate Word,,Fresno St.,,0-1,1-0,,0,34,0,66,0,0,0,0,17,17,32,0,-1.0,-34,-66,,
58,58,2017,1,NCAAF_20170902_MTST@WASHST,Montana St.,,Washington St.,,0-1,1-0,,0,14,0,31,0,0,0,0,7,7,7,10,-1.0,-14,-31,,
59,59,2017,1,NCAAF_20170902_NAZ@ARIZ,N. Arizona,,Arizona,,0-1,1-0,,14,34,24,62,7,7,0,10,14,20,14,14,-1.0,-20,-38,,
60,60,2017,1,NCAAF_20170902_WCAR@HAWAII,W. Carolina,,Hawaii,,0-1,2-0,,10,21,18,41,0,10,8,0,7,14,13,7,-2.0,-11,-23,,
61,61,2017,1,NCAAF_20170901_FORD@ARMY,Fordham,,Army,,0-1,1-0,,6,34,6,64,0,6,0,0,21,13,17,13,-1.0,-28,-58,,
62,62,2017,1,NCAAF_20170901_CHARLO@EMICH,Charlotte,,E. Michigan,,0-1,1-0,,7,17,7,24,7,0,0,0,14,3,7,0,-1.0,-10,-17,,
63,63,2017,1,NCAAF_20170901_CCTST@CUSE,CCSU,,Syracuse,,0-1,1-0,,0,31,7,50,0,0,7,0,21,10,13,6,-1.0,-31,-43,,
64,64,2017,1,NCAAF_20170901_COLOST@COLO,Colorado St.,,Colorado,,1-1,1-0,,3,17,3,17,0,3,0,0,10,7,0,0,0.0,-14,-14,,
65,65,2017,1,NCAAF_20170901_NAVY@FAU,Navy,,FAU,,1-0,0-1,,21,10,42,19,7,14,14,7,3,7,3,6,1.0,11,23,,
66,66,2017,1,NCAAF_20170901_WASH@RUT,Washington,,Rutgers,,1-0,0-1,,10,7,30,14,3,7,10,10,7,0,0,7,1.0,3,16,,
67,67,2017,1,NCAAF_20170901_UTAHST@WISC,Utah St.,,Wisconsin,,0-1,1-0,,10,10,10,59,10,0,0,0,0,10,28,21,-1.0,0,-49,,
68,68,2017,1,NCAAF_20170901_BC@NILL,Boston College,,N. Illinois,,1-0,0-1,,13,10,23,20,3,10,7,3,3,7,7,3,1.0,3,3,,
69,69,2017,1,NCAAF_20170831_FIU@UCF,FIU,,UCF,,0-1,1-0,,10,40,17,61,7,3,7,0,14,26,14,7,-1.0,-30,-44,,
70,70,2017,1,NCAAF_20170831_PRESBY@WAKE,Presbyterian,,Wake Forest,,0-1,1-0,,0,37,7,51,0,0,0,7,16,21,14,0,-1.0,-37,-44,,
71,71,2017,1,NCAAF_20170831_AP@CINCY,Austin Peay,,Cincinnati,,0-1,1-0,,7,14,14,26,0,7,0,7,0,14,6,6,-1.0,-7,-12,,
72,72,2017,1,NCAAF_20170831_BUFF@MINN,Buffalo,,Minnesota,,0-1,1-0,,7,14,7,17,7,0,0,0,14,0,0,3,-1.0,-7,-10,,
73,73,2017,1,NCAAF_20170831_ELON@TOLEDO,Elon,,Toledo,,0-1,1-0,,7,19,13,47,0,7,0,6,13,6,21,7,-1.0,-12,-34,,
74,74,2017,1,NCAAF_20170831_TNST@GAST,Tennessee St.,,Georgia St.,,1-0,0-1,,10,3,17,10,3,7,7,0,0,3,0,7,1.0,7,7,,
75,75,2017,1,NCAAF_20170831_HOLY@UCONN,Holy Cross,,UConn,,0-1,1-0,,20,7,20,27,3,17,0,0,7,0,7,13,-1.0,13,-7,,
76,76,2017,1,NCAAF_20170831_NDK@UTAH,North Dakota,,Utah,,0-1,1-0,,9,17,16,37,3,6,0,7,0,17,10,10,-1.0,-8,-21,,
77,77,2017,1,NCAAF_20170831_TULSA@OKLAST,Tulsa,,Oklahoma State,,0-1,1-0,,17,38,24,59,0,17,0,7,21,17,14,7,-1.0,-21,-35,,
78,78,2017,1,NCAAF_20170831_FAMU@ARK,Florida A&M,,Arkansas,,1-1,1-0,,0,21,7,49,0,0,0,7,7,14,14,14,0.0,-21,-42,,
79,79,2017,1,NCAAF_20170831_OHIOST@IND,Ohio State,,Indiana,,1-0,0-1,,13,14,49,21,3,10,22,14,7,7,7,0,1.0,-1,28,,
80,80,2017,1,NCAAF_20170831_LAMON@MEMP,UL-Monroe,,Memphis,,0-1,1-0,,7,20,29,37,7,0,7,15,7,13,17,0,-1.0,-13,-8,,
81,81,2017,1,NCAAF_20170831_SACST@IDAHO,Sacramento St.,,Idaho,,0-1,1-0,,6,14,6,28,0,6,0,0,0,14,7,7,-1.0,-8,-22,,
82,82,2017,1,NCAAF_20170831_NMEXST@ARIZST,New Mexico St.,,Arizona St.,,0-1,1-0,,13,14,31,37,0,13,0,18,14,0,16,7,-1.0,-1,-6,,
83,83,2017,1,NCAAF_20170826_OREGST@COLOST,Oregon State,,Colorado St.,,1-1,1-1,,20,24,27,58,10,10,0,7,7,17,10,24,0.0,-4,-31,,
84,84,2017,1,NCAAF_20170826_PORTST@BYU,Portland St.,,BYU,,0-2,1-1,,6,14,6,20,0,6,0,0,7,7,0,6,-1.0,-8,-14,,
85,85,2017,1,NCAAF_20170826_HAWAII@MA,Hawaii,,UMass,,2-0,0-2,,14,14,38,35,7,7,7,17,7,7,14,7,2.0,0,3,,
86,86,2017,1,NCAAF_20170826_SFLA@SJST,South Florida,,San Jose St.,,2-0,1-0,,28,16,42,22,0,28,7,7,16,0,0,6,1.0,12,20,,
87,87,2017,1,NCAAF_20170826_STNFRD@RICE,Stanford,,Rice,,1-0,0-1,,38,0,62,7,21,17,14,10,0,0,0,7,1.0,38,55,,
88,88,2017,2,NCAAF_20170909_BUFF@ARMY,Buffalo,,Army,,0-2,2-0,,17,7,17,21,3,14,0,0,7,0,0,14,-2.0,10,-4,,
89,89,2017,2,NCAAF_20170909_CHARLO@KSTATE,Charlotte,,Kansas State,,0-2,2-0,,7,38,7,55,7,0,0,0,21,17,10,7,-2.0,-31,-48,,
90,90,2017,2,NCAAF_20170909_CINCY@MICH,Cincinnati,,Michigan,,1-1,2-0,,7,17,14,36,7,0,7,0,14,3,7,12,-1.0,-10,-22,,
91,91,2017,2,NCAAF_20170909_ECU@WVU,East Carolina,,West Virginia,,0-2,1-1,,3,49,20,56,3,0,10,7,21,28,7,0,-1.0,-46,-36,,
92,92,2017,2,NCAAF_20170909_EKY@UK,E. Kentucky,,Kentucky,,0-2,2-0,,13,10,16,27,7,6,3,0,3,7,7,10,-2.0,3,-11,,
93,93,2017,2,NCAAF_20170909_FAU@WISC,FAU,,Wisconsin,,0-2,2-0,,14,24,14,31,7,7,0,0,14,10,7,0,-2.0,-10,-17,,
94,94,2017,2,NCAAF_20170909_LVILLE@UNC,Louisville,,North Carolina,,2-0,0-2,,20,14,47,35,10,10,7,20,7,7,14,7,2.0,6,12,,
95,95,2017,2,NCAAF_20170909_NWEST@DUKE,Northwestern,,Duke,,1-1,2-0,,10,21,17,41,3,7,0,7,7,14,10,10,-1.0,-11,-24,,
96,96,2017,2,NCAAF_20170909_TNMART@MISS,UT Martin,,Ole Miss,,1-1,2-0,,16,17,23,45,9,7,0,7,7,10,21,7,-1.0,-1,-22,,
97,97,2017,2,NCAAF_20170909_TWST@MD,Towson,,Maryland,,1-1,2-0,,7,28,17,63,0,7,0,10,21,7,21,14,-1.0,-21,-46,,
98,98,2017,2,NCAAF_20170909_JAXST@GATECH,Jacksonville St.,,Georgia Tech,,1-1,1-1,,7,10,10,37,0,7,3,0,3,7,20,7,0.0,-3,-27,,
99,99,2017,2,NCAAF_20170909_WAKE@BC,Wake Forest,,Boston College,,2-0,1-1,,21,7,34,10,7,14,10,3,0,7,3,0,1.0,14,24,,
100,100,2017,2,NCAAF_20170909_TXSTSM@COLO,Texas St.,,Colorado,,1-1,2-0,,0,14,3,37,0,0,3,0,7,7,17,6,-1.0,-14,-34,,
101,101,2017,2,NCAAF_20170909_UAB@BALLST,UAB,,Ball St.,,1-1,1-1,,17,21,31,51,3,14,7,7,7,14,17,13,0.0,-4,-20,,
102,102,2017,2,NCAAF_20170909_ABIL@COLOST,Abil Christian,,Colorado St.,,0-2,2-1,,0,17,10,38,0,0,10,0,10,7,14,7,-2.0,-17,-28,,
103,103,2017,2,NCAAF_20170909_AP@MIAOH,Austin Peay,,Miami-OH,,0-2,1-1,,7,21,10,31,7,0,3,0,7,14,0,10,-1.0,-14,-21,,
104,104,2017,2,NCAAF_20170909_DE@VATECH,Delaware,,Virginia Tech,,1-1,2-0,,0,17,0,27,0,0,0,0,7,10,0,10,-1.0,-17,-27,,
105,105,2017,2,NCAAF_20170909_EIL@NILL,E. Illinois,,N. Illinois,,1-1,1-1,,3,31,10,38,3,0,0,7,7,24,7,0,0.0,-28,-28,,
106,106,2017,2,NCAAF_20170909_EMICH@RUT,E. Michigan,,Rutgers,,2-0,0-2,,10,3,16,13,7,3,3,3,3,0,10,0,2.0,7,3,,
107,107,2017,2,NCAAF_20170909_FRESNO@BAMA,Fresno St.,,Alabama,,1-1,2-0,,3,28,10,41,3,0,0,7,14,14,3,10,-1.0,-25,-31,,
108,108,2017,2,NCAAF_20170909_HOW@KENTST,Howard,,Kent St.,,1-1,1-1,,14,21,31,38,7,7,10,7,14,7,2,15,0.0,-7,-7,,
109,109,2017,2,NCAAF_20170909_IND@UVA,Indiana,,Virginia,,1-1,1-1,,17,3,34,17,0,17,10,7,0,3,7,7,0.0,14,17,,
110,110,2017,2,NCAAF_20170909_MTSU@CUSE,Middle Tenn.,,Syracuse,,1-1,1-1,,9,13,30,23,2,7,7,14,3,10,3,7,0.0,-4,7,,
111,111,2017,2,NCAAF_20170909_NOVA@TEMPLE,Villanova,,Temple,,1-1,1-1,,0,10,13,16,0,0,3,10,3,7,3,3,0.0,-10,-3,,
112,112,2017,2,NCAAF_20170909_ODU@MA,Old Dominion,,UMass,,2-0,0-3,,10,0,17,7,3,7,0,7,0,0,7,0,2.0,10,10,,
113,113,2017,2,NCAAF_20170909_PITT@PSU,Pittsburgh,,Penn State,,1-1,2-0,,3,14,14,33,0,3,3,8,14,0,7,12,-1.0,-11,-19,,
114,114,2017,2,NCAAF_20170909_SAV@APLST,Savannah St.,,App. St.,,0-1,1-1,,0,45,7,54,0,0,0,7,14,31,2,7,-1.0,-45,-47,,
115,115,2017,2,NCAAF_20170909_SJST@TEXAS,San Jose St.,,Texas,,1-2,1-1,,0,21,0,56,0,0,0,0,7,14,14,21,0.0,-21,-56,,
116,116,2017,2,NCAAF_20170909_TCU@ARK,TCU,,Arkansas,,2-0,1-1,,14,7,28,7,7,7,0,14,7,0,0,0,1.0,7,21,,
117,117,2017,2,NCAAF_20170909_TULANE@NAVY,Tulane,,Navy,,1-1,2-0,,13,14,21,23,0,13,0,8,7,7,9,0,-1.0,-1,-2,,
118,118,2017,2,NCAAF_20170909_WMICH@MICHST,W. Michigan,,Michigan St.,,0-2,2-0,,0,14,14,28,0,0,7,7,7,7,7,7,-2.0,-14,-14,,
119,119,2017,2,NCAAF_20170909_ALAM@VANDY,Alabama A&M,,Vanderbilt,,0-2,2-0,,0,35,0,42,0,0,0,0,14,21,7,0,-2.0,-35,-42,,
120,120,2017,2,NCAAF_20170909_CMICH@KANSAS,C. Michigan,,Kansas,,2-0,1-1,,24,6,45,27,0,24,7,14,3,3,14,7,1.0,18,18,,
121,121,2017,2,NCAAF_20170909_GRDWB@WYO,Gardner-Webb,,Wyoming,,0-2,1-1,,0,24,0,27,0,0,0,0,14,10,0,3,-1.0,-24,-27,,
122,122,2017,2,NCAAF_20170909_INST@TENN,Indiana St.,,Tennessee,,0-2,2-0,,0,28,7,42,0,0,7,0,14,14,7,7,-2.0,-28,-35,,
123,123,2017,2,NCAAF_20170909_LALAF@TULSA,Louisiana,,Tulsa,,1-1,1-1,,23,38,42,66,10,13,12,7,10,28,7,21,0.0,-15,-24,,
124,124,2017,2,NCAAF_20170909_NH@GAS,New Hamp.,,Ga. Southern,,2-0,0-2,,22,0,22,12,15,7,0,0,0,0,5,7,2.0,22,10,,
125,125,2017,2,NCAAF_20170909_NEB@OREG,Nebraska,,Oregon,,1-1,2-0,,14,42,35,42,7,7,14,7,21,21,0,0,-1.0,-28,-7,,
126,126,2017,2,NCAAF_20170909_HAWAII@UCLA,Hawaii,,UCLA,,2-1,2-0,,7,35,23,56,0,7,7,9,14,21,14,7,0.0,-28,-33,,
127,127,2017,2,NCAAF_20170909_WBRST@CAL,Weber St.,,California,,1-1,2-0,,20,17,20,33,10,10,0,0,7,10,0,16,-1.0,3,-13,,
128,128,2017,2,NCAAF_20170909_ALST@TROY,Alabama St.,,Troy,,0-2,1-1,,7,20,7,34,7,0,0,0,7,13,7,7,-1.0,-13,-27,,
129,129,2017,2,NCAAF_20170909_MRSHL@NCST,Marshall,,NC State,,1-1,1-1,,20,23,20,37,10,10,0,0,3,20,7,7,0.0,-3,-17,,
130,130,2017,2,NCAAF_20170909_SD@BGREEN,South Dakota,,Bowling Green,,2-0,0-2,,21,9,35,27,21,0,7,7,3,6,7,11,2.0,12,8,,
131,131,2017,2,NCAAF_20170909_ARPB@AKRON,Ark.-Pine Bluff,,Akron,,1-1,1-1,,3,31,3,52,0,3,0,0,14,17,14,7,0.0,-28,-49,,
132,132,2017,2,NCAAF_20170909_AUBURN@CLEM,Auburn,,Clemson,,1-1,2-0,,6,7,6,14,3,3,0,0,0,7,7,0,-1.0,-1,-8,,
133,133,2017,2,NCAAF_20170909_NICHST@TXAM,Nicholls St.,,Texas A&M,,1-1,1-1,,6,14,14,24,0,6,0,8,14,0,0,10,0.0,-8,-10,,
134,134,2017,2,NCAAF_20170909_NTEXAS@SMU,North Texas,,SMU,,1-1,2-0,,10,24,32,54,10,0,7,15,10,14,16,14,-1.0,-14,-22,,
135,135,2017,2,NCAAF_20170909_SC@MIZZOU,South Carolina,,Missouri,,2-0,1-1,,14,10,31,13,0,14,10,7,3,7,3,0,1.0,4,18,,
136,136,2017,2,NCAAF_20170909_SO@USM,Southern U.,,So. Miss,,1-1,1-1,,0,35,0,45,0,0,0,0,28,7,10,0,0.0,-35,-45,,
137,137,2017,2,NCAAF_20170909_TOLEDO@NEVADA,Toledo,,Nevada,,2-0,0-2,,20,10,37,24,17,3,14,3,3,7,14,0,2.0,10,13,,
138,138,2017,2,NCAAF_20170909_UNLV@IDAHO,UNLV,,Idaho,,1-1,1-1,,10,3,44,16,7,3,24,10,0,3,7,6,0.0,7,28,,
139,139,2017,2,NCAAF_20170909_MISSST@LATECH,Miss. State,,Louisiana Tech,,2-0,1-1,,36,14,57,21,16,20,21,0,9,5,0,7,1.0,22,36,,
140,140,2017,2,NCAAF_20170909_OKLA@OHIOST,Oklahoma,,Ohio State,,2-0,1-1,,3,3,31,16,0,3,14,14,0,3,10,3,1.0,0,15,,
141,141,2017,2,NCAAF_20170909_TNCHAT@LSU,Chattanooga,,LSU,,0-2,2-0,,3,28,10,45,3,0,0,7,14,14,14,3,-2.0,-25,-35,,
142,142,2017,2,NCAAF_20170909_UGA@ND,Georgia,,Notre Dame,,1-0,1-0,,10,13,20,19,3,7,7,3,3,10,3,3,0.0,-3,1,,
143,143,2017,2,NCAAF_20170909_MT@WASH,Montana,,Washington,,1-1,2-0,,7,35,7,63,7,0,0,0,21,14,14,14,-1.0,-28,-56,,
144,144,2017,2,NCAAF_20170909_NMEXST@NMEX,New Mexico St.,,New Mexico,,1-1,1-1,,23,5,30,28,13,10,7,0,2,3,0,23,0.0,18,2,,
145,145,2017,2,NCAAF_20170909_RICE@UTEP,Rice,,UTEP,,1-1,0-2,,10,7,31,14,3,7,7,14,7,0,0,7,1.0,3,17,,
146,146,2017,2,NCAAF_20170909_TXSA@BAYLOR,UTSA,,Baylor,,1-0,0-2,,7,7,17,10,0,7,7,3,0,7,0,3,1.0,0,7,,
147,147,2017,2,NCAAF_20170909_WKY@ILL,W. Kentucky,,Illinois,,1-1,2-0,,0,13,7,20,0,0,0,7,3,10,7,0,-1.0,-13,-13,,
148,148,2017,2,NCAAF_20170909_STNFRD@USC,Stanford,,USC,,1-1,2-0,,17,28,24,42,7,10,0,7,14,14,0,14,-1.0,-11,-18,,
149,149,2017,2,NCAAF_20170909_MINN@OREGST,Minnesota,,Oregon State,,2-0,1-2,,20,14,48,14,10,10,14,14,0,14,0,0,1.0,6,34,,
150,150,2017,2,NCAAF_20170909_UTAH@BYU,Utah,,BYU,,2-0,1-2,,9,0,19,13,3,6,10,0,0,0,6,7,1.0,9,6,,
151,151,2017,2,NCAAF_20170909_HOU@ARIZ,Houston,,Arizona,,1-0,1-1,,17,10,19,16,3,14,2,0,3,7,3,3,0.0,7,3,,
152,152,2017,2,NCAAF_20170909_SDGST@ARIZST,San Diego St.,,Arizona St.,,2-0,0-2,,20,14,30,20,7,13,7,3,7,7,0,6,2.0,6,10,,
153,153,2017,2,NCAAF_20170908_ALCORN@FIU,Alcorn St.,,FIU,,1-1,1-1,,7,7,10,17,0,7,0,3,0,7,3,7,0.0,0,-7,,
154,154,2017,2,NCAAF_20170908_OHIO@PURDUE,Ohio,,Purdue,,1-1,1-1,,7,34,21,44,7,0,7,7,10,24,7,3,0.0,-27,-23,,
155,155,2017,2,NCAAF_20170908_OKLAST@SALA,Oklahoma State,,South Alabama,,2-0,0-2,,20,0,44,7,17,3,21,3,0,0,0,7,2.0,20,37,,
156,156,2017,2,NCAAF_20170907_IDST@UTAHST,Idaho State,,Utah St.,,1-1,1-1,,6,38,13,51,0,6,7,0,17,21,7,6,0.0,-32,-38,,
157,157,2017,3,NCAAF_20170916_AF@MICH,Air Force,,Michigan,,1-1,3-0,,6,9,13,29,3,3,7,0,3,6,10,10,-2.0,-3,-16,,
158,158,2017,3,NCAAF_20170916_DEST@WVU,Delaware St.,,West Virginia,,0-3,2-1,,10,45,16,59,10,0,0,6,24,21,7,7,-2.0,-35,-43,,
159,159,2017,3,NCAAF_20170916_IOWAST@AKRON,Iowa St.,,Akron,,2-1,1-2,,20,14,41,14,14,6,14,7,0,14,0,0,1.0,6,27,,
160,160,2017,3,NCAAF_20170916_KANSAS@OHIO,Kansas,,Ohio,,1-2,2-1,,14,25,30,42,0,14,0,16,11,14,14,3,-1.0,-11,-12,,
161,161,2017,3,NCAAF_20170916_LALAF@TXAM,Louisiana,,Texas A&M,,1-2,2-1,,21,14,21,45,0,21,0,0,7,7,17,14,-1.0,7,-24,,
162,162,2017,3,NCAAF_20170916_NILL@NEB,N. Illinois,,Nebraska,,2-1,1-2,,14,0,21,17,14,0,0,7,0,0,10,7,1.0,14,4,,
163,163,2017,3,NCAAF_20170916_OKLAST@PITT,Oklahoma State,,Pittsburgh,,3-0,1-2,,49,14,59,21,21,28,7,3,0,14,7,0,2.0,35,38,,
164,164,2017,3,NCAAF_20170916_UCLA@MEMP,UCLA,,Memphis,,2-1,2-0,,24,27,45,48,7,17,14,7,7,20,14,7,0.0,-3,-3,,
165,165,2017,3,NCAAF_20170916_UCONN@UVA,UConn,,Virginia,,1-1,2-1,,0,24,18,38,0,0,6,12,7,17,7,7,-1.0,-24,-20,,
166,166,2017,3,NCAAF_20170916_FUR@NCST,Furman,,NC State,,0-3,2-1,,13,28,16,49,3,10,0,3,14,14,21,0,-2.0,-15,-33,,
167,167,2017,3,NCAAF_20170916_BAYLOR@DUKE,Baylor,,Duke,,0-3,3-0,,7,14,20,34,7,0,13,0,7,7,10,10,-3.0,-7,-14,,
168,168,2017,3,NCAAF_20170916_CSTCAR@UAB,C. Carolina,,UAB,,1-1,2-1,,5,16,23,30,2,3,8,10,13,3,7,7,-1.0,-11,-7,,
169,169,2017,3,NCAAF_20170916_NCO@COLO,N. Colorado,,Colorado,,1-1,3-0,,14,28,21,41,7,7,7,0,14,14,3,10,-2.0,-14,-20,,
170,170,2017,3,NCAAF_20170916_TNTECH@BALLST,Tenn. Tech,,Ball St.,,0-3,2-1,,7,21,13,28,0,7,6,0,7,14,7,0,-2.0,-14,-15,,
171,171,2017,3,NCAAF_20170916_UTAHST@WAKE,Utah St.,,Wake Forest,,1-2,3-0,,0,29,10,46,0,0,10,0,14,15,17,0,-2.0,-29,-36,,
172,172,2017,3,NCAAF_20170916_CMICH@CUSE,C. Michigan,,Syracuse,,2-1,2-1,,17,24,17,41,10,7,0,0,10,14,17,0,0.0,-7,-24,,
173,173,2017,3,NCAAF_20170916_MRGNST@RUT,Morgan St.,,Rutgers,,0-3,1-2,,0,34,0,65,0,0,0,0,7,27,17,14,-1.0,-34,-65,,
174,174,2017,3,NCAAF_20170916_MTSU@MINN,Middle Tenn.,,Minnesota,,1-2,3-0,,3,20,3,34,0,3,0,0,3,17,7,7,-2.0,-17,-31,,
175,175,2017,3,NCAAF_20170916_ND@BC,Notre Dame,,Boston College,,2-1,1-2,,14,10,49,20,7,7,14,21,3,7,3,7,1.0,4,29,,
176,176,2017,3,NCAAF_20170916_NTEXAS@IOWA,North Texas,,Iowa,,1-2,3-0,,14,10,14,31,7,7,0,0,7,3,7,14,-2.0,4,-17,,
177,177,2017,3,NCAAF_20170916_SMU@TCU,SMU,,TCU,,2-1,3-0,,22,28,36,56,16,6,7,7,7,21,7,21,-1.0,-6,-20,,
178,178,2017,3,NCAAF_20170916_TENN@FLA,Tennessee,,Florida,,2-1,1-1,,3,6,20,26,0,3,0,17,3,3,0,20,1.0,-3,-6,,
179,179,2017,3,NCAAF_20170916_UNC@ODU,North Carolina,,Old Dominion,,1-2,2-1,,39,7,53,23,11,28,7,7,0,7,10,6,-1.0,32,30,,
180,180,2017,3,NCAAF_20170916_VATECH@ECU,Virginia Tech,,East Carolina,,3-0,0-3,,23,17,64,17,7,16,34,7,17,0,0,0,3.0,6,47,,
181,181,2017,3,NCAAF_20170916_WISC@BYU,Wisconsin,,BYU,,3-0,1-3,,24,6,40,6,10,14,7,9,3,3,0,0,2.0,18,34,,
182,182,2017,3,NCAAF_20170916_MERCER@AUBURN,Mercer,,Auburn,,1-2,2-1,,3,10,10,24,0,3,0,7,7,3,7,7,-1.0,-7,-14,,
183,183,2017,3,NCAAF_20170916_PURDUE@MIZZOU,Purdue,,Missouri,,2-1,1-2,,28,3,35,3,14,14,7,0,0,3,0,0,1.0,25,32,,
184,184,2017,3,NCAAF_20170916_ARMY@OHIOST,Army,,Ohio State,,2-1,2-1,,7,17,7,38,0,7,0,0,14,3,14,7,0.0,-10,-31,,
185,185,2017,3,NCAAF_20170916_OREGST@WASHST,Oregon State,,Washington St.,,1-3,3-0,,9,28,23,52,2,7,7,7,7,21,14,10,-2.0,-19,-29,,
186,186,2017,3,NCAAF_20170916_COLG@BUFF,Colgate,,Buffalo,,1-2,1-2,,3,30,10,33,3,0,7,0,20,10,0,3,0.0,-27,-23,,
187,187,2017,3,NCAAF_20170916_NCAT@CHARLO,NC A&T,,Charlotte,,3-0,0-3,,21,10,35,31,14,7,7,7,7,3,7,14,3.0,11,4,,
188,188,2017,3,NCAAF_20170916_TULANE@OKLA,Tulane,,Oklahoma,,1-2,3-0,,14,28,14,56,14,0,0,0,14,14,7,21,-2.0,-14,-42,,
189,189,2017,3,NCAAF_20170916_BTHN@FAU,Bethune-Cook.,,FAU,,1-2,1-2,,0,21,0,45,0,0,0,0,14,7,17,7,0.0,-21,-45,,
190,190,2017,3,NCAAF_20170916_KENTST@MRSHL,Kent St.,,Marshall,,1-2,2-1,,0,7,0,21,0,0,0,0,0,7,0,14,-1.0,-7,-21,,
191,191,2017,3,NCAAF_20170916_ALAM@SALA,Alabama A&M,,South Alabama,,0-3,1-2,,0,31,0,45,0,0,0,0,24,7,14,0,-1.0,-31,-45,,
192,192,2017,3,NCAAF_20170916_APLST@TXSTSM,App. St.,,Texas St.,,2-1,1-2,,7,10,20,13,0,7,10,3,7,3,0,3,1.0,-3,7,,
193,193,2017,3,NCAAF_20170916_ARPB@ARKST,Ark.-Pine Bluff,,Arkansas St.,,1-2,1-1,,3,20,3,48,0,3,0,0,13,7,21,7,0.0,-17,-45,,
194,194,2017,3,NCAAF_20170916_COLOST@BAMA,Colorado St.,,Alabama,,2-2,3-0,,10,24,23,41,0,10,0,13,17,7,14,3,-1.0,-14,-18,,
195,195,2017,3,NCAAF_20170916_IDAHO@WMICH,Idaho,,W. Michigan,,1-2,1-2,,14,6,28,37,7,7,14,0,3,3,13,18,0.0,8,-9,,
196,196,2017,3,NCAAF_20170916_IDST@NEVADA,Idaho State,,Nevada,,2-1,0-3,,23,7,30,28,10,13,7,0,0,7,7,14,2.0,16,2,,
197,197,2017,3,NCAAF_20170916_LATECH@WKY,Louisiana Tech,,W. Kentucky,,2-1,1-2,,13,15,23,22,3,10,0,10,8,7,7,0,1.0,-2,1,,
198,198,2017,3,NCAAF_20170916_LSU@MISSST,LSU,,Miss. State,,2-1,3-0,,7,17,7,37,0,7,0,0,0,17,13,7,-1.0,-10,-30,,
199,199,2017,3,NCAAF_20170916_OREG@WYO,Oregon,,Wyoming,,3-0,1-2,,42,10,49,13,14,28,0,7,10,0,3,0,2.0,32,36,,
200,200,2017,3,NCAAF_20170916_SO@TXSA,Southern U.,,UTSA,,1-2,2-0,,0,48,17,51,0,0,7,10,21,27,3,0,-1.0,-48,-34,,
201,201,2017,3,NCAAF_20170916_TULSA@TOLEDO,Tulsa,,Toledo,,1-2,3-0,,28,14,51,54,21,7,9,14,7,7,22,18,-2.0,14,-3,,
202,202,2017,3,NCAAF_20170916_USM@LAMON,So. Miss,,UL-Monroe,,2-1,0-2,,21,10,28,17,7,14,7,0,0,10,7,0,2.0,11,11,,
203,203,2017,3,NCAAF_20170916_BGREEN@NWEST,Bowling Green,,Northwestern,,0-3,2-1,,7,35,7,49,7,0,0,0,14,21,0,14,-2.0,-28,-42,,
204,204,2017,3,NCAAF_20170916_GAST@PSU,Georgia St.,,Penn State,,0-2,3-0,,0,35,0,56,0,0,0,0,14,21,14,7,-3.0,-35,-56,,
205,205,2017,3,NCAAF_20170916_KSTATE@VANDY,Kansas State,,Vanderbilt,,2-1,3-0,,7,7,7,14,0,7,0,0,7,0,0,7,-1.0,0,-7,,
206,206,2017,3,NCAAF_20170916_SAMF@UGA,Samford,,Georgia,,2-1,3-0,,7,21,14,42,0,7,0,7,14,7,21,0,-1.0,-14,-28,,
207,207,2017,3,NCAAF_20170916_UK@SC,Kentucky,,South Carolina,,3-0,2-1,,14,6,23,13,7,7,3,6,6,0,0,7,1.0,8,10,,
208,208,2017,3,NCAAF_20170916_ARIZST@TXTECH,Arizona St.,,Texas Tech,,1-2,2-0,,17,35,45,52,3,14,21,7,21,14,10,7,-1.0,-18,-7,,
209,209,2017,3,NCAAF_20170916_CINCY@MIAOH,Cincinnati,,Miami-OH,,2-1,1-2,,3,7,21,17,3,0,0,18,7,0,7,3,1.0,-4,4,,
210,210,2017,3,NCAAF_20170916_CLEM@LVILLE,Clemson,,Louisville,,3-0,2-1,,19,7,47,21,7,12,14,14,7,0,0,14,1.0,12,26,,
211,211,2017,3,NCAAF_20170916_RICE@HOU,Rice,,Houston,,1-2,2-0,,0,38,3,38,0,0,0,3,17,21,0,0,-1.0,-38,-35,,
212,212,2017,3,NCAAF_20170916_TROY@NMEXST,Troy,,New Mexico St.,,2-1,1-2,,13,3,27,24,13,0,14,0,3,0,13,8,1.0,10,3,,
213,213,2017,3,NCAAF_20170916_FRESNO@WASH,Fresno St.,,Washington,,1-2,3-0,,7,41,16,48,0,7,6,3,27,14,7,0,-2.0,-34,-32,,
214,214,2017,3,NCAAF_20170916_SJST@UTAH,San Jose St.,,Utah,,1-3,3-0,,13,30,16,54,3,10,0,3,9,21,7,17,-2.0,-17,-38,,
215,215,2017,3,NCAAF_20170916_MISS@CAL,Ole Miss,,California,,2-1,3-0,,16,7,16,27,10,6,0,0,7,0,10,10,-1.0,9,-11,,
216,216,2017,3,NCAAF_20170916_STNFRD@SDGST,Stanford,,San Diego St.,,1-2,3-0,,7,10,17,20,0,7,3,7,0,10,3,7,-2.0,-3,-3,,
217,217,2017,3,NCAAF_20170915_ILL@SFLA,Illinois,,South Florida,,2-1,3-0,,9,23,23,47,2,7,0,14,9,14,14,10,-1.0,-14,-24,,
218,218,2017,3,NCAAF_20170915_MA@TEMPLE,UMass,,Temple,,0-4,2-1,,7,16,21,29,0,7,7,7,3,13,6,7,-2.0,-9,-8,,
219,219,2017,3,NCAAF_20170915_ARIZ@UTEP,Arizona,,UTEP,,2-1,0-3,,35,9,63,16,0,35,14,14,0,9,7,0,2.0,26,47,,
220,220,2017,3,NCAAF_20170914_NMEX@BOISE,New Mexico,,Boise St.,,1-2,2-1,,7,14,14,28,0,7,0,7,7,7,0,14,-1.0,-7,-14,,
221,221,2017,4,NCAAF_20170924_ECU@UCONN,East Carolina,,UConn,,1-3,1-2,,27,14,41,38,21,6,14,0,7,7,17,7,0.0,13,3,,
222,222,2017,4,NCAAF_20170923_ARMY@TULANE,Army,,Tulane,,2-2,2-2,,10,14,17,21,0,10,0,7,7,7,0,7,0.0,-4,-4,,
223,223,2017,4,NCAAF_20170923_KENTST@LVILLE,Kent St.,,Louisville,,1-3,3-1,,3,28,3,42,0,3,0,0,21,7,14,0,-2.0,-25,-39,,
224,224,2017,4,NCAAF_20170923_MA@TENN,UMass,,Tennessee,,0-5,3-1,,6,14,13,17,0,6,7,0,0,14,3,0,-3.0,-8,-4,,
225,225,2017,4,NCAAF_20170923_NCST@FSU,NC State,,Florida State,,3-1,0-2,,17,10,27,21,10,7,3,7,0,10,3,8,3.0,7,6,,
226,226,2017,4,NCAAF_20170923_TXTECH@HOU,Texas Tech,,Houston,,3-0,2-1,,13,10,27,24,6,7,7,7,0,10,0,14,1.0,3,3,,
227,227,2017,4,NCAAF_20170923_UNLV@OHIOST,UNLV,,Ohio State,,1-2,3-1,,7,44,21,54,0,7,7,7,16,28,10,0,-2.0,-37,-33,,
228,228,2017,4,NCAAF_20170923_WVU@KANSAS,West Virginia,,Kansas,,3-1,1-3,,35,13,56,34,7,28,0,21,3,10,14,7,2.0,22,22,,
229,229,2017,4,NCAAF_20170923_PITT@GATECH,Pittsburgh,,Georgia Tech,,1-3,2-1,,17,21,17,35,7,10,0,0,7,14,7,7,-1.0,-4,-18,,
230,230,2017,4,NCAAF_20170923_NMEX@TULSA,New Mexico,,Tulsa,,2-2,1-3,,13,10,16,13,7,6,0,3,3,7,0,3,1.0,3,3,,
231,231,2017,4,NCAAF_20170923_ODU@VATECH,Old Dominion,,Virginia Tech,,2-2,4-0,,0,17,0,38,0,0,0,0,3,14,14,7,-2.0,-17,-38,,
232,232,2017,4,NCAAF_20170923_UCF@MD,UCF,,Maryland,,2-0,2-1,,14,3,38,10,0,14,7,17,3,0,7,0,0.0,11,28,,
233,233,2017,4,NCAAF_20170923_BAMA@VANDY,Alabama,,Vanderbilt,,4-0,3-1,,31,0,59,0,21,10,21,7,0,0,0,0,1.0,31,59,,
234,234,2017,4,NCAAF_20170923_BC@CLEM,Boston College,,Clemson,,1-3,4-0,,0,7,7,34,0,0,7,0,0,7,0,27,-3.0,-7,-27,,
235,235,2017,4,NCAAF_20170923_CINCY@NAVY,Cincinnati,,Navy,,2-2,3-0,,17,21,32,42,7,10,7,8,14,7,14,7,-1.0,-4,-10,,
236,236,2017,4,NCAAF_20170923_DUKE@UNC,Duke,,North Carolina,,4-0,1-3,,10,10,27,17,7,3,3,14,3,7,7,0,3.0,0,10,,
237,237,2017,4,NCAAF_20170923_GAS@IND,Ga. Southern,,Indiana,,0-3,2-1,,7,31,17,52,0,7,10,0,21,10,14,7,-2.0,-24,-35,,
238,238,2017,4,NCAAF_20170923_LATECH@SC,Louisiana Tech,,South Carolina,,2-2,3-1,,6,0,16,17,3,3,7,3,0,0,0,17,-1.0,6,-1,,
239,239,2017,4,NCAAF_20170923_MIAOH@CMICH,Miami-OH,,C. Michigan,,2-2,2-2,,28,14,31,14,14,14,3,0,0,14,0,0,0.0,14,17,,
240,240,2017,4,NCAAF_20170923_RUT@NEB,Rutgers,,Nebraska,,1-3,2-2,,10,14,17,27,7,3,7,0,7,7,7,6,-1.0,-4,-10,,
241,241,2017,4,NCAAF_20170923_TCU@OKLAST,TCU,,Oklahoma State,,4-0,3-1,,20,10,44,31,6,14,14,10,7,3,7,14,1.0,10,13,,
242,242,2017,4,NCAAF_20170923_TOLEDO@MIAMI,Toledo,,Miami (Fla.),,3-1,2-0,,16,10,30,52,0,16,0,14,10,0,14,28,1.0,6,-22,,
243,243,2017,4,NCAAF_20170923_USC@CAL,USC,,California,,4-0,3-1,,13,13,30,20,3,10,0,17,3,10,0,7,1.0,0,10,,
244,244,2017,4,NCAAF_20170923_WAKE@APLST,Wake Forest,,App. St.,,4-0,2-2,,3,9,20,19,3,0,14,3,6,3,7,3,2.0,-6,1,,
245,245,2017,4,NCAAF_20170923_MICH@PURDUE,Michigan,,Purdue,,4-0,2-2,,7,10,28,10,0,7,7,14,0,10,0,0,2.0,-3,18,,
246,246,2017,4,NCAAF_20170923_AKRON@TROY,Akron,,Troy,,1-3,3-1,,10,16,17,22,10,0,7,0,7,9,0,6,-2.0,-6,-5,,
247,247,2017,4,NCAAF_20170923_GAST@CHARLO,Georgia St.,,Charlotte,,1-2,0-4,,14,0,28,0,0,14,0,14,0,0,0,0,1.0,14,28,,
248,248,2017,4,NCAAF_20170923_NEVADA@WASHST,Nevada,,Washington St.,,0-4,4-0,,0,35,7,45,0,0,0,7,14,21,3,7,-4.0,-35,-38,,
249,249,2017,4,NCAAF_20170923_OKLA@BAYLOR,Oklahoma,,Baylor,,4-0,0-4,,28,17,49,41,21,7,7,14,7,10,14,10,4.0,11,8,,
250,250,2017,4,NCAAF_20170923_UAB@NTEXAS,UAB,,North Texas,,2-2,2-2,,14,30,43,46,7,7,15,14,10,20,7,9,0.0,-16,-3,,
251,251,2017,4,NCAAF_20170923_WIL@CSTCAR,W. Illinois,,C. Carolina,,3-0,1-2,,21,10,52,10,7,14,21,10,10,0,0,0,2.0,11,42,,
252,252,2017,4,NCAAF_20170923_ARKST@SMU,Arkansas St.,,SMU,,1-2,3-1,,14,30,21,44,14,0,0,7,10,20,7,7,-2.0,-16,-23,,
253,253,2017,4,NCAAF_20170923_BALLST@WKY,Ball St.,,W. Kentucky,,2-2,2-2,,7,17,21,33,7,0,7,7,7,10,0,16,0.0,-10,-12,,
254,254,2017,4,NCAAF_20170923_BGREEN@MTSU,Bowling Green,,Middle Tenn.,,0-4,2-2,,10,21,13,24,7,3,3,0,7,14,0,3,-2.0,-11,-11,,
255,255,2017,4,NCAAF_20170923_CUSE@LSU,Syracuse,,LSU,,2-2,3-1,,3,14,26,35,3,0,16,7,7,7,14,7,-1.0,-11,-9,,
256,256,2017,4,NCAAF_20170923_FAU@BUFF,FAU,,Buffalo,,1-3,2-2,,17,17,31,34,7,10,0,14,14,3,7,10,-1.0,0,-3,,
257,257,2017,4,NCAAF_20170923_MISSST@UGA,Miss. State,,Georgia,,3-1,4-0,,3,14,3,31,0,3,0,0,14,0,17,0,-1.0,-11,-28,,
258,258,2017,4,NCAAF_20170923_SDGST@AF,San Diego St.,,Air Force,,4-0,1-2,,7,9,28,24,0,7,7,14,6,3,0,15,3.0,-2,4,,
259,259,2017,4,NCAAF_20170923_WAG@WMICH,Wagner,,W. Michigan,,1-3,2-2,,7,21,14,49,0,7,0,7,7,14,28,0,-1.0,-14,-35,,
260,260,2017,4,NCAAF_20170923_AUBURN@MIZZOU,Auburn,,Missouri,,3-1,1-3,,31,7,51,14,14,17,17,3,0,7,0,7,2.0,24,37,,
261,261,2017,4,NCAAF_20170923_FIU@RICE,FIU,,Rice,,2-1,1-3,,10,7,13,7,0,10,3,0,0,7,0,0,1.0,3,6,,
262,262,2017,4,NCAAF_20170923_FLA@UK,Florida,,Kentucky,,2-1,3-1,,14,14,28,27,0,14,0,14,7,7,10,3,-1.0,0,1,,
263,263,2017,4,NCAAF_20170923_PSU@IOWA,Penn State,,Iowa,,4-0,3-1,,5,7,21,19,3,2,10,6,0,7,0,12,1.0,-2,2,,
264,264,2017,4,NCAAF_20170923_TXSA@TXSTSM,UTSA,,Texas St.,,3-0,1-3,,27,14,44,14,10,17,3,14,7,7,0,0,2.0,13,30,,
265,265,2017,4,NCAAF_20170923_UTAHST@SJST,Utah St.,,San Jose St.,,2-2,1-4,,38,0,61,10,14,24,17,6,0,0,7,3,1.0,38,51,,
266,266,2017,4,NCAAF_20170923_ND@MICHST,Notre Dame,,Michigan St.,,3-1,2-1,,28,7,38,18,14,14,7,3,7,0,3,8,1.0,21,20,,
267,267,2017,4,NCAAF_20170923_SIL@MEMP,S. Illinois,,Memphis,,2-1,3-0,,21,17,31,44,14,7,3,7,7,10,17,10,-1.0,4,-13,,
268,268,2017,4,NCAAF_20170923_UTEP@NMEXST,UTEP,,New Mexico St.,,0-4,2-2,,7,21,14,41,7,0,0,7,7,14,13,7,-2.0,-14,-27,,
269,269,2017,4,NCAAF_20170923_OREG@ARIZST,Oregon,,Arizona St.,,3-1,0-1,,14,17,35,37,7,7,14,7,17,0,14,6,3.0,-3,-2,,
270,270,2017,4,NCAAF_20170923_WASH@COLO,Washington,,Colorado,,4-0,3-1,,10,7,37,10,0,10,14,13,7,0,3,0,1.0,3,27,,
271,271,2017,4,NCAAF_20170923_UCLA@STNFRD,UCLA,,Stanford,,2-2,2-2,,13,23,34,58,3,10,14,7,6,17,14,21,0.0,-10,-24,,
272,272,2017,4,NCAAF_20170922_UVA@BOISE,Virginia,,Boise St.,,3-1,2-2,,21,14,42,23,7,14,14,7,7,7,0,9,1.0,7,19,,
273,273,2017,4,NCAAF_20170922_UTAH@ARIZ,Utah,,Arizona,,4-0,2-2,,13,10,30,24,10,3,14,3,3,7,7,7,2.0,3,6,,
274,274,2017,4,NCAAF_20170921_TEMPLE@SFLA,Temple,,South Florida,,2-2,4-0,,7,20,7,43,0,7,0,0,3,17,13,10,-2.0,-13,-36,,
275,275,2017,5,NCAAF_20170930_HOU@TEMPLE,Houston,,Temple,,3-1,2-3,,13,0,20,13,7,6,7,0,0,0,3,10,1.0,13,7,,
276,276,2017,5,NCAAF_20170930_MD@MINN,Maryland,,Minnesota,,3-1,3-1,,17,10,31,24,7,10,0,14,0,10,7,7,0.0,7,7,,
277,277,2017,5,NCAAF_20170930_NMEXST@ARK,New Mexico St.,,Arkansas,,2-3,2-2,,10,28,24,42,0,10,7,7,14,14,7,7,0.0,-18,-18,,
278,278,2017,5,NCAAF_20170930_NWEST@WISC,Northwestern,,Wisconsin,,2-2,4-0,,10,7,24,33,3,7,0,14,7,0,14,12,-2.0,3,-9,,
279,279,2017,5,NCAAF_20170930_RICE@PITT,Rice,,Pittsburgh,,1-4,2-3,,0,28,10,42,0,0,10,0,21,7,0,14,-1.0,-28,-32,,
280,280,2017,5,NCAAF_20170930_SFLA@ECU,South Florida,,East Carolina,,5-0,1-4,,31,24,61,31,21,10,17,13,10,14,7,0,4.0,7,30,,
281,281,2017,5,NCAAF_20170930_UNC@GATECH,North Carolina,,Georgia Tech,,1-4,3-1,,0,10,7,33,0,0,0,7,7,3,14,9,-2.0,-10,-26,,
282,282,2017,5,NCAAF_20170930_VANDY@FLA,Vanderbilt,,Florida,,3-2,3-1,,17,17,24,38,7,10,0,7,7,10,7,14,0.0,0,-14,,
283,283,2017,5,NCAAF_20170930_CUSE@NCST,Syracuse,,NC State,,2-3,4-1,,7,26,25,33,0,7,10,8,13,13,0,7,-2.0,-19,-8,,
284,284,2017,5,NCAAF_20170930_CMICH@BC,C. Michigan,,Boston College,,2-3,2-3,,8,21,8,28,2,6,0,0,14,7,7,0,0.0,-13,-20,,
285,285,2017,5,NCAAF_20170930_BAYLOR@KSTATE,Baylor,,Kansas State,,0-5,3-1,,3,20,20,33,3,0,10,7,7,13,0,13,-3.0,-17,-13,,
286,286,2017,5,NCAAF_20170930_BUFF@KENTST,Buffalo,,Kent St.,,3-2,1-4,,20,13,27,13,7,13,7,0,0,13,0,0,2.0,7,14,,
287,287,2017,5,NCAAF_20170930_FSU@WAKE,Florida State,,Wake Forest,,1-2,4-1,,13,12,26,19,3,10,3,10,3,9,0,7,-3.0,1,7,,
288,288,2017,5,NCAAF_20170930_IND@PSU,Indiana,,Penn State,,2-2,5-0,,14,28,14,45,0,14,0,0,28,0,10,7,-3.0,-14,-31,,
289,289,2017,5,NCAAF_20170930_MURYST@LVILLE,Murray St.,,Louisville,,1-4,4-1,,3,35,10,55,3,0,7,0,14,21,10,10,-3.0,-32,-45,,
290,290,2017,5,NCAAF_20170930_NAVY@TULSA,Navy,,Tulsa,,4-0,1-4,,14,14,31,21,0,14,3,14,14,0,0,7,3.0,0,10,,
291,291,2017,5,NCAAF_20170930_OHIO@MA,Ohio,,UMass,,4-1,0-6,,27,27,58,50,7,20,14,17,10,17,2,21,4.0,0,8,,
292,292,2017,5,NCAAF_20170930_UGA@TENN,Georgia,,Tennessee,,5-0,3-2,,24,0,41,0,10,14,7,10,0,0,0,0,2.0,24,41,,
293,293,2017,5,NCAAF_20170930_UTEP@ARMY,UTEP,,Army,,0-5,3-2,,14,14,21,35,7,7,0,7,0,14,14,7,-3.0,0,-14,,
294,294,2017,5,NCAAF_20170930_ARIZST@STNFRD,Arizona St.,,Stanford,,2-3,3-2,,17,24,24,34,3,14,0,7,7,17,7,3,-1.0,-7,-10,,
295,295,2017,5,NCAAF_20170930_EMICH@UK,E. Michigan,,Kentucky,,2-2,4-1,,14,14,20,24,7,7,0,6,7,7,3,7,-2.0,0,-4,,
296,296,2017,5,NCAAF_20170930_IOWA@MICHST,Iowa,,Michigan St.,,3-2,3-1,,7,17,10,17,0,7,0,3,14,3,0,0,0.0,-10,-7,,
297,297,2017,5,NCAAF_20170930_TXSTSM@WYO,Texas St.,,Wyoming,,1-4,3-2,,10,31,10,45,0,10,0,0,0,31,14,0,-2.0,-21,-35,,
298,298,2017,5,NCAAF_20170930_UCONN@SMU,UConn,,SMU,,1-3,4-1,,10,21,28,49,7,3,10,8,7,14,7,21,-3.0,-11,-21,,
299,299,2017,5,NCAAF_20170930_MIAOH@ND,Miami-OH,,Notre Dame,,2-3,4-1,,14,45,17,52,7,7,3,0,28,17,0,7,-2.0,-31,-35,,
300,300,2017,5,NCAAF_20170930_AKRON@BGREEN,Akron,,Bowling Green,,2-3,0-5,,20,13,34,23,13,7,7,7,6,7,10,0,2.0,7,11,,
301,301,2017,5,NCAAF_20170930_MISSST@AUBURN,Miss. State,,Auburn,,3-2,4-1,,10,21,10,49,3,7,0,0,14,7,7,21,-1.0,-11,-39,,
302,302,2017,5,NCAAF_20170930_AF@NMEX,Air Force,,New Mexico,,1-3,3-2,,21,14,38,56,0,21,3,14,7,7,21,21,-2.0,7,-18,,
303,303,2017,5,NCAAF_20170930_BALLST@WMICH,Ball St.,,W. Michigan,,2-3,3-2,,0,31,3,55,0,0,3,0,14,17,17,7,-1.0,-31,-52,,
304,304,2017,5,NCAAF_20170930_CHARLO@FIU,Charlotte,,FIU,,0-5,3-1,,26,14,29,30,12,14,3,0,7,7,7,9,-3.0,12,-1,,
305,305,2017,5,NCAAF_20170930_CSTCAR@LAMON,C. Carolina,,UL-Monroe,,1-3,2-2,,22,31,43,51,15,7,8,13,10,21,14,6,-1.0,-9,-8,,
306,306,2017,5,NCAAF_20170930_MEMP@UCF,Memphis,,UCF,,3-1,3-0,,7,23,13,40,7,0,0,6,6,17,7,10,0.0,-16,-27,,
307,307,2017,5,NCAAF_20170930_MRSHL@CINCY,Marshall,,Cincinnati,,3-1,2-3,,24,0,38,21,7,17,7,7,0,0,7,14,1.0,24,17,,
308,308,2017,5,NCAAF_20170930_MTSU@FAU,Middle Tenn.,,FAU,,2-3,2-3,,6,24,20,38,6,0,7,7,14,10,0,14,0.0,-18,-18,,
309,309,2017,5,NCAAF_20170930_NTEXAS@USM,North Texas,,So. Miss,,3-2,2-2,,17,21,43,28,7,10,16,10,14,7,7,0,1.0,-4,15,,
310,310,2017,5,NCAAF_20170930_SALA@LATECH,South Alabama,,Louisiana Tech,,1-4,3-2,,13,17,16,34,7,6,3,0,14,3,0,17,-2.0,-4,-18,,
311,311,2017,5,NCAAF_20170930_TROY@LSU,Troy,,LSU,,4-1,3-2,,10,0,24,21,7,3,7,7,0,0,7,14,1.0,10,3,,
312,312,2017,5,NCAAF_20170930_OHIOST@RUT,Ohio State,,Rutgers,,4-1,1-4,,35,0,56,0,7,28,7,14,0,0,0,0,3.0,35,56,,
313,313,2017,5,NCAAF_20170930_SC@TXAM,South Carolina,,Texas A&M,,3-2,4-1,,10,7,17,24,0,10,7,0,0,7,3,14,-1.0,3,-7,,
314,314,2017,5,NCAAF_20170930_CLEM@VATECH,Clemson,,Virginia Tech,,5-0,4-1,,17,3,31,17,10,7,7,7,0,3,0,14,1.0,14,14,,
315,315,2017,5,NCAAF_20170930_OKLAST@TXTECH,Oklahoma State,,Texas Tech,,4-1,3-1,,21,17,41,34,7,14,13,7,7,10,3,14,1.0,4,7,,
316,316,2017,5,NCAAF_20170930_WASH@OREGST,Washington,,Oregon State,,5-0,1-4,,7,0,42,7,7,0,21,14,0,0,0,7,4.0,7,35,,
317,317,2017,5,NCAAF_20170930_MISS@BAMA,Ole Miss,,Alabama,,2-2,5-0,,3,35,3,66,3,0,0,0,21,14,24,7,-3.0,-32,-63,,
318,318,2017,5,NCAAF_20170930_NEVADA@FRESNO,Nevada,,Fresno St.,,0-5,2-2,,14,31,21,41,0,14,0,7,10,21,7,3,-2.0,-17,-20,,
319,319,2017,5,NCAAF_20170930_CAL@OREG,California,,Oregon,,3-2,4-1,,7,17,24,45,0,7,7,10,17,0,7,21,-1.0,-10,-21,,
320,320,2017,5,NCAAF_20170930_COLO@UCLA,Colorado,,UCLA,,3-2,3-2,,10,14,23,27,7,3,10,3,7,7,7,6,0.0,-4,-4,,
321,321,2017,5,NCAAF_20170930_NILL@SDGST,N. Illinois,,San Diego St.,,2-2,5-0,,14,31,28,34,14,0,14,0,14,17,0,3,-3.0,-17,-6,,
322,322,2017,5,NCAAF_20170930_SJST@UNLV,San Jose St.,,UNLV,,1-5,2-2,,13,35,13,41,3,10,0,0,14,21,6,0,-1.0,-22,-28,,
323,323,2017,5,NCAAF_20170930_COLOST@HAWAII,Colorado St.,,Hawaii,,3-2,2-3,,31,7,51,21,14,17,13,7,0,7,7,7,1.0,24,30,,
324,324,2017,5,NCAAF_20170929_MIAMI@DUKE,Miami (Fla.),,Duke,,3-0,4-1,,17,6,31,6,14,3,0,14,3,3,0,0,-1.0,11,25,,
325,325,2017,5,NCAAF_20170929_BYU@UTAHST,BYU,,Utah St.,,1-4,3-2,,21,24,24,40,7,14,0,3,7,17,3,13,-2.0,-3,-16,,
326,326,2017,5,NCAAF_20170929_NEB@ILL,Nebraska,,Illinois,,3-2,2-2,,21,3,28,6,7,14,0,7,0,3,3,0,1.0,18,22,,
327,327,2017,5,NCAAF_20170929_USC@WASHST,USC,,Washington St.,,4-1,5-0,,17,17,27,30,7,10,3,7,3,14,3,10,-1.0,0,-3,,
328,328,2017,5,NCAAF_20170928_TEXAS@IOWAST,Texas,,Iowa St.,,2-2,2-2,,14,0,17,7,7,7,0,3,0,0,7,0,0.0,14,10,,
329,329,2017,6,NCAAF_20171007_TULSA@TULANE,Tulsa,,Tulane,,1-5,3-2,,7,48,28,62,7,0,14,7,21,27,7,7,-2.0,-41,-34,,
330,330,2017,6,NCAAF_20171007_EMICH@TOLEDO,E. Michigan,,Toledo,,2-3,4-1,,6,10,15,20,6,0,3,6,3,7,7,3,-2.0,-4,-5,,
331,331,2017,6,NCAAF_20171007_ILL@IOWA,Illinois,,Iowa,,2-3,4-2,,13,17,16,45,3,10,3,0,7,10,7,21,-2.0,-4,-29,,
332,332,2017,6,NCAAF_20171007_IOWAST@OKLA,Iowa St.,,Oklahoma,,3-2,4-1,,13,24,38,31,3,10,11,14,14,10,0,7,-1.0,-11,7,,
333,333,2017,6,NCAAF_20171007_MISS@AUBURN,Ole Miss,,Auburn,,2-3,5-1,,3,35,23,44,3,0,7,13,14,21,6,3,-3.0,-32,-21,,
334,334,2017,6,NCAAF_20171007_PSU@NWEST,Penn State,,Northwestern,,6-0,2-3,,10,0,31,7,3,7,14,7,0,0,0,7,4.0,10,24,,
335,335,2017,6,NCAAF_20171007_TEMPLE@ECU,Temple,,East Carolina,,3-3,1-5,,24,3,34,10,0,24,7,3,3,0,7,0,2.0,21,24,,
336,336,2017,6,NCAAF_20171007_TXTECH@KANSAS,Texas Tech,,Kansas,,4-1,1-4,,35,10,65,19,21,14,13,17,7,3,9,0,3.0,25,46,,
337,337,2017,6,NCAAF_20171007_UGA@VANDY,Georgia,,Vanderbilt,,6-0,3-3,,21,7,45,14,7,14,17,7,0,7,0,7,3.0,14,31,,
338,338,2017,6,NCAAF_20171007_WAKE@CLEM,Wake Forest,,Clemson,,4-2,6-0,,0,14,14,28,0,0,0,14,14,0,7,7,-2.0,-14,-14,,
339,339,2017,6,NCAAF_20171007_DUKE@UVA,Duke,,Virginia,,4-2,4-1,,14,14,21,28,7,7,0,7,7,7,7,7,0.0,0,-7,,
340,340,2017,6,NCAAF_20171007_PITT@CUSE,Pittsburgh,,Syracuse,,2-4,3-3,,10,10,24,27,0,10,3,11,3,7,10,7,-1.0,0,-3,,
341,341,2017,6,NCAAF_20171007_CMICH@OHIO,C. Michigan,,Ohio,,3-3,4-2,,13,14,26,23,7,6,6,7,7,7,0,9,-1.0,-1,3,,
342,342,2017,6,NCAAF_20171007_BGREEN@MIAOH,Bowling Green,,Miami-OH,,1-5,2-4,,17,19,37,29,3,14,7,13,6,13,10,0,-1.0,-2,8,,
343,343,2017,6,NCAAF_20171007_FIU@MTSU,FIU,,Middle Tenn.,,3-2,3-3,,3,17,17,37,3,0,7,7,3,14,10,10,0.0,-14,-20,,
344,344,2017,6,NCAAF_20171007_LAMON@TXSTSM,UL-Monroe,,Texas St.,,3-2,1-5,,26,20,45,27,19,7,9,10,20,0,0,7,2.0,6,18,,
345,345,2017,6,NCAAF_20171007_AF@NAVY,Air Force,,Navy,,1-4,5-0,,10,28,45,48,7,3,14,21,7,21,10,10,-4.0,-18,-3,,
346,346,2017,6,NCAAF_20171007_BALLST@AKRON,Ball St.,,Akron,,2-4,3-3,,3,17,3,31,3,0,0,0,7,10,0,14,-1.0,-14,-28,,
347,347,2017,6,NCAAF_20171007_CHARSO@IND,Charleston So.,,Indiana,,2-3,3-2,,0,24,0,27,0,0,0,0,10,14,3,0,-1.0,-24,-27,,
348,348,2017,6,NCAAF_20171007_KENTST@NILL,Kent St.,,N. Illinois,,1-5,3-2,,3,14,3,24,0,3,0,0,7,7,10,0,-2.0,-11,-21,,
349,349,2017,6,NCAAF_20171007_LSU@FLA,LSU,,Florida,,4-2,3-2,,10,3,17,16,7,3,7,0,0,3,13,0,1.0,7,1,,
350,350,2017,6,NCAAF_20171007_MIAMI@FSU,Miami (Fla.),,Florida State,,4-0,1-3,,0,3,24,20,0,0,10,14,3,0,0,17,3.0,-3,4,,
351,351,2017,6,NCAAF_20171007_MINN@PURDUE,Minnesota,,Purdue,,3-2,3-2,,14,6,17,31,7,7,0,3,6,0,7,18,0.0,8,-14,,
352,352,2017,6,NCAAF_20171007_ND@UNC,Notre Dame,,North Carolina,,5-1,1-5,,16,7,33,10,0,16,10,7,0,7,0,3,4.0,9,23,,
353,353,2017,6,NCAAF_20171007_NMEXST@APLST,New Mexico St.,,App. St.,,2-4,3-2,,14,17,31,45,7,7,3,14,3,14,0,28,-1.0,-3,-14,,
354,354,2017,6,NCAAF_20171007_WVU@TCU,West Virginia,,TCU,,3-2,5-0,,3,7,24,31,3,0,14,7,0,7,17,7,-2.0,-4,-7,,
355,355,2017,6,NCAAF_20171007_ARK@SC,Arkansas,,South Carolina,,2-3,4-2,,10,17,22,48,3,7,0,12,3,14,17,14,-2.0,-7,-26,,
356,356,2017,6,NCAAF_20171007_LATECH@UAB,Louisiana Tech,,UAB,,3-3,3-2,,10,16,22,23,7,3,0,12,13,3,0,7,0.0,-6,-1,,
357,357,2017,6,NCAAF_20171007_MD@OHIOST,Maryland,,Ohio State,,3-2,5-1,,7,41,14,62,7,0,0,7,20,21,14,7,-2.0,-34,-48,,
358,358,2017,6,NCAAF_20171007_OREGST@USC,Oregon State,,USC,,1-5,5-1,,3,21,10,38,0,3,0,7,14,7,7,10,-4.0,-18,-28,,
359,359,2017,6,NCAAF_20171007_COLOST@UTAHST,Colorado St.,,Utah St.,,4-2,3-3,,24,7,27,14,17,7,0,3,0,7,0,7,1.0,17,13,,
360,360,2017,6,NCAAF_20171007_LALAF@IDAHO,Louisiana,,Idaho,,2-3,2-3,,14,10,21,16,7,7,7,0,7,3,3,3,0.0,4,5,,
361,361,2017,6,NCAAF_20171007_FAU@ODU,FAU,,Old Dominion,,3-3,2-3,,31,14,58,28,17,14,14,13,7,7,7,7,1.0,17,30,,
362,362,2017,6,NCAAF_20171007_MRSHL@CHARLO,Marshall,,Charlotte,,4-1,0-6,,7,0,14,3,7,0,7,0,0,0,3,0,4.0,7,11,,
363,363,2017,6,NCAAF_20171007_ARMY@RICE,Army,,Rice,,4-2,1-5,,35,0,49,12,21,14,7,7,0,0,6,6,3.0,35,37,,
364,364,2017,6,NCAAF_20171007_GAST@CSTCAR,Georgia St.,,C. Carolina,,2-2,1-4,,21,7,27,21,14,7,0,6,0,7,0,14,1.0,14,6,,
365,365,2017,6,NCAAF_20171007_SMU@HOU,SMU,,Houston,,4-2,4-1,,12,21,22,35,9,3,10,0,7,14,7,7,0.0,-9,-13,,
366,366,2017,6,NCAAF_20171007_USM@TXSA,So. Miss,,UTSA,,3-2,3-1,,7,13,31,29,7,0,14,10,3,10,0,16,0.0,-6,2,,
367,367,2017,6,NCAAF_20171007_BAMA@TXAM,Alabama,,Texas A&M,,6-0,4-2,,17,3,27,19,7,10,7,3,3,0,7,9,2.0,14,8,,
368,368,2017,6,NCAAF_20171007_VATECH@BC,Virginia Tech,,Boston College,,5-1,2-4,,17,3,23,10,7,10,3,3,3,0,0,7,3.0,14,13,,
369,369,2017,6,NCAAF_20171007_FRESNO@SJST,Fresno St.,,San Jose St.,,3-2,1-6,,21,0,27,10,14,7,0,6,0,0,7,3,2.0,21,17,,
370,370,2017,6,NCAAF_20171007_MICHST@MICH,Michigan St.,,Michigan,,4-1,4-1,,14,3,14,10,7,7,0,0,3,0,7,0,0.0,11,4,,
371,371,2017,6,NCAAF_20171007_MIZZOU@UK,Missouri,,Kentucky,,1-4,5-1,,14,20,34,40,0,14,13,7,10,10,7,13,-4.0,-6,-6,,
372,372,2017,6,NCAAF_20171007_ARIZ@COLO,Arizona,,Colorado,,3-2,3-3,,21,14,45,42,14,7,14,10,7,7,7,21,0.0,7,3,,
373,373,2017,6,NCAAF_20171007_WASHST@OREG,Washington St.,,Oregon,,6-0,4-2,,13,10,33,10,7,6,10,10,10,0,0,0,2.0,3,23,,
374,374,2017,6,NCAAF_20171007_WISC@NEB,Wisconsin,,Nebraska,,5-0,3-3,,17,10,38,17,10,7,7,14,0,10,7,0,2.0,7,21,,
375,375,2017,6,NCAAF_20171007_WKY@UTEP,W. Kentucky,,UTEP,,3-2,0-6,,8,14,15,14,0,8,7,0,0,14,0,0,3.0,-6,1,,
376,376,2017,6,NCAAF_20171007_STNFRD@UTAH,Stanford,,Utah,,4-2,4-1,,13,10,23,20,3,10,3,7,7,3,3,7,0.0,3,3,,
377,377,2017,6,NCAAF_20171007_HAWAII@NEVADA,Hawaii,,Nevada,,2-4,1-5,,14,21,21,35,7,7,7,0,7,14,7,7,1.0,-7,-14,,
378,378,2017,6,NCAAF_20171007_CAL@WASH,California,,Washington,,3-3,6-0,,0,24,7,38,0,0,7,0,7,17,7,7,-3.0,-24,-31,,
379,379,2017,6,NCAAF_20171007_SDGST@UNLV,San Diego St.,,UNLV,,6-0,2-3,,20,10,41,10,3,17,7,14,3,7,0,0,4.0,10,31,,
380,380,2017,6,NCAAF_20171006_MEMP@UCONN,Memphis,,UConn,,4-1,1-4,,35,24,70,31,7,28,21,14,14,10,0,7,3.0,11,39,,
381,381,2017,6,NCAAF_20171006_BOISE@BYU,Boise St.,,BYU,,3-2,1-5,,17,7,24,7,0,17,0,7,7,0,0,0,2.0,10,17,,
382,382,2017,6,NCAAF_20171005_LVILLE@NCST,Louisville,,NC State,,4-2,5-1,,10,17,25,39,0,10,3,12,0,17,7,15,-1.0,-7,-14,,
383,383,2017,6,NCAAF_20171004_ARKST@GAS,Arkansas St.,,Ga. Southern,,2-2,0-4,,22,17,43,25,3,19,14,7,0,17,0,8,2.0,5,18,,
384,384,2017,7,NCAAF_20171015_SJST@HAWAII,San Jose St.,,Hawaii,,1-7,3-4,,13,14,26,37,10,3,7,6,0,14,7,16,-2.0,-1,-11,,
385,385,2017,7,NCAAF_20171015_AKRON@WMICH,Akron,,W. Michigan,,4-3,4-3,,14,3,14,13,7,7,0,0,0,3,0,10,0.0,11,1,,
386,386,2017,7,NCAAF_20171014_BYU@MISSST,BYU,,Miss. State,,1-6,4-2,,3,21,10,35,0,3,7,0,7,14,7,7,-3.0,-18,-25,,
387,387,2017,7,NCAAF_20171014_EMICH@ARMY,E. Michigan,,Army,,2-4,5-2,,14,14,27,28,7,7,0,13,7,7,7,7,-3.0,0,-1,,
388,388,2017,7,NCAAF_20171014_FSU@DUKE,Florida State,,Duke,,2-3,4-3,,7,3,17,10,7,0,3,7,0,3,7,0,-2.0,4,7,,
389,389,2017,7,NCAAF_20171014_KANSAS@IOWAST,Kansas,,Iowa St.,,1-5,4-2,,0,24,0,45,0,0,0,0,14,10,14,7,-3.0,-24,-45,,
390,390,2017,7,NCAAF_20171014_NCST@PITT,NC State,,Pittsburgh,,6-1,2-5,,14,14,35,17,14,0,7,14,7,7,0,3,4.0,0,18,,
391,391,2017,7,NCAAF_20171014_RUT@ILL,Rutgers,,Illinois,,2-4,2-4,,21,10,35,24,7,14,7,7,3,7,0,14,0.0,11,11,,
392,392,2017,7,NCAAF_20171014_SC@TENN,South Carolina,,Tennessee,,5-2,3-3,,3,9,15,9,0,3,6,6,6,3,0,0,2.0,-6,6,,
393,393,2017,7,NCAAF_20171014_TCU@KSTATE,TCU,,Kansas State,,6-0,3-3,,13,3,26,6,10,3,7,6,0,3,3,0,3.0,10,20,,
394,394,2017,7,NCAAF_20171014_TXTECH@WVU,Texas Tech,,West Virginia,,4-2,4-2,,28,17,35,46,14,14,7,0,10,7,7,22,0.0,11,-11,,
395,395,2017,7,NCAAF_20171014_UCONN@TEMPLE,UConn,,Temple,,2-4,3-4,,14,7,28,24,0,14,14,0,7,0,7,10,-1.0,7,4,,
396,396,2017,7,NCAAF_20171014_BC@LVILLE,Boston College,,Louisville,,3-4,4-3,,14,21,45,42,7,7,14,17,14,7,0,21,-1.0,-7,3,,
397,397,2017,7,NCAAF_20171014_UNLV@AF,UNLV,,Air Force,,2-4,2-4,,27,7,30,34,17,10,3,0,0,7,13,14,0.0,20,-4,,
398,398,2017,7,NCAAF_20171014_ODU@MRSHL,Old Dominion,,Marshall,,2-4,5-1,,3,7,3,35,0,3,0,0,0,7,7,21,-3.0,-4,-32,,
399,399,2017,7,NCAAF_20171014_AUBURN@LSU,Auburn,,LSU,,5-2,5-2,,23,14,23,27,17,6,0,0,0,14,0,13,0.0,9,-4,,
400,400,2017,7,NCAAF_20171014_BAYLOR@OKLAST,Baylor,,Oklahoma State,,0-6,5-1,,10,35,16,59,7,3,6,0,7,28,10,14,-5.0,-25,-43,,
401,401,2017,7,NCAAF_20171014_GATECH@MIAMI,Georgia Tech,,Miami (Fla.),,3-2,5-0,,14,13,24,25,7,7,10,0,3,10,3,9,-2.0,1,-1,,
402,402,2017,7,NCAAF_20171014_MIAOH@KENTST,Miami-OH,,Kent St.,,2-5,2-5,,14,3,14,17,0,14,0,0,0,3,14,0,0.0,11,-3,,
403,403,2017,7,NCAAF_20171014_NILL@BUFF,N. Illinois,,Buffalo,,4-2,3-4,,14,13,14,13,0,14,0,0,3,10,0,0,1.0,1,1,,
404,404,2017,7,NCAAF_20171014_NWEST@MD,Northwestern,,Maryland,,3-3,3-3,,24,14,37,21,3,21,3,10,7,7,7,0,0.0,10,16,,
405,405,2017,7,NCAAF_20171014_OHIO@BGREEN,Ohio,,Bowling Green,,5-2,1-6,,21,16,48,30,0,21,6,21,6,10,7,7,4.0,5,18,,
406,406,2017,7,NCAAF_20171014_OKLA@TEXAS,Oklahoma,,Texas,,5-1,3-3,,20,10,29,24,10,10,3,6,0,10,7,7,2.0,10,5,,
407,407,2017,7,NCAAF_20171014_PURDUE@WISC,Purdue,,Wisconsin,,3-3,6-0,,6,17,9,17,3,3,3,0,14,3,0,0,-3.0,-11,-8,,
408,408,2017,7,NCAAF_20171014_TOLEDO@CMICH,Toledo,,C. Michigan,,5-1,3-4,,17,0,30,10,7,10,0,13,0,0,3,7,2.0,17,20,,
409,409,2017,7,NCAAF_20171014_UVA@UNC,Virginia,,North Carolina,,5-1,1-6,,10,0,20,14,0,10,7,3,0,0,14,0,4.0,10,6,,
410,410,2017,7,NCAAF_20171014_VANDY@MISS,Vanderbilt,,Ole Miss,,3-4,3-3,,21,35,35,57,0,21,0,14,7,28,12,10,0.0,-14,-22,,
411,411,2017,7,NCAAF_20171014_NAVY@MEMP,Navy,,Memphis,,5-1,5-1,,10,10,27,30,10,0,9,8,7,3,10,10,0.0,0,-3,,
412,412,2017,7,NCAAF_20171014_COLO@OREGST,Colorado,,Oregon State,,4-3,1-6,,14,19,36,33,7,7,7,15,10,9,7,7,3.0,-5,3,,
413,413,2017,7,NCAAF_20171014_HOU@TULSA,Houston,,Tulsa,,4-2,2-5,,10,7,17,45,3,7,0,7,0,7,17,21,2.0,3,-28,,
414,414,2017,7,NCAAF_20171014_CHARLO@WKY,Charlotte,,W. Kentucky,,0-7,4-2,,14,38,14,45,7,7,0,0,14,24,0,7,-4.0,-24,-31,,
415,415,2017,7,NCAAF_20171014_WYO@UTAHST,Wyoming,,Utah St.,,4-2,3-4,,9,16,28,23,3,6,7,12,6,10,0,7,1.0,-7,5,,
416,416,2017,7,NCAAF_20171014_APLST@IDAHO,App. St.,,Idaho,,4-2,2-4,,0,17,23,20,0,0,7,16,0,17,3,0,2.0,-17,3,,
417,417,2017,7,NCAAF_20171014_GAST@LAMON,Georgia St.,,UL-Monroe,,3-2,3-3,,26,10,47,37,13,13,14,7,10,0,14,13,0.0,16,10,,
418,418,2017,7,NCAAF_20171014_NMEXST@GAS,New Mexico St.,,Ga. Southern,,3-4,0-5,,21,24,35,27,14,7,0,14,14,10,3,0,3.0,-3,8,,
419,419,2017,7,NCAAF_20171014_MTSU@UAB,Middle Tenn.,,UAB,,3-4,4-2,,20,22,23,25,10,10,3,0,9,13,0,3,-1.0,-2,-2,,
420,420,2017,7,NCAAF_20171014_CSTCAR@ARKST,C. Carolina,,Arkansas St.,,1-5,3-2,,7,17,17,51,0,7,0,10,7,10,17,17,-2.0,-10,-34,,
421,421,2017,7,NCAAF_20171014_ECU@UCF,East Carolina,,UCF,,1-6,5-0,,14,42,21,63,7,7,0,7,21,21,7,14,-4.0,-28,-42,,
422,422,2017,7,NCAAF_20171014_TULANE@FIU,Tulane,,FIU,,3-3,4-2,,3,10,10,23,0,3,7,0,7,3,3,10,-1.0,-7,-13,,
423,423,2017,7,NCAAF_20171014_TXAM@FLA,Texas A&M,,Florida,,5-2,3-3,,3,10,19,17,3,0,7,9,3,7,0,7,2.0,-7,2,,
424,424,2017,7,NCAAF_20171014_TXSA@NTEXAS,UTSA,,North Texas,,3-2,4-2,,17,16,26,29,7,10,3,6,16,0,0,13,-1.0,1,-3,,
425,425,2017,7,NCAAF_20171014_UTEP@USM,UTEP,,So. Miss,,0-7,4-2,,0,14,0,24,0,0,0,0,7,7,0,10,-4.0,-14,-24,,
426,426,2017,7,NCAAF_20171014_ARK@BAMA,Arkansas,,Alabama,,2-4,7-0,,0,24,9,41,0,0,3,6,17,7,7,10,-5.0,-24,-32,,
427,427,2017,7,NCAAF_20171014_CINCY@SFLA,Cincinnati,,South Florida,,2-5,6-0,,3,23,3,33,3,0,0,0,3,20,7,3,-4.0,-20,-30,,
428,428,2017,7,NCAAF_20171014_MIZZOU@UGA,Missouri,,Georgia,,1-5,7-0,,21,34,28,53,14,7,0,7,14,20,13,6,-6.0,-13,-25,,
429,429,2017,7,NCAAF_20171014_OHIOST@NEB,Ohio State,,Nebraska,,6-1,3-4,,35,0,56,14,14,21,14,7,0,0,14,0,3.0,35,42,,
430,430,2017,7,NCAAF_20171014_MICHST@MINN,Michigan St.,,Minnesota,,5-1,3-3,,17,6,30,27,10,7,6,7,6,0,0,21,2.0,11,3,,
431,431,2017,7,NCAAF_20171014_UTAH@USC,Utah,,USC,,4-2,6-1,,21,7,27,28,7,14,0,6,7,0,7,14,-2.0,14,-1,,
432,432,2017,7,NCAAF_20171014_UCLA@ARIZ,UCLA,,Arizona,,3-3,4-2,,14,30,30,47,7,7,16,0,17,13,10,7,-1.0,-16,-17,,
433,433,2017,7,NCAAF_20171014_NMEX@FRESNO,New Mexico,,Fresno St.,,3-3,4-2,,0,21,0,38,0,0,0,0,14,7,10,7,-1.0,-21,-38,,
434,434,2017,7,NCAAF_20171014_NEVADA@COLOST,Nevada,,Colorado St.,,1-6,5-2,,21,28,42,44,14,7,21,0,14,14,10,6,-4.0,-7,-2,,
435,435,2017,7,NCAAF_20171014_BOISE@SDGST,Boise St.,,San Diego St.,,4-2,6-1,,21,0,31,14,14,7,0,10,0,0,7,7,-2.0,21,17,,
436,436,2017,7,NCAAF_20171014_WASH@ARIZST,Washington,,Arizona St.,,6-1,1-2,,0,13,7,13,0,0,0,7,7,6,0,0,5.0,-13,-6,,
437,437,2017,7,NCAAF_20171014_OREG@STNFRD,Oregon,,Stanford,,4-3,5-2,,7,28,7,49,7,0,0,0,21,7,7,14,-1.0,-21,-42,,
438,438,2017,7,NCAAF_20171013_CLEM@CUSE,Clemson,,Syracuse,,6-1,4-3,,14,17,24,27,7,7,10,0,14,3,7,3,2.0,-3,-3,,
439,439,2017,7,NCAAF_20171013_WASHST@CAL,Washington St.,,California,,6-1,4-3,,3,17,3,37,0,3,0,0,10,7,3,17,2.0,-14,-34,,
440,440,2017,7,NCAAF_20171012_TXSTSM@LALAF,Texas St.,,Louisiana,,1-6,3-3,,0,14,7,24,0,0,7,0,14,0,3,7,-2.0,-14,-17,,
441,441,2017,7,NCAAF_20171011_SALA@TROY,South Alabama,,Troy,,2-4,4-2,,9,0,19,8,7,2,7,3,0,0,0,8,-2.0,9,11,,
442,442,2017,8,NCAAF_20171021_AKRON@TOLEDO,Akron,,Toledo,,4-4,6-1,,7,24,21,48,0,7,0,14,21,3,14,10,-2.0,-17,-27,,
443,443,2017,8,NCAAF_20171021_IDAHO@MIZZOU,Idaho,,Missouri,,2-5,2-5,,14,51,21,68,7,7,0,7,34,17,14,3,0.0,-37,-47,,
444,444,2017,8,NCAAF_20171021_IOWAST@TXTECH,Iowa St.,,Texas Tech,,5-2,4-3,,24,6,31,13,7,17,0,7,6,0,7,0,1.0,18,18,,
445,445,2017,8,NCAAF_20171021_LVILLE@FSU,Louisville,,Florida State,,5-3,2-4,,14,14,31,28,7,7,14,3,7,7,0,14,3.0,0,3,,
446,446,2017,8,NCAAF_20171021_MD@WISC,Maryland,,Wisconsin,,3-4,7-0,,3,21,13,38,0,3,10,0,7,14,7,10,-4.0,-18,-25,,
447,447,2017,8,NCAAF_20171021_PURDUE@RUT,Purdue,,Rutgers,,3-4,3-4,,3,7,12,14,0,3,3,6,7,0,7,0,0.0,-4,-2,,
448,448,2017,8,NCAAF_20171021_TULSA@UCONN,Tulsa,,UConn,,2-6,3-4,,0,3,14,20,0,0,0,14,3,0,14,3,-1.0,-3,-6,,
449,449,2017,8,NCAAF_20171021_PITT@DUKE,Pittsburgh,,Duke,,3-5,4-4,,7,3,24,17,7,0,7,10,0,3,14,0,-1.0,4,7,,
450,450,2017,8,NCAAF_20171021_BC@UVA,Boston College,,Virginia,,4-4,5-2,,24,7,41,10,17,7,10,7,0,7,0,3,-1.0,17,31,,
451,451,2017,8,NCAAF_20171021_KENTST@OHIO,Kent St.,,Ohio,,2-6,6-2,,3,13,3,48,3,0,0,0,0,13,28,7,-4.0,-10,-45,,
452,452,2017,8,NCAAF_20171021_NILL@BGREEN,N. Illinois,,Bowling Green,,5-2,1-7,,31,7,48,17,14,17,10,7,7,0,3,7,4.0,24,31,,
453,453,2017,8,NCAAF_20171021_TROY@GAST,Troy,,Georgia St.,,5-2,3-3,,21,3,34,10,7,14,10,3,3,0,0,7,2.0,18,24,,
454,454,2017,8,NCAAF_20171021_BUFF@MIAOH,Buffalo,,Miami-OH,,3-5,3-5,,7,10,14,24,0,7,0,7,10,0,14,0,0.0,-3,-10,,
455,455,2017,8,NCAAF_20171021_CMICH@BALLST,C. Michigan,,Ball St.,,4-4,2-5,,28,6,56,9,7,21,7,21,3,3,3,0,2.0,22,47,,
456,456,2017,8,NCAAF_20171021_ARIZST@UTAH,Arizona St.,,Utah,,4-3,4-3,,16,0,30,10,9,7,7,7,0,0,3,7,0.0,16,20,,
457,457,2017,8,NCAAF_20171021_CSTCAR@APLST,C. Carolina,,App. St.,,1-6,5-2,,19,17,29,37,3,16,3,7,14,3,6,14,-4.0,2,-8,,
458,458,2017,8,NCAAF_20171021_CUSE@MIAMI,Syracuse,,Miami (Fla.),,4-4,6-0,,3,13,19,27,0,3,10,6,3,10,7,7,-2.0,-10,-8,,
459,459,2017,8,NCAAF_20171021_GAS@MA,Ga. Southern,,UMass,,0-6,1-6,,17,48,20,55,7,10,3,0,28,20,0,7,-1.0,-31,-35,,
460,460,2017,8,NCAAF_20171021_ILL@MINN,Illinois,,Minnesota,,2-5,4-3,,7,7,17,24,7,0,0,10,7,0,3,14,-2.0,0,-7,,
461,461,2017,8,NCAAF_20171021_IND@MICHST,Indiana,,Michigan St.,,3-4,6-1,,3,3,9,17,3,0,3,3,0,3,0,14,-3.0,0,-8,,
462,462,2017,8,NCAAF_20171021_TENN@BAMA,Tennessee,,Alabama,,3-4,8-0,,0,21,7,45,0,0,7,0,7,14,10,14,-5.0,-21,-38,,
463,463,2017,8,NCAAF_20171021_UCF@NAVY,UCF,,Navy,,6-0,5-2,,14,7,31,21,7,7,10,7,0,7,7,7,1.0,7,10,,
464,464,2017,8,NCAAF_20171021_UNC@VATECH,North Carolina,,Virginia Tech,,1-7,6-1,,0,35,7,59,0,0,0,7,14,21,17,7,-5.0,-35,-52,,
465,465,2017,8,NCAAF_20171021_OKLA@KSTATE,Oklahoma,,Kansas State,,6-1,3-4,,10,21,42,35,7,3,10,22,14,7,0,14,3.0,-11,7,,
466,466,2017,8,NCAAF_20171021_OREG@UCLA,Oregon,,UCLA,,4-4,4-3,,14,14,14,31,0,14,0,0,14,0,10,7,0.0,0,-17,,
467,467,2017,8,NCAAF_20171021_UK@MISSST,Kentucky,,Miss. State,,5-2,5-2,,7,17,7,45,0,7,0,0,7,10,7,21,0.0,-10,-38,,
468,468,2017,8,NCAAF_20171021_LAMON@SALA,UL-Monroe,,South Alabama,,3-4,3-4,,20,24,23,33,7,13,3,0,14,10,6,3,0.0,-4,-10,,
469,469,2017,8,NCAAF_20171021_NTEXAS@FAU,North Texas,,FAU,,4-3,4-3,,7,41,31,69,0,7,10,14,24,17,21,7,0.0,-34,-38,,
470,470,2017,8,NCAAF_20171021_UTAHST@UNLV,Utah St.,,UNLV,,4-4,2-5,,28,28,52,28,7,21,7,17,14,14,0,0,2.0,0,24,,
471,471,2017,8,NCAAF_20171021_BYU@ECU,BYU,,East Carolina,,1-7,2-6,,10,10,17,33,7,3,0,7,7,3,9,14,-1.0,0,-16,,
472,472,2017,8,NCAAF_20171021_RICE@TXSA,Rice,,UTSA,,1-6,4-2,,7,10,7,20,0,7,0,0,10,0,10,0,-3.0,-3,-13,,
473,473,2017,8,NCAAF_20171021_SFLA@TULANE,South Florida,,Tulane,,7-0,3-4,,20,7,34,28,7,13,14,0,0,7,7,14,4.0,13,6,,
474,474,2017,8,NCAAF_20171021_LSU@MISS,LSU,,Ole Miss,,6-2,3-4,,13,6,40,24,10,3,17,10,3,3,10,8,3.0,7,16,,
475,475,2017,8,NCAAF_20171021_AUBURN@ARK,Auburn,,Arkansas,,6-2,2-5,,17,6,52,20,10,7,28,7,3,3,7,7,4.0,11,32,,
476,476,2017,8,NCAAF_20171021_MICH@PSU,Michigan,,Penn State,,5-2,7-0,,13,21,13,42,0,13,0,0,14,7,7,14,-2.0,-8,-29,,
477,477,2017,8,NCAAF_20171021_USC@ND,USC,,Notre Dame,,6-2,6-1,,0,28,14,49,0,0,14,0,14,14,14,7,0.0,-28,-35,,
478,478,2017,8,NCAAF_20171021_WAKE@GATECH,Wake Forest,,Georgia Tech,,4-3,4-2,,21,13,24,38,7,14,3,0,3,10,12,13,0.0,8,-14,,
479,479,2017,8,NCAAF_20171021_KANSAS@TCU,Kansas,,TCU,,1-6,7-0,,0,24,0,43,0,0,0,0,10,14,19,0,-6.0,-24,-43,,
480,480,2017,8,NCAAF_20171021_WVU@BAYLOR,West Virginia,,Baylor,,5-2,0-7,,17,6,38,36,10,7,21,0,0,6,7,23,5.0,11,2,,
481,481,2017,8,NCAAF_20171021_WYO@BOISE,Wyoming,,Boise St.,,4-3,5-2,,7,3,14,24,7,0,7,0,0,3,7,14,-1.0,4,-10,,
482,482,2017,8,NCAAF_20171021_FRESNO@SDGST,Fresno St.,,San Diego St.,,5-2,6-2,,17,3,27,3,7,10,10,0,0,3,0,0,-1.0,14,24,,
483,483,2017,8,NCAAF_20171021_COLO@WASHST,Colorado,,Washington St.,,4-4,7-1,,0,14,0,28,0,0,0,0,0,14,7,7,-3.0,-14,-28,,
484,484,2017,8,NCAAF_20171020_WKY@ODU,W. Kentucky,,Old Dominion,,5-2,2-5,,21,14,35,31,7,14,0,14,7,7,17,0,3.0,7,4,,
485,485,2017,8,NCAAF_20171020_MRSHL@MTSU,Marshall,,Middle Tenn.,,6-1,3-5,,31,10,38,10,7,24,0,7,3,7,0,0,3.0,21,28,,
486,486,2017,8,NCAAF_20171020_AF@NEVADA,Air Force,,Nevada,,3-4,1-7,,28,20,45,42,7,21,7,10,14,6,8,14,2.0,8,3,,
487,487,2017,8,NCAAF_20171020_COLOST@NMEX,Colorado St.,,New Mexico,,6-2,3-4,,21,10,27,24,0,21,0,6,7,3,7,7,3.0,11,3,,
488,488,2017,8,NCAAF_20171019_LALAF@ARKST,Louisiana,,Arkansas St.,,3-4,4-2,,3,34,3,47,3,0,0,0,14,20,3,10,-1.0,-31,-44,,
489,489,2017,8,NCAAF_20171019_MEMP@HOU,Memphis,,Houston,,6-1,4-3,,0,17,42,38,0,0,21,21,7,10,14,7,2.0,-17,4,,
490,490,2017,9,NCAAF_20171028_BUFF@AKRON,Buffalo,,Akron,,3-6,5-4,,13,14,20,21,7,6,0,7,7,7,0,7,-2.0,-1,-1,,
491,491,2017,9,NCAAF_20171028_ARK@MISS,Arkansas,,Ole Miss,,3-5,3-5,,21,31,38,37,7,14,7,10,21,10,0,6,0.0,-10,1,,
492,492,2017,9,NCAAF_20171028_MIAMI@UNC,Miami (Fla.),,North Carolina,,7-0,1-8,,7,6,24,19,0,7,10,7,3,3,7,6,6.0,1,5,,
493,493,2017,9,NCAAF_20171028_OKLAST@WVU,Oklahoma State,,West Virginia,,7-1,5-3,,23,10,50,39,13,10,7,20,0,10,14,15,2.0,13,11,,
494,494,2017,9,NCAAF_20171028_RUT@MICH,Rutgers,,Michigan,,3-5,6-2,,7,21,14,35,0,7,7,0,0,21,7,7,-3.0,-14,-21,,
495,495,2017,9,NCAAF_20171028_TEXAS@BAYLOR,Texas,,Baylor,,4-4,0-8,,21,7,38,7,7,14,3,14,0,7,0,0,4.0,14,31,,
496,496,2017,9,NCAAF_20171028_WISC@ILL,Wisconsin,,Illinois,,8-0,2-6,,17,3,24,10,7,10,0,7,0,3,0,7,6.0,14,14,,
497,497,2017,9,NCAAF_20171028_LVILLE@WAKE,Louisville,,Wake Forest,,5-4,5-3,,10,28,32,42,3,7,7,15,14,14,7,7,0.0,-18,-10,,
498,498,2017,9,NCAAF_20171028_UVA@PITT,Virginia,,Pittsburgh,,5-3,4-5,,7,21,14,31,0,7,0,7,7,14,7,3,1.0,-14,-17,,
499,499,2017,9,NCAAF_20171028_CAL@COLO,California,,Colorado,,4-5,5-4,,14,27,28,44,7,7,0,14,14,13,0,17,-1.0,-13,-16,,
500,500,2017,9,NCAAF_20171028_FIU@MRSHL,FIU,,Marshall,,5-2,6-2,,28,7,41,30,14,14,7,6,0,7,7,16,-1.0,21,11,,
501,501,2017,9,NCAAF_20171028_AF@COLOST,Air Force,,Colorado St.,,4-4,6-3,,28,21,45,28,7,21,3,14,14,7,7,0,-2.0,7,17,,
502,502,2017,9,NCAAF_20171028_KSTATE@KANSAS,Kansas State,,Kansas,,4-4,1-7,,10,6,30,20,7,3,10,10,6,0,0,14,3.0,4,10,,
503,503,2017,9,NCAAF_20171028_SJST@BYU,San Jose St.,,BYU,,1-8,2-7,,6,24,20,41,3,3,0,14,14,10,7,10,-1.0,-18,-21,,
504,504,2017,9,NCAAF_20171028_GAS@TROY,Ga. Southern,,Troy,,0-7,6-2,,10,28,16,38,7,3,0,6,14,14,3,7,-6.0,-18,-22,,
505,505,2017,9,NCAAF_20171028_IND@MD,Indiana,,Maryland,,3-5,4-4,,23,28,39,42,16,7,10,6,7,21,0,14,-1.0,-5,-3,,
506,506,2017,9,NCAAF_20171028_LATECH@RICE,Louisiana Tech,,Rice,,4-4,1-7,,21,7,42,28,7,14,7,14,0,7,7,14,3.0,14,14,,
507,507,2017,9,NCAAF_20171028_NCST@ND,NC State,,Notre Dame,,6-2,7-1,,14,21,14,35,7,7,0,0,7,14,14,0,-1.0,-7,-21,,
508,508,2017,9,NCAAF_20171028_PSU@OHIOST,Penn State,,Ohio State,,7-1,7-1,,28,17,38,39,14,14,7,3,3,14,3,19,0.0,11,-1,,
509,509,2017,9,NCAAF_20171028_TCU@IOWAST,TCU,,Iowa St.,,7-1,6-2,,0,14,7,14,0,0,7,0,7,7,0,0,1.0,-14,-7,,
510,510,2017,9,NCAAF_20171028_UCLA@WASH,UCLA,,Washington,,4-4,7-1,,9,20,23,44,3,6,0,14,3,17,17,7,-3.0,-11,-21,,
511,511,2017,9,NCAAF_20171028_UGA@FLA,Georgia,,Florida,,8-0,3-4,,21,0,42,7,21,0,14,7,0,0,0,7,5.0,21,35,,
512,512,2017,9,NCAAF_20171028_HOU@SFLA,Houston,,South Florida,,5-3,7-1,,0,7,28,24,0,0,14,14,0,7,7,10,-2.0,-7,4,,
513,513,2017,9,NCAAF_20171028_VANDY@SC,Vanderbilt,,South Carolina,,3-5,6-2,,13,24,27,34,7,6,7,7,14,10,7,3,-3.0,-11,-7,,
514,514,2017,9,NCAAF_20171028_FAU@WKY,FAU,,W. Kentucky,,5-3,5-3,,20,21,42,28,10,10,0,22,7,14,7,0,0.0,-1,14,,
515,515,2017,9,NCAAF_20171028_AP@UCF,Austin Peay,,UCF,,5-4,7-0,,26,45,33,73,7,19,7,0,14,31,14,14,-2.0,-19,-40,,
516,516,2017,9,NCAAF_20171028_LAMON@IDAHO,UL-Monroe,,Idaho,,3-5,3-5,,7,28,23,31,0,7,6,10,14,14,3,0,0.0,-21,-8,,
517,517,2017,9,NCAAF_20171028_UTAH@OREG,Utah,,Oregon,,4-4,5-4,,6,17,20,41,0,6,7,7,7,10,10,14,-1.0,-11,-21,,
518,518,2017,9,NCAAF_20171028_TXSTSM@CSTCAR,Texas St.,,C. Carolina,,2-6,1-7,,17,7,27,7,7,10,3,7,7,0,0,0,1.0,10,20,,
519,519,2017,9,NCAAF_20171028_MINN@IOWA,Minnesota,,Iowa,,4-4,5-3,,0,7,10,17,0,0,0,10,7,0,7,3,-1.0,-7,-7,,
520,520,2017,9,NCAAF_20171028_MIZZOU@UCONN,Missouri,,UConn,,3-5,3-5,,31,5,52,12,21,10,14,7,2,3,7,0,0.0,26,40,,
521,521,2017,9,NCAAF_20171028_ODU@NTEXAS,Old Dominion,,North Texas,,2-6,5-3,,23,35,38,45,10,13,15,0,14,21,0,10,-3.0,-12,-7,,
522,522,2017,9,NCAAF_20171028_UAB@USM,UAB,,So. Miss,,5-3,5-3,,7,12,30,12,7,0,6,17,9,3,0,0,0.0,-5,18,,
523,523,2017,9,NCAAF_20171028_MISSST@TXAM,Miss. State,,Texas A&M,,6-2,5-3,,14,0,35,14,7,7,14,7,0,0,7,7,1.0,14,21,,
524,524,2017,9,NCAAF_20171028_DUKE@VATECH,Duke,,Virginia Tech,,4-5,7-1,,3,17,3,24,0,3,0,0,7,10,7,0,-3.0,-14,-21,,
525,525,2017,9,NCAAF_20171028_NEB@PURDUE,Nebraska,,Purdue,,4-4,3-5,,6,14,25,24,3,3,6,13,0,14,3,7,1.0,-8,1,,
526,526,2017,9,NCAAF_20171028_NMEX@WYO,New Mexico,,Wyoming,,3-5,5-3,,0,42,3,42,0,0,0,3,7,35,0,0,-2.0,-42,-39,,
527,527,2017,9,NCAAF_20171028_TENN@UK,Tennessee,,Kentucky,,3-5,6-2,,20,21,26,29,6,14,3,3,7,14,0,8,-3.0,-1,-3,,
528,528,2017,9,NCAAF_20171028_ARKST@NMEXST,Arkansas St.,,New Mexico St.,,5-2,3-5,,7,14,37,21,7,0,10,20,0,14,0,7,2.0,-7,16,,
529,529,2017,9,NCAAF_20171028_GATECH@CLEM,Georgia Tech,,Clemson,,4-3,7-1,,3,21,10,24,3,0,0,7,14,7,3,0,-3.0,-18,-14,,
530,530,2017,9,NCAAF_20171028_TXSA@UTEP,UTSA,,UTEP,,5-2,0-8,,17,14,31,14,3,14,7,7,0,14,0,0,5.0,3,17,,
531,531,2017,9,NCAAF_20171028_TXTECH@OKLA,Texas Tech,,Oklahoma,,4-4,7-1,,20,28,27,49,20,0,7,0,14,14,21,0,-3.0,-8,-22,,
532,532,2017,9,NCAAF_20171028_WASHST@ARIZ,Washington St.,,Arizona,,7-2,6-2,,14,23,37,58,7,7,13,10,10,13,14,21,1.0,-9,-21,,
533,533,2017,9,NCAAF_20171028_BOISE@UTAHST,Boise St.,,Utah St.,,6-2,4-5,,28,7,41,14,14,14,7,6,7,0,7,0,2.0,21,27,,
534,534,2017,9,NCAAF_20171028_UNLV@FRESNO,UNLV,,Fresno St.,,3-5,5-3,,9,9,26,16,3,6,7,10,9,0,7,0,-2.0,0,10,,
535,535,2017,9,NCAAF_20171028_USC@ARIZST,USC,,Arizona St.,,7-2,0-5,,31,10,48,17,14,17,7,10,3,7,7,0,7.0,21,31,,
536,536,2017,9,NCAAF_20171028_SDGST@HAWAII,San Diego St.,,Hawaii,,7-2,3-5,,14,7,28,7,7,7,7,7,0,7,0,0,4.0,7,21,,
537,537,2017,9,NCAAF_20171027_FSU@BC,Florida State,,Boston College,,2-5,5-4,,3,21,3,35,0,3,0,0,7,14,14,0,-3.0,-18,-32,,
538,538,2017,9,NCAAF_20171027_TULANE@MEMP,Tulane,,Memphis,,3-5,7-1,,12,35,26,56,0,12,7,7,14,21,0,21,-4.0,-23,-30,,
539,539,2017,9,NCAAF_20171027_TULSA@SMU,Tulsa,,SMU,,2-7,6-2,,28,21,34,38,14,14,6,0,7,14,7,10,-4.0,7,-4,,
540,540,2017,9,NCAAF_20171026_TOLEDO@BALLST,Toledo,,Ball St.,,7-1,2-6,,24,10,58,17,3,21,27,7,7,3,7,0,5.0,14,41,,
541,541,2017,9,NCAAF_20171026_SALA@GAST,South Alabama,,Georgia St.,,3-5,4-3,,3,14,13,21,0,3,3,7,7,7,0,7,-1.0,-11,-8,,
542,542,2017,9,NCAAF_20171026_STNFRD@OREGST,Stanford,,Oregon State,,6-2,1-7,,6,7,15,14,0,6,3,6,0,7,7,0,5.0,-1,1,,
543,543,2017,10,NCAAF_20171104_AUBURN@TXAM,Auburn,,Texas A&M,,7-2,5-4,,21,13,42,27,0,21,14,7,3,10,7,7,2.0,8,15,,
544,544,2017,10,NCAAF_20171104_BAYLOR@KANSAS,Baylor,,Kansas,,1-8,1-8,,21,6,38,9,0,21,7,10,0,6,3,0,0.0,15,29,,
545,545,2017,10,NCAAF_20171104_ECU@HOU,East Carolina,,Houston,,2-7,6-3,,10,28,27,52,0,10,7,10,21,7,17,7,-4.0,-18,-25,,
546,546,2017,10,NCAAF_20171104_FLA@MIZZOU,Florida,,Missouri,,3-5,4-5,,6,28,16,45,0,6,3,7,7,21,7,10,-1.0,-22,-29,,
547,547,2017,10,NCAAF_20171104_ILL@PURDUE,Illinois,,Purdue,,2-7,4-5,,10,13,10,29,7,3,0,0,7,6,3,13,-2.0,-3,-19,,
548,548,2017,10,NCAAF_20171104_MA@MISSST,UMass,,Miss. State,,2-7,7-2,,20,13,23,34,3,17,0,3,10,3,14,7,-5.0,7,-11,,
549,549,2017,10,NCAAF_20171104_PSU@MICHST,Penn State,,Michigan St.,,7-2,7-2,,14,14,24,27,14,0,10,0,7,7,7,6,0.0,0,-3,,
550,550,2017,10,NCAAF_20171104_WISC@IND,Wisconsin,,Indiana,,9-0,3-6,,14,10,45,17,0,14,10,21,7,3,7,0,6.0,4,28,,
551,551,2017,10,NCAAF_20171104_WKY@VANDY,W. Kentucky,,Vanderbilt,,5-4,4-5,,14,21,17,31,7,7,3,0,14,7,7,3,1.0,-7,-14,,
552,552,2017,10,NCAAF_20171104_CUSE@FSU,Syracuse,,Florida State,,4-5,3-5,,14,21,24,27,0,14,3,7,7,14,3,3,1.0,-7,-3,,
553,553,2017,10,NCAAF_20171104_APLST@LAMON,App. St.,,UL-Monroe,,5-4,4-5,,24,28,45,52,0,24,14,7,14,14,7,17,1.0,-4,-7,,
554,554,2017,10,NCAAF_20171104_GAST@GAS,Georgia St.,,Ga. Southern,,5-3,0-8,,7,10,21,17,7,0,7,7,7,3,7,0,5.0,-3,4,,
555,555,2017,10,NCAAF_20171104_GATECH@UVA,Georgia Tech,,Virginia,,4-4,6-3,,14,13,36,40,7,7,14,8,3,10,15,12,-2.0,1,-4,,
556,556,2017,10,NCAAF_20171104_NMEXST@TXSTSM,New Mexico St.,,Texas St.,,4-5,2-7,,17,21,45,35,7,10,14,14,14,7,7,7,2.0,-4,10,,
557,557,2017,10,NCAAF_20171104_RICE@UAB,Rice,,UAB,,1-8,6-3,,7,42,21,52,0,7,0,14,21,21,7,3,-5.0,-35,-31,,
558,558,2017,10,NCAAF_20171104_ARMY@AF,Army,,Air Force,,7-2,4-5,,14,0,21,0,7,7,0,7,0,0,0,0,3.0,14,21,,
559,559,2017,10,NCAAF_20171104_CHARLO@ODU,Charlotte,,Old Dominion,,1-8,3-6,,0,3,0,6,0,0,0,0,3,0,3,0,-2.0,-3,-6,,
560,560,2017,10,NCAAF_20171104_CLEM@NCST,Clemson,,NC State,,8-1,6-3,,17,21,38,31,7,10,14,7,14,7,0,10,2.0,-4,7,,
561,561,2017,10,NCAAF_20171104_IOWAST@WVU,Iowa St.,,West Virginia,,6-3,6-3,,3,20,16,20,0,3,10,3,10,10,0,0,0.0,-17,-4,,
562,562,2017,10,NCAAF_20171104_MD@RUT,Maryland,,Rutgers,,4-5,4-5,,14,17,24,31,7,7,10,0,0,17,0,14,0.0,-3,-7,,
563,563,2017,10,NCAAF_20171104_NTEXAS@LATECH,North Texas,,Louisiana Tech,,6-3,4-5,,10,17,24,23,7,3,7,7,3,14,3,3,2.0,-7,1,,
564,564,2017,10,NCAAF_20171104_OHIOST@IOWA,Ohio State,,Iowa,,7-2,6-3,,17,31,24,55,10,7,0,7,10,21,7,17,1.0,-14,-31,,
565,565,2017,10,NCAAF_20171104_SC@UGA,South Carolina,,Georgia,,6-3,9-0,,7,14,10,24,0,7,3,0,7,7,7,3,-3.0,-7,-14,,
566,566,2017,10,NCAAF_20171104_SFLA@UCONN,South Florida,,UConn,,8-1,3-6,,17,7,37,20,7,10,17,3,0,7,0,13,5.0,10,17,,
567,567,2017,10,NCAAF_20171104_STNFRD@WASHST,Stanford,,Washington St.,,6-3,8-2,,7,14,21,24,0,7,14,0,0,14,3,7,-2.0,-7,-3,,
568,568,2017,10,NCAAF_20171104_WAKE@ND,Wake Forest,,Notre Dame,,5-4,8-1,,10,31,37,48,3,7,13,14,7,24,10,7,-3.0,-21,-11,,
569,569,2017,10,NCAAF_20171104_CINCY@TULANE,Cincinnati,,Tulane,,3-6,3-6,,10,13,17,16,3,7,7,0,7,6,0,3,0.0,-3,1,,
570,570,2017,10,NCAAF_20171104_CSTCAR@ARK,C. Carolina,,Arkansas,,1-8,4-5,,14,17,38,39,7,7,17,7,7,10,8,14,-3.0,-3,-1,,
571,571,2017,10,NCAAF_20171104_LALAF@SALA,Louisiana,,South Alabama,,4-4,3-6,,19,7,19,14,3,16,0,0,0,7,0,7,1.0,12,5,,
572,572,2017,10,NCAAF_20171104_MISS@UK,Ole Miss,,Kentucky,,4-5,6-3,,17,20,37,34,7,10,10,10,3,17,7,7,-2.0,-3,3,,
573,573,2017,10,NCAAF_20171104_OKLA@OKLAST,Oklahoma,,Oklahoma State,,8-1,7-2,,38,38,62,52,14,24,10,14,10,28,0,14,1.0,0,10,,
574,574,2017,10,NCAAF_20171104_OREGST@CAL,Oregon State,,California,,1-8,5-5,,13,20,23,37,7,6,7,3,14,6,10,7,-4.0,-7,-14,,
575,575,2017,10,NCAAF_20171104_UTAHST@NMEX,Utah St.,,New Mexico,,5-5,3-6,,14,3,24,10,7,7,3,7,0,3,0,7,2.0,11,14,,
576,576,2017,10,NCAAF_20171104_HAWAII@UNLV,Hawaii,,UNLV,,3-6,4-5,,6,7,23,31,0,6,7,10,7,0,21,3,-1.0,-1,-8,,
577,577,2017,10,NCAAF_20171104_COLOST@WYO,Colorado St.,,Wyoming,,6-4,6-3,,10,6,13,16,3,7,0,3,0,6,3,7,0.0,4,-3,,
578,578,2017,10,NCAAF_20171104_NEVADA@BOISE,Nevada,,Boise St.,,1-8,7-2,,14,31,14,41,7,7,0,0,10,21,7,3,-6.0,-17,-27,,
579,579,2017,10,NCAAF_20171104_TXSA@FIU,UTSA,,FIU,,5-3,6-2,,0,0,7,14,0,0,0,7,0,0,14,0,-1.0,0,-7,,
580,580,2017,10,NCAAF_20171104_TEXAS@TCU,Texas,,TCU,,4-5,8-1,,7,17,7,24,0,7,0,0,7,10,0,7,-4.0,-10,-17,,
581,581,2017,10,NCAAF_20171104_UCF@SMU,UCF,,SMU,,8-0,6-3,,21,14,31,24,7,14,7,3,7,7,10,0,2.0,7,7,,
582,582,2017,10,NCAAF_20171104_MINN@MICH,Minnesota,,Michigan,,4-5,7-2,,7,20,10,33,7,0,0,3,13,7,13,0,-3.0,-13,-23,,
583,583,2017,10,NCAAF_20171104_USM@TENN,So. Miss,,Tennessee,,5-4,4-5,,3,10,10,24,0,3,0,7,7,3,14,0,1.0,-7,-14,,
584,584,2017,10,NCAAF_20171104_UTEP@MTSU,UTEP,,Middle Tenn.,,0-9,4-5,,0,17,3,30,0,0,3,0,10,7,7,6,-4.0,-17,-27,,
585,585,2017,10,NCAAF_20171104_LSU@BAMA,LSU,,Alabama,,6-3,9-0,,3,14,10,24,0,3,7,0,7,7,7,3,-3.0,-11,-14,,
586,586,2017,10,NCAAF_20171104_VATECH@MIAMI,Virginia Tech,,Miami (Fla.),,7-2,8-0,,3,14,10,28,0,3,7,0,0,14,7,7,-1.0,-11,-18,,
587,587,2017,10,NCAAF_20171104_COLO@ARIZST,Colorado,,Arizona St.,,5-5,1-4,,17,14,30,41,3,14,10,3,0,14,3,24,4.0,3,-11,,
588,588,2017,10,NCAAF_20171104_OREG@WASH,Oregon,,Washington,,5-5,8-1,,3,17,3,38,3,0,0,0,0,17,21,0,-3.0,-14,-35,,
589,589,2017,10,NCAAF_20171104_SDGST@SJST,San Diego St.,,San Jose St.,,8-2,1-9,,35,0,52,7,21,14,14,3,0,0,7,0,7.0,35,45,,
590,590,2017,10,NCAAF_20171104_ARIZ@USC,Arizona,,USC,,6-3,8-2,,6,21,35,49,0,6,14,15,7,14,7,21,-2.0,-15,-14,,
591,591,2017,10,NCAAF_20171104_BYU@FRESNO,BYU,,Fresno St.,,2-8,6-3,,6,10,13,20,0,6,7,0,10,0,3,7,-4.0,-4,-7,,
592,592,2017,10,NCAAF_20171103_MRSHL@FAU,Marshall,,FAU,,6-3,6-3,,3,16,25,30,0,3,13,9,13,3,7,7,0.0,-13,-5,,
593,593,2017,10,NCAAF_20171103_MEMP@TULSA,Memphis,,Tulsa,,8-1,2-8,,21,14,41,14,14,7,10,10,7,7,0,0,6.0,7,27,,
594,594,2017,10,NCAAF_20171103_UCLA@UTAH,UCLA,,Utah,,4-4,4-4,,10,17,17,48,0,10,0,7,7,10,21,10,0.0,-7,-31,,
595,595,2017,10,NCAAF_20171102_BALLST@EMICH,Ball St.,,E. Michigan,,2-7,3-6,,14,35,14,56,7,7,0,0,14,21,14,7,-1.0,-21,-42,,
596,596,2017,10,NCAAF_20171102_NILL@TOLEDO,N. Illinois,,Toledo,,6-3,8-1,,7,10,17,27,7,0,7,3,7,3,14,3,-2.0,-3,-10,,
597,597,2017,10,NCAAF_20171102_NAVY@TEMPLE,Navy,,Temple,,5-3,4-5,,6,17,26,34,3,3,7,13,10,7,14,3,1.0,-11,-8,,
598,598,2017,10,NCAAF_20171102_IDAHO@TROY,Idaho,,Troy,,3-6,7-2,,7,10,21,24,7,0,0,14,0,10,7,7,-4.0,-3,-3,,
599,599,2017,10,NCAAF_20171101_CMICH@WMICH,C. Michigan,,W. Michigan,,5-4,5-4,,7,21,35,28,7,0,7,21,14,7,7,0,0.0,-14,7,,
600,600,2017,10,NCAAF_20171031_BGREEN@KENTST,Bowling Green,,Kent St.,,2-7,2-7,,20,9,44,16,17,3,14,10,0,9,0,7,0.0,11,28,,
601,601,2017,10,NCAAF_20171031_MIAOH@OHIO,Miami-OH,,Ohio,,3-6,7-2,,21,28,28,45,14,7,7,0,14,14,7,10,-4.0,-7,-17,,
602,602,2017,11,NCAAF_20171111_ARK@LSU,Arkansas,,LSU,,4-6,7-3,,7,7,10,33,0,7,3,0,7,0,12,14,-3.0,0,-23,,
603,603,2017,11,NCAAF_20171111_DUKE@ARMY,Duke,,Army,,4-6,8-2,,10,21,16,21,3,7,0,6,7,14,0,0,-4.0,-11,-5,,
604,604,2017,11,NCAAF_20171111_FLA@SC,Florida,,South Carolina,,3-6,7-3,,13,21,20,28,0,13,0,7,14,7,7,0,-4.0,-8,-8,,
605,605,2017,11,NCAAF_20171111_IND@ILL,Indiana,,Illinois,,4-6,2-8,,14,0,24,14,0,14,3,7,0,0,7,7,2.0,14,10,,
606,606,2017,11,NCAAF_20171111_LALAF@MISS,Louisiana,,Ole Miss,,4-5,5-5,,10,35,22,50,0,10,0,12,21,14,7,8,-1.0,-25,-28,,
607,607,2017,11,NCAAF_20171111_MICHST@OHIOST,Michigan St.,,Ohio State,,7-3,8-2,,3,35,3,48,0,3,0,0,14,21,13,0,-1.0,-32,-45,,
608,608,2017,11,NCAAF_20171111_NCST@BC,NC State,,Boston College,,7-3,5-5,,10,7,17,14,0,10,0,7,0,7,7,0,2.0,3,3,,
609,609,2017,11,NCAAF_20171111_NEB@MINN,Nebraska,,Minnesota,,4-6,5-5,,14,30,21,54,7,7,0,7,14,16,10,14,-1.0,-16,-33,,
610,610,2017,11,NCAAF_20171111_OKLAST@IOWAST,Oklahoma State,,Iowa St.,,8-2,6-4,,21,21,49,42,7,14,10,18,14,7,7,14,2.0,0,7,,
611,611,2017,11,NCAAF_20171111_RUT@PSU,Rutgers,,Penn State,,4-6,8-2,,6,14,6,35,3,3,0,0,0,14,14,7,-4.0,-8,-29,,
612,612,2017,11,NCAAF_20171111_TXTECH@BAYLOR,Texas Tech,,Baylor,,5-5,1-9,,21,7,38,24,14,7,10,7,7,0,7,10,4.0,14,14,,
613,613,2017,11,NCAAF_20171111_UCONN@UCF,UConn,,UCF,,3-7,9-0,,10,28,24,49,3,7,7,7,21,7,0,21,-6.0,-18,-25,,
614,614,2017,11,NCAAF_20171111_VATECH@GATECH,Virginia Tech,,Georgia Tech,,7-3,5-4,,9,14,22,28,3,6,7,6,7,7,7,7,2.0,-5,-6,,
615,615,2017,11,NCAAF_20171111_MTSU@CHARLO,Middle Tenn.,,Charlotte,,5-5,1-9,,28,7,35,21,14,14,0,7,7,0,7,7,4.0,21,14,,
616,616,2017,11,NCAAF_20171111_WAKE@CUSE,Wake Forest,,Syracuse,,6-4,4-6,,24,38,64,43,21,3,16,24,14,24,5,0,2.0,-14,21,,
617,617,2017,11,NCAAF_20171111_FAU@LATECH,FAU,,Louisiana Tech,,7-3,4-6,,20,9,48,23,6,14,22,6,3,6,7,7,3.0,11,25,,
618,618,2017,11,NCAAF_20171111_FSU@CLEM,Florida State,,Clemson,,3-6,9-1,,0,17,14,31,0,0,7,7,7,10,0,14,-6.0,-17,-17,,
619,619,2017,11,NCAAF_20171111_IOWA@WISC,Iowa,,Wisconsin,,6-4,10-0,,7,17,14,38,7,0,7,0,3,14,7,14,-4.0,-10,-24,,
620,620,2017,11,NCAAF_20171111_MICH@MD,Michigan,,Maryland,,8-2,4-6,,28,0,35,10,7,21,0,7,0,0,3,7,4.0,28,25,,
621,621,2017,11,NCAAF_20171111_SMU@NAVY,SMU,,Navy,,6-4,6-3,,11,34,40,43,5,6,21,8,13,21,6,3,0.0,-23,-3,,
622,622,2017,11,NCAAF_20171111_UGA@AUBURN,Georgia,,Auburn,,9-0,7-2,,7,16,17,40,7,0,3,7,6,10,14,10,2.0,-9,-23,,
623,623,2017,11,NCAAF_20171111_USM@RICE,So. Miss,,Rice,,6-4,1-9,,22,14,43,34,10,12,14,7,0,14,13,7,5.0,8,9,,
624,624,2017,11,NCAAF_20171111_UVA@LVILLE,Virginia,,Louisville,,6-4,6-4,,14,17,21,38,7,7,0,7,7,10,14,7,0.0,-3,-17,,
625,625,2017,11,NCAAF_20171111_WVU@KSTATE,West Virginia,,Kansas State,,7-3,5-5,,28,20,28,23,7,21,0,0,6,14,0,3,2.0,8,5,,
626,626,2017,11,NCAAF_20171111_GAST@TXSTSM,Georgia St.,,Texas St.,,6-3,2-8,,13,14,33,30,10,3,10,10,7,7,3,13,4.0,-1,3,,
627,627,2017,11,NCAAF_20171111_ME@MA,Maine,,UMass,,4-5,3-7,,16,24,31,44,7,9,8,7,21,3,13,7,1.0,-8,-13,,
628,628,2017,11,NCAAF_20171111_SJST@NEVADA,San Jose St.,,Nevada,,1-10,2-8,,7,38,14,59,7,0,0,7,14,24,14,7,-1.0,-31,-45,,
629,629,2017,11,NCAAF_20171111_UK@VANDY,Kentucky,,Vanderbilt,,7-3,4-6,,20,7,44,21,7,13,21,3,7,0,14,0,3.0,13,23,,
630,630,2017,11,NCAAF_20171111_USC@COLO,USC,,Colorado,,9-2,5-6,,20,0,38,24,0,20,10,8,0,0,14,10,4.0,20,14,,
631,631,2017,11,NCAAF_20171111_TROY@CSTCAR,Troy,,C. Carolina,,8-2,1-9,,28,10,42,17,14,14,7,7,10,0,7,0,7.0,18,25,,
632,632,2017,11,NCAAF_20171111_ARKST@SALA,Arkansas St.,,South Alabama,,5-3,4-6,,6,10,19,24,0,6,6,7,10,0,7,7,1.0,-4,-5,,
633,633,2017,11,NCAAF_20171111_UTEP@NTEXAS,UTEP,,North Texas,,0-10,7-3,,7,14,10,45,7,0,3,0,7,7,14,17,-7.0,-7,-35,,
634,634,2017,11,NCAAF_20171111_WASHST@UTAH,Washington St.,,Utah,,8-2,5-4,,20,10,33,25,13,7,6,7,0,10,0,15,3.0,10,8,,
635,635,2017,11,NCAAF_20171111_KANSAS@TEXAS,Kansas,,Texas,,1-9,5-5,,17,35,27,42,7,10,3,7,28,7,0,7,-4.0,-18,-15,,
636,636,2017,11,NCAAF_20171111_WKY@MRSHL,W. Kentucky,,Marshall,,5-5,7-3,,7,13,23,30,7,0,3,13,0,13,17,0,-2.0,-6,-7,,
637,637,2017,11,NCAAF_20171111_BAMA@MISSST,Alabama,,Miss. State,,10-0,7-3,,14,14,31,24,7,7,3,14,7,7,7,3,3.0,0,7,,
638,638,2017,11,NCAAF_20171111_NMEX@TXAM,New Mexico,,Texas A&M,,3-7,6-4,,7,48,14,55,0,7,7,0,13,35,0,7,-3.0,-41,-41,,
639,639,2017,11,NCAAF_20171111_ODU@FIU,Old Dominion,,FIU,,4-6,6-3,,24,14,37,30,7,17,7,6,7,7,9,7,-2.0,10,7,,
640,640,2017,11,NCAAF_20171111_PURDUE@NWEST,Purdue,,Northwestern,,4-6,7-3,,0,14,13,23,0,0,7,6,0,14,6,3,-3.0,-14,-10,,
641,641,2017,11,NCAAF_20171111_UAB@TXSA,UAB,,UTSA,,7-3,5-4,,21,6,24,19,14,7,0,3,3,3,0,13,2.0,15,5,,
642,642,2017,11,NCAAF_20171111_TENN@MIZZOU,Tennessee,,Missouri,,4-6,5-5,,17,24,17,50,10,7,0,0,14,10,17,9,-1.0,-7,-33,,
643,643,2017,11,NCAAF_20171111_ND@MIAMI,Notre Dame,,Miami (Fla.),,8-2,9-0,,0,27,8,41,0,0,8,0,14,13,7,7,-1.0,-27,-33,,
644,644,2017,11,NCAAF_20171111_TCU@OKLA,TCU,,Oklahoma,,8-2,9-1,,14,38,20,38,7,7,0,6,17,21,0,0,-1.0,-24,-18,,
645,645,2017,11,NCAAF_20171111_ARIZST@UCLA,Arizona St.,,UCLA,,5-5,5-5,,21,20,37,44,14,7,13,3,7,13,14,10,0.0,1,-7,,
646,646,2017,11,NCAAF_20171111_OREGST@ARIZ,Oregon State,,Arizona,,1-9,7-3,,0,28,28,49,0,0,14,14,14,14,14,7,-6.0,-28,-21,,
647,647,2017,11,NCAAF_20171111_WYO@AF,Wyoming,,Air Force,,7-3,4-6,,21,7,28,14,7,14,0,7,0,7,7,0,3.0,14,14,,
648,648,2017,11,NCAAF_20171111_FRESNO@HAWAII,Fresno St.,,Hawaii,,7-3,3-7,,21,7,31,21,0,21,10,0,7,0,0,14,4.0,14,10,,
649,649,2017,11,NCAAF_20171110_TEMPLE@CINCY,Temple,,Cincinnati,,5-5,3-7,,13,0,35,24,3,10,15,7,0,0,14,10,2.0,13,11,,
650,650,2017,11,NCAAF_20171110_BYU@UNLV,BYU,,UNLV,,3-8,4-6,,14,7,31,21,0,14,14,3,0,7,7,7,-1.0,7,10,,
651,651,2017,11,NCAAF_20171110_WASH@STNFRD,Washington,,Stanford,,8-2,7-3,,14,10,22,30,7,7,0,8,0,10,10,10,1.0,4,-8,,
652,652,2017,11,NCAAF_20171109_BALLST@NILL,Ball St.,,N. Illinois,,2-8,7-3,,7,35,17,63,7,0,10,0,21,14,14,14,-5.0,-28,-46,,
653,653,2017,11,NCAAF_20171109_GAS@APLST,Ga. Southern,,App. St.,,0-9,6-4,,3,10,6,27,3,0,3,0,0,10,3,14,-6.0,-7,-21,,
654,654,2017,11,NCAAF_20171109_UNC@PITT,North Carolina,,Pittsburgh,,2-8,4-6,,24,17,34,31,14,10,3,7,3,14,7,7,-2.0,7,3,,
655,655,2017,11,NCAAF_20171108_KENTST@WMICH,Kent St.,,W. Michigan,,2-8,6-4,,14,31,20,48,14,0,0,6,21,10,3,14,-4.0,-17,-28,,
656,656,2017,11,NCAAF_20171108_TOLEDO@OHIO,Toledo,,Ohio,,8-2,8-2,,7,10,10,38,0,7,3,0,7,3,14,14,0.0,-3,-28,,
657,657,2017,11,NCAAF_20171108_EMICH@CMICH,E. Michigan,,C. Michigan,,3-7,6-4,,17,28,30,42,7,10,0,13,14,14,7,7,-3.0,-11,-12,,
658,658,2017,11,NCAAF_20171107_AKRON@MIAOH,Akron,,Miami-OH,,5-5,4-6,,7,10,14,24,7,0,0,7,7,3,14,0,1.0,-3,-10,,
659,659,2017,11,NCAAF_20171107_BGREEN@BUFF,Bowling Green,,Buffalo,,2-8,4-6,,14,21,28,38,7,7,7,7,21,0,7,10,-2.0,-7,-10,,
660,660,2017,12,NCAAF_20171118_CINCY@ECU,Cincinnati,,East Carolina,,3-8,3-8,,13,24,20,48,0,13,7,0,14,10,14,10,0.0,-11,-28,,
661,661,2017,12,NCAAF_20171118_DEST@FSU,Delaware St.,,Florida State,,2-9,4-6,,6,56,6,77,6,0,0,0,21,35,7,14,-2.0,-50,-71,,
662,662,2017,12,NCAAF_20171118_LAMON@AUBURN,UL-Monroe,,Auburn,,4-5,8-2,,7,14,14,42,7,0,0,7,7,7,14,14,-4.0,-7,-28,,
663,663,2017,12,NCAAF_20171118_MERCER@BAMA,Mercer,,Alabama,,5-5,10-0,,0,35,0,56,0,0,0,0,14,21,14,7,-5.0,-35,-56,,
664,664,2017,12,NCAAF_20171118_MICH@WISC,Michigan,,Wisconsin,,8-3,11-0,,7,7,10,24,0,7,3,0,7,0,14,3,-3.0,0,-14,,
665,665,2017,12,NCAAF_20171118_MINN@NWEST,Minnesota,,Northwestern,,5-6,8-3,,0,25,0,39,0,0,0,0,0,25,7,7,-3.0,-25,-39,,
666,666,2017,12,NCAAF_20171118_MISSST@ARK,Miss. State,,Arkansas,,7-3,4-6,,14,14,28,21,0,14,0,14,14,0,7,0,3.0,0,7,,
667,667,2017,12,NCAAF_20171118_RUT@IND,Rutgers,,Indiana,,4-7,5-6,,0,20,0,41,0,0,0,0,17,3,14,7,-1.0,-20,-41,,
668,668,2017,12,NCAAF_20171118_SMU@MEMP,SMU,,Memphis,,6-5,9-1,,24,31,45,66,10,14,14,7,10,21,14,21,-3.0,-7,-21,,
669,669,2017,12,NCAAF_20171118_TCU@TXTECH,TCU,,Texas Tech,,9-2,5-6,,10,3,27,3,0,10,7,10,3,0,0,0,4.0,7,24,,
670,670,2017,12,NCAAF_20171118_TEXAS@WVU,Texas,,West Virginia,,6-5,7-4,,14,0,28,14,0,14,7,7,0,0,7,7,-1.0,14,14,,
671,671,2017,12,NCAAF_20171118_UCF@TEMPLE,UCF,,Temple,,10-0,5-6,,31,13,45,19,7,24,14,0,3,10,0,6,5.0,18,26,,
672,672,2017,12,NCAAF_20171118_UVA@MIAMI,Virginia,,Miami (Fla.),,6-5,10-0,,21,14,28,44,14,7,7,0,7,7,17,13,-4.0,7,-16,,
673,673,2017,12,NCAAF_20171118_CIT@CLEM,The Citadel,,Clemson,,5-6,10-1,,0,38,3,61,0,0,0,3,21,17,20,3,-5.0,-38,-58,,
674,674,2017,12,NCAAF_20171118_PITT@VATECH,Pittsburgh,,Virginia Tech,,4-7,8-3,,7,10,14,20,7,0,0,7,7,3,0,10,-4.0,-3,-6,,
675,675,2017,12,NCAAF_20171118_FRESNO@WYO,Fresno St.,,Wyoming,,8-3,7-4,,10,0,13,7,3,7,3,0,0,0,0,7,1.0,10,6,,
676,676,2017,12,NCAAF_20171118_RICE@ODU,Rice,,Old Dominion,,1-10,5-6,,7,10,21,24,7,0,0,14,7,3,7,7,-4.0,-3,-3,,
677,677,2017,12,NCAAF_20171118_IOWAST@BAYLOR,Iowa St.,,Baylor,,7-4,1-10,,17,10,23,13,7,10,3,3,7,3,3,0,6.0,7,10,,
678,678,2017,12,NCAAF_20171118_ARIZST@OREGST,Arizona St.,,Oregon State,,6-5,1-10,,30,7,40,24,16,14,3,7,0,7,3,14,5.0,23,16,,
679,679,2017,12,NCAAF_20171118_CHARLO@USM,Charlotte,,So. Miss,,1-10,7-4,,7,38,21,66,0,7,7,7,13,25,14,14,-6.0,-31,-45,,
680,680,2017,12,NCAAF_20171118_HAWAII@UTAHST,Hawaii,,Utah St.,,3-8,6-5,,0,21,0,38,0,0,0,0,14,7,14,3,-3.0,-21,-38,,
681,681,2017,12,NCAAF_20171118_LATECH@UTEP,Louisiana Tech,,UTEP,,5-6,0-11,,28,0,42,21,7,21,0,14,0,0,14,7,5.0,28,21,,
682,682,2017,12,NCAAF_20171118_MA@BYU,UMass,,BYU,,4-7,3-9,,3,0,16,10,0,3,13,0,0,0,3,7,1.0,3,6,,
683,683,2017,12,NCAAF_20171118_SALA@GAS,South Alabama,,Ga. Southern,,4-7,1-9,,0,31,0,52,0,0,0,0,21,10,14,7,3.0,-31,-52,,
684,684,2017,12,NCAAF_20171118_TXSTSM@ARKST,Texas St.,,Arkansas St.,,2-9,6-3,,6,16,12,30,6,0,6,0,16,0,14,0,-4.0,-10,-18,,
685,685,2017,12,NCAAF_20171118_WCAR@UNC,W. Carolina,,North Carolina,,7-5,3-8,,7,42,10,65,7,0,0,3,7,35,10,13,4.0,-35,-55,,
686,686,2017,12,NCAAF_20171118_CUSE@LVILLE,Syracuse,,Louisville,,4-7,7-4,,3,35,10,56,3,0,0,7,7,28,14,7,-3.0,-32,-46,,
687,687,2017,12,NCAAF_20171118_GATECH@DUKE,Georgia Tech,,Duke,,5-5,5-6,,20,20,20,43,7,13,0,0,3,17,10,13,0.0,0,-23,,
688,688,2017,12,NCAAF_20171118_ILL@OHIOST,Illinois,,Ohio State,,2-9,9-2,,0,38,14,52,0,0,7,7,28,10,7,7,-7.0,-38,-38,,
689,689,2017,12,NCAAF_20171118_KSTATE@OKLAST,Kansas State,,Oklahoma State,,6-5,8-3,,28,13,45,40,7,21,14,3,10,3,7,20,-2.0,15,5,,
690,690,2017,12,NCAAF_20171118_NAVY@ND,Navy,,Notre Dame,,6-4,9-2,,10,10,17,24,0,10,7,0,3,7,7,7,-3.0,0,-7,,
691,691,2017,12,NCAAF_20171118_OKLA@KANSAS,Oklahoma,,Kansas,,10-1,1-10,,21,3,41,3,7,14,7,13,0,3,0,0,9.0,18,38,,
692,692,2017,12,NCAAF_20171118_PURDUE@IOWA,Purdue,,Iowa,,5-6,6-5,,7,9,24,15,7,0,14,3,0,9,0,6,-1.0,-2,9,,
693,693,2017,12,NCAAF_20171118_SJST@COLOST,San Jose St.,,Colorado St.,,1-11,7-5,,7,28,14,42,7,0,0,7,14,14,7,7,-6.0,-21,-28,,
694,694,2017,12,NCAAF_20171118_UK@UGA,Kentucky,,Georgia,,7-4,10-1,,6,21,13,42,6,0,7,0,7,14,7,14,-3.0,-15,-29,,
695,695,2017,12,NCAAF_20171118_HOU@TULANE,Houston,,Tulane,,6-4,5-6,,3,13,17,20,3,0,7,7,3,10,0,7,1.0,-10,-3,,
696,696,2017,12,NCAAF_20171118_MD@MICHST,Maryland,,Michigan St.,,4-7,8-3,,0,14,7,17,0,0,0,7,7,7,3,0,-4.0,-14,-10,,
697,697,2017,12,NCAAF_20171118_NEB@PSU,Nebraska,,Penn State,,4-7,9-2,,10,42,44,56,10,0,14,20,14,28,0,14,-5.0,-32,-12,,
698,698,2017,12,NCAAF_20171118_UAB@FLA,UAB,,Florida,,7-4,4-6,,0,19,7,36,0,0,0,7,6,13,14,3,3.0,-19,-29,,
699,699,2017,12,NCAAF_20171118_WOFF@SC,Wofford,,South Carolina,,9-2,8-3,,3,14,10,31,3,0,7,0,0,14,7,10,1.0,-11,-21,,
700,700,2017,12,NCAAF_20171118_CSTCAR@IDAHO,C. Carolina,,Idaho,,2-9,3-7,,10,7,13,7,0,10,0,3,7,0,0,0,-1.0,3,6,,
701,701,2017,12,NCAAF_20171118_NMEXST@LALAF,New Mexico St.,,Louisiana,,4-6,5-5,,17,31,34,47,7,10,14,3,14,17,3,13,-1.0,-14,-13,,
702,702,2017,12,NCAAF_20171118_ARMY@NTEXAS,Army,,North Texas,,8-3,8-3,,20,28,49,52,7,13,8,21,14,14,7,17,0.0,-8,-3,,
703,703,2017,12,NCAAF_20171118_ARIZ@OREG,Arizona,,Oregon,,7-4,6-5,,21,28,28,48,7,14,7,0,14,14,7,13,1.0,-7,-20,,
704,704,2017,12,NCAAF_20171118_BC@UCONN,Boston College,,UConn,,6-5,3-8,,14,3,39,16,0,14,19,6,3,0,0,13,3.0,11,23,,
705,705,2017,12,NCAAF_20171118_FIU@FAU,FIU,,FAU,,6-4,8-3,,10,21,24,52,0,10,7,7,14,7,16,15,-2.0,-11,-28,,
706,706,2017,12,NCAAF_20171118_LSU@TENN,LSU,,Tennessee,,8-3,4-7,,17,10,30,10,3,14,13,0,0,10,0,0,4.0,7,20,,
707,707,2017,12,NCAAF_20171118_MRSHL@TXSA,Marshall,,UTSA,,7-4,6-4,,0,6,7,9,0,0,0,7,3,3,0,3,1.0,-6,-2,,
708,708,2017,12,NCAAF_20171118_TXAM@MISS,Texas A&M,,Ole Miss,,7-4,5-6,,21,24,31,24,14,7,7,3,14,10,0,0,2.0,-3,7,,
709,709,2017,12,NCAAF_20171118_MIZZOU@VANDY,Missouri,,Vanderbilt,,6-5,4-7,,35,0,45,17,7,28,3,7,0,0,17,0,2.0,35,28,,
710,710,2017,12,NCAAF_20171118_NCST@WAKE,NC State,,Wake Forest,,7-4,7-4,,14,21,24,30,7,7,7,3,14,7,3,6,0.0,-7,-6,,
711,711,2017,12,NCAAF_20171118_CAL@STNFRD,California,,Stanford,,5-6,8-3,,6,10,14,17,3,3,8,0,3,7,7,0,-3.0,-4,-3,,
712,712,2017,12,NCAAF_20171118_UCLA@USC,UCLA,,USC,,5-6,10-2,,7,14,23,28,7,0,7,9,14,0,7,7,-5.0,-7,-5,,
713,713,2017,12,NCAAF_20171118_AF@BOISE,Air Force,,Boise St.,,4-7,9-2,,10,27,19,44,7,3,0,9,17,10,10,7,-5.0,-17,-25,,
714,714,2017,12,NCAAF_20171118_NEVADA@SDGST,Nevada,,San Diego St.,,2-9,9-2,,17,21,23,42,10,7,0,6,14,7,7,14,-7.0,-4,-19,,
715,715,2017,12,NCAAF_20171118_UTAH@WASH,Utah,,Washington,,5-6,9-2,,13,16,30,33,7,6,10,7,6,10,7,10,-4.0,-3,-3,,
716,716,2017,12,NCAAF_20171117_UNLV@NMEX,UNLV,,New Mexico,,4-6,3-7,,24,14,38,35,10,14,3,11,0,14,7,14,1.0,10,3,,
717,717,2017,12,NCAAF_20171116_BUFF@BALLST,Buffalo,,Ball St.,,5-6,2-9,,23,10,40,24,10,13,14,3,0,10,7,7,3.0,13,16,,
718,718,2017,12,NCAAF_20171116_TULSA@SFLA,Tulsa,,South Florida,,2-9,9-1,,17,24,20,27,7,10,0,3,21,3,3,0,-7.0,-7,-7,,
719,719,2017,12,NCAAF_20171115_EMICH@MIAOH,E. Michigan,,Miami-OH,,4-7,4-7,,13,17,27,24,7,6,14,0,0,17,0,7,0.0,-4,3,,
720,720,2017,12,NCAAF_20171115_WMICH@NILL,W. Michigan,,N. Illinois,,6-5,8-3,,14,21,31,35,7,7,14,3,14,7,0,14,-2.0,-7,-4,,
721,721,2017,12,NCAAF_20171115_TOLEDO@BGREEN,Toledo,,Bowling Green,,9-2,2-9,,24,21,66,37,14,10,28,14,7,14,7,9,7.0,3,29,,
722,722,2017,12,NCAAF_20171114_CMICH@KENTST,C. Michigan,,Kent St.,,7-4,2-9,,28,17,42,23,7,21,0,14,3,14,0,6,5.0,11,19,,
723,723,2017,12,NCAAF_20171114_OHIO@AKRON,Ohio,,Akron,,8-3,6-5,,24,30,34,37,14,10,3,7,10,20,0,7,2.0,-6,-3,,
724,724,2017,13,NCAAF_20171125_FSU@FLA,Florida State,,Florida,,5-6,4-7,,24,13,38,22,7,17,0,14,7,6,3,6,1.0,11,16,,
725,725,2017,13,NCAAF_20171125_IND@PURDUE,Indiana,,Purdue,,5-7,6-6,,10,21,24,31,7,3,0,14,7,14,3,7,-1.0,-11,-7,,
726,726,2017,13,NCAAF_20171125_LVILLE@UK,Louisville,,Kentucky,,8-4,7-5,,31,10,44,17,17,14,3,10,7,3,0,7,1.0,21,27,,
727,727,2017,13,NCAAF_20171125_UCONN@CINCY,UConn,,Cincinnati,,3-9,4-8,,6,7,21,22,3,3,9,6,0,7,0,15,-1.0,-1,-1,,
728,728,2017,13,NCAAF_20171125_UGA@GATECH,Georgia,,Georgia Tech,,11-1,5-6,,17,7,38,7,7,10,14,7,0,7,0,0,6.0,10,31,,
729,729,2017,13,NCAAF_20171125_ECU@MEMP,East Carolina,,Memphis,,3-9,10-1,,0,49,13,70,0,0,13,0,28,21,14,7,-7.0,-49,-57,,
730,730,2017,13,NCAAF_20171125_KANSAS@OKLAST,Kansas,,Oklahoma State,,1-11,9-3,,10,34,17,58,3,7,7,0,10,24,14,10,-8.0,-24,-41,,
731,731,2017,13,NCAAF_20171125_OHIOST@MICH,Ohio State,,Michigan,,10-2,8-4,,14,14,31,20,0,14,7,10,7,7,6,0,2.0,0,11,,
732,732,2017,13,NCAAF_20171125_TULANE@SMU,Tulane,,SMU,,5-7,7-5,,21,27,38,41,7,14,17,0,14,13,7,7,-2.0,-6,-3,,
733,733,2017,13,NCAAF_20171125_BC@CUSE,Boston College,,Syracuse,,7-5,4-8,,28,14,42,14,14,14,7,7,7,7,0,0,3.0,14,28,,
734,734,2017,13,NCAAF_20171125_DUKE@WAKE,Duke,,Wake Forest,,6-6,7-5,,10,17,31,23,3,7,7,14,10,7,6,0,-1.0,-7,8,,
735,735,2017,13,NCAAF_20171125_NTEXAS@RICE,North Texas,,Rice,,9-3,1-11,,24,14,30,14,7,17,3,3,7,7,0,0,8.0,10,16,,
736,736,2017,13,NCAAF_20171125_UTEP@UAB,UTEP,,UAB,,0-12,8-4,,7,14,7,28,7,0,0,0,3,11,14,0,-8.0,-7,-21,,
737,737,2017,13,NCAAF_20171125_APLST@GAST,App. St.,,Georgia St.,,7-4,6-4,,10,7,31,10,0,10,14,7,0,7,0,3,1.0,3,21,,
738,738,2017,13,NCAAF_20171125_FAU@CHARLO,FAU,,Charlotte,,9-3,1-11,,24,6,31,12,10,14,7,0,0,6,6,0,8.0,18,19,,
739,739,2017,13,NCAAF_20171125_USM@MRSHL,So. Miss,,Marshall,,8-4,7-5,,14,14,28,27,0,14,7,7,0,14,7,6,1.0,0,1,,
740,740,2017,13,NCAAF_20171125_ARKST@LAMON,Arkansas St.,,UL-Monroe,,7-3,4-7,,28,21,67,50,7,21,21,18,14,7,14,15,3.0,7,17,,
741,741,2017,13,NCAAF_20171125_ODU@MTSU,Old Dominion,,Middle Tenn.,,5-7,6-6,,3,24,10,41,3,0,0,7,3,21,7,10,-1.0,-21,-31,,
742,742,2017,13,NCAAF_20171125_UNLV@NEVADA,UNLV,,Nevada,,5-7,3-9,,13,9,16,23,0,13,3,0,6,3,7,7,2.0,4,-7,,
743,743,2017,13,NCAAF_20171125_BAMA@AUBURN,Alabama,,Auburn,,11-1,10-2,,7,10,14,26,0,7,7,0,7,3,10,6,1.0,-3,-12,,
744,744,2017,13,NCAAF_20171125_IOWAST@KSTATE,Iowa St.,,Kansas State,,7-5,7-5,,6,7,19,20,3,3,6,7,0,7,0,13,0.0,-1,-1,,
745,745,2017,13,NCAAF_20171125_PSU@MD,Penn State,,Maryland,,10-2,4-8,,31,0,66,3,14,17,21,14,0,0,3,0,6.0,31,63,,
746,746,2017,13,NCAAF_20171125_UNC@NCST,North Carolina,,NC State,,3-9,8-4,,14,12,21,33,7,7,0,7,6,6,7,14,-5.0,2,-12,,
747,747,2017,13,NCAAF_20171125_BOISE@FRESNO,Boise St.,,Fresno St.,,9-3,9-3,,7,10,17,28,7,0,3,7,7,3,6,12,0.0,-3,-11,,
748,748,2017,13,NCAAF_20171125_WISC@MINN,Wisconsin,,Minnesota,,12-0,5-7,,17,0,31,0,7,10,7,7,0,0,0,0,7.0,17,31,,
749,749,2017,13,NCAAF_20171125_WVU@OKLA,West Virginia,,Oklahoma,,7-5,11-1,,10,45,31,59,3,7,14,7,14,31,14,0,-4.0,-35,-28,,
750,750,2017,13,NCAAF_20171125_MICHST@RUT,Michigan St.,,Rutgers,,9-3,4-8,,16,7,40,7,13,3,3,21,0,7,0,0,5.0,9,33,,
751,751,2017,13,NCAAF_20171125_NWEST@ILL,Northwestern,,Illinois,,9-3,2-10,,14,7,42,7,0,14,14,14,7,0,0,0,7.0,7,35,,
752,752,2017,13,NCAAF_20171125_VANDY@TENN,Vanderbilt,,Tennessee,,5-7,4-8,,21,14,42,24,7,14,0,21,14,0,3,7,1.0,7,18,,
753,753,2017,13,NCAAF_20171125_IDAHO@NMEXST,Idaho,,New Mexico St.,,3-8,5-6,,7,14,10,17,0,7,3,0,14,0,0,3,-2.0,-7,-7,,
754,754,2017,13,NCAAF_20171125_TEMPLE@TULSA,Temple,,Tulsa,,6-6,2-10,,31,13,43,22,10,21,6,6,7,6,7,2,4.0,18,21,,
755,755,2017,13,NCAAF_20171125_ARIZ@ARIZST,Arizona,,Arizona St.,,7-5,7-5,,24,14,30,42,14,10,0,6,7,7,21,7,0.0,10,-12,,
756,756,2017,13,NCAAF_20171125_GAS@LALAF,Ga. Southern,,Louisiana,,2-9,5-6,,17,7,34,24,14,3,10,7,0,7,3,14,-3.0,10,10,,
757,757,2017,13,NCAAF_20171125_WYO@SJST,Wyoming,,San Jose St.,,7-5,2-11,,7,13,17,20,0,7,3,7,7,6,0,7,5.0,-6,-3,,
758,758,2017,13,NCAAF_20171125_OREGST@OREG,Oregon State,,Oregon,,1-11,7-5,,7,52,10,69,7,0,3,0,17,35,10,7,-6.0,-45,-59,,
759,759,2017,13,NCAAF_20171125_CLEM@SC,Clemson,,South Carolina,,11-1,8-4,,20,0,34,10,7,13,14,0,0,0,0,10,3.0,20,24,,
760,760,2017,13,NCAAF_20171125_TXAM@LSU,Texas A&M,,LSU,,7-5,9-3,,7,20,21,45,0,7,14,0,13,7,14,11,-2.0,-13,-24,,
761,761,2017,13,NCAAF_20171125_TXSA@LATECH,UTSA,,Louisiana Tech,,6-5,6-6,,0,10,6,20,0,0,3,3,7,3,3,7,0.0,-10,-14,,
762,762,2017,13,NCAAF_20171125_ND@STNFRD,Notre Dame,,Stanford,,9-3,9-3,,10,14,20,38,7,3,10,0,7,7,3,21,0.0,-4,-18,,
763,763,2017,13,NCAAF_20171125_WASHST@WASH,Washington St.,,Washington,,9-3,10-2,,0,24,14,41,0,0,0,14,7,17,10,7,-1.0,-24,-27,,
764,764,2017,13,NCAAF_20171125_BYU@HAWAII,BYU,,Hawaii,,4-9,3-9,,13,7,30,20,7,6,7,10,7,0,0,13,1.0,6,10,,
765,765,2017,13,NCAAF_20171125_COLO@UTAH,Colorado,,Utah,,5-7,6-6,,0,28,13,34,0,0,7,6,14,14,3,3,-1.0,-28,-21,,
766,766,2017,13,NCAAF_20171125_UTAHST@AF,Utah St.,,Air Force,,6-6,5-7,,21,17,35,38,14,7,0,14,10,7,7,14,1.0,4,-3,,
767,767,2017,13,NCAAF_20171124_WMICH@TOLEDO,W. Michigan,,Toledo,,6-6,10-2,,3,17,10,37,0,3,7,0,3,14,14,6,-4.0,-14,-27,,
768,768,2017,13,NCAAF_20171124_BAYLOR@TCU,Baylor,,TCU,,1-11,10-2,,19,21,22,45,9,10,3,0,14,7,14,10,-9.0,-2,-23,,
769,769,2017,13,NCAAF_20171124_MIAMI@PITT,Miami (Fla.),,Pittsburgh,,10-1,5-7,,7,10,14,24,0,7,0,7,3,7,7,7,5.0,-3,-10,,
770,770,2017,13,NCAAF_20171124_NAVY@HOU,Navy,,Houston,,6-5,7-4,,14,7,14,24,0,14,0,0,7,0,7,10,-1.0,7,-10,,
771,771,2017,13,NCAAF_20171124_NILL@CMICH,N. Illinois,,C. Michigan,,8-4,8-4,,17,0,24,31,14,3,0,7,0,0,17,14,0.0,17,-7,,
772,772,2017,13,NCAAF_20171124_OHIO@BUFF,Ohio,,Buffalo,,8-4,6-6,,10,24,24,31,7,3,14,0,24,0,0,7,2.0,-14,-7,,
773,773,2017,13,NCAAF_20171124_MIZZOU@ARK,Missouri,,Arkansas,,7-5,4-8,,31,28,48,45,7,24,0,17,21,7,7,10,3.0,3,3,,
774,774,2017,13,NCAAF_20171124_NMEX@SDGST,New Mexico,,San Diego St.,,3-9,10-2,,0,14,10,35,0,0,10,0,7,7,7,14,-7.0,-14,-25,,
775,775,2017,13,NCAAF_20171124_SFLA@UCF,South Florida,,UCF,,9-2,11-0,,20,21,42,49,7,13,14,8,21,0,7,21,-2.0,-1,-7,,
776,776,2017,13,NCAAF_20171124_IOWA@NEB,Iowa,,Nebraska,,7-5,4-8,,14,14,56,14,7,7,28,14,7,7,0,0,3.0,0,42,,
777,777,2017,13,NCAAF_20171124_TXSTSM@TROY,Texas St.,,Troy,,2-10,9-2,,0,41,9,62,0,0,6,3,17,24,14,7,-7.0,-41,-53,,
778,778,2017,13,NCAAF_20171124_WKY@FIU,W. Kentucky,,FIU,,6-6,7-4,,10,13,17,41,3,7,7,0,3,10,21,7,-1.0,-3,-24,,
779,779,2017,13,NCAAF_20171124_TXTECH@TEXAS,Texas Tech,,Texas,,6-6,6-6,,10,20,27,23,7,3,3,14,7,13,0,3,0.0,-10,4,,
780,780,2017,13,NCAAF_20171124_VATECH@UVA,Virginia Tech,,Virginia,,9-3,6-6,,3,0,10,0,0,3,7,0,0,0,0,0,3.0,3,10,,
781,781,2017,13,NCAAF_20171124_CAL@UCLA,California,,UCLA,,5-7,6-6,,9,17,27,30,3,6,8,10,7,10,7,6,-1.0,-8,-3,,
782,782,2017,13,NCAAF_20171123_MISS@MISSST,Ole Miss,,Miss. State,,6-6,8-4,,10,6,31,28,7,3,14,7,0,6,0,22,-2.0,4,3,,
783,783,2017,13,NCAAF_20171121_BGREEN@EMICH,Bowling Green,,E. Michigan,,2-10,5-7,,17,20,31,34,10,7,14,0,13,7,14,0,-3.0,-3,-3,,
784,784,2017,13,NCAAF_20171121_KENTST@AKRON,Kent St.,,Akron,,2-10,7-5,,7,24,14,24,0,7,7,0,10,14,0,0,-5.0,-17,-10,,
785,785,2017,13,NCAAF_20171121_MIAOH@BALLST,Miami-OH,,Ball St.,,5-7,2-10,,28,0,28,7,14,14,0,0,0,0,0,7,3.0,28,21,,
786,786,2017,14,NCAAF_20171202_AKRON@TOLEDO,Akron,,Toledo,,7-6,11-2,,0,28,28,45,0,0,7,21,7,21,10,7,-4.0,-28,-17,,
787,787,2017,14,NCAAF_20171202_LAMON@FSU,UL-Monroe,,Florida State,,4-8,6-6,,0,14,10,42,0,0,10,0,7,7,14,14,-2.0,-14,-32,,
788,788,2017,14,NCAAF_20171202_MA@FIU,UMass,,FIU,,4-8,8-4,,21,35,45,63,14,7,10,14,14,21,7,21,-4.0,-14,-18,,
789,789,2017,14,NCAAF_20171202_NTEXAS@FAU,North Texas,,FAU,,9-4,10-3,,0,27,17,41,0,0,9,8,10,17,7,7,-1.0,-27,-24,,
790,790,2017,14,NCAAF_20171202_TCU@OKLA,TCU,,Oklahoma,,10-3,12-1,,17,24,17,41,0,17,0,0,17,7,17,0,-2.0,-7,-24,,
791,791,2017,14,NCAAF_20171202_GAS@CSTCAR,Ga. Southern,,C. Carolina,,2-10,3-9,,10,14,17,28,3,7,7,0,7,7,14,0,-1.0,-4,-11,,
792,792,2017,14,NCAAF_20171202_IDAHO@GAST,Idaho,,Georgia St.,,4-8,6-5,,14,10,24,10,7,7,3,7,7,3,0,0,-2.0,4,14,,
793,793,2017,14,NCAAF_20171202_LALAF@APLST,Louisiana,,App. St.,,5-7,8-4,,7,35,14,63,7,0,0,7,14,21,14,14,-3.0,-28,-49,,
794,794,2017,14,NCAAF_20171202_UGA@AUBURN,Georgia,,Auburn,,12-1,10-3,,10,7,28,7,0,10,3,15,7,0,0,0,2.0,3,21,,
795,795,2017,14,NCAAF_20171202_SALA@NMEXST,South Alabama,,New Mexico St.,,4-8,6-6,,7,13,17,22,0,7,0,10,0,13,0,9,-2.0,-6,-5,,
796,796,2017,14,NCAAF_20171202_TROY@ARKST,Troy,,Arkansas St.,,10-2,7-4,,7,10,32,25,0,7,10,15,0,10,3,12,3.0,-3,7,,
797,797,2017,14,NCAAF_20171202_FRESNO@BOISE,Fresno St.,,Boise St.,,9-4,10-3,,14,10,14,17,0,14,0,0,3,7,0,7,-1.0,4,-3,,
798,798,2017,14,NCAAF_20171202_MIAMI@CLEM,Miami (Fla.),,Clemson,,10-2,12-1,,0,21,3,38,0,0,0,3,14,7,17,0,-2.0,-21,-35,,
799,799,2017,14,NCAAF_20171202_OHIOST@WISC,Ohio State,,Wisconsin,,11-2,12-1,,21,10,27,21,14,7,3,3,7,3,3,8,-1.0,11,6,,
800,800,2017,14,NCAAF_20171201_STNFRD@USC,Stanford,,USC,,9-4,11-2,,14,17,28,31,0,14,7,7,7,10,7,7,-2.0,-3,-3,,
801,801,2017,15,NCAAF_20171209_ARMY@NAVY,Army,,Navy,,9-3,6-6,,7,10,14,13,7,0,0,7,3,7,3,0,3.0,-3,1,,
802,802,2018,2,NCAAF_20180909_RICE@HAWAII,Rice,,Hawaii,,1-2,3-0,,10,21,29,43,7,3,3,16,14,7,7,15,-2.0,-11,-14,0.3785988751022553,-4.526030135483985
803,803,2018,2,NCAAF_20180908_ARIZ@HOU,Arizona,,Houston,,0-2,2-0,,0,31,18,45,0,0,10,8,21,10,7,7,-2.0,-31,-27,0.5562344107787949,2.070466823076117
804,804,2018,2,NCAAF_20180908_DUKE@NWEST,Duke,,Northwestern,,2-0,1-1,,21,7,21,7,0,21,0,0,7,0,0,0,1.0,14,14,0.3476113705145596,-5.735478175035766
805,805,2018,2,NCAAF_20180908_EMICH@PURDUE,E. Michigan,,Purdue,,2-0,0-2,,10,12,20,19,7,3,0,10,6,6,0,7,2.0,-2,1,0.10437803907078669,-18.401925487510514
806,806,2018,2,NCAAF_20180908_GATECH@SFLA,Georgia Tech,,South Florida,,1-1,2-0,,17,21,38,49,17,0,14,7,14,7,7,21,-1.0,-4,-11,0.6729845288550698,6.56103757337943
807,807,2018,2,NCAAF_20180908_LIB@ARMY,Liberty,Flames,Army,Black Knights,1-1,1-1,0.0,0,17,14,38,0,0,14,0,14,3,7,14,0.0,-17,-24,0.5172490575146008,0.6331709876398772
808,808,2018,2,NCAAF_20180908_MISSST@KSTATE,Miss. State,Bulldogs,Kansas State,Wildcats,2-0,1-1,0.0,17,3,31,10,3,14,7,7,3,0,7,0,1.0,14,21,0.6661809840448185,6.286142040568288
809,809,2018,2,NCAAF_20180908_NEVADA@VANDY,Nevada,,Vanderbilt,,1-1,2-0,,10,17,10,41,0,10,0,0,0,17,17,7,-1.0,-7,-31,0.4121778532963496,-3.2492129915292303
810,810,2018,2,NCAAF_20180908_NMEX@WISC,New Mexico,Lobos,Wisconsin,Badgers,1-1,2-0,0.0,7,10,14,45,7,0,0,7,3,7,14,21,-1.0,-3,-31,0.0012401591059053585,-44.295623321185815
811,811,2018,2,NCAAF_20180908_TWST@WAKE,Towson,,Wake Forest,,1-1,2-0,,20,38,20,51,14,6,0,0,14,24,3,10,-1.0,-18,-31,4.749125991465597e-06,-64.82858048851347
812,812,2018,2,NCAAF_20180908_WMICH@MICH,W. Michigan,Broncos,Michigan,Wolverines,0-2,1-1,0.0,0,35,3,49,0,0,0,3,21,14,7,7,-1.0,-35,-46,0.09277876269581786,-19.38047868281062
813,813,2018,2,NCAAF_20180908_GAST@NCST,Georgia St.,,NC State,,1-1,2-0,,7,20,7,41,7,0,0,0,10,10,7,14,-1.0,-13,-34,0.012702234909816035,-32.72246216362099
814,814,2018,2,NCAAF_20180908_HOLY@BC,Holy Cross,,Boston College,,0-2,2-0,,0,34,14,62,0,0,7,7,21,13,14,14,-2.0,-34,-48,0.007929382008834862,-35.31299855313609
815,815,2018,2,NCAAF_20180908_UCLA@OKLA,UCLA,Bruins,Oklahoma,Sooners,0-2,2-0,0.0,7,21,21,49,7,0,0,14,14,7,14,14,-2.0,-14,-28,0.054514100303897695,-23.46113789611907
816,816,2018,2,NCAAF_20180908_AF@FAU,Air Force,,FAU,,1-1,1-1,,7,19,27,33,0,7,13,7,6,13,6,8,0.0,-12,-6,0.16333991688331706,-14.358899038732956
817,817,2018,2,NCAAF_20180908_PORTST@OREG,Portland St.,Vikings,Oregon,Ducks,0-2,2-0,0.0,7,35,14,62,0,7,0,7,14,21,14,13,-2.0,-28,-48,0.014307566946749395,-32.04248260391387
818,818,2018,2,NCAAF_20180908_WMMARY@VATECH,William & Mary,Tribe,Virginia Tech,Hokies,1-0,1-0,0.0,7,38,17,62,0,7,7,3,17,21,17,7,0.0,-31,-45,0.010344064886070647,-33.870676819752276
819,819,2018,2,NCAAF_20180908_KANSAS@CMICH,Kansas,Jayhawks,C. Michigan,Chippewas,1-1,0-2,0.0,7,0,31,7,0,7,14,10,0,0,7,0,1.0,7,24,0.1574564091363263,-14.712350130229568
820,820,2018,2,NCAAF_20180908_ARKST@BAMA,Arkansas St.,Red Wolves,Alabama,Crimson Tide,1-1,2-0,0.0,0,40,7,57,0,0,7,0,19,21,10,7,-1.0,-40,-50,0.008413426260333257,-34.99560488616369
821,821,2018,2,NCAAF_20180908_BALLST@ND,Ball St.,Cardinals,Notre Dame,Fighting Irish,1-1,2-0,0.0,6,14,16,24,3,3,0,10,7,7,10,0,-1.0,-8,-8,5.3622479929460454e-05,-56.70791375681411
822,822,2018,2,NCAAF_20180908_BUFF@TEMPLE,Buffalo,,Temple,,2-0,0-2,,12,7,36,29,6,6,10,14,0,7,7,15,2.0,5,7,0.475479579563875,-0.9003718065928421
823,823,2018,2,NCAAF_20180908_COLO@NEB,Colorado,,Nebraska,,2-0,0-1,,17,21,33,28,14,3,10,6,7,14,7,0,2.0,-4,5,0.4633490869073399,-1.34684416952169
824,824,2018,2,NCAAF_20180908_HOW@KENTST,Howard,,Kent St.,,0-2,1-1,,0,26,14,54,0,0,14,0,16,10,21,7,-1.0,-26,-40,0.6073801044912844,3.98925930930546
825,825,2018,2,NCAAF_20180908_MEMP@NAVY,Memphis,Tigers,Navy,Midshipmen,1-1,1-1,0.0,7,9,21,22,0,7,14,0,3,6,0,13,0.0,-2,-1,0.7635064205477949,10.50580255409877
826,826,2018,2,NCAAF_20180908_MRGNST@AKRON,Morgan St.,,Akron,,0-2,1-0,,0,27,7,41,0,0,0,7,17,10,14,0,-1.0,-27,-34,9.94377355822973e-06,-62.45488298406357
827,827,2018,2,NCAAF_20180908_RUT@OHIOST,Rutgers,Scarlet Knights,Ohio State,Buckeyes,1-1,2-0,0.0,0,35,3,52,0,0,3,0,14,21,10,7,-1.0,-35,-49,0.005041648432416501,-37.6671960716196
828,828,2018,2,NCAAF_20180908_UGA@SC,Georgia,Bulldogs,South Carolina,Gamecocks,1-0,1-0,0.0,20,10,41,17,17,3,21,0,7,3,0,7,0.0,10,24,0.9389005566782883,22.62716381465558
829,829,2018,2,NCAAF_20180908_UNC@ECU,North Carolina,,East Carolina,,0-2,1-1,,19,21,19,41,6,13,0,0,7,14,7,13,-1.0,-2,-22,0.8929502731173939,18.187871164686626
830,830,2018,2,NCAAF_20180908_WAG@CUSE,Wagner,,Syracuse,,1-1,2-0,,7,45,10,62,7,0,0,3,21,24,14,3,-1.0,-38,-52,0.002331277166642387,-41.4223774871253
831,831,2018,2,NCAAF_20180908_ETNST@TENN,ETSU,Buccaneers,Tennessee,Volunteers,1-1,1-1,0.0,0,38,3,59,0,0,3,0,10,28,7,14,0.0,-38,-56,,
832,832,2018,2,NCAAF_20180908_LAMAR@TXTECH,Lamar,,Texas Tech,,1-1,1-1,,0,42,0,77,0,0,0,0,14,28,14,21,0.0,-42,-77,7.042454745032067e-06,-63.57311376516806
833,833,2018,2,NCAAF_20180908_SIL@MISS,S. Illinois,,Ole Miss,,1-1,2-0,,38,35,41,76,21,17,3,0,14,21,14,27,-1.0,3,-35,0.5462908600444576,1.7025252833453166
834,834,2018,2,NCAAF_20180908_IOWAST@IOWA,Iowa St.,Cyclones,Iowa,Hawkeyes,0-1,2-0,0.0,3,3,3,13,3,0,0,0,0,3,3,7,-2.0,0,-10,0.4167350466117389,-3.078029987593709
835,835,2018,2,NCAAF_20180908_NDK@WASH,North Dakota,Fighting Hawks,Washington,Huskies,1-1,1-1,0.0,0,17,3,45,0,0,3,0,10,7,7,21,0.0,-17,-42,0.007807049970620095,-35.39590526861373
836,836,2018,2,NCAAF_20180908_APLST@CHARLO,App. St.,,Charlotte,,1-1,1-1,,24,9,45,9,10,14,7,14,0,9,0,0,0.0,15,36,0.9757554755979664,28.884841633007394
837,837,2018,2,NCAAF_20180908_MA@GAS,UMass,,Ga. Southern,,1-2,2-0,,10,17,13,34,3,7,3,0,0,17,10,7,-1.0,-7,-21,0.6411448441482125,5.292530436467295
838,838,2018,2,NCAAF_20180908_MD@BGREEN,Maryland,,Bowling Green,,2-0,0-2,,10,14,45,14,0,10,7,28,7,7,0,0,2.0,-4,31,0.8111411301521414,12.913759336969346
839,839,2018,2,NCAAF_20180908_SAV@MIAMI,Savannah St.,Tigers,Miami (Fla.),Hurricanes,0-2,1-1,0.0,0,28,0,77,0,0,0,0,7,21,21,28,-1.0,-28,-77,1.97559516956769e-06,-67.5463124224349
840,840,2018,2,NCAAF_20180908_SCST@UCF,SC State,Bulldogs,UCF,Knights,0-2,2-0,0.0,0,24,0,38,0,0,0,0,14,10,14,0,-2.0,-24,-38,,
841,841,2018,2,NCAAF_20180908_YST@WVU,Youngstown St.,Penguins,West Virginia,Mountaineers,0-2,2-0,0.0,7,21,17,52,0,7,10,0,7,14,21,10,-2.0,-14,-35,,
842,842,2018,2,NCAAF_20180908_EKY@MRSHL,E. Kentucky,,Marshall,,1-1,2-0,,6,20,16,32,0,6,7,3,13,7,7,5,-1.0,-14,-16,0.12601339564340686,-16.768831425218078
843,843,2018,2,NCAAF_20180908_BAYLOR@TXSA,Baylor,,UTSA,,2-0,0-2,,20,13,37,20,10,10,7,10,3,10,0,7,2.0,7,17,0.7447931100719954,9.635714674439658
844,844,2018,2,NCAAF_20180908_CLEM@TXAM,Clemson,Tigers,Texas A&M,Aggies,2-0,1-1,0.0,14,3,28,26,7,7,14,0,3,0,10,13,1.0,11,2,0.9556254647119901,24.91715472179182
845,845,2018,2,NCAAF_20180908_FAMU@TROY,Florida A&M,,Troy,,1-1,1-1,,7,38,7,59,0,7,0,0,21,17,14,7,0.0,-31,-52,0.0010320406367277934,-45.10257926212603
846,846,2018,2,NCAAF_20180908_INST@LVILLE,Indiana St.,,Louisville,,1-1,1-1,,7,7,7,31,7,0,0,0,7,0,7,17,0.0,0,-24,1.5424836776523065e-05,-61.00485963544192
847,847,2018,2,NCAAF_20180908_LAMON@USM,UL-Monroe,,So. Miss,,2-0,1-1,,14,17,21,20,14,0,7,0,10,7,3,0,1.0,-3,1,0.41515277928604855,-3.137416222642768
848,848,2018,2,NCAAF_20180908_SELOU@LSU,SE Louisiana,Lions,LSU,Tigers,0-2,2-0,0.0,0,24,0,31,0,0,0,0,14,10,0,7,-2.0,-24,-31,0.0032724892620787926,-39.807380065082555
849,849,2018,2,NCAAF_20180908_SO@LATECH,Southern U.,,Louisiana Tech,,0-2,2-0,,14,31,17,54,7,7,3,0,21,10,14,9,-2.0,-17,-37,0.0024625587861212273,-41.16506609016327
850,850,2018,2,NCAAF_20180908_TNMART@MTSU,UT Martin,,Middle Tenn.,,0-2,1-1,,17,26,37,61,7,10,7,13,14,12,21,14,-1.0,-9,-24,0.21155092878299508,-11.72710287130948
851,851,2018,2,NCAAF_20180908_TXSO@TXSTSM,Texas Southern,,Texas St.,,1-1,1-1,,0,16,20,36,0,0,7,13,3,13,10,10,0.0,-16,-16,,
852,852,2018,2,NCAAF_20180908_UAB@CSTCAR,UAB,,C. Carolina,,1-1,1-1,,24,20,24,47,14,10,0,0,7,13,7,20,0.0,4,-23,0.6547262785444745,5.828219033050713
853,853,2018,2,NCAAF_20180908_WYO@MIZZOU,Wyoming,,Missouri,,1-2,2-0,,0,16,13,40,0,0,10,3,3,13,14,10,-1.0,-16,-27,0.22342745836936095,-11.135915380452353
854,854,2018,2,NCAAF_20180908_SAMF@FSU,Samford,Bulldogs,Florida State,Seminoles,1-1,1-1,0.0,23,21,26,36,16,7,0,3,7,14,0,15,0.0,2,-10,0.2212411077413885,-11.243363993508531
855,855,2018,2,NCAAF_20180908_ALST@AUBURN,Alabama St.,Hornets,Auburn,Tigers,1-1,2-0,0.0,2,42,9,63,0,2,7,0,21,21,7,14,-1.0,-40,-54,0.00011212621449196991,-54.020289034018546
856,856,2018,2,NCAAF_20180908_ARK@COLOST,Arkansas,Razorbacks,Colorado St.,Rams,1-1,1-2,0.0,13,9,27,34,7,6,14,0,3,6,8,17,0.0,4,-7,0.48861704846191256,-0.4177669530747412
857,857,2018,2,NCAAF_20180908_FIU@ODU,FIU,,Old Dominion,,1-1,0-2,,14,20,28,20,0,14,14,0,7,13,0,0,1.0,-6,8,0.7555890556717737,10.133320378457025
858,858,2018,2,NCAAF_20180908_FRESNO@MINN,Fresno St.,,Minnesota,,1-1,2-0,,0,10,14,21,0,0,7,7,7,3,0,11,-1.0,-10,-7,0.4258577965209458,-2.7365860063265277
859,859,2018,2,NCAAF_20180908_ME@WKY,Maine,,W. Kentucky,,2-0,0-2,,14,21,31,28,0,14,14,3,21,0,0,7,2.0,-7,3,0.2598998793825241,-9.422862682829308
860,860,2018,2,NCAAF_20180908_UIW@NTEXAS,Incarnate Word,,North Texas,,0-2,2-0,,6,41,16,58,6,0,10,0,10,31,14,3,-2.0,-35,-42,8.674350587745128e-05,-54.96876125991141
861,861,2018,2,NCAAF_20180908_UK@FLA,Kentucky,Wildcats,Florida,Gators,2-0,1-1,0.0,7,10,27,16,7,0,14,6,0,10,0,6,1.0,-3,11,0.46362472370189556,-1.3366867931065975
862,862,2018,2,NCAAF_20180908_UTAH@NILL,Utah,,N. Illinois,,2-0,0-2,,0,3,17,6,0,0,7,10,3,0,0,3,2.0,-3,11,0.65505017037775,5.841087081603224
863,863,2018,2,NCAAF_20180908_UVA@IND,Virginia,,Indiana,,1-1,2-0,,9,20,16,20,9,0,7,0,13,7,0,0,-1.0,-11,-4,0.42074000555733493,-2.9279381538823817
864,864,2018,2,NCAAF_20180908_WIL@ILL,W. Illinois,,Illinois,,0-2,2-0,,7,14,14,34,7,0,7,0,0,14,10,10,-2.0,-7,-20,0.985944278957603,32.144656828902704
865,865,2018,2,NCAAF_20180908_CINCY@MIAOH,Cincinnati,,Miami-OH,,2-0,0-2,,7,0,21,0,7,0,0,14,0,0,0,0,2.0,7,21,0.34023841110191233,-6.0287864130163396
866,866,2018,2,NCAAF_20180908_NICHST@TULANE,Nicholls St.,,Tulane,,1-1,1-1,,10,21,17,42,3,7,0,7,7,14,7,14,0.0,-11,-25,0.49082032551499255,-0.336888251006064
867,867,2018,2,NCAAF_20180908_NMEXST@UTAHST,New Mexico St.,,Utah St.,,0-3,1-1,,10,33,13,60,7,3,3,0,16,17,14,13,-1.0,-23,-47,0.2148449168359572,-11.561251426530267
868,868,2018,2,NCAAF_20180908_PSU@PITT,Penn State,Nittany Lions,Pittsburgh,Panthers,2-0,1-1,0.0,14,6,51,6,7,7,16,21,6,0,0,0,1.0,8,45,0.9603192702619886,25.68382536377707
869,869,2018,2,NCAAF_20180908_SALA@OKLAST,South Alabama,,Oklahoma State,,0-2,2-0,,13,31,13,55,7,6,0,0,14,17,10,14,-2.0,-18,-42,0.002439884327007591,-41.20860700179723
870,870,2018,2,NCAAF_20180908_SUT@OREGST,So. Utah,,Oregon State,,0-2,1-1,,7,41,25,48,0,7,9,9,17,24,0,7,-1.0,-34,-23,0.0205469106358116,-29.902661830599953
871,871,2018,2,NCAAF_20180908_TULSA@TEXAS,Tulsa,Golden Hurricane,Texas,Longhorns,1-1,1-1,0.0,0,21,21,28,0,0,7,14,14,7,0,7,0.0,-21,-7,0.07016799991753098,-21.586744907525514
872,872,2018,2,NCAAF_20180908_USC@STNFRD,USC,Trojans,Stanford,Cardinal,1-1,2-0,0.0,0,14,3,17,0,0,3,0,7,7,3,0,-1.0,-14,-14,0.45231750327311737,-1.753950077710602
873,873,2018,2,NCAAF_20180908_SACST@SDGST,Sacramento St.,,San Diego St.,,1-1,1-1,,7,13,14,28,0,7,7,0,7,6,0,15,0.0,-6,-14,0.0009138441095832839,-45.63016150245386
874,874,2018,2,NCAAF_20180908_UTEP@UNLV,UTEP,,UNLV,,0-2,1-1,,10,38,24,52,10,0,7,7,14,24,7,7,-1.0,-28,-28,0.0757858879065888,-20.99326504615211
875,875,2018,2,NCAAF_20180908_CAL@BYU,California,,BYU,,2-0,1-1,,7,3,21,18,7,0,7,7,0,3,7,8,1.0,4,3,0.85685164725912,15.609964969405267
876,876,2018,2,NCAAF_20180908_UCONN@BOISE,UConn,Huskies,Boise St.,Broncos,0-2,2-0,0.0,0,41,7,62,0,0,7,0,24,17,14,7,-2.0,-41,-55,0.07629272406711884,-20.94139482623258
877,877,2018,2,NCAAF_20180908_MICHST@ARIZST,Michigan St.,Spartans,Arizona St.,Sun Devils,1-1,2-0,0.0,3,0,13,16,0,3,10,0,0,0,3,13,-1.0,3,-3,0.7043919291405685,7.862576210846893
878,878,2018,2,NCAAF_20180908_SJST@WASHST,San Jose St.,,Washington St.,,0-2,2-0,,0,24,0,31,0,0,0,0,14,10,0,7,-2.0,-24,-31,0.0018118574430946444,-42.589424551969024
879,879,2018,2,NCAAF_20180907_TCU@SMU,TCU,Horned Frogs,SMU,Mustangs,2-0,0-2,0.0,14,12,42,12,0,14,14,14,9,3,0,0,2.0,2,30,0.8856641230178104,17.623011331349694
880,880,2018,3,NCAAF_20180915_BALLST@IND,Ball St.,Cardinals,Indiana,Hoosiers,1-2,3-0,0.0,3,24,10,38,3,0,7,0,3,21,7,7,-2.0,-21,-28,0.00516053921558024,-38.220630843487754
881,881,2018,3,NCAAF_20180915_FSU@CUSE,Florida State,,Syracuse,,1-2,3-0,,0,6,7,30,0,0,0,7,3,3,14,10,-2.0,-6,-23,0.7582001327878857,10.438877477230335
882,882,2018,3,NCAAF_20180915_GAS@CLEM,Ga. Southern,Eagles,Clemson,Tigers,2-1,3-0,0.0,0,21,7,38,0,0,0,7,0,21,3,14,-1.0,-21,-31,0.0011746602331598188,-45.331929922191364
883,883,2018,3,NCAAF_20180915_HAWAII@ARMY,Hawaii,Rainbow Warriors,Army,Black Knights,3-1,2-1,0.0,14,21,21,28,7,7,0,7,7,14,0,7,1.0,-7,-7,0.056329405612568495,-23.639090711893857
884,884,2018,3,NCAAF_20180915_KENTST@PSU,Kent St.,Golden Flashes,Penn State,Nittany Lions,1-2,3-0,0.0,10,28,10,63,7,3,0,0,21,7,21,14,-2.0,-18,-53,4.2431312628599116e-05,-58.56646269961078
885,885,2018,3,NCAAF_20180915_MIAMI@TOLEDO,Miami (Fla.),Hurricanes,Toledo,Rockets,2-1,1-1,0.0,21,7,49,24,7,14,14,14,0,7,14,3,1.0,14,25,0.7940525525606631,12.227639833139392
886,886,2018,3,NCAAF_20180915_MTSU@UGA,Middle Tenn.,Blue Raiders,Georgia,Bulldogs,1-2,3-0,0.0,7,42,7,49,0,7,0,0,14,28,7,0,-2.0,-35,-42,0.003031147828317371,-40.8956073604877
887,887,2018,3,NCAAF_20180915_MURYST@UK,Murray St.,Racers,Kentucky,Wildcats,0-3,3-0,0.0,3,17,10,48,0,3,0,7,7,10,17,14,-3.0,-14,-38,0.015822917948542625,-32.021204222111464
888,888,2018,3,NCAAF_20180915_OKLA@IOWAST,Oklahoma,Sooners,Iowa St.,Cyclones,2-0,0-1,0.0,24,10,37,27,10,14,10,3,0,10,14,3,2.0,14,10,0.7703724571874966,11.02822330190628
889,889,2018,3,NCAAF_20180915_RI@UCONN,Rhode Island,Rams,UConn,Huskies,2-1,1-2,0.0,28,42,49,56,7,21,14,7,14,28,7,7,1.0,-14,-7,,
890,890,2018,3,NCAAF_20180915_RUT@KANSAS,Rutgers,,Kansas,,1-2,2-1,,14,31,14,55,7,7,0,0,17,14,10,14,-1.0,-17,-41,0.7451076974273056,9.822677514649286
891,891,2018,3,NCAAF_20180915_TEMPLE@MD,Temple,Owls,Maryland,Terrapins,1-2,2-1,0.0,21,7,35,14,7,14,7,7,0,7,0,7,-1.0,14,21,0.36241182395628324,-5.245623331080537
892,892,2018,3,NCAAF_20180915_TROY@NEB,Troy,,Nebraska,,2-1,0-2,,17,7,24,19,3,14,0,7,0,7,6,6,2.0,10,5,0.4924866603239625,-0.28065903622660926
893,893,2018,3,NCAAF_20180915_UTEP@TENN,UTEP,Miners,Tennessee,Volunteers,0-2,1-1,0.0,0,10,0,24,0,0,0,0,3,7,7,7,-1.0,-10,-24,0.03286864701828951,-27.421927161235033
894,894,2018,3,NCAAF_20180915_GATECH@PITT,Georgia Tech,,Pittsburgh,,1-2,2-1,,0,21,19,24,0,0,6,13,14,7,3,0,-1.0,-21,-5,0.6842194586786345,7.145734520320616
895,895,2018,3,NCAAF_20180915_TULANE@UAB,Tulane,,UAB,,1-2,2-1,,7,21,24,31,0,7,14,3,7,14,3,7,-1.0,-14,-7,0.8599008870885559,16.091759803354364
896,896,2018,3,NCAAF_20180915_DAVIS@STNFRD,UC-Davis,Aggies,Stanford,Cardinal,2-1,3-0,0.0,3,17,10,30,3,0,0,7,0,17,10,3,-1.0,-14,-20,0.014037692085648756,-32.72717319654646
897,897,2018,3,NCAAF_20180915_VANDY@ND,Vanderbilt,Commodores,Notre Dame,Fighting Irish,2-0,2-0,0.0,3,16,17,22,0,3,7,7,10,6,0,6,0.0,-13,-5,0.05383356392394345,-23.973075703995733
898,898,2018,3,NCAAF_20180915_BOISE@OKLAST,Boise St.,Broncos,Oklahoma State,Cowboys,2-1,3-0,0.0,7,17,21,44,0,7,14,0,0,17,17,10,-1.0,-10,-23,0.20534086489097936,-12.259394005040235
899,899,2018,3,NCAAF_20180915_BYU@WISC,BYU,Cougars,Wisconsin,Badgers,2-1,2-1,0.0,14,14,24,21,7,7,7,3,7,7,0,7,0.0,0,3,0.0054468266928310305,-37.94062279906717
900,900,2018,3,NCAAF_20180915_CMICH@NILL,C. Michigan,,N. Illinois,,0-3,1-2,,3,14,16,24,0,3,7,6,0,14,7,3,-1.0,-11,-8,0.31120198842843827,-7.338193308268217
901,901,2018,3,NCAAF_20180915_DUKE@BAYLOR,Duke,,Baylor,,3-0,2-1,,23,0,40,27,7,16,7,10,0,0,13,14,1.0,23,13,0.8042790136013689,12.770676040310434
902,902,2018,3,NCAAF_20180915_LEH@NAVY,Lehigh,Mountain Hawks,Navy,Midshipmen,1-2,2-1,0.0,7,34,21,51,7,0,0,14,21,13,14,3,-1.0,-27,-30,,
903,903,2018,3,NCAAF_20180915_LSU@AUBURN,LSU,Tigers,Auburn,Tigers,3-0,2-1,1.0,10,14,22,21,7,3,3,9,0,14,7,0,1.0,-4,1,0.16694559131952347,-14.399419500531621
904,904,2018,3,NCAAF_20180915_MIAOH@MINN,Miami-OH,,Minnesota,,0-3,3-0,,3,19,3,26,0,3,0,0,7,12,7,0,-3.0,-16,-23,0.13056827081203204,-16.744963870240667
905,905,2018,3,NCAAF_20180915_SFLA@ILL,South Florida,,Illinois,,3-0,2-1,,7,16,25,19,7,0,0,18,10,6,3,0,1.0,-9,6,0.8834068022238952,17.765449626572718
906,906,2018,3,NCAAF_20180915_SMU@MICH,SMU,Mustangs,Michigan,Wolverines,0-3,2-1,0.0,7,21,20,45,0,7,6,7,0,21,14,10,-2.0,-14,-25,0.13979406465625543,-16.112188090338634
907,907,2018,3,NCAAF_20180915_COLOST@FLA,Colorado St.,,Florida,,1-3,2-1,,3,27,10,48,0,3,7,0,6,21,0,21,-1.0,-24,-38,0.43948627070962276,-2.269080826711786
908,908,2018,3,NCAAF_20180915_EKY@BGREEN,E. Kentucky,,Bowling Green,,1-2,1-2,,21,28,35,42,14,7,14,0,0,28,6,8,0.0,-7,-7,0.3916803944158491,-4.097052264564411
909,909,2018,3,NCAAF_20180915_NTEXAS@ARK,North Texas,,Arkansas,,3-0,1-2,,34,10,44,17,17,17,3,7,0,10,0,7,2.0,24,27,0.31274110411342537,-7.273361735864341
910,910,2018,3,NCAAF_20180915_TXSA@KSTATE,UTSA,,Kansas State,,0-3,2-1,,7,27,17,41,7,0,0,10,10,17,14,0,-2.0,-20,-24,0.07185424743848634,-21.78779267911119
911,911,2018,3,NCAAF_20180915_WOFF@WYO,Wofford,,Wyoming,,2-1,2-2,,7,10,14,17,0,7,0,7,0,10,0,7,0.0,-3,-3,0.24294592301873585,-10.38423494122327
912,912,2018,3,NCAAF_20180915_HOU@TXTECH,Houston,,Texas Tech,,2-1,2-1,,28,35,49,63,21,7,14,7,14,21,14,14,0.0,-7,-14,0.3893720688511909,-4.186669975710743
913,913,2018,3,NCAAF_20180915_OHIO@UVA,Ohio,,Virginia,,1-1,2-1,,21,38,31,45,7,14,7,3,21,17,0,7,-1.0,-17,-14,0.4390444172489859,-2.285779065370832
914,914,2018,3,NCAAF_20180915_NH@COLO,New Hamp.,,Colorado,,0-3,3-0,,0,28,14,45,0,0,14,0,7,21,10,7,-3.0,-28,-31,0.364977991527761,-5.1437654788810505
915,915,2018,3,NCAAF_20180915_SJST@OREG,San Jose St.,Spartans,Oregon,Ducks,0-3,3-0,0.0,6,21,22,35,0,6,6,10,14,7,7,7,-3.0,-15,-13,0.003317131629720138,-40.45263420858538
916,916,2018,3,NCAAF_20180915_BTHN@FAU,Bethune-Cook.,,FAU,,1-2,2-1,,14,36,28,49,0,14,7,7,29,7,7,6,-1.0,-22,-21,0.020373426604489486,-30.4899393590199
917,917,2018,3,NCAAF_20180915_EMICH@BUFF,E. Michigan,,Buffalo,,2-1,3-0,,21,28,28,35,0,21,0,7,14,14,0,7,-1.0,-7,-7,0.5358039772934597,1.3391704842769627
918,918,2018,3,NCAAF_20180915_IDST@CAL,Idaho State,,California,,1-1,3-0,,3,28,23,45,0,3,6,14,7,21,3,14,-2.0,-25,-22,0.04209950961734599,-25.732313439736004
919,919,2018,3,NCAAF_20180915_ALAM@CINCY,Alabama A&M,,Cincinnati,,1-2,3-0,,0,42,7,63,0,0,7,0,28,14,14,7,-2.0,-42,-56,0.003188220309718659,-40.64787551283405
920,920,2018,3,NCAAF_20180915_ARKST@TULSA,Arkansas St.,Red Wolves,Tulsa,Golden Hurricane,2-1,1-2,0.0,13,7,29,20,3,10,14,2,7,0,3,10,1.0,6,9,0.5475654081668334,1.7809200886638905
921,921,2018,3,NCAAF_20180915_BAMA@MISS,Alabama,Crimson Tide,Ole Miss,Rebels,3-0,2-1,0.0,49,7,62,7,28,21,10,3,7,0,0,0,1.0,42,55,0.9841036938404438,31.993675910570346
922,922,2018,3,NCAAF_20180915_DEST@WMICH,Delaware St.,,W. Michigan,,0-3,1-2,,0,28,0,68,0,0,0,0,14,14,16,24,-1.0,-28,-68,0.004413696475930817,-39.02211124802744
923,923,2018,3,NCAAF_20180915_OREGST@NEVADA,Oregon State,,Nevada,,1-2,2-1,,21,30,35,37,7,14,0,14,16,14,0,7,-1.0,-9,-2,0.3402022563090503,-6.13810050138386
924,924,2018,3,NCAAF_20180915_TXSTSM@SALA,Texas St.,,South Alabama,,1-2,1-2,,24,16,31,41,17,7,7,0,3,13,7,18,0.0,8,-10,0.24263687765040487,-10.39895607086055
925,925,2018,3,NCAAF_20180915_AKRON@NWEST,Akron,,Northwestern,,2-0,1-2,,3,21,39,34,0,3,23,13,7,14,7,6,1.0,-18,5,0.04585068673067316,-25.131261072113432
926,926,2018,3,NCAAF_20180915_LALAF@MISSST,Louisiana,Ragin' Cajuns,Miss. State,Bulldogs,1-1,3-0,0.0,3,35,10,56,3,0,0,7,14,21,14,7,-2.0,-32,-46,0.003263167373028897,-40.533519932410854
927,927,2018,3,NCAAF_20180915_LAMON@TXAM,UL-Monroe,,Texas A&M,,2-1,2-1,,10,24,10,48,3,7,0,0,7,17,10,14,0.0,-14,-38,0.06470081549369855,-22.597635270270757
928,928,2018,3,NCAAF_20180915_MA@FIU,UMass,,FIU,,1-3,2-1,,10,42,24,63,7,3,14,0,14,28,14,7,-1.0,-32,-39,0.4528749019133075,-1.764356601445968
929,929,2018,3,NCAAF_20180915_MIZZOU@PURDUE,Missouri,,Purdue,,3-0,0-3,,27,24,40,37,13,14,10,3,7,17,3,10,3.0,3,3,0.42297707137311047,-2.8951137689953157
930,930,2018,3,NCAAF_20180915_NOIOWA@IOWA,Northern Iowa,,Iowa,,0-2,3-0,,0,21,14,38,0,0,0,14,7,14,17,0,-3.0,-21,-24,0.06895374701770196,-22.108311486163075
931,931,2018,3,NCAAF_20180915_WKY@LVILLE,W. Kentucky,,Louisville,,0-3,2-1,,14,3,17,20,7,7,0,3,0,3,3,14,-2.0,11,-3,0.017991774677647343,-31.250162859754596
932,932,2018,3,NCAAF_20180915_EWASH@WASHST,E. Washington,,Washington St.,,2-1,3-0,,10,28,24,59,0,10,14,0,14,14,7,24,-1.0,-18,-35,0.0017303820672970316,-43.56516354226943
933,933,2018,3,NCAAF_20180915_NMEX@NMEXST,New Mexico,,New Mexico St.,,2-1,0-4,,21,17,42,25,7,14,7,14,17,0,0,8,2.0,4,17,0.5527863705090847,1.9774946696459779
934,934,2018,3,NCAAF_20180915_OHIOST@TCU,Ohio State,Buckeyes,TCU,Horned Frogs,3-0,2-1,0.0,13,14,40,28,10,3,20,7,7,7,14,0,1.0,-1,12,0.7685184911356782,10.937362166317769
935,935,2018,3,NCAAF_20180915_USC@TEXAS,USC,Trojans,Texas,Longhorns,1-2,2-1,0.0,14,16,14,37,14,0,0,0,3,13,21,0,-1.0,-2,-23,0.47462271990781324,-0.9485464629864282
936,936,2018,3,NCAAF_20180915_PRARIE@UNLV,Prairie View,,UNLV,,1-3,2-1,,0,34,17,46,0,0,14,3,20,14,0,12,-1.0,-34,-29,,
937,937,2018,3,NCAAF_20180915_WASH@UTAH,Washington,Huskies,Utah,Utes,1-1,2-0,0.0,14,7,21,7,7,7,7,0,7,0,0,0,-1.0,7,14,0.838396112083919,14.72101859784948
938,938,2018,3,NCAAF_20180915_ARIZST@SDGST,Arizona St.,Sun Devils,San Diego St.,Aztecs,2-0,1-1,0.0,14,14,21,28,7,7,0,7,0,14,3,11,1.0,0,-7,0.5443968118898611,1.6617723174203434
939,939,2018,3,NCAAF_20180915_FRESNO@UCLA,Fresno St.,,UCLA,,2-1,0-3,,16,7,38,14,13,3,15,7,0,7,7,0,2.0,9,24,0.49286203532180595,-0.26663545556573354
940,940,2018,3,NCAAF_20180915_SUT@ARIZ,So. Utah,,Arizona,,0-3,1-2,,17,24,31,62,0,17,0,14,7,17,24,14,-1.0,-7,-31,0.0008486810247643195,-46.77042697834651
941,941,2018,3,NCAAF_20180914_GAST@MEMP,Georgia St.,Panthers,Memphis,Tigers,1-2,2-1,0.0,10,38,22,59,3,7,6,6,21,17,7,14,-1.0,-28,-37,0.021378891506784292,-30.19148564690613
942,942,2018,3,NCAAF_20180913_ODU@CHARLO,Old Dominion,Monarchs,Charlotte,49ers,0-3,2-1,0.0,12,13,25,28,6,6,6,7,7,6,8,7,-2.0,-1,-3,0.7105536108345687,8.270381292876777
943,943,2018,3,NCAAF_20180913_BC@WAKE,Boston College,Eagles,Wake Forest,Demon Deacons,3-0,2-1,0.0,21,21,41,34,7,14,7,13,7,14,3,10,1.0,0,7,0.47258173783176893,-1.024949768160809
944,944,2018,3,NCAAF_20180913_TNTECH@UTAHST,Tenn. Tech,Golden Eagles,Utah St.,Aggies,0-3,2-1,0.0,6,45,12,73,3,3,3,3,17,28,7,21,-2.0,-39,-61,0.0012435411747713232,-45.075718674777534
945,945,2018,3,NCAAF_20180912_CSTCAR@CAMP,C. Carolina,,Campbell,,2-1,2-1,,24,21,58,21,7,17,21,13,14,7,0,0,0.0,3,37,,
946,946,2018,4,NCAAF_20180923_DUQ@HAWAII,Duquesne,,Hawaii,,3-2,4-1,,14,21,21,42,14,0,0,7,7,14,7,14,-1.0,-7,-21,,
947,947,2018,4,NCAAF_20180922_AKRON@IOWAST,Akron,,Iowa St.,,2-1,1-2,,10,17,13,26,7,3,3,0,7,10,0,9,1.0,-7,-13,0.03298757095358351,-27.605221222451632
948,948,2018,4,NCAAF_20180922_BC@PURDUE,Boston College,Eagles,Purdue,Boilermakers,3-1,1-3,0.0,7,23,13,30,7,0,0,6,7,16,7,0,2.0,-16,-17,0.554841205655047,2.0705104512744583
949,949,2018,4,NCAAF_20180922_BUFF@RUT,Buffalo,,Rutgers,,4-0,1-3,,35,6,42,13,14,21,0,7,3,3,0,7,3.0,29,29,0.6447082321127571,5.571402157359671
950,950,2018,4,NCAAF_20180922_KENTST@MISS,Kent St.,,Ole Miss,,1-3,3-1,,7,7,17,38,0,7,10,0,7,0,17,14,-2.0,0,-21,0.056727473755603275,-23.76546723625563
951,951,2018,4,NCAAF_20180922_MINN@MD,Minnesota,Golden Gophers,Maryland,Terrapins,3-1,3-1,0.0,10,21,13,42,0,10,3,0,14,7,14,7,0.0,-11,-29,0.6783722153404192,6.953910386286793
952,952,2018,4,NCAAF_20180922_NAVY@SMU,Navy,,SMU,,2-2,1-3,,7,10,30,31,0,7,7,16,7,3,7,14,1.0,-3,-1,0.5691967630298175,2.6174401617696503
953,953,2018,4,NCAAF_20180922_ND@WAKE,Notre Dame,Fighting Irish,Wake Forest,Demon Deacons,4-0,2-2,0.0,28,13,56,27,7,21,21,7,3,10,7,7,2.0,15,29,0.64685365758517,5.657993842107317
954,954,2018,4,NCAAF_20180922_NEB@MICH,Nebraska,Cornhuskers,Michigan,Wolverines,0-3,3-1,0.0,0,39,10,56,0,0,3,7,20,19,10,7,-3.0,-39,-46,0.08896189478669636,-20.226924122861305
955,955,2018,4,NCAAF_20180922_NEVADA@TOLEDO,Nevada,Wolf Pack,Toledo,Rockets,2-2,2-1,0.0,24,35,44,63,7,17,14,6,14,21,14,14,0.0,-11,-19,0.13758667743752429,-16.384022415379263
956,956,2018,4,NCAAF_20180922_OHIO@CINCY,Ohio,,Cincinnati,,1-2,4-0,,24,7,30,34,14,10,3,3,0,7,14,13,-3.0,17,-4,0.7671219699954509,10.951470403828694
957,957,2018,4,NCAAF_20180922_UGA@MIZZOU,Georgia,Bulldogs,Missouri,Tigers,4-0,3-1,0.0,20,7,43,29,7,13,13,10,7,0,15,7,1.0,13,14,0.9126761739376789,20.3807485996349
958,958,2018,4,NCAAF_20180922_PITT@UNC,Pittsburgh,Panthers,North Carolina,Tar Heels,2-2,1-2,0.0,28,21,35,38,7,21,0,7,7,14,17,0,1.0,7,-3,0.7480525246249464,10.035181355281566
959,959,2018,4,NCAAF_20180922_LVILLE@UVA,Louisville,,Virginia,,2-2,3-1,,0,6,3,27,0,0,3,0,0,6,7,14,-1.0,-6,-24,0.7025140541669685,7.982289523862619
960,960,2018,4,NCAAF_20180922_WMICH@GAST,W. Michigan,,Georgia St.,,2-2,1-3,,20,9,34,15,3,17,14,0,0,9,6,0,1.0,11,19,0.8096507022181605,13.161702832269157
961,961,2018,4,NCAAF_20180922_ILST@COLOST,Illinois St.,,Colorado St.,,3-0,1-4,,14,6,35,19,0,14,7,14,6,0,7,6,2.0,8,16,,
962,962,2018,4,NCAAF_20180922_ME@CMICH,Maine,,C. Michigan,,2-1,1-3,,0,10,5,17,0,0,3,2,0,10,0,7,1.0,-10,-12,0.15640671594420896,-15.154499070072234
963,963,2018,4,NCAAF_20180922_MIAOH@BGREEN,Miami-OH,,Bowling Green,,1-3,1-3,,24,3,38,23,7,17,7,7,0,3,0,20,0.0,21,15,0.649236055804253,5.75437116647845
964,964,2018,4,NCAAF_20180922_WKY@BALLST,W. Kentucky,,Ball St.,,1-3,1-3,,7,10,28,20,0,7,7,14,7,3,3,7,0.0,-3,8,0.8318996945348971,14.439265399799524
965,965,2018,4,NCAAF_20180922_CHARLO@MA,Charlotte,,UMass,,2-2,2-3,,10,35,31,49,0,10,7,14,28,7,7,7,0.0,-25,-18,0.18992768204098964,-13.185019899203326
966,966,2018,4,NCAAF_20180922_CLEM@GATECH,Clemson,Tigers,Georgia Tech,Yellow Jackets,4-0,1-3,0.0,28,7,49,21,7,21,14,7,0,7,7,7,3.0,21,28,0.8730000305943504,17.126651936269923
967,967,2018,4,NCAAF_20180922_FIU@MIAMI,FIU,Panthers,Miami (Fla.),Hurricanes,2-2,3-1,0.0,0,24,17,31,0,0,0,17,7,17,7,0,-1.0,-24,-14,0.03411833969278377,-27.377726013701817
968,968,2018,4,NCAAF_20180922_GRDWB@APLST,Gardner-Webb,,App. St.,,1-3,2-1,,7,52,7,72,7,0,0,0,28,24,14,6,-1.0,-45,-65,0.02971707862548656,-28.30151771369526
969,969,2018,4,NCAAF_20180922_KANSAS@BAYLOR,Kansas,,Baylor,,2-2,3-1,,0,23,7,26,0,0,7,0,7,16,3,0,-1.0,-23,-19,0.27677773712197773,-8.895096781497728
970,970,2018,4,NCAAF_20180922_KSTATE@WVU,Kansas State,Wildcats,West Virginia,Mountaineers,2-2,3-0,0.0,0,21,6,35,0,0,3,3,7,14,14,0,-1.0,-21,-29,0.4773645795091408,-0.8523490113012713
971,971,2018,4,NCAAF_20180922_NCCEN@DUKE,NC Central,,Duke,,1-2,4-0,,13,27,13,55,7,6,0,0,20,7,21,7,-3.0,-14,-42,0.00020780905879669298,-52.99999999999807
972,972,2018,4,NCAAF_20180922_NILL@FSU,N. Illinois,,Florida State,,1-3,2-2,,7,20,19,37,0,7,6,6,14,6,3,14,-1.0,-13,-18,0.31257572660715727,-7.335435274473184
973,973,2018,4,NCAAF_20180922_TULANE@OHIOST,Tulane,Green Wave,Ohio State,Buckeyes,1-3,4-0,0.0,6,42,6,49,0,6,0,0,21,21,0,7,-3.0,-36,-43,0.010649836529401768,-34.57242871070957
974,974,2018,4,NCAAF_20180922_TXAM@BAMA,Texas A&M,Aggies,Alabama,Crimson Tide,2-2,4-0,0.0,13,31,23,45,7,6,3,7,14,17,14,0,-2.0,-18,-22,0.04478831332366995,-25.488843169477832
975,975,2018,4,NCAAF_20180922_VATECH@ODU,Virginia Tech,Hokies,Old Dominion,Monarchs,2-1,1-3,0.0,14,14,35,49,7,7,14,7,7,7,7,28,1.0,0,-14,0.997631821251873,42.407026866803335
976,976,2018,4,NCAAF_20180922_ARIZ@OREGST,Arizona,,Oregon State,,2-2,1-3,,14,7,35,14,7,7,7,14,7,0,0,7,1.0,7,21,0.905887532947147,19.756572183557637
977,977,2018,4,NCAAF_20180922_SC@VANDY,South Carolina,Gamecocks,Vanderbilt,Commodores,2-1,2-2,0.0,20,14,37,14,10,10,10,7,0,14,0,0,0.0,6,23,0.761859850963286,10.694671074543407
978,978,2018,4,NCAAF_20180922_UCONN@CUSE,UConn,,Syracuse,,1-3,4-0,,14,31,21,51,7,7,0,7,24,7,10,10,-3.0,-17,-30,0.09686654297332664,-19.51283314675311
979,979,2018,4,NCAAF_20180922_TCU@TEXAS,TCU,Horned Frogs,Texas,Longhorns,2-2,3-1,0.0,13,10,16,31,6,7,3,0,7,3,14,7,-1.0,3,-15,0.6887722949323978,7.392652841919357
980,980,2018,4,NCAAF_20180922_MCN@BYU,McNeese St.,Cowboys,BYU,Cougars,3-1,3-1,0.0,3,24,3,30,3,0,0,0,0,24,6,0,0.0,-21,-27,,
981,981,2018,4,NCAAF_20180922_NTEXAS@LIB,North Texas,,Liberty,,4-0,1-2,,21,7,47,7,14,7,6,20,0,7,0,0,3.0,14,40,0.5731121136556331,2.767184462207524
982,982,2018,4,NCAAF_20180922_CSTCAR@LALAF,C. Carolina,,Louisiana,,3-1,1-2,,16,7,30,28,3,13,7,7,7,0,14,7,2.0,9,2,0.6129731040669208,4.31025826555765
983,983,2018,4,NCAAF_20180922_FLA@TENN,Florida,Gators,Tennessee,Volunteers,3-1,2-2,0.0,26,3,47,21,14,12,7,14,0,3,10,8,1.0,23,26,0.7423155838164658,9.766827750102152
984,984,2018,4,NCAAF_20180922_LATECH@LSU,Louisiana Tech,Bulldogs,LSU,Tigers,2-1,4-0,0.0,7,24,21,38,0,7,7,7,7,17,0,14,-2.0,-17,-17,0.0539084478633165,-24.144284172261564
985,985,2018,4,NCAAF_20180922_MISSST@UK,Miss. State,Bulldogs,Kentucky,Wildcats,3-1,4-0,0.0,7,7,7,28,0,7,0,0,0,7,7,14,-1.0,0,-21,0.8576079400632113,16.05982874740289
986,986,2018,4,NCAAF_20180922_NCST@MRSHL,NC State,,Marshall,,3-0,2-1,,23,7,37,20,3,20,14,0,0,7,13,0,1.0,16,17,0.8692058296264291,16.85575256977245
987,987,2018,4,NCAAF_20180922_RICE@USM,Rice,,So. Miss,,1-3,2-1,,15,24,22,40,8,7,0,7,10,14,10,6,-1.0,-9,-18,0.1314856292130845,-16.806971869735435
988,988,2018,4,NCAAF_20180922_TROY@LAMON,Troy,,UL-Monroe,,3-1,2-2,,35,7,35,27,7,28,0,0,7,0,7,13,1.0,28,8,0.8527783555822723,15.741376524097745
989,989,2018,4,NCAAF_20180922_TXSTSM@TXSA,Texas St.,,UTSA,,1-3,1-3,,7,17,21,25,7,0,7,7,14,3,0,8,0.0,-10,-4,0.12257450325665031,-17.44983899409351
990,990,2018,4,NCAAF_20180922_TXTECH@OKLAST,Texas Tech,Red Raiders,Oklahoma State,Cowboys,3-1,3-1,0.0,24,17,41,17,7,17,10,7,10,7,0,0,0.0,7,24,0.2177045143815518,-11.710708552116557
991,991,2018,4,NCAAF_20180922_UNLV@ARKST,UNLV,,Arkansas St.,,2-2,3-1,,7,13,20,27,7,0,13,0,6,7,6,8,-1.0,-6,-7,0.3496308536666517,-5.800292199423893
992,992,2018,4,NCAAF_20180922_ARK@AUBURN,Arkansas,Razorbacks,Auburn,Tigers,1-3,3-1,0.0,0,17,3,34,0,0,3,0,10,7,7,10,-2.0,-17,-31,0.01538517489368052,-32.431386700484495
993,993,2018,4,NCAAF_20180922_MICHST@IND,Michigan St.,Spartans,Indiana,Hoosiers,2-1,3-1,0.0,21,7,35,21,14,7,7,7,0,7,0,14,-1.0,14,14,0.6437412520816668,5.532434475536888
994,994,2018,4,NCAAF_20180922_NMEXST@UTEP,New Mexico St.,,UTEP,,1-4,0-4,,17,10,27,20,10,7,7,3,7,3,7,3,1.0,7,7,0.8429879026567859,15.116629262128072
995,995,2018,4,NCAAF_20180922_ECU@SFLA,East Carolina,,South Florida,,1-2,4-0,,10,13,13,20,7,3,3,0,6,7,0,7,-3.0,-3,-7,0.05712220468781748,-23.713616362444554
996,996,2018,4,NCAAF_20180922_SALA@MEMP,South Alabama,,Memphis,,1-3,3-1,,21,21,35,52,7,14,6,8,7,14,10,21,-2.0,0,-17,0.017156801433559132,-31.77581746154806
997,997,2018,4,NCAAF_20180922_TXSO@HOU,Texas Southern,,Houston,,1-3,3-1,,0,42,14,70,0,0,7,7,14,28,7,21,-2.0,-42,-56,0.0003060019242641099,-51.44264270215956
998,998,2018,4,NCAAF_20180922_WISC@IOWA,Wisconsin,Badgers,Iowa,Hawkeyes,3-1,3-1,0.0,7,7,28,17,0,7,7,14,0,7,10,0,0.0,0,11,0.5897955492380567,3.4085377805104144
999,999,2018,4,NCAAF_20180922_AF@UTAHST,Air Force,,Utah St.,,1-2,3-1,,14,21,32,42,0,14,3,15,7,14,14,7,-2.0,-7,-10,0.30808683396335146,-7.526388388446776
1000,1000,2018,4,NCAAF_20180922_ARIZST@WASH,Arizona St.,Sun Devils,Washington,Huskies,2-2,3-1,0.0,10,17,20,27,10,0,3,7,14,3,3,7,-1.0,-7,-7,0.13363156283805333,-16.656699238642318
1001,1001,2018,4,NCAAF_20180921_FAU@UCF,FAU,Owls,UCF,Knights,2-2,3-0,0.0,17,21,36,56,7,10,6,13,14,7,21,14,-1.0,-4,-20,0.14828315458146757,-15.672327004671502
1002,1002,2018,4,NCAAF_20180921_PSU@ILL,Penn State,Nittany Lions,Illinois,Fighting Illini,4-0,2-2,0.0,21,17,63,24,7,14,7,35,7,10,7,0,2.0,4,39,0.9963905392404031,40.33707063520035
1003,1003,2018,4,NCAAF_20180921_WASHST@USC,Washington St.,Cougars,USC,Trojans,3-1,2-2,0.0,24,17,36,39,3,21,6,6,7,10,7,15,1.0,7,-3,0.4249544080277534,-2.8412319059666515
1004,1004,2018,4,NCAAF_20180920_TULSA@TEMPLE,Tulsa,Golden Hurricane,Temple,Owls,1-3,2-2,0.0,10,21,17,31,7,3,0,7,7,14,7,3,-1.0,-11,-14,0.38389896024081893,-4.433076794767203
1005,1005,2018,5,NCAAF_20180929_ARK@TXAM,Arkansas,,Texas A&M,,1-4,3-2,,7,17,17,24,0,7,3,7,14,3,0,7,-2.0,-10,-7,0.14567190738634617,-15.915194523038167
1006,1006,2018,5,NCAAF_20180929_ARMY@BUFF,Army,Black Knights,Buffalo,Bulls,3-2,4-1,0.0,21,7,42,13,7,14,7,14,7,0,6,0,-1.0,14,29,0.5470851237103553,1.7843162011385516
1007,1007,2018,5,NCAAF_20180929_BGREEN@GATECH,Bowling Green,,Georgia Tech,,1-4,2-3,,10,28,17,63,3,7,7,0,14,14,21,14,-1.0,-18,-46,0.046969857280845684,-25.26351009775459
1008,1008,2018,5,NCAAF_20180929_CMICH@MICHST,C. Michigan,Chippewas,Michigan St.,Spartans,1-4,3-1,0.0,3,17,20,31,3,0,0,17,0,17,14,0,-2.0,-14,-11,0.107864271224,-18.672177241342013
1009,1009,2018,5,NCAAF_20180929_CUSE@CLEM,Syracuse,Orange,Clemson,Tigers,4-1,5-0,0.0,16,7,23,27,6,10,0,7,7,0,6,14,-1.0,9,-4,0.06108754788534132,-23.313828088751563
1010,1010,2018,5,NCAAF_20180929_IND@RUT,Indiana,,Rutgers,,4-1,1-4,,24,7,24,17,7,17,0,0,7,0,0,10,3.0,17,7,0.8692590885734893,16.93657219091125
1011,1011,2018,5,NCAAF_20180929_LALAF@BAMA,Louisiana,Ragin' Cajuns,Alabama,Crimson Tide,1-3,5-0,0.0,0,49,14,56,0,0,0,14,28,21,7,0,-4.0,-49,-42,5.291054855638411e-05,-58.474189246062
1012,1012,2018,5,NCAAF_20180929_OKLAST@KANSAS,Oklahoma State,Cowboys,Kansas,Jayhawks,4-1,2-3,0.0,24,7,48,28,14,10,10,14,0,7,7,14,2.0,17,20,0.9857986552032151,33.05697285682214
1013,1013,2018,5,NCAAF_20180929_TEMPLE@BC,Temple,,Boston College,,2-3,4-1,,21,31,35,45,14,7,7,7,13,18,7,7,-2.0,-10,-10,0.21458057067731373,-11.924997026258552
1014,1014,2018,5,NCAAF_20180929_WVU@TXTECH,West Virginia,Mountaineers,Texas Tech,Red Raiders,4-0,3-2,0.0,35,10,42,34,28,7,0,7,7,3,7,17,1.0,25,8,0.41512373240216727,-3.2335448740830657
1015,1015,2018,5,NCAAF_20180929_UVA@NCST,Virginia,,NC State,,3-2,4-0,,7,20,21,35,7,0,7,7,3,17,7,8,-1.0,-13,-14,0.2927372347893614,-8.22632488286331
1016,1016,2018,5,NCAAF_20180929_LAMON@GAST,UL-Monroe,,Georgia St.,,2-3,2-3,,14,30,14,46,7,7,0,0,14,16,6,10,0.0,-16,-32,0.5931460914468333,3.554226894148826
1017,1017,2018,5,NCAAF_20180929_MA@OHIO,UMass,,Ohio,,2-4,2-2,,28,35,42,58,21,7,7,7,14,21,17,6,0.0,-7,-16,0.16071639466832055,-14.95500816347834
1018,1018,2018,5,NCAAF_20180929_KENTST@BALLST,Kent St.,,Ball St.,,1-4,2-3,,17,35,24,52,7,10,7,0,21,14,7,10,-1.0,-18,-28,0.6210904084588759,4.6507632210320935
1019,1019,2018,5,NCAAF_20180929_BAYLOR@OKLA,Baylor,Bears,Oklahoma,Sooners,3-2,5-0,0.0,9,28,33,66,6,3,14,10,14,14,21,17,-2.0,-19,-33,0.020708625658181323,-30.7590782925227
1020,1020,2018,5,NCAAF_20180929_CINCY@UCONN,Cincinnati,Bearcats,UConn,Huskies,5-0,1-4,0.0,21,7,49,7,7,14,21,7,7,0,0,0,4.0,14,42,0.6880811760776774,7.396957876884358
1021,1021,2018,5,NCAAF_20180929_CSTCAR@TROY,C. Carolina,,Troy,,3-2,4-1,,14,24,21,45,0,14,7,0,21,3,14,7,-1.0,-10,-24,0.10029879233665806,-19.303919484206517
1022,1022,2018,5,NCAAF_20180929_FSU@LVILLE,Florida State,,Louisville,,3-2,2-3,,7,21,28,24,7,0,7,14,7,14,3,0,1.0,-14,4,0.4969216521689972,-0.11638528100513668
1023,1023,2018,5,NCAAF_20180929_ODU@ECU,Old Dominion,,East Carolina,,1-4,2-2,,20,21,35,37,14,6,7,8,14,7,7,9,-1.0,-1,-2,0.35192116665962525,-5.7336133803952976
1024,1024,2018,5,NCAAF_20180929_PITT@UCF,Pittsburgh,Panthers,UCF,Knights,2-3,4-0,0.0,7,31,14,45,7,0,0,7,14,17,7,7,-2.0,-24,-31,0.09920958946049141,-19.39769848348027
1025,1025,2018,5,NCAAF_20180929_PURDUE@NEB,Purdue,,Nebraska,,2-3,0-4,,20,7,42,28,10,10,15,7,7,0,14,7,2.0,13,14,0.840863105033865,15.052951552711363
1026,1026,2018,5,NCAAF_20180929_RICE@WAKE,Rice,,Wake Forest,,1-4,3-2,,3,42,24,56,0,3,14,7,21,21,14,0,-2.0,-39,-32,0.006300969667031198,-37.62930082501964
1027,1027,2018,5,NCAAF_20180929_SALA@APLST,South Alabama,,App. St.,,1-4,3-1,,7,42,7,52,7,0,0,0,21,21,3,7,-2.0,-35,-45,0.11850006184382089,-17.835856995481038
1028,1028,2018,5,NCAAF_20180929_TENN@UGA,Tennessee,Volunteers,Georgia,Bulldogs,2-3,5-0,0.0,0,17,12,38,0,0,6,6,7,10,7,14,-3.0,-17,-26,0.006590377577610718,-37.38832250199124
1029,1029,2018,5,NCAAF_20180929_TEXAS@KSTATE,Texas,Longhorns,Kansas State,Wildcats,4-1,2-3,0.0,19,0,19,14,7,12,0,0,0,0,7,7,2.0,19,5,0.7646180726947334,10.87837391954946
1030,1030,2018,5,NCAAF_20180929_WMICH@MIAOH,W. Michigan,,Miami-OH,,3-2,1-4,,14,27,40,39,14,0,13,13,17,10,6,6,2.0,-13,1,0.6516962641931126,5.880901598679316
1031,1031,2018,5,NCAAF_20180929_NEVADA@AF,Nevada,,Air Force,,3-2,1-3,,21,7,28,25,7,14,7,0,0,7,10,8,2.0,14,3,0.3526057127969745,-5.705803072054323
1032,1032,2018,5,NCAAF_20180929_TNST@VANDY,Tennessee St.,,Vanderbilt,,2-1,3-2,,13,10,27,31,0,13,7,7,0,10,14,7,-1.0,3,-4,0.2890970353712874,-8.386487307060008
1033,1033,2018,5,NCAAF_20180929_USM@AUBURN,So. Miss,Golden Eagles,Auburn,Tigers,2-2,4-1,0.0,3,14,13,24,0,3,3,7,7,7,7,3,-2.0,-11,-11,0.008420668540753073,-36.05055036988574
1034,1034,2018,5,NCAAF_20180929_MICH@NWEST,Michigan,Wolverines,Northwestern,Wildcats,4-1,1-3,0.0,7,17,20,17,0,7,6,7,10,7,0,0,3.0,-10,3,0.7386659839758074,9.641593026535645
1035,1035,2018,5,NCAAF_20180929_ARKST@GAS,Arkansas St.,,Ga. Southern,,3-2,3-1,,3,7,21,28,0,3,11,7,0,7,7,14,0.0,-4,-7,0.8018897699762504,12.796228532558303
1036,1036,2018,5,NCAAF_20180929_FLA@MISSST,Florida,Gators,Miss. State,Bulldogs,4-1,3-2,0.0,3,6,13,6,0,3,7,3,3,3,0,0,1.0,-3,7,0.2575040969822717,-9.819891438790705
1037,1037,2018,5,NCAAF_20180929_LIB@NMEX,Liberty,,New Mexico,,2-2,2-2,,42,10,52,43,21,21,0,10,7,3,13,20,0.0,32,9,0.28198637441677066,-8.702115472295645
1038,1038,2018,5,NCAAF_20180929_UTAH@WASHST,Utah,,Washington St.,,2-2,4-1,,21,21,24,28,14,7,3,0,7,14,0,7,-2.0,0,-4,0.490909958767784,-0.34369997191754464
1039,1039,2018,5,NCAAF_20180929_BOISE@WYO,Boise St.,Broncos,Wyoming,Cowboys,3-1,2-3,0.0,24,0,34,14,7,17,3,7,0,0,7,7,1.0,24,20,0.8424530609278209,15.152188602489957
1040,1040,2018,5,NCAAF_20180929_CHARLO@UAB,Charlotte,,UAB,,2-3,3-1,,0,21,7,28,0,0,0,7,14,7,0,7,-1.0,-21,-21,0.1551897042683017,-15.300534406001816
1041,1041,2018,5,NCAAF_20180929_FAU@MTSU,FAU,,Middle Tenn.,,2-3,2-2,,21,10,24,25,14,7,3,0,0,10,7,8,0.0,11,-1,0.854063663534412,15.897760706141526
1042,1042,2018,5,NCAAF_20180929_HOUBP@SMU,Houston Christian,,SMU,,1-3,2-3,,10,35,27,63,3,7,10,7,21,14,14,14,-1.0,-25,-36,0.003791091126542745,-40.273426032308805
1043,1043,2018,5,NCAAF_20180929_IOWAST@TCU,Iowa St.,,TCU,,1-3,3-2,,7,7,14,17,0,7,0,7,0,7,7,3,-2.0,0,-3,0.3911200999730936,-4.168938683273609
1044,1044,2018,5,NCAAF_20180929_UTEP@TXSA,UTEP,,UTSA,,0-5,2-3,,7,24,21,30,7,0,7,7,7,17,0,6,-2.0,-17,-9,0.09641999346851038,-19.641364734450974
1045,1045,2018,5,NCAAF_20180929_VATECH@DUKE,Virginia Tech,Hokies,Duke,Blue Devils,3-1,4-1,0.0,17,7,31,14,3,14,7,7,7,0,0,7,-1.0,10,17,0.6710570023924067,6.67923663621815
1046,1046,2018,5,NCAAF_20180929_ARPB@FIU,Ark.-Pine Bluff,,FIU,,1-4,3-2,,3,38,9,55,3,0,3,3,17,21,17,0,-2.0,-35,-46,0.00130171538474666,-45.41555025887425
1047,1047,2018,5,NCAAF_20180929_LATECH@NTEXAS,Louisiana Tech,,North Texas,,3-1,4-1,,26,21,29,27,6,20,3,0,21,0,6,0,-1.0,5,2,0.4196677904421515,-3.05796774937329
1048,1048,2018,5,NCAAF_20180929_MRSHL@WKY,Marshall,,W. Kentucky,,3-1,1-4,,10,10,20,17,7,3,0,10,3,7,0,7,2.0,0,3,0.7614785334787251,10.724978673950773
1049,1049,2018,5,NCAAF_20180929_OHIOST@PSU,Ohio State,Buckeyes,Penn State,Nittany Lions,5-0,4-1,0.0,7,13,27,26,0,7,7,13,3,10,0,13,1.0,-6,1,0.4961652961646078,-0.14498216309476675
1050,1050,2018,5,NCAAF_20180929_SC@UK,South Carolina,Gamecocks,Kentucky,Wildcats,2-2,5-0,0.0,3,24,10,24,3,0,7,0,3,21,0,0,-3.0,-21,-14,0.641450284249977,5.46512451676881
1051,1051,2018,5,NCAAF_20180929_STNFRD@ND,Stanford,Cardinal,Notre Dame,Fighting Irish,4-1,5-0,0.0,14,21,17,38,7,7,3,0,14,7,3,14,-1.0,-7,-21,0.37281028589782195,-4.893198968111562
1052,1052,2018,5,NCAAF_20180929_BYU@WASH,BYU,Cougars,Washington,Huskies,3-2,4-1,0.0,0,21,7,35,0,0,0,7,7,14,14,0,-1.0,-21,-28,0.03240492385777416,-27.851674653473196
1053,1053,2018,5,NCAAF_20180929_MISS@LSU,Ole Miss,Rebels,LSU,Tigers,3-2,5-0,0.0,6,28,16,45,3,3,7,3,14,14,7,10,-2.0,-22,-29,0.17592064187542156,-14.042579154478119
1054,1054,2018,5,NCAAF_20180929_OREGST@ARIZST,Oregon State,,Arizona St.,,1-4,1-2,,17,31,24,52,0,17,7,0,10,21,7,14,0.0,-14,-28,0.05422755939620849,-24.210777258912685
1055,1055,2018,5,NCAAF_20180929_OREG@CAL,Oregon,Ducks,California,Golden Bears,4-1,3-1,0.0,28,10,42,24,7,21,7,7,3,7,7,7,1.0,18,18,0.6546409287938252,6.001212096724657
1056,1056,2018,5,NCAAF_20180929_TOLEDO@FRESNO,Toledo,,Fresno St.,,2-2,3-1,,13,28,27,49,7,6,0,14,7,21,21,0,-1.0,-15,-22,0.4942495516392895,-0.21741665356643125
1057,1057,2018,5,NCAAF_20180929_USC@ARIZ,USC,,Arizona,,3-2,2-3,,17,0,24,20,7,10,7,0,0,0,7,13,1.0,17,4,0.7259210812052845,9.05765264492203
1058,1058,2018,5,NCAAF_20180928_MEMP@TULANE,Memphis,Tigers,Tulane,Green Wave,3-2,2-3,0.0,7,17,24,40,7,0,7,10,14,3,7,16,1.0,-10,-16,0.8325991702619361,14.547308548805518
1059,1059,2018,5,NCAAF_20180928_UCLA@COLO,UCLA,Bruins,Colorado,Buffaloes,0-4,4-0,0.0,13,14,16,38,10,3,3,0,7,7,14,10,-4.0,-1,-22,0.5768442313281099,2.9234781251698223
1060,1060,2018,5,NCAAF_20180927_UNC@MIAMI,North Carolina,Tar Heels,Miami (Fla.),Hurricanes,1-3,4-1,0.0,10,33,10,47,10,0,0,0,14,19,0,14,-3.0,-23,-37,0.07899715127849305,-21.294846102877557
1061,1061,2018,6,NCAAF_20181007_WYO@HAWAII,Wyoming,,Hawaii,,2-4,6-1,,3,3,13,17,3,0,7,3,0,3,7,7,-4.0,0,-4,0.840106870294735,14.93652553012788
1062,1062,2018,6,NCAAF_20181006_BAMA@ARK,Alabama,Crimson Tide,Arkansas,Razorbacks,6-0,1-5,0.0,41,14,65,31,21,20,7,17,7,7,3,14,5.0,27,34,0.9954351432193091,39.14161827748342
1063,1063,2018,6,NCAAF_20181006_BUFF@CMICH,Buffalo,Bulls,C. Michigan,Chippewas,5-1,1-5,0.0,17,3,34,24,7,10,7,10,3,0,14,7,4.0,14,10,0.5401115719097738,1.5120449448324962
1064,1064,2018,6,NCAAF_20181006_ECU@TEMPLE,East Carolina,,Temple,,2-3,3-3,,3,35,6,49,0,3,0,3,14,21,7,7,-1.0,-32,-43,0.21406994979451044,-11.896087796144514
1065,1065,2018,6,NCAAF_20181006_EMICH@WMICH,E. Michigan,,W. Michigan,,2-4,4-2,,10,14,24,27,0,10,7,7,7,7,0,13,-2.0,-4,-3,0.5271079814601547,1.0209232610496883
1066,1066,2018,6,NCAAF_20181006_ILL@RUT,Illinois,Fighting Illini,Rutgers,Scarlet Knights,3-2,1-5,0.0,24,14,38,17,10,14,0,14,7,7,0,3,2.0,10,21,0.5696010831831197,2.632682900997793
1067,1067,2018,6,NCAAF_20181006_KANSAS@WVU,Kansas,Jayhawks,West Virginia,Mountaineers,2-4,5-0,0.0,7,21,22,38,7,0,7,8,14,7,7,10,-3.0,-14,-16,0.06090572582050158,-23.22854413109593
1068,1068,2018,6,NCAAF_20181006_MD@MICH,Maryland,Terrapins,Michigan,Wolverines,3-2,5-1,0.0,7,17,21,42,7,0,0,14,3,14,10,15,-2.0,-10,-21,0.09082643746552577,-20.052789902415554
1069,1069,2018,6,NCAAF_20181006_MIZZOU@SC,Missouri,Tigers,South Carolina,Gamecocks,3-2,3-2,0.0,23,14,35,37,14,9,0,12,7,7,17,6,0.0,9,-2,0.5669874408364068,2.5328589232848913
1070,1070,2018,6,NCAAF_20181006_NWEST@MICHST,Northwestern,Wildcats,Michigan St.,Spartans,2-3,3-2,0.0,14,6,29,19,7,7,8,7,3,3,13,0,-1.0,8,10,0.4793254210791187,-0.7783815157329741
1071,1071,2018,6,NCAAF_20181006_TEXAS@OKLA,Texas,Longhorns,Oklahoma,Sooners,5-1,5-1,0.0,24,17,48,45,10,14,21,3,7,10,7,21,0.0,7,3,0.21461675355603616,-11.867942269647699
1072,1072,2018,6,NCAAF_20181006_TULANE@CINCY,Tulane,,Cincinnati,,2-4,6-0,,14,24,21,37,7,7,0,7,3,21,6,7,-4.0,-10,-16,0.662319889134801,6.287543469348634
1073,1073,2018,6,NCAAF_20181006_BC@NCST,Boston College,Eagles,NC State,Wolfpack,4-2,5-0,0.0,3,21,23,28,3,0,7,13,7,14,7,0,-1.0,-18,-5,0.4438272613880633,-2.1209458924575983
1074,1074,2018,6,NCAAF_20181006_NILL@BALLST,N. Illinois,,Ball St.,,3-3,2-4,,14,6,24,16,7,7,7,3,0,6,3,7,1.0,8,8,0.9595398247922474,26.203485911361042
1075,1075,2018,6,NCAAF_20181006_BGREEN@TOLEDO,Bowling Green,,Toledo,,1-5,3-2,,21,24,36,52,7,14,7,8,17,7,7,21,-2.0,-3,-16,0.0717588007484149,-21.961460444151896
1076,1076,2018,6,NCAAF_20181006_CLEM@WAKE,Clemson,Tigers,Wake Forest,Demon Deacons,6-0,3-3,0.0,28,0,63,3,7,21,21,14,0,0,3,0,3.0,28,60,0.8483259713790812,15.45272092456156
1077,1077,2018,6,NCAAF_20181006_FSU@MIAMI,Florida State,Seminoles,Miami (Fla.),Hurricanes,3-3,5-1,0.0,20,7,27,28,7,13,7,0,0,7,14,7,-2.0,13,-1,0.2842202357732835,-8.562738167948964
1078,1078,2018,6,NCAAF_20181006_IOWA@MINN,Iowa,Hawkeyes,Minnesota,Golden Gophers,4-1,3-2,0.0,28,17,48,31,14,14,10,10,7,10,7,7,1.0,11,17,0.8729968762669726,17.125069065484638
1079,1079,2018,6,NCAAF_20181006_IOWAST@OKLAST,Iowa St.,Cyclones,Oklahoma State,Cowboys,2-3,4-2,0.0,30,21,48,42,9,21,10,8,7,14,7,14,-2.0,9,6,0.41900391134630666,-3.069320777570624
1080,1080,2018,6,NCAAF_20181006_KSTATE@BAYLOR,Kansas State,,Baylor,,2-4,4-2,,14,12,34,37,7,7,0,20,3,9,8,17,-2.0,2,-3,0.7260133013542985,9.019886785009021
1081,1081,2018,6,NCAAF_20181006_LSU@FLA,LSU,Tigers,Florida,Gators,5-1,5-1,0.0,10,14,19,27,7,3,3,6,0,14,0,13,0.0,-4,-8,0.7012851710877167,7.928442174461736
1082,1082,2018,6,NCAAF_20181006_MIAOH@AKRON,Miami-OH,,Akron,,2-4,2-2,,14,10,41,17,0,14,10,17,0,10,7,0,0.0,4,24,0.4474795945680784,-1.9822102078831563
1083,1083,2018,6,NCAAF_20181006_NAVY@AF,Navy,Midshipmen,Air Force,Falcons,2-3,2-3,0.0,7,14,7,35,0,7,0,0,0,14,14,7,0.0,-7,-28,0.7928225534441735,12.254530590681611
1084,1084,2018,6,NCAAF_20181006_OHIO@KENTST,Ohio,,Kent St.,,3-2,1-5,,7,17,27,26,7,0,7,13,14,3,6,3,2.0,-10,1,0.9533425318224109,25.19451327922434
1085,1085,2018,6,NCAAF_20181006_SALA@GAS,South Alabama,,Ga. Southern,,1-5,4-1,,6,17,13,48,0,6,0,7,7,10,10,21,-3.0,-11,-35,0.3891131568334095,-4.228167059683415
1086,1086,2018,6,NCAAF_20181006_SDGST@BOISE,San Diego St.,,Boise St.,,4-1,3-2,,13,7,19,13,3,10,0,6,7,0,0,6,1.0,6,6,0.3738573744324314,-4.829036333170166
1087,1087,2018,6,NCAAF_20181006_SFLA@MA,South Florida,,UMass,,5-0,2-5,,20,14,58,42,10,10,28,10,7,7,14,14,3.0,6,16,0.9474829915376166,24.335144384801765
1088,1088,2018,6,NCAAF_20181006_ARIZST@COLO,Arizona St.,Sun Devils,Colorado,Buffaloes,3-3,5-0,0.0,14,14,21,28,7,7,7,0,7,7,14,0,-2.0,0,-7,0.6531319209223467,5.912020762514771
1089,1089,2018,6,NCAAF_20181006_IND@OHIOST,Indiana,Hoosiers,Ohio State,Buckeyes,4-2,6-0,0.0,20,28,26,49,3,17,6,0,7,21,7,14,-2.0,-8,-23,0.03521058789720821,-27.161643036245437
1090,1090,2018,6,NCAAF_20181006_LAMON@MISS,UL-Monroe,,Ole Miss,,2-4,4-2,,7,49,21,70,0,7,7,7,21,28,14,7,-2.0,-42,-49,0.15782731350077883,-15.064592343563447
1091,1091,2018,6,NCAAF_20181006_NMEX@UNLV,New Mexico,,UNLV,,3-2,2-3,,29,0,50,14,0,29,7,14,0,0,0,14,1.0,29,36,0.3829473291850055,-4.470147394788341
1092,1092,2018,6,NCAAF_20181006_ODU@FAU,Old Dominion,,FAU,,1-5,3-3,,7,26,33,52,0,7,14,12,6,20,6,20,-2.0,-19,-19,0.05528082822457614,-23.956064161545214
1093,1093,2018,6,NCAAF_20181006_LALAF@TXSTSM,Louisiana,,Texas St.,,2-3,1-4,,28,0,42,27,7,21,7,7,0,0,13,14,1.0,28,15,0.6336407444900112,5.12715880015611
1094,1094,2018,6,NCAAF_20181006_SMU@UCF,SMU,Mustangs,UCF,Knights,2-4,5-0,0.0,10,27,20,48,3,7,3,7,21,6,7,14,-3.0,-17,-28,0.07902133680774037,-21.19381958757981
1095,1095,2018,6,NCAAF_20181006_TXSA@RICE,UTSA,,Rice,,3-3,1-5,,13,0,20,3,3,10,0,7,0,0,3,0,2.0,13,17,0.8179627921965716,13.62635193361848
1096,1096,2018,6,NCAAF_20181006_UAB@LATECH,UAB,,Louisiana Tech,,4-1,3-2,,7,7,28,7,0,7,7,14,7,0,0,0,1.0,0,21,0.3912015852617514,-4.146457392202365
1097,1097,2018,6,NCAAF_20181006_UCONN@MEMP,UConn,Huskies,Memphis,Tigers,1-5,4-2,0.0,14,41,14,55,7,7,0,0,13,28,7,7,-3.0,-27,-41,0.029940214017394884,-28.249809597167598
1098,1098,2018,6,NCAAF_20181006_AUBURN@MISSST,Auburn,Tigers,Miss. State,Bulldogs,4-2,4-2,0.0,3,13,9,23,3,0,3,3,3,10,3,7,0.0,-10,-14,0.7473934163635487,10.003397057138727
1099,1099,2018,6,NCAAF_20181006_NEB@WISC,Nebraska,Cornhuskers,Wisconsin,Badgers,0-5,4-1,0.0,3,20,24,41,0,3,14,7,3,17,14,7,-4.0,-17,-17,0.029376868812158174,-28.375297990498723
1100,1100,2018,6,NCAAF_20181006_NTEXAS@UTEP,North Texas,,UTEP,,5-1,0-6,,10,10,27,24,7,3,10,7,3,7,0,14,5.0,0,3,0.9566172784233798,25.71318302273994
1101,1101,2018,6,NCAAF_20181006_VANDY@UGA,Vanderbilt,Commodores,Georgia,Bulldogs,3-3,6-0,0.0,6,21,13,41,3,3,0,7,7,14,17,3,-3.0,-15,-28,0.014319037055403272,-32.85523925429567
1102,1102,2018,6,NCAAF_20181006_WASH@UCLA,Washington,Huskies,UCLA,Bruins,5-1,0-5,0.0,24,7,31,24,7,17,0,7,0,7,3,14,5.0,17,7,0.9216775172040949,21.265294061407133
1103,1103,2018,6,NCAAF_20181006_LIB@NMEXST,Liberty,,New Mexico St.,,2-3,2-4,,14,21,41,49,7,7,14,13,7,14,14,14,0.0,-7,-8,0.506199405968398,0.23330758770850935
1104,1104,2018,6,NCAAF_20181006_ND@VATECH,Notre Dame,Fighting Irish,Virginia Tech,Hokies,6-0,3-2,0.0,17,16,45,23,10,7,14,14,3,13,0,7,3.0,1,22,0.6043826295185349,3.9740904085228976
1105,1105,2018,6,NCAAF_20181006_WASHST@OREGST,Washington St.,,Oregon State,,5-1,1-5,,28,24,56,37,14,14,7,21,14,10,6,7,4.0,4,19,0.9608009529483947,26.423976556676564
1106,1106,2018,6,NCAAF_20181006_CAL@ARIZ,California,,Arizona,,3-2,3-3,,14,10,17,24,0,14,0,3,10,0,7,7,0.0,4,-7,0.4428281637689624,-2.158928180313012
1107,1107,2018,6,NCAAF_20181006_COLOST@SJST,Colorado St.,Rams,San Jose St.,Spartans,2-4,0-5,0.0,28,0,42,30,14,14,0,14,0,0,30,0,2.0,28,12,0.9463800017211386,24.18200869025071
1108,1108,2018,6,NCAAF_20181006_FRESNO@NEVADA,Fresno St.,,Nevada,,4-1,3-3,,7,3,21,3,0,7,7,7,0,3,0,0,1.0,4,18,0.8817039736897867,17.76876450709858
1109,1109,2018,6,NCAAF_20181006_UTAH@STNFRD,Utah,Utes,Stanford,Cardinal,3-2,4-2,0.0,24,7,40,21,7,17,3,13,0,7,14,0,-1.0,17,19,0.3218095175791309,-6.945747629215191
1110,1110,2018,6,NCAAF_20181005_GATECH@LVILLE,Georgia Tech,Yellow Jackets,Louisville,Cardinals,3-3,2-4,0.0,31,17,66,31,21,10,14,21,0,17,0,14,1.0,14,35,0.5143113910489936,0.5386868022961835
1111,1111,2018,6,NCAAF_20181005_MTSU@MRSHL,Middle Tenn.,Blue Raiders,Marshall,Thundering Herd,3-2,3-2,0.0,10,17,34,24,3,7,14,10,3,14,0,7,0.0,-7,10,0.38953618156897496,-4.211606196295975
1112,1112,2018,6,NCAAF_20181005_UTAHST@BYU,Utah St.,Aggies,BYU,Cougars,4-1,3-3,0.0,21,7,45,20,14,7,14,10,0,7,6,7,1.0,14,25,0.7146970861971756,8.514841649628636
1113,1113,2018,6,NCAAF_20181004_GAST@TROY,Georgia St.,Panthers,Troy,Trojans,2-4,5-1,0.0,3,23,20,37,0,3,3,14,14,9,0,14,-3.0,-20,-17,0.1463574647290835,-15.796586641485192
1114,1114,2018,6,NCAAF_20181004_TULSA@HOU,Tulsa,Golden Hurricane,Houston,Cougars,1-4,4-1,0.0,13,17,26,41,13,0,10,3,7,10,0,24,-3.0,-4,-15,0.16761429533622807,-14.46719259655066
1115,1115,2018,7,NCAAF_20181013_AKRON@BUFF,Akron,Zips,Buffalo,Bulls,2-3,6-1,0.0,6,10,6,24,3,3,0,0,7,3,7,7,-4.0,-4,-18,0.34442661971281974,-6.064990478777986
1116,1116,2018,7,NCAAF_20181013_FLA@VANDY,Florida,Gators,Vanderbilt,Commodores,6-1,3-4,0.0,13,21,37,27,0,13,7,17,7,14,0,6,3.0,-8,10,0.7457349919355557,10.01403334431319
1117,1117,2018,7,NCAAF_20181013_IOWA@IND,Iowa,,Indiana,,5-1,4-3,,21,10,42,16,14,7,14,7,3,7,6,0,1.0,11,26,0.8268980591140935,14.26803094961457
1118,1118,2018,7,NCAAF_20181013_MINN@OHIOST,Minnesota,Golden Gophers,Ohio State,Buckeyes,3-3,7-0,0.0,14,17,14,30,7,7,0,0,10,7,3,10,-4.0,-3,-16,0.029113041658684335,-28.688073405832824
1119,1119,2018,7,NCAAF_20181013_OKLAST@KSTATE,Oklahoma State,Cowboys,Kansas State,Wildcats,4-3,3-4,0.0,6,3,12,31,3,3,0,6,0,3,14,14,1.0,3,-19,0.8072992703005137,13.147297028211824
1120,1120,2018,7,NCAAF_20181013_RUT@MD,Rutgers,,Maryland,,1-6,4-2,,0,24,7,34,0,0,0,7,10,14,10,0,-3.0,-24,-27,0.21880557967927894,-11.757517034468435
1121,1121,2018,7,NCAAF_20181013_TENN@AUBURN,Tennessee,Volunteers,Auburn,Tigers,3-3,4-3,0.0,13,17,30,24,3,10,14,3,10,7,0,7,-1.0,-4,6,0.030613483031030064,-28.352735415176767
1122,1122,2018,7,NCAAF_20181013_TOLEDO@EMICH,Toledo,,E. Michigan,,3-3,3-4,,3,28,26,28,3,0,3,20,21,7,0,0,0.0,-25,-2,0.6656786871855276,6.483042542021451
1123,1123,2018,7,NCAAF_20181013_DUKE@GATECH,Duke,,Georgia Tech,,5-1,3-4,,7,7,28,14,7,0,21,0,0,7,0,7,2.0,0,14,0.4147185782829015,-3.262994360303651
1124,1124,2018,7,NCAAF_20181013_LVILLE@BC,Louisville,,Boston College,,2-5,5-2,,20,24,20,38,13,7,0,0,14,10,0,14,-3.0,-4,-18,0.41773896599526394,-3.1457221205514543
1125,1125,2018,7,NCAAF_20181013_UAB@RICE,UAB,,Rice,,5-1,1-6,,28,0,42,0,14,14,14,0,0,0,0,0,4.0,28,42,0.8540190036511446,15.962198520208858
1126,1126,2018,7,NCAAF_20181013_TROY@LIB,Troy,,Liberty,,5-2,3-3,,10,14,16,22,7,3,3,3,0,14,0,8,2.0,-4,-6,0.8881840859375213,18.432657079638602
1127,1127,2018,7,NCAAF_20181013_USM@NTEXAS,So. Miss,,North Texas,,2-3,6-1,,7,10,7,30,0,7,0,0,0,10,6,14,-4.0,-3,-23,0.4470713862049809,-2.0155046768191482
1128,1128,2018,7,NCAAF_20181013_KENTST@MIAOH,Kent St.,,Miami-OH,,1-6,3-4,,0,21,6,31,0,0,0,6,0,21,10,0,-2.0,-21,-25,0.1392376118796994,-16.415449057571266
1129,1129,2018,7,NCAAF_20181013_PITT@ND,Pittsburgh,Panthers,Notre Dame,Fighting Irish,3-4,7-0,0.0,7,6,14,19,7,0,7,0,0,6,6,7,-4.0,1,-5,0.11543404924767109,-18.147868958540187
1130,1130,2018,7,NCAAF_20181013_BALLST@CMICH,Ball St.,,C. Michigan,,3-4,1-6,,7,20,24,23,0,7,0,17,3,17,0,3,2.0,-13,1,0.10474338409737127,-19.009003694961677
1131,1131,2018,7,NCAAF_20181013_WMICH@BGREEN,W. Michigan,,Bowling Green,,5-2,1-6,,7,21,42,35,0,7,21,14,7,14,7,7,4.0,-14,7,0.8162521224074443,13.649978538727623
1132,1132,2018,7,NCAAF_20181013_ARMY@SJST,Army,,San Jose St.,,4-2,0-6,,14,3,52,3,0,14,24,14,3,0,0,0,4.0,11,49,0.9763989093973231,30.058709555512507
1133,1133,2018,7,NCAAF_20181013_BAYLOR@TEXAS,Baylor,Bears,Texas,Longhorns,4-3,6-1,0.0,10,23,17,23,7,3,7,0,3,20,0,0,-2.0,-13,-6,0.09876802889203429,-19.518322111210352
1134,1134,2018,7,NCAAF_20181013_MICHST@PSU,Michigan St.,Spartans,Penn State,Nittany Lions,4-2,4-2,0.0,7,14,21,17,0,7,7,7,7,7,0,3,0.0,-7,4,0.08416169076184676,-20.866514300404617
1135,1135,2018,7,NCAAF_20181013_MRSHL@ODU,Marshall,,Old Dominion,,4-2,1-6,,14,3,42,20,0,14,7,21,0,3,7,10,3.0,11,22,0.8207260409753014,13.906891140640766
1136,1136,2018,7,NCAAF_20181013_OHIO@NILL,Ohio,,N. Illinois,,3-3,4-3,,7,9,21,24,0,7,14,0,3,6,0,15,-1.0,-2,-3,0.4617978957474026,-1.4526662126756946
1137,1137,2018,7,NCAAF_20181013_PURDUE@ILL,Purdue,,Illinois,,3-3,3-3,,29,7,46,7,14,15,7,10,7,0,0,0,0.0,22,39,0.8785633991623314,17.689064512017183
1138,1138,2018,7,NCAAF_20181013_TEMPLE@NAVY,Temple,Owls,Navy,Midshipmen,4-3,2-4,0.0,7,10,24,17,0,7,10,7,0,10,7,0,2.0,-3,7,0.4496046275497607,-1.9185089717357755
1139,1139,2018,7,NCAAF_20181013_TXAM@SC,Texas A&M,Aggies,South Carolina,Gamecocks,5-2,3-3,0.0,13,0,26,23,3,10,3,10,0,0,16,7,2.0,13,3,0.5023220779275817,0.0881642342850455
1140,1140,2018,7,NCAAF_20181013_UCF@MEMP,UCF,Knights,Memphis,Tigers,6-0,4-3,0.0,17,30,31,30,7,10,7,7,17,13,0,0,2.0,-13,1,0.8261694873175847,14.224979845411838
1141,1141,2018,7,NCAAF_20181013_UGA@LSU,Georgia,Bulldogs,LSU,Tigers,6-1,6-1,0.0,0,16,16,36,0,0,9,7,3,13,3,17,0.0,-16,-20,0.8604816599579577,16.396286896122433
1142,1142,2018,7,NCAAF_20181013_WKY@CHARLO,W. Kentucky,,Charlotte,,1-5,3-3,,7,9,14,40,7,0,0,7,6,3,21,10,-2.0,-2,-26,0.8455509407725798,15.412511121456646
1143,1143,2018,7,NCAAF_20181013_NMEX@COLOST,New Mexico,,Colorado St.,,3-3,3-4,,3,14,18,20,0,3,8,7,7,7,3,3,0.0,-11,-2,0.29615302153424006,-8.111114393158857
1144,1144,2018,7,NCAAF_20181013_UNLV@UTAHST,UNLV,,Utah St.,,2-4,5-1,,7,42,28,59,7,0,7,14,14,28,7,10,-3.0,-35,-31,0.16505061832492396,-14.751700303505856
1145,1145,2018,7,NCAAF_20181013_ALST@SALA,Alabama St.,,South Alabama,,2-4,2-5,,7,28,7,45,0,7,0,0,7,21,10,7,0.0,-21,-38,0.3198189775747142,-7.091847115799737
1146,1146,2018,7,NCAAF_20181013_NMEXST@LALAF,New Mexico St.,,Louisiana,,2-5,3-3,,21,45,38,66,14,7,10,7,28,17,7,14,-1.0,-24,-28,0.6400043911983389,5.429711093478261
1147,1147,2018,7,NCAAF_20181013_LAMON@CSTCAR,UL-Monroe,,C. Carolina,,3-4,3-3,,24,13,45,20,14,10,7,14,3,10,7,0,0.0,11,25,0.500081828889948,0.003106846955063247
1148,1148,2018,7,NCAAF_20181013_HOU@ECU,Houston,Cougars,East Carolina,Pirates,5-1,2-4,0.0,21,3,42,20,14,7,7,14,0,3,3,14,3.0,18,22,0.9192887824993439,21.21023382968218
1149,1149,2018,7,NCAAF_20181013_LATECH@TXSA,Louisiana Tech,,UTSA,,4-2,3-4,,17,0,31,3,7,10,7,7,0,0,3,0,1.0,17,28,0.5695334010251338,2.6535273247733926
1150,1150,2018,7,NCAAF_20181013_MIAMI@UVA,Miami (Fla.),Hurricanes,Virginia,Cavaliers,5-2,4-2,0.0,6,13,13,16,0,6,0,7,0,13,0,3,1.0,-7,-3,0.8272176926633379,14.286954422931672
1151,1151,2018,7,NCAAF_20181013_MIZZOU@BAMA,Missouri,Tigers,Alabama,Crimson Tide,3-3,7-0,0.0,10,30,10,39,10,0,0,0,13,17,2,7,-4.0,-20,-29,0.06851893424813338,-22.52209236603261
1152,1152,2018,7,NCAAF_20181013_UCLA@CAL,UCLA,,California,,1-5,3-3,,13,0,37,7,7,6,7,17,0,0,7,0,-2.0,13,30,0.5178506645992309,0.6779732872155932
1153,1153,2018,7,NCAAF_20181013_VATECH@UNC,Virginia Tech,,North Carolina,,4-2,1-4,,7,9,22,19,7,0,7,8,6,3,7,3,3.0,-2,3,0.914431596874361,20.72942018272539
1154,1154,2018,7,NCAAF_20181013_WVU@IOWAST,West Virginia,Mountaineers,Iowa St.,Cyclones,5-1,3-3,0.0,14,20,14,30,7,7,0,0,13,7,0,10,2.0,-6,-16,0.3492746631684689,-5.866076640555718
1155,1155,2018,7,NCAAF_20181013_MISS@ARK,Ole Miss,Rebels,Arkansas,Razorbacks,5-2,1-6,0.0,17,27,37,33,3,14,7,13,17,10,6,0,4.0,-10,4,0.6574117159690913,6.1406893524271595
1156,1156,2018,7,NCAAF_20181013_MTSU@FIU,Middle Tenn.,,FIU,,3-3,4-2,,14,13,21,24,0,14,7,0,3,10,0,11,-1.0,1,-3,0.5167443298411265,0.6359288661893174
1157,1157,2018,7,NCAAF_20181013_WISC@MICH,Wisconsin,Badgers,Michigan,Wolverines,4-2,6-1,0.0,7,13,13,38,0,7,0,6,0,13,8,17,-2.0,-6,-25,0.5977477369932074,3.749181649475304
1158,1158,2018,7,NCAAF_20181013_HAWAII@BYU,Hawaii,,BYU,,6-2,4-3,,3,28,23,49,0,3,14,6,14,14,7,14,2.0,-25,-26,0.24929074856219013,-10.250249261622628
1159,1159,2018,7,NCAAF_20181013_BOISE@NEVADA,Boise St.,Broncos,Nevada,Wolf Pack,4-2,3-4,0.0,17,17,31,27,7,10,14,0,10,7,10,0,1.0,0,4,0.9199306471059674,21.275390442583557
1160,1160,2018,7,NCAAF_20181013_COLO@USC,Colorado,Buffaloes,USC,Trojans,5-1,4-2,0.0,7,21,20,31,0,7,0,13,0,21,7,3,1.0,-14,-11,0.26786739235121926,-9.380095607777832
1161,1161,2018,7,NCAAF_20181013_WYO@FRESNO,Wyoming,,Fresno St.,,2-5,5-1,,3,13,3,27,3,0,0,0,6,7,14,0,-3.0,-10,-24,0.21248271511991246,-12.084734516524406
1162,1162,2018,7,NCAAF_20181012_SFLA@TULSA,South Florida,Bulls,Tulsa,Golden Hurricane,6-0,1-5,0.0,3,10,25,24,3,0,7,15,7,3,14,0,5.0,-7,1,0.8653022622114838,16.729062184844963
1163,1163,2018,7,NCAAF_20181012_AF@SDGST,Air Force,Falcons,San Diego St.,Aztecs,2-4,5-1,0.0,9,14,17,21,2,7,0,8,7,7,0,7,-3.0,-5,-4,0.23491975689288114,-10.947261034551957
1164,1164,2018,7,NCAAF_20181012_ARIZ@UTAH,Arizona,Wildcats,Utah,Utes,3-4,4-2,0.0,0,28,10,42,0,0,3,7,14,14,7,7,-1.0,-28,-32,0.3539648169869619,-5.674599361947514
1165,1165,2018,7,NCAAF_20181011_GAS@TXSTSM,Ga. Southern,Eagles,Texas St.,Bobcats,5-1,1-5,0.0,10,0,15,13,0,10,5,0,0,0,7,6,4.0,10,2,0.8438303688084078,15.303285210604372
1166,1166,2018,7,NCAAF_20181011_TXTECH@TCU,Texas Tech,Red Raiders,TCU,Horned Frogs,4-2,3-3,0.0,3,7,17,14,3,0,7,7,0,7,0,7,1.0,-4,3,0.31526556173260256,-7.285338915949922
1167,1167,2018,7,NCAAF_20181009_APLST@ARKST,App. St.,Mountaineers,Arkansas St.,Red Wolves,4-1,3-3,0.0,21,9,35,9,0,21,7,7,3,6,0,0,1.0,12,26,0.689217922632301,7.477027668236474
1168,1168,2018,8,NCAAF_20181021_NEVADA@HAWAII,Nevada,,Hawaii,,4-4,6-3,,20,14,40,22,10,10,7,13,14,0,0,8,-2.0,6,18,0.7195165959767836,8.897268687846804
1169,1169,2018,8,NCAAF_20181020_AUBURN@MISS,Auburn,Tigers,Ole Miss,Rebels,5-3,5-3,0.0,10,6,31,16,7,3,21,0,3,3,3,7,0.0,4,15,0.9055594186271132,20.106578651581913
1170,1170,2018,8,NCAAF_20181020_BUFF@TOLEDO,Buffalo,,Toledo,,7-1,3-4,,7,17,31,17,0,7,10,14,7,10,0,0,4.0,-10,14,0.3886719769929715,-4.327418580669644
1171,1171,2018,8,NCAAF_20181020_ILL@WISC,Illinois,Fighting Illini,Wisconsin,Badgers,3-4,5-2,0.0,10,28,20,49,0,10,7,3,14,14,14,7,-2.0,-18,-29,0.019951670414587452,-31.443851312910283
1172,1172,2018,8,NCAAF_20181020_MD@IOWA,Maryland,Terrapins,Iowa,Hawkeyes,4-3,6-1,0.0,0,13,0,23,0,0,0,0,3,10,10,0,-2.0,-13,-23,0.1028555391756365,-19.36516318036638
1173,1173,2018,8,NCAAF_20181020_MICH@MICHST,Michigan,Wolverines,Michigan St.,Spartans,7-1,4-3,0.0,7,0,21,7,0,7,7,7,0,0,7,0,3.0,7,14,0.7339677806549286,9.562210287171752
1174,1174,2018,8,NCAAF_20181020_NWEST@RUT,Northwestern,,Rutgers,,4-3,1-7,,7,12,18,15,7,0,3,8,0,12,3,0,3.0,-5,3,0.9476872689718931,24.834220563011286
1175,1175,2018,8,NCAAF_20181020_OKLA@TCU,Oklahoma,Sooners,TCU,Horned Frogs,6-1,3-4,0.0,28,24,52,27,14,14,10,14,7,17,3,0,3.0,4,25,0.6900757040940845,7.59129173795219
1176,1176,2018,8,NCAAF_20181020_TULSA@ARK,Tulsa,,Arkansas,,1-6,2-6,,0,10,0,23,0,0,0,0,0,10,10,3,-1.0,-10,-23,0.4695443315218891,-1.169385526029032
1177,1177,2018,8,NCAAF_20181020_UVA@DUKE,Virginia,Cavaliers,Duke,Blue Devils,5-2,5-2,0.0,14,0,28,14,7,7,6,8,0,0,7,7,0.0,14,14,0.3504694938021057,-5.877174406077529
1178,1178,2018,8,NCAAF_20181020_BGREEN@OHIO,Bowling Green,,Ohio,,1-7,4-3,,14,35,14,49,7,7,0,0,14,21,7,7,-3.0,-21,-35,0.15825448534305941,-15.328386914081022
1179,1179,2018,8,NCAAF_20181020_IDST@LIB,Idaho State,,Liberty,,4-3,4-3,,17,20,41,48,0,17,14,10,7,13,14,14,0.0,-3,-7,0.29710727750850197,-8.152509149502805
1180,1180,2018,8,NCAAF_20181020_FAU@MRSHL,FAU,,Marshall,,3-4,5-2,,7,10,7,31,0,7,0,0,0,10,14,7,-2.0,-3,-24,0.7366147739384196,9.685949074737152
1181,1181,2018,8,NCAAF_20181020_UTAHST@WYO,Utah St.,,Wyoming,,6-1,2-6,,10,3,24,16,7,3,14,0,3,0,10,3,4.0,7,8,0.7401142905572033,9.850520241164077
1182,1182,2018,8,NCAAF_20181020_CHARLO@MTSU,Charlotte,,Middle Tenn.,,3-4,4-3,,6,14,13,21,6,0,0,7,0,14,0,7,-1.0,-8,-8,0.10314782005534795,-19.340220112960253
1183,1183,2018,8,NCAAF_20181020_EMICH@BALLST,E. Michigan,,Ball St.,,4-4,3-5,,21,6,42,20,7,14,14,7,0,6,7,7,1.0,15,22,0.9176763865798412,21.26523515774454
1184,1184,2018,8,NCAAF_20181020_WMICH@CMICH,W. Michigan,,C. Michigan,,6-2,1-7,,21,0,35,10,7,14,0,14,0,0,10,0,5.0,21,25,0.5522272913768146,2.009142873210692
1185,1185,2018,8,NCAAF_20181020_BAMA@TENN,Alabama,Crimson Tide,Tennessee,Volunteers,8-0,3-4,0.0,42,14,58,21,28,14,16,0,0,14,7,0,5.0,28,37,0.9920127461952951,36.87258763352577
1186,1186,2018,8,NCAAF_20181020_COLO@WASH,Colorado,Buffaloes,Washington,Huskies,5-2,6-2,0.0,13,14,13,27,7,6,0,0,0,14,3,10,-1.0,-1,-14,0.10200336028377377,-19.438182900542188
1187,1187,2018,8,NCAAF_20181020_CSTCAR@MA,C. Carolina,,UMass,,4-3,2-6,,3,6,24,13,3,0,14,7,3,3,7,0,2.0,-3,11,0.3370331309545296,-6.436050662797925
1188,1188,2018,8,NCAAF_20181020_HOU@NAVY,Houston,Cougars,Navy,Midshipmen,6-1,2-5,0.0,21,24,49,36,7,14,14,14,10,14,0,12,4.0,-3,13,0.591230902393011,3.530597339216058
1189,1189,2018,8,NCAAF_20181020_KANSAS@TXTECH,Kansas,Jayhawks,Texas Tech,Red Raiders,2-5,5-2,0.0,3,24,16,48,3,0,6,7,3,21,3,21,-3.0,-21,-32,0.05030756763513289,-25.125703251270295
1190,1190,2018,8,NCAAF_20181020_LALAF@APLST,Louisiana,,App. St.,,3-4,5-1,,10,17,17,27,7,3,0,7,7,10,7,3,-2.0,-7,-10,0.06772144358940935,-22.84707557941624
1191,1191,2018,8,NCAAF_20181020_MINN@NEB,Minnesota,,Nebraska,,3-4,1-6,,8,28,28,53,0,8,14,6,14,14,8,17,2.0,-20,-25,0.6948661242280663,7.799816089007209
1192,1192,2018,8,NCAAF_20181020_NCST@CLEM,NC State,Wolfpack,Clemson,Tigers,5-1,7-0,0.0,0,24,7,41,0,0,0,7,14,10,7,10,-2.0,-24,-34,0.16080091240078676,-15.167917878257697
1193,1193,2018,8,NCAAF_20181020_PSU@IND,Penn State,Nittany Lions,Indiana,Hoosiers,5-2,4-4,0.0,17,14,33,28,7,10,9,7,14,0,7,7,1.0,3,5,0.9548947668198364,25.927731432665496
1194,1194,2018,8,NCAAF_20181020_SMU@TULANE,SMU,,Tulane,,3-4,2-5,,7,9,27,23,0,7,7,13,2,7,7,7,1.0,-2,4,0.5751825272878113,2.9012112642077454
1195,1195,2018,8,NCAAF_20181020_UTEP@LATECH,UTEP,,Louisiana Tech,,0-7,5-2,,7,17,24,31,7,0,14,3,14,3,7,7,-5.0,-10,-7,0.07747289479115593,-21.765136688616053
1196,1196,2018,8,NCAAF_20181020_WAKE@FSU,Wake Forest,,Florida State,,3-4,4-3,,10,21,17,38,10,0,0,7,7,14,10,7,-1.0,-11,-21,0.4653927741137551,-1.3291673036440557
1197,1197,2018,8,NCAAF_20181020_CAL@OREGST,California,,Oregon State,,4-3,1-6,,21,0,49,7,7,14,7,21,0,0,7,0,3.0,21,42,0.8599021270872431,16.52542090170664
1198,1198,2018,8,NCAAF_20181020_MEMP@MIZZOU,Memphis,Tigers,Missouri,Tigers,4-4,4-3,1.0,20,48,33,65,3,17,7,6,21,27,14,3,0.0,-28,-32,0.510999244736824,0.4219733056750101
1199,1199,2018,8,NCAAF_20181020_GAS@NMEXST,Ga. Southern,,New Mexico St.,,6-1,2-6,,24,17,48,31,10,14,21,3,14,3,7,7,4.0,7,17,0.5884461242235992,3.4209846408710405
1200,1200,2018,8,NCAAF_20181020_MISSST@LSU,Miss. State,Bulldogs,LSU,Tigers,4-3,7-1,0.0,3,10,3,19,3,0,0,0,7,3,6,3,-3.0,-7,-16,0.4926548559789714,-0.2817681715324625
1201,1201,2018,8,NCAAF_20181020_TXSA@USM,UTSA,,So. Miss,,3-5,3-3,,3,20,17,27,0,3,7,7,6,14,7,0,0.0,-17,-10,0.399673522282587,-3.889908941274257
1202,1202,2018,8,NCAAF_20181020_TXSTSM@LAMON,Texas St.,,UL-Monroe,,1-6,4-4,,7,17,14,20,7,0,0,7,7,10,3,0,-3.0,-10,-6,0.24959940802065472,-10.341029453397994
1203,1203,2018,8,NCAAF_20181020_UCF@ECU,UCF,Knights,East Carolina,Pirates,7-0,2-5,0.0,20,3,37,10,0,20,3,14,3,0,7,0,5.0,17,27,0.9935212590401861,38.02702138179478
1204,1204,2018,8,NCAAF_20181020_UCONN@SFLA,UConn,Huskies,South Florida,Bulls,1-6,7-0,0.0,7,7,30,38,7,0,7,16,0,7,17,14,-6.0,0,-8,0.03924426928908176,-26.92603171844371
1205,1205,2018,8,NCAAF_20181020_FRESNO@NMEX,Fresno St.,,New Mexico,,6-1,3-4,,24,7,38,7,10,14,14,0,0,7,0,0,3.0,17,31,0.8901954585814603,18.78550160244049
1206,1206,2018,8,NCAAF_20181020_NTEXAS@UAB,North Texas,,UAB,,6-2,6-1,,21,10,21,29,7,14,0,0,3,7,9,10,0.0,11,-8,0.5995631388937375,3.8596741942481003
1207,1207,2018,8,NCAAF_20181020_ODU@WKY,Old Dominion,,W. Kentucky,,2-6,1-6,,17,24,37,34,14,3,2,18,7,17,3,7,1.0,-7,3,0.42664449450432773,-2.8298889803323277
1208,1208,2018,8,NCAAF_20181020_OHIOST@PURDUE,Ohio State,Buckeyes,Purdue,Boilermakers,7-1,4-3,0.0,3,14,20,49,0,3,3,14,7,7,7,28,3.0,-11,-29,0.8942362525268814,19.119229538578907
1209,1209,2018,8,NCAAF_20181020_OREG@WASHST,Oregon,Ducks,Washington St.,Cougars,5-2,6-1,0.0,0,27,20,34,0,0,17,3,7,20,0,7,-1.0,-27,-14,0.4991683857870475,-0.03189989818736194
1210,1210,2018,8,NCAAF_20181020_RICE@FIU,Rice,,FIU,,1-7,5-2,,10,16,17,36,7,3,7,0,0,16,10,10,-4.0,-6,-19,0.0854358054687866,-20.956086009460137
1211,1211,2018,8,NCAAF_20181020_VANDY@UK,Vanderbilt,Commodores,Kentucky,Wildcats,3-5,6-1,0.0,7,7,7,14,7,0,0,0,0,7,0,7,-3.0,0,-7,0.30934613114660237,-7.616383501566304
1212,1212,2018,8,NCAAF_20181020_USC@UTAH,USC,Trojans,Utah,Utes,4-3,5-2,0.0,14,20,28,41,14,0,0,14,7,13,14,7,-1.0,-6,-13,0.5085031993323419,0.3261987756727649
1213,1213,2018,8,NCAAF_20181020_ARIZ@UCLA,Arizona,,UCLA,,3-5,2-5,,7,17,30,31,0,7,13,10,7,10,7,7,1.0,-10,-1,0.47500795028245313,-0.9592975105936148
1214,1214,2018,8,NCAAF_20181020_SJST@SDGST,San Jose St.,Spartans,San Diego St.,Aztecs,0-7,6-1,0.0,6,10,13,16,6,0,7,0,0,10,3,3,-6.0,-4,-3,0.011797629920771047,-34.64077816241331
1215,1215,2018,8,NCAAF_20181019_COLOST@BOISE,Colorado St.,Rams,Boise St.,Broncos,3-5,5-2,0.0,7,35,28,56,0,7,7,14,21,14,7,14,-2.0,-28,-28,0.1885457184095891,-13.516669323566703
1216,1216,2018,8,NCAAF_20181019_AF@UNLV,Air Force,Falcons,UNLV,Rebels,3-4,2-5,0.0,20,21,41,35,3,17,21,0,7,14,7,7,1.0,-1,6,0.7337875810465434,9.553809287241506
1217,1217,2018,8,NCAAF_20181018_GAST@ARKST,Georgia St.,Panthers,Arkansas St.,Red Wolves,2-5,4-3,0.0,7,34,35,51,7,0,14,14,20,14,7,10,-2.0,-27,-16,0.2768568704430866,-9.06251536175796
1218,1218,2018,8,NCAAF_20181018_STNFRD@ARIZST,Stanford,Cardinal,Arizona St.,Sun Devils,5-2,0-4,0.0,6,3,20,13,0,6,14,0,3,0,3,7,5.0,3,7,0.6814848284952676,7.220805351627803
1219,1219,2018,9,NCAAF_20181027_ARMY@EMICH,Army,Black Knights,E. Michigan,Eagles,6-2,4-5,0.0,16,0,37,22,3,13,7,14,0,0,14,8,2.0,16,15,0.6583942986346469,6.254911876772269
1220,1220,2018,9,NCAAF_20181027_BTHN@NEB,Bethune-Cook.,,Nebraska,,4-5,2-6,,3,38,9,45,3,0,0,6,28,10,0,7,2.0,-35,-36,0.07367639649757718,-22.208683477178
1221,1221,2018,9,NCAAF_20181027_CLEM@FSU,Clemson,Tigers,Florida State,Seminoles,8-0,4-4,0.0,28,0,59,10,0,28,24,7,0,0,3,7,4.0,28,49,0.888634217758508,18.688747033381105
1222,1222,2018,9,NCAAF_20181027_CMICH@AKRON,C. Michigan,,Akron,,1-8,4-3,,0,17,10,17,0,0,10,0,7,10,0,0,-3.0,-17,-7,0.5538519912554936,2.0753331423597956
1223,1223,2018,9,NCAAF_20181027_MA@UCONN,UMass,,UConn,,3-6,1-7,,3,7,22,17,3,0,6,13,7,0,7,3,2.0,-4,5,0.5951725757764745,3.691950350185266
1224,1224,2018,9,NCAAF_20181027_PURDUE@MICHST,Purdue,Boilermakers,Michigan St.,Spartans,4-4,5-3,0.0,6,13,13,23,3,3,7,0,6,7,3,7,-1.0,-7,-10,0.5828618206175373,3.2068181055012133
1225,1225,2018,9,NCAAF_20181027_TXTECH@IOWAST,Texas Tech,Red Raiders,Iowa St.,Cyclones,5-3,4-3,0.0,17,14,31,40,10,7,7,7,0,14,17,9,1.0,3,-9,0.4135540342623859,-3.347706469120567
1226,1226,2018,9,NCAAF_20181027_VANDY@ARK,Vanderbilt,Commodores,Arkansas,Razorbacks,4-5,2-7,0.0,21,14,45,31,7,14,3,21,7,7,3,14,2.0,7,14,0.5714158846071378,2.758640574573178
1227,1227,2018,9,NCAAF_20181027_WAKE@LVILLE,Wake Forest,,Louisville,,4-4,2-6,,35,21,56,35,21,14,21,0,7,14,14,0,2.0,14,21,0.5045698537422025,0.17557896559367236
1228,1228,2018,9,NCAAF_20181027_WISC@NWEST,Wisconsin,Badgers,Northwestern,Wildcats,5-3,5-3,0.0,10,14,17,31,7,3,0,7,7,7,10,7,0.0,-4,-14,0.7889490253274203,12.304593050993958
1229,1229,2018,9,NCAAF_20181027_UNC@UVA,North Carolina,,Virginia,,1-6,6-2,,14,17,21,31,7,7,0,7,14,3,7,7,-5.0,-3,-10,0.256900855291474,-10.007764194348454
1230,1230,2018,9,NCAAF_20181027_CSTCAR@GAST,C. Carolina,,Georgia St.,,5-3,2-6,,20,13,37,34,17,3,7,10,7,6,21,0,3.0,7,3,0.43000847340387205,-2.70304079920885
1231,1231,2018,9,NCAAF_20181027_USM@CHARLO,So. Miss,,Charlotte,,3-4,4-4,,0,14,17,20,0,0,3,14,14,0,3,3,-1.0,-14,-3,0.8526785466467517,16.063055812056916
1232,1232,2018,9,NCAAF_20181027_TCU@KANSAS,TCU,,Kansas,,3-5,3-5,,10,7,26,27,0,10,7,9,7,0,10,10,0.0,3,-1,0.9779627474998959,30.86006509727872
1233,1233,2018,9,NCAAF_20181027_ARIZST@USC,Arizona St.,,USC,,4-4,4-4,,24,14,38,35,14,10,7,7,7,7,14,7,0.0,10,3,0.37734370749600754,-4.789295806860423
1234,1234,2018,9,NCAAF_20181027_DUKE@PITT,Duke,,Pittsburgh,,5-3,4-4,,21,17,45,54,7,14,21,3,7,10,18,19,1.0,4,-9,0.6396398471116262,5.479517117894147
1235,1235,2018,9,NCAAF_20181027_FLA@UGA,Florida,Gators,Georgia,Bulldogs,6-2,7-1,0.0,7,13,17,36,0,7,7,3,10,3,10,13,-1.0,-6,-19,0.0990771847379247,-19.723824746825073
1236,1236,2018,9,NCAAF_20181027_ILL@MD,Illinois,,Maryland,,3-5,5-3,,9,28,33,63,3,6,10,14,14,14,21,14,-2.0,-19,-30,0.287843751409237,-8.578713609195802
1237,1237,2018,9,NCAAF_20181027_IOWA@PSU,Iowa,Hawkeyes,Penn State,Nittany Lions,6-2,6-2,0.0,17,17,24,30,12,5,0,7,7,10,10,3,0.0,0,-6,0.2835005369557557,-8.774579643039488
1238,1238,2018,9,NCAAF_20181027_KSTATE@OKLA,Kansas State,Wildcats,Oklahoma,Sooners,3-5,7-1,0.0,7,34,14,51,0,7,0,7,17,17,14,3,-4.0,-27,-37,0.09144134749379673,-20.41515337699775
1239,1239,2018,9,NCAAF_20181027_MTSU@ODU,Middle Tenn.,,Old Dominion,,5-3,2-7,,31,10,51,17,17,14,14,6,7,3,7,0,3.0,21,34,0.7629696882057189,10.972756025789295
1240,1240,2018,9,NCAAF_20181027_NILL@BYU,N. Illinois,,BYU,,5-3,4-4,,0,3,7,6,0,0,7,0,3,0,3,0,1.0,-3,1,0.6827671410459284,7.287462016641541
1241,1241,2018,9,NCAAF_20181027_SFLA@HOU,South Florida,Bulls,Houston,Cougars,7-1,7-1,0.0,21,28,36,57,0,21,15,0,14,14,15,14,0.0,-7,-21,0.4996971459137838,-0.011635744242880719
1242,1242,2018,9,NCAAF_20181027_NMEX@UTAHST,New Mexico,,Utah St.,,3-5,7-1,,5,52,19,61,3,2,14,0,28,24,9,0,-4.0,-47,-42,0.1502751694865867,-15.867833722066507
1243,1243,2018,9,NCAAF_20181027_RICE@NTEXAS,Rice,,North Texas,,1-8,7-2,,10,17,17,41,7,3,7,0,10,7,3,21,-6.0,-7,-24,0.07306987041330681,-22.27546710572915
1244,1244,2018,9,NCAAF_20181027_UK@MIZZOU,Kentucky,Wildcats,Missouri,Tigers,7-1,4-4,0.0,3,14,15,14,3,0,0,12,0,14,0,0,3.0,-11,1,0.3334714186859089,-6.596143504203553
1245,1245,2018,9,NCAAF_20181027_UNLV@SJST,UNLV,,San Jose St.,,2-6,1-7,,21,24,37,50,7,14,7,9,7,17,17,9,1.0,-3,-13,0.8156655048862442,13.77893447100928
1246,1246,2018,9,NCAAF_20181027_WASH@CAL,Washington,Huskies,California,Golden Bears,6-3,5-3,0.0,7,6,10,12,7,0,0,3,3,3,6,0,1.0,1,-2,0.9122280466952492,20.762658354248742
1247,1247,2018,9,NCAAF_20181027_ARKST@LALAF,Arkansas St.,,Louisiana,,4-4,4-4,,21,31,43,47,14,7,7,15,21,10,3,13,0.0,-10,-4,0.7928217296299916,12.511072141543991
1248,1248,2018,9,NCAAF_20181027_BOISE@AF,Boise St.,Broncos,Air Force,Falcons,6-2,3-5,0.0,28,28,48,38,14,14,10,10,7,21,3,7,3.0,0,10,0.8237250462802027,14.249263323437162
1249,1249,2018,9,NCAAF_20181027_NCST@CUSE,NC State,Wolfpack,Syracuse,Orange,5-2,6-2,0.0,20,27,41,51,7,13,7,14,24,3,14,10,-1.0,-7,-10,0.6751882087854928,6.963046908920546
1250,1250,2018,9,NCAAF_20181027_NMEXST@TXSTSM,New Mexico St.,,Texas St.,,2-7,2-6,,13,20,20,27,0,13,7,0,13,7,7,0,0.0,-7,-7,0.723969831164107,9.114878197816608
1251,1251,2018,9,NCAAF_20181027_TULANE@TULSA,Tulane,,Tulsa,,3-5,1-7,,7,10,24,17,0,7,7,10,3,7,7,0,2.0,-3,7,0.6591224281259889,6.2853282663061805
1252,1252,2018,9,NCAAF_20181027_TXAM@MISSST,Texas A&M,Aggies,Miss. State,Bulldogs,5-3,5-3,0.0,10,7,13,28,0,10,3,0,7,0,7,14,0.0,3,-15,0.3634764575890941,-5.352075231588572
1253,1253,2018,9,NCAAF_20181027_WASHST@STNFRD,Washington St.,Cougars,Stanford,Cardinal,7-1,5-3,0.0,17,28,41,38,14,3,7,17,14,14,3,7,2.0,-11,3,0.3985695466487129,-3.9399501680258027
1254,1254,2018,9,NCAAF_20181027_FIU@WKY,FIU,,W. Kentucky,,6-2,1-7,,14,3,38,17,7,7,14,10,0,3,0,14,5.0,11,21,0.6997127734814712,8.025079091915359
1255,1255,2018,9,NCAAF_20181027_TENN@SC,Tennessee,Volunteers,South Carolina,Gamecocks,3-5,4-3,0.0,14,9,24,27,7,7,10,0,3,6,15,3,-1.0,5,-3,0.21755352266133765,-11.962826619380053
1256,1256,2018,9,NCAAF_20181027_UAB@UTEP,UAB,,UTEP,,7-1,0-8,,10,0,19,0,10,0,2,7,0,0,0,0,7.0,10,19,0.9141046067854848,20.94457577636615
1257,1257,2018,9,NCAAF_20181027_ND@NAVY,Notre Dame,Fighting Irish,Navy,Midshipmen,8-0,2-6,0.0,27,0,44,22,13,14,10,7,0,0,14,8,6.0,27,22,0.8926404267932488,19.016698369904475
1258,1258,2018,9,NCAAF_20181027_TEXAS@OKLAST,Texas,Longhorns,Oklahoma State,Cowboys,6-2,5-3,0.0,14,31,35,38,7,7,7,14,17,14,0,7,1.0,-17,-3,0.4801319435155611,-0.7636523924554695
1259,1259,2018,9,NCAAF_20181027_HAWAII@FRESNO,Hawaii,,Fresno St.,,6-4,7-1,,13,37,20,50,3,10,0,7,14,23,10,3,-1.0,-24,-30,0.036844863446398035,-27.41373481535811
1260,1260,2018,9,NCAAF_20181027_OREG@ARIZ,Oregon,Ducks,Arizona,Wildcats,5-3,4-5,0.0,8,23,15,44,0,8,0,7,10,13,14,7,1.0,-15,-29,0.6475338685475126,5.804070629502462
1261,1261,2018,9,NCAAF_20181027_SDGST@NEVADA,San Diego St.,,Nevada,,6-2,5-4,,24,15,24,28,14,10,0,0,9,6,10,3,1.0,9,-4,0.8259212834566106,14.379770407381045
1262,1262,2018,9,NCAAF_20181026_LATECH@FAU,Louisiana Tech,Bulldogs,FAU,Owls,6-2,3-5,0.0,14,10,21,13,0,14,0,7,10,0,3,0,3.0,4,8,0.2031781736290763,-12.726754699066305
1263,1263,2018,9,NCAAF_20181026_MIAMI@BC,Miami (Fla.),Hurricanes,Boston College,Eagles,5-3,6-2,0.0,14,17,14,27,7,7,0,0,14,3,10,0,-1.0,-3,-13,0.6395134168083108,5.47433940637643
1264,1264,2018,9,NCAAF_20181026_IND@MINN,Indiana,Hoosiers,Minnesota,Golden Gophers,4-5,4-4,0.0,9,21,31,38,6,3,0,22,7,14,10,7,0.0,-12,-7,0.5889846695615357,3.447670517823326
1265,1265,2018,9,NCAAF_20181026_WYO@COLOST,Wyoming,Cowboys,Colorado St.,Rams,3-6,3-6,0.0,3,0,34,21,0,3,21,10,0,0,7,14,0.0,3,13,0.47278997801394107,-1.0462289181087385
1266,1266,2018,9,NCAAF_20181026_UTAH@UCLA,Utah,Utes,UCLA,Bruins,6-2,2-6,0.0,17,7,41,10,3,14,21,3,7,0,3,0,4.0,10,31,0.7109922402910446,8.526458782719146
1267,1267,2018,9,NCAAF_20181025_BALLST@OHIO,Ball St.,Cardinals,Ohio,Bobcats,3-6,5-3,0.0,7,31,14,52,7,0,0,7,0,31,21,0,-2.0,-24,-38,0.06747405204027812,-22.9126055631981
1268,1268,2018,9,NCAAF_20181025_BAYLOR@WVU,Baylor,Bears,West Virginia,Mountaineers,4-4,6-1,0.0,0,41,14,58,0,0,14,0,10,31,10,7,-2.0,-41,-44,0.22025991689975233,-11.822325698349061
1269,1269,2018,9,NCAAF_20181025_TOLEDO@WMICH,Toledo,Rockets,W. Michigan,Broncos,4-4,6-3,0.0,23,17,51,24,14,9,21,7,7,10,7,0,-2.0,6,27,0.6223958874159901,4.778791565889037
1270,1270,2018,9,NCAAF_20181025_APLST@GAS,App. St.,Mountaineers,Ga. Southern,Eagles,5-2,7-1,0.0,7,17,14,34,0,7,0,7,0,17,10,7,-2.0,-10,-20,0.85422558729082,16.16635285398172
1271,1271,2018,9,NCAAF_20181025_GATECH@VATECH,Georgia Tech,Yellow Jackets,Virginia Tech,Hokies,4-4,4-3,0.0,28,21,49,28,14,14,14,7,14,7,0,7,0.0,7,21,0.4033572185375228,-3.7501254313592653
1272,1272,2018,9,NCAAF_20181023_TROY@SALA,Troy,Trojans,South Alabama,Jaguars,6-2,2-6,0.0,31,17,38,17,16,15,0,7,7,10,0,0,4.0,14,21,0.8922605394355547,18.98522657712715
1273,1273,2018,10,NCAAF_20181104_UTAHST@HAWAII,Utah St.,,Hawaii,,8-1,6-5,,28,3,56,17,28,0,28,0,3,0,14,0,2.0,25,39,0.9416501609371992,24.130211524161552
1274,1274,2018,10,NCAAF_20181103_AF@ARMY,Air Force,Falcons,Army,Black Knights,3-6,7-2,0.0,0,14,14,17,0,0,6,8,7,7,0,3,-4.0,-14,-3,0.2735880064981103,-9.259639933932533
1275,1275,2018,10,NCAAF_20181103_CMICH@EMICH,C. Michigan,,E. Michigan,,1-9,5-5,,7,7,7,17,0,7,0,0,7,0,0,10,-4.0,0,-10,0.3688382897609862,-5.151763817556969
1276,1276,2018,10,NCAAF_20181103_CUSE@WAKE,Syracuse,Orange,Wake Forest,Demon Deacons,7-2,4-5,0.0,21,10,41,24,14,7,14,6,10,0,14,0,3.0,11,17,0.45257283656685743,-1.832920304702668
1277,1277,2018,10,NCAAF_20181103_IOWAST@KANSAS,Iowa St.,,Kansas,,5-3,3-6,,20,3,27,3,14,6,7,0,0,3,0,0,2.0,17,24,0.9655105932826601,27.972218879788272
1278,1278,2018,10,NCAAF_20181103_LVILLE@CLEM,Louisville,Cardinals,Clemson,Tigers,2-7,9-0,0.0,3,35,16,77,3,0,6,7,14,21,28,14,-7.0,-32,-61,0.05093024513193811,-25.1626529832634
1279,1279,2018,10,NCAAF_20181103_MEMP@ECU,Memphis,,East Carolina,,5-4,2-6,,24,17,59,41,10,14,14,21,14,3,17,7,3.0,7,18,0.9345136368622015,23.230378452874106
1280,1280,2018,10,NCAAF_20181103_MICHST@MD,Michigan St.,,Maryland,,6-3,5-4,,10,3,24,3,10,0,7,7,0,3,0,0,1.0,7,21,0.7651275346062045,11.119220391390968
1281,1281,2018,10,NCAAF_20181103_NEB@OHIOST,Nebraska,Cornhuskers,Ohio State,Buckeyes,2-7,8-1,0.0,21,16,31,36,7,14,0,10,16,0,14,6,-6.0,5,-5,0.02572632400267194,-29.958384736725975
1282,1282,2018,10,NCAAF_20181103_OKLAST@BAYLOR,Oklahoma State,,Baylor,,5-4,5-4,,10,14,31,35,7,3,14,7,0,14,7,14,0.0,-4,-4,0.9077072318269581,20.407722148897278
1283,1283,2018,10,NCAAF_20181103_RUT@WISC,Rutgers,,Wisconsin,,1-8,6-3,,0,10,17,31,0,0,3,14,7,3,14,7,-5.0,-10,-14,0.016359011088447395,-32.847673869319124
1284,1284,2018,10,NCAAF_20181103_SC@MISS,South Carolina,Gamecocks,Ole Miss,Rebels,5-3,5-4,0.0,27,27,48,44,17,10,7,14,3,24,10,7,0.0,0,4,0.6851134193390536,7.414609117132329
1285,1285,2018,10,NCAAF_20181103_TXAM@AUBURN,Texas A&M,Aggies,Auburn,Tigers,5-4,6-3,0.0,17,14,24,28,3,14,7,0,7,7,0,14,-1.0,3,-4,0.2192331154222933,-11.91739415260406
1286,1286,2018,10,NCAAF_20181103_GATECH@UNC,Georgia Tech,,North Carolina,,5-4,1-7,,21,10,38,28,7,14,7,10,7,3,10,8,4.0,11,10,0.8654162012646285,16.99631043897506
1287,1287,2018,10,NCAAF_20181103_SJST@WYO,San Jose St.,,Wyoming,,1-8,4-6,,0,10,9,24,0,0,3,6,3,7,7,7,-3.0,-10,-15,0.0951035803759811,-20.14929419765059
1288,1288,2018,10,NCAAF_20181103_TXSTSM@GAST,Texas St.,,Georgia St.,,3-6,2-7,,13,10,40,31,13,0,20,7,7,3,0,21,1.0,3,9,0.2568715884248973,-10.044454087493932
1289,1289,2018,10,NCAAF_20181103_GAS@LAMON,Ga. Southern,,UL-Monroe,,7-2,5-4,,10,27,25,44,0,10,8,7,13,14,14,3,2.0,-17,-19,0.6563010806310937,6.189358397037381
1290,1290,2018,10,NCAAF_20181103_MRSHL@USM,Marshall,,So. Miss,,5-3,4-4,,10,17,24,26,3,7,7,7,3,14,3,6,1.0,-7,-2,0.688668787896223,7.568953057051033
1291,1291,2018,10,NCAAF_20181103_SALA@ARKST,South Alabama,,Arkansas St.,,2-7,5-4,,7,14,14,38,0,7,0,7,0,14,14,10,-3.0,-7,-24,0.1925614736655067,-13.358798050156679
1292,1292,2018,10,NCAAF_20181103_FSU@NCST,Florida State,,NC State,,4-5,6-2,,14,27,28,47,0,14,7,7,10,17,10,10,-2.0,-13,-19,0.4358319012852556,-2.484817071108978
1293,1293,2018,10,NCAAF_20181103_IOWA@PURDUE,Iowa,Hawkeyes,Purdue,Boilermakers,6-3,5-4,0.0,17,21,36,38,7,10,6,13,14,7,14,3,1.0,-4,-2,0.660835391412615,6.379400929939436
1294,1294,2018,10,NCAAF_20181103_KSTATE@TCU,Kansas State,,TCU,,3-6,4-5,,7,7,13,14,7,0,0,6,7,0,7,0,-1.0,0,-1,0.24652145770575307,-10.543688878769103
1295,1295,2018,10,NCAAF_20181103_LALAF@TROY,Louisiana,,Troy,,4-5,7-2,,3,23,16,26,3,0,13,0,10,13,3,0,-3.0,-20,-10,0.13966598984264533,-16.64006939098988
1296,1296,2018,10,NCAAF_20181103_MINN@ILL,Minnesota,,Illinois,,4-5,4-5,,17,24,31,55,7,10,0,14,14,10,21,10,0.0,-7,-24,0.7986748259435923,12.872762638917038
1297,1297,2018,10,NCAAF_20181103_NAVY@CINCY,Navy,,Cincinnati,,2-7,8-1,,0,28,0,42,0,0,0,0,7,21,7,7,-6.0,-28,-42,0.6592300174373322,6.312006406801515
1298,1298,2018,10,NCAAF_20181103_TULANE@SFLA,Tulane,Green Wave,South Florida,Bulls,4-5,7-2,0.0,27,3,41,15,7,20,7,7,3,0,6,6,-3.0,24,26,0.3167535873186267,-7.333858477418005
1299,1299,2018,10,NCAAF_20181103_UGA@UK,Georgia,Bulldogs,Kentucky,Wildcats,8-1,7-2,0.0,14,3,34,17,7,7,14,6,0,3,7,7,1.0,11,17,0.9287296944750009,22.555409539084962
1300,1300,2018,10,NCAAF_20181103_UTEP@RICE,UTEP,,Rice,,1-8,1-9,,27,3,34,26,7,20,7,0,0,3,7,16,0.0,24,8,0.47667222406068444,-0.8999339321759408
1301,1301,2018,10,NCAAF_20181103_WVU@TEXAS,West Virginia,Mountaineers,Texas,Longhorns,7-1,6-3,0.0,27,28,42,41,10,17,0,15,14,14,3,10,1.0,-1,1,0.3919931579768283,-4.216507880672509
1302,1302,2018,10,NCAAF_20181103_BC@VATECH,Boston College,Eagles,Virginia Tech,Hokies,7-2,4-4,0.0,7,14,31,21,7,0,14,10,7,7,0,7,3.0,-7,10,0.47770715119858764,-0.8599661410632393
1303,1303,2018,10,NCAAF_20181103_PSU@MICH,Penn State,Nittany Lions,Michigan,Wolverines,6-3,8-1,0.0,0,14,7,42,0,0,0,7,7,7,14,14,-2.0,-14,-35,0.6770855826418211,7.068807059852304
1304,1304,2018,10,NCAAF_20181103_ALCORN@NMEXST,Alcorn St.,,New Mexico St.,,7-3,3-7,,14,35,42,52,7,7,7,21,14,21,3,14,4.0,-21,-10,0.6473591129044562,5.817301240376935
1305,1305,2018,10,NCAAF_20181103_CHARLO@TENN,Charlotte,,Tennessee,,4-5,4-5,,3,14,3,14,0,3,0,0,14,0,0,0,0.0,-11,-11,0.07381285632511625,-22.271984374610156
1306,1306,2018,10,NCAAF_20181103_MIZZOU@FLA,Missouri,Tigers,Florida,Gators,5-4,6-3,0.0,21,10,38,17,7,14,14,3,3,7,7,0,-1.0,11,21,0.576257772955255,2.958315965182976
1307,1307,2018,10,NCAAF_20181103_UTAH@ARIZST,Utah,Utes,Arizona St.,Sun Devils,6-3,5-4,0.0,17,21,20,38,7,10,3,0,14,7,0,17,1.0,-4,-18,0.6712208792913813,6.818432137517789
1308,1308,2018,10,NCAAF_20181103_APLST@CSTCAR,App. St.,,C. Carolina,,6-2,5-4,,14,7,23,7,7,7,0,9,7,0,0,0,1.0,7,16,0.8962340568306362,19.386595617643025
1309,1309,2018,10,NCAAF_20181103_DUKE@MIAMI,Duke,Blue Devils,Miami (Fla.),Hurricanes,6-3,5-4,0.0,7,12,20,12,7,0,10,3,0,12,0,0,1.0,-5,8,0.30530566777965196,-7.83229247689701
1310,1310,2018,10,NCAAF_20181103_HOU@SMU,Houston,Cougars,SMU,Mustangs,7-2,4-5,0.0,14,31,31,45,0,14,3,14,10,21,7,7,3.0,-17,-14,0.6757807998955234,7.012943623255694
1311,1311,2018,10,NCAAF_20181103_UCONN@TULSA,UConn,Huskies,Tulsa,Golden Hurricane,1-8,2-7,0.0,13,28,19,49,10,3,0,6,0,28,21,0,-1.0,-15,-30,0.2574014788314224,-10.019181941303827
1312,1312,2018,10,NCAAF_20181103_ND@NWEST,Notre Dame,Fighting Irish,Northwestern,Wildcats,9-0,5-4,0.0,7,7,31,21,7,0,14,10,0,7,0,14,4.0,0,10,0.6872624870091327,7.507813131798855
1313,1313,2018,10,NCAAF_20181103_FAU@FIU,FAU,,FIU,,4-5,6-3,,14,7,49,14,7,7,7,28,0,7,7,0,-2.0,7,35,0.7284540308207377,9.354188197525787
1314,1314,2018,10,NCAAF_20181103_LATECH@MISSST,Louisiana Tech,Bulldogs,Miss. State,Bulldogs,6-3,6-3,1.0,3,31,3,45,3,0,0,0,21,10,7,7,0.0,-28,-42,0.06185671045993013,-23.67790760313693
1315,1315,2018,10,NCAAF_20181103_TXSA@UAB,UTSA,,UAB,,3-6,8-1,,3,38,3,52,3,0,0,0,21,17,7,7,-5.0,-35,-49,0.3535227511923361,-5.780795893165816
1316,1316,2018,10,NCAAF_20181103_UCLA@OREG,UCLA,,Oregon,,2-7,6-3,,7,21,21,42,0,7,7,7,14,7,7,14,-4.0,-14,-21,0.3938826473786008,-4.140918463941659
1317,1317,2018,10,NCAAF_20181103_BAMA@LSU,Alabama,Crimson Tide,LSU,Tigers,9-0,7-2,0.0,16,0,29,0,6,10,6,7,0,0,0,0,2.0,16,29,0.8602054126873125,16.63117079289907
1318,1318,2018,10,NCAAF_20181103_OKLA@TXTECH,Oklahoma,Sooners,Texas Tech,Red Raiders,8-1,5-4,0.0,28,31,51,46,7,21,7,16,14,17,0,15,3.0,-3,5,0.8311894201744379,14.748985226406376
1319,1319,2018,10,NCAAF_20181103_STNFRD@WASH,Stanford,Cardinal,Washington,Huskies,5-4,7-3,0.0,0,21,23,27,0,0,14,9,14,7,3,3,-2.0,-21,-4,0.3189910422997043,-7.237350753730993
1320,1320,2018,10,NCAAF_20181103_USC@OREGST,USC,,Oregon State,,5-4,2-7,,21,14,38,21,7,14,7,10,0,14,7,0,3.0,7,17,0.9714154230782739,29.255912459712704
1321,1321,2018,10,NCAAF_20181103_BYU@BOISE,BYU,,Boise St.,,4-5,7-2,,6,14,16,21,0,6,7,3,14,0,7,0,-3.0,-8,-5,0.1428476192222219,-16.421521178912144
1322,1322,2018,10,NCAAF_20181103_SDGST@NMEX,San Diego St.,,New Mexico,,7-2,3-6,,7,10,31,23,7,0,7,17,7,3,6,7,4.0,-3,8,0.876076939950907,17.774851002021308
1323,1323,2018,10,NCAAF_20181103_FRESNO@UNLV,Fresno St.,Bulldogs,UNLV,Rebels,8-1,2-7,0.0,17,0,48,3,7,10,17,14,0,0,0,3,6.0,17,45,0.9260694670709024,22.259048693150362
1324,1324,2018,10,NCAAF_20181103_CAL@WASHST,California,Golden Bears,Washington St.,Cougars,5-4,8-1,0.0,10,13,13,19,0,10,3,0,3,10,0,6,-3.0,-3,-6,0.2933543165191197,-8.361583319877639
1325,1325,2018,10,NCAAF_20181102_PITT@UVA,Pittsburgh,Panthers,Virginia,Cavaliers,5-4,6-3,0.0,7,10,23,13,7,0,7,9,7,3,0,3,-1.0,-3,10,0.47054259965876255,-1.1367872855321934
1326,1326,2018,10,NCAAF_20181102_WKY@MTSU,W. Kentucky,Hilltoppers,Middle Tenn.,Blue Raiders,1-8,6-3,0.0,3,20,10,29,3,0,7,0,10,10,3,6,-5.0,-17,-19,0.24169155851195345,-10.78048091951382
1327,1327,2018,10,NCAAF_20181102_COLO@ARIZ,Colorado,,Arizona,,5-4,5-5,,24,26,34,42,10,14,10,0,0,26,9,7,0.0,-2,-8,0.45573105306492456,-1.7103420789516122
1328,1328,2018,10,NCAAF_20181101_NILL@AKRON,N. Illinois,,Akron,,6-3,4-4,,24,10,36,26,7,17,5,7,7,3,16,0,2.0,14,10,0.7040767955426346,8.24699797075084
1329,1329,2018,10,NCAAF_20181101_OHIO@WMICH,Ohio,,W. Michigan,,6-3,6-4,,45,0,59,14,21,24,7,7,0,0,7,7,0.0,45,45,0.6206015560544068,4.723070208119509
1330,1330,2018,10,NCAAF_20181101_TEMPLE@UCF,Temple,Owls,UCF,Knights,5-4,8-0,0.0,34,28,40,52,17,17,0,6,14,14,14,10,-3.0,6,-12,0.09471515719741119,-20.184667567658607
1331,1331,2018,10,NCAAF_20181031_BALLST@TOLEDO,Ball St.,Cardinals,Toledo,Rockets,3-7,5-4,0.0,7,28,13,45,0,7,0,6,21,7,3,14,-2.0,-21,-32,0.038052731459250366,-27.28290696890292
1332,1332,2018,10,NCAAF_20181030_KENTST@BGREEN,Kent St.,,Bowling Green,,2-7,1-8,,14,13,35,28,7,7,7,14,3,10,0,15,1.0,1,7,0.33403770732054217,-6.595461399820351
1333,1333,2018,10,NCAAF_20181030_MIAOH@BUFF,Miami-OH,,Buffalo,,3-6,8-1,,21,28,42,51,14,7,21,0,14,14,14,9,-5.0,-7,-9,0.33930934378299094,-6.373319856951639
1334,1334,2018,11,NCAAF_20181110_AKRON@EMICH,Akron,,E. Michigan,,4-5,6-5,,7,10,7,27,0,7,0,0,7,3,0,17,-2.0,-3,-20,0.33507074463241127,-6.607870005462644
1335,1335,2018,11,NCAAF_20181110_BYU@MA,BYU,,UMass,,5-5,4-7,,14,10,35,16,7,7,14,7,10,0,0,6,1.0,4,19,0.6994277707518926,8.109564208483846
1336,1336,2018,11,NCAAF_20181110_ILL@NEB,Illinois,,Nebraska,,4-6,3-7,,21,38,35,54,14,7,0,14,21,17,7,9,1.0,-17,-19,0.3010090359116757,-8.090098225054277
1337,1337,2018,11,NCAAF_20181110_KANSAS@KSTATE,Kansas,Jayhawks,Kansas State,Wildcats,3-7,4-6,0.0,3,0,17,21,0,3,7,7,0,0,14,7,-1.0,3,-4,0.13247206599776362,-17.293729279497654
1338,1338,2018,11,NCAAF_20181110_LAF@ARMY,Lafayette,Leopards,Army,Black Knights,3-7,8-2,0.0,6,17,13,31,3,3,0,7,3,14,14,0,-5.0,-11,-18,,
1339,1339,2018,11,NCAAF_20181110_MD@IND,Maryland,,Indiana,,5-5,5-5,,15,21,32,34,6,9,8,9,0,21,10,3,0.0,-6,-2,0.3988268509580275,-3.977326874458896
1340,1340,2018,11,NCAAF_20181110_MISS@TXAM,Ole Miss,Rebels,Texas A&M,Aggies,5-5,6-4,0.0,14,14,24,38,0,14,7,3,7,7,7,17,-1.0,0,-14,0.29765948245384055,-8.239697715231557
1341,1341,2018,11,NCAAF_20181110_NAVY@UCF,Navy,Midshipmen,UCF,Knights,2-8,9-0,0.0,3,21,24,35,0,3,7,14,14,7,7,7,-7.0,-18,-11,0.08214340278793997,-21.575600968023934
1342,1342,2018,11,NCAAF_20181110_OHIOST@MICHST,Ohio State,Buckeyes,Michigan St.,Spartans,9-1,6-4,0.0,7,3,26,6,0,7,2,17,0,3,3,0,3.0,4,20,0.8253291189348213,14.518207982011205
1343,1343,2018,11,NCAAF_20181110_SC@FLA,South Carolina,Gamecocks,Florida,Gators,5-4,7-3,0.0,21,14,31,35,14,7,10,0,0,14,7,14,-2.0,7,-4,0.5125248315484148,0.4871157293902968
1344,1344,2018,11,NCAAF_20181110_SMU@UCONN,SMU,,UConn,,5-5,1-9,,31,10,62,50,17,14,14,17,7,3,14,26,4.0,21,12,0.913754796882642,21.163690320926975
1345,1345,2018,11,NCAAF_20181110_TCU@WVU,TCU,Horned Frogs,West Virginia,Mountaineers,4-6,8-1,0.0,3,24,10,47,3,0,7,0,0,24,16,7,-4.0,-21,-37,0.6163803951755358,4.591696097597293
1346,1346,2018,11,NCAAF_20181110_TULSA@MEMP,Tulsa,,Memphis,,2-8,6-4,,0,27,21,47,0,0,14,7,17,10,7,13,-4.0,-27,-26,0.15495859798563716,-15.751949991863228
1347,1347,2018,11,NCAAF_20181110_VANDY@MIZZOU,Vanderbilt,,Missouri,,4-6,6-4,,21,13,28,33,14,7,7,0,7,6,13,7,-2.0,8,-5,0.18280790989119122,-14.034963022950706
1348,1348,2018,11,NCAAF_20181110_WISC@PSU,Wisconsin,Badgers,Penn State,Nittany Lions,6-4,7-3,0.0,7,16,10,22,7,0,3,0,10,6,3,3,-1.0,-9,-12,0.33966673478111387,-6.412699702940387
1349,1349,2018,11,NCAAF_20181110_UNC@DUKE,North Carolina,,Duke,,1-8,7-3,,28,35,35,42,14,14,0,7,14,21,7,0,-6.0,-7,-7,0.19721186322118045,-13.211314086442428
1350,1350,2018,11,NCAAF_20181110_TROY@GAS,Troy,,Ga. Southern,,8-2,7-3,,17,14,35,21,3,14,11,7,14,0,0,7,1.0,3,14,0.7646349064453642,11.189476691595445
1351,1351,2018,11,NCAAF_20181110_UCLA@ARIZST,UCLA,,Arizona St.,,2-8,6-4,,14,17,28,31,7,7,7,7,3,14,7,7,-4.0,-3,-3,0.35447949963321257,-5.790340120208242
1352,1352,2018,11,NCAAF_20181110_CHARLO@MRSHL,Charlotte,,Marshall,,4-6,6-3,,10,13,13,30,7,3,3,0,10,3,17,0,-2.0,-3,-17,0.08730727291848028,-21.059434656481784
1353,1353,2018,11,NCAAF_20181110_BGREEN@CMICH,Bowling Green,,C. Michigan,,2-8,1-10,,0,13,24,13,0,0,17,7,7,6,0,0,1.0,-13,11,0.2515752478306372,-10.386663908243918
1354,1354,2018,11,NCAAF_20181110_LIB@UVA,Liberty,Flames,Virginia,Cavaliers,4-5,7-3,0.0,17,24,24,45,7,10,7,0,14,10,14,7,-3.0,-7,-21,0.10925293755944998,-19.08905382294114
1355,1355,2018,11,NCAAF_20181110_MTSU@UTEP,Middle Tenn.,,UTEP,,7-3,1-9,,27,10,48,32,14,13,7,14,0,10,0,22,6.0,17,16,0.9330290029306626,23.250069641183728
1356,1356,2018,11,NCAAF_20181110_BAYLOR@IOWAST,Baylor,Bears,Iowa St.,Cyclones,5-5,6-3,0.0,0,17,14,28,0,0,7,7,7,10,11,0,-1.0,-17,-14,0.1070705158338301,-19.27130395995647
1357,1357,2018,11,NCAAF_20181110_MICH@RUT,Michigan,Wolverines,Rutgers,Scarlet Knights,9-1,1-9,0.0,21,7,42,7,7,14,14,7,7,0,0,0,8.0,14,35,0.9873136540291866,34.68236842743309
1358,1358,2018,11,NCAAF_20181110_MISSST@BAMA,Miss. State,Bulldogs,Alabama,Crimson Tide,6-4,10-0,0.0,0,21,0,24,0,0,0,0,14,7,0,3,-4.0,-21,-24,0.1212636700389279,-18.13006699325757
1359,1359,2018,11,NCAAF_20181110_NMEX@AF,New Mexico,Lobos,Air Force,Falcons,3-7,4-6,0.0,17,21,24,42,0,17,7,0,7,14,14,7,-1.0,-4,-18,0.26647375860866307,-9.672626484551586
1360,1360,2018,11,NCAAF_20181110_NTEXAS@ODU,North Texas,,Old Dominion,,7-3,3-7,,28,10,31,34,14,14,3,0,0,10,14,10,4.0,18,-3,0.8150494786660873,13.909968612697725
1361,1361,2018,11,NCAAF_20181110_NWEST@IOWA,Northwestern,Wildcats,Iowa,Hawkeyes,6-4,6-4,0.0,0,3,14,10,0,0,7,7,0,3,7,0,0.0,-3,4,0.3068102697150441,-7.832759380127328
1362,1362,2018,11,NCAAF_20181110_OKLAST@OKLA,Oklahoma State,Cowboys,Oklahoma,Sooners,5-5,9-1,0.0,28,34,47,48,14,14,7,12,14,20,7,7,-4.0,-6,-1,0.2209207430678819,-11.930938410647371
1363,1363,2018,11,NCAAF_20181110_PURDUE@MINN,Purdue,,Minnesota,,5-5,5-5,,3,13,10,41,3,0,0,7,3,10,21,7,0.0,-10,-31,0.8060855055041072,13.396522621904836
1364,1364,2018,11,NCAAF_20181110_UK@TENN,Kentucky,Wildcats,Tennessee,Volunteers,7-3,5-5,0.0,0,17,7,24,0,0,7,0,3,14,7,0,2.0,-17,-17,0.7269903436459064,9.365821746177744
1365,1365,2018,11,NCAAF_20181110_VATECH@PITT,Virginia Tech,,Pittsburgh,,4-5,6-4,,7,31,22,52,0,7,8,7,10,21,7,14,-2.0,-24,-30,0.7025334163231781,8.248336305866985
1366,1366,2018,11,NCAAF_20181110_WASHST@COLO,Washington St.,Cougars,Colorado,Buffaloes,9-1,5-5,0.0,10,7,31,7,0,10,7,14,7,0,0,0,4.0,3,24,0.6896016453437276,7.674670957406647
1367,1367,2018,11,NCAAF_20181110_APLST@TXSTSM,App. St.,,Texas St.,,7-2,3-7,,21,0,38,7,7,14,7,10,0,0,7,0,4.0,21,31,0.9552419699985103,26.340584277468736
1368,1368,2018,11,NCAAF_20181110_ECU@TULANE,East Carolina,,Tulane,,2-7,5-5,,10,14,18,24,3,7,0,8,7,7,7,3,-3.0,-4,-6,0.17194405377396282,-14.68332950741518
1369,1369,2018,11,NCAAF_20181110_SJST@UTAHST,San Jose St.,,Utah St.,,1-9,9-1,,10,38,24,62,7,3,7,7,10,28,21,3,-8.0,-28,-38,0.02462325762667672,-30.505780025018396
1370,1370,2018,11,NCAAF_20181110_ARKST@CSTCAR,Arkansas St.,,C. Carolina,,6-4,5-5,,27,6,44,16,14,13,14,3,0,6,7,3,1.0,21,28,0.7771212856468184,11.828858442933097
1371,1371,2018,11,NCAAF_20181110_GAST@LALAF,Georgia St.,,Louisiana,,2-8,5-5,,7,13,22,36,0,7,7,8,7,6,3,20,-3.0,-6,-14,0.49129527982139476,-0.33851520235626253
1372,1372,2018,11,NCAAF_20181110_LAMON@SALA,UL-Monroe,,South Alabama,,6-4,2-8,,24,10,38,10,10,14,14,0,7,3,0,0,4.0,14,28,0.6129279445964615,4.451619423031104
1373,1373,2018,11,NCAAF_20181110_WKY@FAU,W. Kentucky,,FAU,,1-9,5-5,,9,10,15,34,0,9,0,6,10,0,7,17,-4.0,-1,-19,0.09381502901595207,-20.440426687847236
1374,1374,2018,11,NCAAF_20181110_OREG@UTAH,Oregon,Ducks,Utah,Utes,6-4,7-3,0.0,7,19,25,32,0,7,10,8,10,9,3,10,-1.0,-12,-7,0.39296788342868816,-4.213237143650247
1375,1375,2018,11,NCAAF_20181110_AUBURN@UGA,Auburn,Tigers,Georgia,Bulldogs,6-4,9-1,0.0,10,20,10,27,7,3,0,0,3,17,0,7,-3.0,-10,-17,0.3184856851945591,-7.321220539036318
1376,1376,2018,11,NCAAF_20181110_FIU@TXSA,FIU,,UTSA,,7-3,3-7,,17,0,45,7,0,17,7,21,0,0,0,7,4.0,17,38,0.6773453875285593,7.140506109475837
1377,1377,2018,11,NCAAF_20181110_MIAMI@GATECH,Miami (Fla.),,Georgia Tech,,5-5,6-4,,14,17,21,27,7,7,0,7,14,3,10,0,-1.0,-3,-6,0.5829355613333711,3.2485873265253247
1378,1378,2018,11,NCAAF_20181110_RICE@LATECH,Rice,,Louisiana Tech,,1-10,7-3,,3,7,13,28,0,3,7,3,0,7,14,7,-6.0,-4,-15,0.0989612648371756,-19.973023755605
1379,1379,2018,11,NCAAF_20181110_SFLA@CINCY,South Florida,,Cincinnati,,7-3,9-1,,16,14,23,35,9,7,7,0,7,7,21,0,-2.0,2,-12,0.6379856109434678,5.477363574158716
1380,1380,2018,11,NCAAF_20181110_TEMPLE@HOU,Temple,Owls,Houston,Cougars,6-4,7-3,0.0,28,14,59,49,14,14,21,10,7,7,21,14,-1.0,14,10,0.37493057975217736,-4.945928649521591
1381,1381,2018,11,NCAAF_20181110_FSU@ND,Florida State,Seminoles,Notre Dame,Fighting Irish,4-6,10-0,0.0,6,32,13,42,0,6,7,0,17,15,3,7,-6.0,-26,-29,0.2212948196691591,-11.911395883548266
1382,1382,2018,11,NCAAF_20181110_LSU@ARK,LSU,Tigers,Arkansas,Razorbacks,8-2,2-8,0.0,14,3,24,17,7,7,10,0,0,3,0,14,6.0,11,7,0.9210478498517032,21.906921869212397
1383,1383,2018,11,NCAAF_20181110_TEXAS@TXTECH,Texas,Longhorns,Texas Tech,Red Raiders,7-3,5-5,0.0,17,10,41,34,0,17,10,14,7,3,0,24,2.0,7,7,0.5469343943121289,1.8293030793743696
1384,1384,2018,11,NCAAF_20181110_CLEM@BC,Clemson,Tigers,Boston College,Eagles,10-0,7-3,0.0,13,7,27,7,10,3,7,7,7,0,0,0,3.0,6,20,0.9040011669568977,20.239838430720795
1385,1385,2018,11,NCAAF_20181110_OREGST@STNFRD,Oregon State,Beavers,Stanford,Cardinal,2-8,6-4,0.0,17,34,17,48,7,10,0,0,13,21,7,7,-4.0,-17,-31,0.023556335720175237,-30.797965073568207
1386,1386,2018,11,NCAAF_20181110_CAL@USC,California,,USC,,6-4,5-5,,0,14,15,14,0,0,15,0,0,14,0,0,1.0,-14,1,0.3027843163791384,-8.011114601925215
1387,1387,2018,11,NCAAF_20181110_COLOST@NEVADA,Colorado St.,,Nevada,,3-7,6-4,,0,28,10,49,0,0,0,10,7,21,21,0,-3.0,-28,-39,0.5849142529608962,3.327277752206072
1388,1388,2018,11,NCAAF_20181110_UNLV@SDGST,UNLV,,San Diego St.,,3-7,7-3,,13,14,27,24,6,7,0,14,0,14,10,0,-4.0,-1,3,0.11746447062873311,-18.425817467645373
1389,1389,2018,11,NCAAF_20181109_LVILLE@CUSE,Louisville,Cardinals,Syracuse,Orange,2-8,8-2,0.0,7,37,23,54,0,7,7,9,7,30,7,10,-6.0,-30,-31,0.41264477673883926,-3.4244708186648722
1390,1390,2018,11,NCAAF_20181109_FRESNO@BOISE,Fresno St.,Bulldogs,Boise St.,Broncos,8-2,8-2,0.0,10,3,17,24,0,10,7,0,3,0,7,14,0.0,7,-7,0.4840013196906302,-0.6222852616071464
1391,1391,2018,11,NCAAF_20181108_WAKE@NCST,Wake Forest,Demon Deacons,NC State,Wolfpack,5-5,6-3,0.0,3,13,27,23,0,3,10,14,6,7,3,7,-1.0,-10,4,0.3692983344604477,-5.176916667704177
1392,1392,2018,11,NCAAF_20181107_OHIO@MIAOH,Ohio,Bobcats,Miami-OH,RedHawks,6-4,4-6,0.0,7,28,28,30,7,0,7,14,7,21,0,2,2.0,-21,-2,0.7331114184687728,9.653042511584715
1393,1393,2018,11,NCAAF_20181107_TOLEDO@NILL,Toledo,,N. Illinois,,5-5,7-3,,9,17,15,38,3,6,0,6,7,10,14,7,-2.0,-8,-23,0.5836696530782329,3.277771501204711
1394,1394,2018,11,NCAAF_20181106_KENTST@BUFF,Kent St.,Golden Flashes,Buffalo,Bulls,2-8,9-1,0.0,0,34,14,48,0,0,0,14,21,13,14,0,-7.0,-34,-34,0.06714858140298452,-23.228861273358746
1395,1395,2018,12,NCAAF_20181117_ARK@MISSST,Arkansas,Razorbacks,Miss. State,Bulldogs,2-9,7-4,0.0,3,17,6,52,0,3,3,0,3,14,21,14,-5.0,-14,-46,0.08869196752898811,-20.92633366979271
1396,1396,2018,12,NCAAF_20181117_CIT@BAMA,The Citadel,Bulldogs,Alabama,Crimson Tide,4-6,11-0,0.0,10,10,17,50,0,10,0,7,7,3,27,13,-7.0,0,-33,4.1124125673253076e-05,-61.09092813762561
1397,1397,2018,12,NCAAF_20181117_COLG@ARMY,Colgate,Raiders,Army,Black Knights,9-1,9-2,0.0,0,14,14,28,0,0,7,7,7,7,0,14,0.0,-14,-14,0.04018380828675994,-27.12739409838798
1398,1398,2018,12,NCAAF_20181117_IDAHO@FLA,Idaho,Vandals,Florida,Gators,4-7,8-3,0.0,0,49,10,63,0,0,3,7,28,21,7,7,-4.0,-49,-53,0.047886796241868534,-25.84190464767687
1399,1399,2018,12,NCAAF_20181117_MICHST@NEB,Michigan St.,Spartans,Nebraska,Cornhuskers,6-5,4-7,0.0,3,0,6,9,3,0,0,3,0,0,0,9,2.0,3,-3,0.7879026686727768,12.398375983895335
1400,1400,2018,12,NCAAF_20181117_MTSU@UK,Middle Tenn.,Blue Raiders,Kentucky,Wildcats,7-4,8-3,0.0,10,24,23,34,0,10,6,7,17,7,7,3,-1.0,-14,-11,0.25410573264000824,-10.2645590379542
1401,1401,2018,12,NCAAF_20181117_NWEST@MINN,Northwestern,,Minnesota,,7-4,5-6,,13,7,24,14,7,6,0,11,0,7,0,7,2.0,6,10,0.7235606084886087,9.206907397711461
1402,1402,2018,12,NCAAF_20181117_PITT@WAKE,Pittsburgh,,Wake Forest,,7-4,5-6,,6,10,34,13,0,6,14,14,3,7,0,3,2.0,-4,21,0.45732244550772794,-1.6628329286709231
1403,1403,2018,12,NCAAF_20181117_PSU@RUT,Penn State,Nittany Lions,Rutgers,Scarlet Knights,8-3,1-10,0.0,13,0,20,7,3,10,0,7,0,0,0,7,7.0,13,13,0.9929817595013885,38.10787268269155
1404,1404,2018,12,NCAAF_20181117_SFLA@TEMPLE,South Florida,,Temple,,7-4,7-4,,17,0,17,27,7,10,0,0,0,0,10,17,0.0,17,-10,0.5094591480762269,0.36788402389595376
1405,1405,2018,12,NCAAF_20181117_TCU@BAYLOR,TCU,,Baylor,,5-6,5-6,,9,6,16,9,3,6,7,0,6,0,3,0,0.0,3,7,0.8617274022989587,16.88116042600052
1406,1406,2018,12,NCAAF_20181117_NCST@LVILLE,NC State,Wolfpack,Louisville,Cardinals,7-3,2-9,0.0,17,3,52,10,7,10,21,14,3,0,0,7,5.0,14,42,0.7313900906161493,9.572587456012798
1407,1407,2018,12,NCAAF_20181117_UTAH@COLO,Utah,,Colorado,,8-3,5-6,,7,7,30,7,0,7,17,6,7,0,0,0,3.0,0,23,0.7535668868484011,10.63894713233276
1408,1408,2018,12,NCAAF_20181117_FIU@CHARLO,FIU,,Charlotte,,8-3,4-7,,20,14,42,35,10,10,7,15,7,7,7,14,4.0,6,7,0.8513919881952176,16.17230346773829
1409,1409,2018,12,NCAAF_20181117_UTAHST@COLOST,Utah St.,,Colorado St.,,10-1,3-8,,10,7,29,24,3,7,10,9,0,7,3,14,7.0,3,5,0.8074924471981137,13.477041370088045
1410,1410,2018,12,NCAAF_20181117_VMI@ODU,VMI,,Old Dominion,,1-10,4-7,,0,49,14,77,0,0,14,0,21,28,14,14,-3.0,-49,-63,0.001149111201894204,-47.298255997617275
1411,1411,2018,12,NCAAF_20181117_CUSE@ND,Syracuse,Orange,Notre Dame,Fighting Irish,8-3,11-0,0.0,0,20,3,36,0,0,0,3,13,7,9,7,-3.0,-20,-33,0.20977928455105688,-12.522833398306034
1412,1412,2018,12,NCAAF_20181117_GAST@APLST,Georgia St.,,App. St.,,2-9,8-2,,7,17,17,45,7,0,3,7,14,3,14,14,-6.0,-10,-28,0.10985436738301002,-19.040575067119562
1413,1413,2018,12,NCAAF_20181117_TXSA@MRSHL,UTSA,,Marshall,,3-8,7-3,,0,20,0,23,0,0,0,0,10,10,3,0,-4.0,-20,-23,0.16917706516698705,-14.853603438117375
1414,1414,2018,12,NCAAF_20181117_LAMON@ARKST,UL-Monroe,,Arkansas St.,,6-5,7-4,,7,17,17,31,0,7,10,0,7,10,14,0,-1.0,-10,-14,0.25731867124024443,-10.109553440564696
1415,1415,2018,12,NCAAF_20181117_NEVADA@SJST,Nevada,,San Jose St.,,7-4,1-10,,7,6,21,12,0,7,7,7,6,0,6,0,6.0,1,9,0.8870867879836926,18.79044060677211
1416,1416,2018,12,NCAAF_20181117_WCAR@UNC,W. Carolina,,North Carolina,,3-8,2-8,,16,35,26,49,7,9,3,7,14,21,14,0,1.0,-19,-23,0.0012076244995244956,-47.06626937676697
1417,1417,2018,12,NCAAF_20181117_BC@FSU,Boston College,Eagles,Florida State,Seminoles,7-4,5-6,0.0,7,6,21,22,0,7,7,7,0,6,7,9,2.0,1,-1,0.6140469669563628,4.497284834503944
1418,1418,2018,12,NCAAF_20181117_BGREEN@AKRON,Bowling Green,,Akron,,3-8,4-6,,7,6,21,6,0,7,7,7,3,3,0,0,-1.0,1,15,0.30898534628258423,-7.73735320426681
1419,1419,2018,12,NCAAF_20181117_IOWA@ILL,Iowa,Hawkeyes,Illinois,Fighting Illini,7-4,4-7,0.0,35,0,63,0,7,28,14,14,0,0,0,0,3.0,35,63,0.9639477585314193,27.901563101043052
1420,1420,2018,12,NCAAF_20181117_LATECH@USM,Louisiana Tech,,So. Miss,,7-4,5-5,,17,14,20,21,7,10,0,3,7,7,0,7,2.0,3,-1,0.5092808035488503,0.36094660681158075
1421,1421,2018,12,NCAAF_20181117_MIAMI@VATECH,Miami (Fla.),,Virginia Tech,,6-5,4-6,,17,14,38,14,3,14,21,0,7,7,0,0,2.0,3,24,0.5913157317066435,3.5826979367466265
1422,1422,2018,12,NCAAF_20181117_MIZZOU@TENN,Missouri,Tigers,Tennessee,Volunteers,7-4,5-6,0.0,26,10,50,17,6,20,14,10,0,10,7,0,2.0,16,33,0.8160354099585096,13.968315266274772
1423,1423,2018,12,NCAAF_20181117_TULSA@NAVY,Tulsa,Golden Hurricane,Navy,Midshipmen,2-9,3-8,0.0,16,27,29,37,7,9,0,13,7,20,3,7,-1.0,-11,-8,0.2978938888969367,-8.229759080237727
1424,1424,2018,12,NCAAF_20181117_TXSTSM@TROY,Texas St.,,Troy,,3-8,9-2,,0,9,7,12,0,0,0,7,3,6,0,3,-6.0,-9,-5,0.05686983684140201,-24.53727997464148
1425,1425,2018,12,NCAAF_20181117_TXTECH@KSTATE,Texas Tech,,Kansas State,,5-6,5-6,,6,10,6,21,6,0,0,0,0,10,5,6,0.0,-4,-15,0.6825685165313431,7.367572034623663
1426,1426,2018,12,NCAAF_20181117_USC@UCLA,USC,,UCLA,,5-6,3-8,,24,21,27,34,10,14,3,0,14,7,0,13,2.0,3,-7,0.6988045981386635,8.082342242972686
1427,1427,2018,12,NCAAF_20181117_WVU@OKLAST,West Virginia,Mountaineers,Oklahoma State,Cowboys,8-2,6-5,0.0,31,14,41,45,14,17,0,10,7,7,10,21,2.0,17,-4,0.4383079565532355,-2.408737078191052
1428,1428,2018,12,NCAAF_20181117_AF@WYO,Air Force,,Wyoming,,4-7,5-6,,17,14,27,35,7,10,7,3,14,0,0,21,-1.0,3,-8,0.5580961255268377,2.2673007045519853
1429,1429,2018,12,NCAAF_20181117_IND@MICH,Indiana,Hoosiers,Michigan,Wolverines,5-6,10-1,0.0,17,15,20,31,7,10,0,3,3,12,10,6,-5.0,2,-11,0.10251813848279046,-19.661605796862887
1430,1430,2018,12,NCAAF_20181117_LIB@AUBURN,Liberty,Flames,Auburn,Tigers,4-6,7-4,0.0,0,32,0,53,0,0,0,0,15,17,21,0,-3.0,-32,-53,0.009775716949402824,-36.223184707305904
1431,1431,2018,12,NCAAF_20181117_MA@UGA,UMass,Minutemen,Georgia,Bulldogs,4-8,10-1,0.0,13,42,27,66,7,6,7,7,14,28,17,7,-6.0,-29,-39,0.0022357486335792265,-44.10411347078434
1432,1432,2018,12,NCAAF_20181117_OREGST@WASH,Oregon State,Beavers,Washington,Huskies,2-9,8-3,0.0,16,35,23,42,3,13,0,7,28,7,7,0,-6.0,-19,-19,0.007304582896940692,-37.88442153514427
1433,1433,2018,12,NCAAF_20181117_GAS@CSTCAR,Ga. Southern,,C. Carolina,,8-3,5-6,,13,10,41,17,3,10,21,7,7,3,0,7,3.0,3,24,0.6475160910189686,5.874018330546505
1434,1434,2018,12,NCAAF_20181117_SALA@LALAF,South Alabama,,Louisiana,,2-9,6-5,,17,24,38,48,0,17,7,14,10,14,17,7,-4.0,-7,-10,0.3645573776622665,-5.372605557649308
1435,1435,2018,12,NCAAF_20181117_DUKE@CLEM,Duke,Blue Devils,Clemson,Tigers,7-4,11-0,0.0,6,14,6,35,6,0,0,0,0,14,14,7,-4.0,-8,-29,0.05953857104051341,-24.18128332759386
1436,1436,2018,12,NCAAF_20181117_UAB@TXAM,UAB,,Texas A&M,,9-2,7-4,,7,24,20,41,7,0,0,13,14,10,10,7,2.0,-17,-21,0.14184311362096136,-16.63234739871598
1437,1437,2018,12,NCAAF_20181117_UCONN@ECU,UConn,Huskies,East Carolina,Pirates,1-10,3-7,0.0,21,34,21,55,7,14,0,0,7,27,14,7,-2.0,-13,-34,0.3808135527933536,-4.706139866414105
1438,1438,2018,12,NCAAF_20181117_KANSAS@OKLA,Kansas,Jayhawks,Oklahoma,Sooners,3-8,10-1,0.0,10,21,40,55,7,3,7,23,7,14,14,20,-7.0,-11,-15,0.008557159332830855,-36.989520669959575
1439,1439,2018,12,NCAAF_20181117_RICE@LSU,Rice,Owls,LSU,Tigers,1-11,9-2,0.0,3,28,10,42,0,3,0,7,14,14,7,7,-8.0,-25,-32,0.001914065318293856,-44.8667587499217
1440,1440,2018,12,NCAAF_20181117_TNCHAT@SC,Chattanooga,,South Carolina,,6-5,6-4,,3,28,9,49,0,3,0,6,14,14,7,14,0.0,-25,-40,0.03942961060050487,-27.263713665745968
1441,1441,2018,12,NCAAF_20181117_UTEP@WKY,UTEP,,W. Kentucky,,1-10,2-9,,0,40,16,40,0,0,8,8,27,13,0,0,-1.0,-40,-24,0.22680726255081574,-11.626353498440494
1442,1442,2018,12,NCAAF_20181117_CINCY@UCF,Cincinnati,Bearcats,UCF,Knights,9-2,10-0,0.0,6,21,13,38,6,0,0,7,7,14,7,10,-1.0,-15,-25,0.08633890607829686,-21.155881341302234
1443,1443,2018,12,NCAAF_20181117_IOWAST@TEXAS,Iowa St.,Cyclones,Texas,Longhorns,6-4,8-3,0.0,3,17,10,24,3,0,0,7,7,10,7,0,-2.0,-14,-14,0.5181510860396187,0.7061073628681243
1444,1444,2018,12,NCAAF_20181117_NMEXST@BYU,New Mexico St.,,BYU,,3-8,6-5,,7,31,10,45,7,0,3,0,7,24,7,7,-3.0,-24,-35,0.19724947454443864,-13.210103824491853
1445,1445,2018,12,NCAAF_20181117_ARIZ@WASHST,Arizona,Wildcats,Washington St.,Cougars,5-6,10-1,0.0,14,55,28,69,7,7,14,0,21,34,0,14,-5.0,-41,-41,0.3375421097931486,-6.503233475001025
1446,1446,2018,12,NCAAF_20181117_ARIZST@OREG,Arizona St.,,Oregon,,6-5,7-4,,13,28,29,31,3,10,3,13,7,21,0,3,-1.0,-15,-2,0.48495639020857495,-0.5851581096907239
1447,1447,2018,12,NCAAF_20181117_SDGST@FRESNO,San Diego St.,Aztecs,Fresno St.,Bulldogs,7-4,9-2,0.0,14,10,14,23,7,7,0,0,7,3,7,6,-2.0,4,-9,0.3393191675198921,-6.427857217297515
1448,1448,2018,12,NCAAF_20181117_UNLV@HAWAII,UNLV,,Hawaii,,3-8,7-5,,21,6,28,35,7,14,0,7,3,3,7,22,-4.0,15,-7,0.6505039759656268,5.999038007411741
1449,1449,2018,12,NCAAF_20181116_BOISE@NMEX,Boise St.,Broncos,New Mexico,Lobos,9-2,3-8,0.0,24,7,45,14,14,10,7,14,0,7,0,7,6.0,17,31,0.9392640608373033,24.02561722259793
1450,1450,2018,12,NCAAF_20181116_MEMP@SMU,Memphis,Tigers,SMU,Mustangs,7-4,5-6,0.0,7,5,28,18,0,7,7,14,3,2,7,6,2.0,2,10,0.6849055436531928,7.469462610662845
1451,1451,2018,12,NCAAF_20181115_TOLEDO@KENTST,Toledo,Rockets,Kent St.,Golden Flashes,6-5,2-9,0.0,28,17,56,34,14,14,21,7,7,10,10,7,4.0,11,22,0.9530412043598816,25.987534174471875
1452,1452,2018,12,NCAAF_20181115_TULANE@HOU,Tulane,Green Wave,Houston,Cougars,5-6,8-3,0.0,9,31,17,48,6,3,0,8,14,17,10,7,-3.0,-22,-31,0.34434078839429505,-6.215669288410254
1453,1453,2018,12,NCAAF_20181115_FAU@NTEXAS,FAU,Owls,North Texas,Mean Green,5-6,8-3,0.0,21,20,38,41,7,14,10,7,17,3,14,7,-3.0,1,-3,0.7427210648321474,10.111464292828487
1454,1454,2018,12,NCAAF_20181114_BUFF@OHIO,Buffalo,Bulls,Ohio,Bobcats,9-2,7-4,0.0,10,31,17,52,7,3,0,7,14,17,14,7,2.0,-21,-35,0.45201245489802544,-1.8706739530279037
1455,1455,2018,12,NCAAF_20181114_MIAOH@NILL,Miami-OH,RedHawks,N. Illinois,Huskies,5-6,7-4,0.0,3,0,13,7,0,3,10,0,0,0,7,0,-2.0,3,6,0.3298554219228279,-6.831077468679723
1456,1456,2018,13,NCAAF_20181124_BAYLOR@TXTECH,Baylor,,Texas Tech,,6-6,5-7,,14,17,35,24,7,7,14,7,10,7,0,7,1.0,-3,11,0.17548621449657031,-14.483490673928372
1457,1457,2018,13,NCAAF_20181124_CUSE@BC,Syracuse,Orange,Boston College,Eagles,9-3,7-5,0.0,28,14,42,21,14,14,7,7,7,7,7,0,2.0,14,21,0.3974566207283544,-4.036409950037239
1458,1458,2018,13,NCAAF_20181124_FLA@FSU,Florida,Gators,Florida State,Seminoles,9-3,5-7,0.0,13,7,41,14,3,10,14,14,0,7,7,0,4.0,6,27,0.5538714614189681,2.1033138199825316
1459,1459,2018,13,NCAAF_20181124_GATECH@UGA,Georgia Tech,Yellow Jackets,Georgia,Bulldogs,7-5,11-1,0.0,7,38,21,45,7,0,0,14,14,24,7,0,-4.0,-31,-24,0.1334631976204954,-17.239234589503496
1460,1460,2018,13,NCAAF_20181124_MICH@OHIOST,Michigan,Wolverines,Ohio State,Buckeyes,10-2,11-1,0.0,19,24,39,62,3,16,0,20,7,17,17,21,-1.0,-5,-23,0.4139546269220481,-3.3756408393192032
1461,1461,2018,13,NCAAF_20181124_MRSHL@FIU,Marshall,,FIU,,8-3,8-4,,14,10,28,25,14,0,7,7,3,7,0,15,0.0,4,3,0.637964121618701,5.481900354109143
1462,1462,2018,13,NCAAF_20181124_NAVY@TULANE,Navy,,Tulane,,3-9,6-6,,3,21,28,29,0,3,18,7,0,21,0,8,-3.0,-18,-1,0.5483653193493431,1.8872137486618499
1463,1463,2018,13,NCAAF_20181124_PURDUE@IND,Purdue,,Indiana,,6-6,5-7,,14,7,28,21,7,7,7,7,0,7,0,14,1.0,7,7,0.6933015466028392,7.845464597609066
1464,1464,2018,13,NCAAF_20181124_WKY@LATECH,W. Kentucky,Hilltoppers,Louisiana Tech,Bulldogs,3-9,7-5,0.0,23,12,30,15,14,9,0,7,0,12,3,0,-4.0,11,15,0.3310087482678463,-6.787957022532169
1465,1465,2018,13,NCAAF_20181124_WAKE@DUKE,Wake Forest,,Duke,,6-6,7-5,,31,7,59,7,21,10,14,14,0,7,0,0,-1.0,24,52,0.467650544369553,-1.2605577153201466
1466,1466,2018,13,NCAAF_20181124_ODU@RICE,Old Dominion,,Rice,,4-8,2-11,,6,13,13,27,3,3,7,0,6,7,7,7,2.0,-7,-14,0.7377977090766936,9.884976213410596
1467,1467,2018,13,NCAAF_20181124_GAS@GAST,Ga. Southern,,Georgia St.,,9-3,2-10,,13,0,35,14,0,13,15,7,0,0,0,14,7.0,13,21,0.661196909278297,6.455686373886067
1468,1468,2018,13,NCAAF_20181124_NMEXST@LIB,New Mexico St.,,Liberty,,3-9,5-6,,14,28,21,28,14,0,0,7,17,11,0,0,-2.0,-14,-7,0.4250735137916324,-2.933809376265117
1469,1469,2018,13,NCAAF_20181124_TROY@APLST,Troy,,App. St.,,9-3,9-2,,3,21,10,21,0,3,7,0,7,14,0,0,0.0,-18,-11,0.39664563325549373,-4.069070544007559
1470,1470,2018,13,NCAAF_20181124_WYO@NMEX,Wyoming,,New Mexico,,6-6,3-9,,14,3,31,3,7,7,3,14,0,3,0,0,3.0,11,28,0.7425306890597491,10.111637846580493
1471,1471,2018,13,NCAAF_20181124_LALAF@LAMON,Louisiana,,UL-Monroe,,7-5,6-6,,24,21,31,28,14,10,0,7,0,21,0,7,1.0,3,3,0.48143261646128976,-0.7229804853182031
1472,1472,2018,13,NCAAF_20181124_STNFRD@UCLA,Stanford,Cardinal,UCLA,Bruins,7-4,3-9,0.0,27,20,49,42,10,17,14,8,6,14,16,6,4.0,7,7,0.7674403881646321,11.342677846832203
1473,1473,2018,13,NCAAF_20181124_UAB@MTSU,UAB,,Middle Tenn.,,9-3,8-4,,3,13,3,27,3,0,0,0,0,13,7,7,1.0,-10,-24,0.46050655220189773,-1.5397678646733652
1474,1474,2018,13,NCAAF_20181124_USM@UTEP,So. Miss,,UTEP,,6-5,1-11,,19,0,39,7,16,3,7,13,0,0,0,7,5.0,19,32,0.8970036943381847,19.638279301775356
1475,1475,2018,13,NCAAF_20181124_ARIZST@ARIZ,Arizona St.,,Arizona,,7-5,5-7,,14,22,41,40,7,7,7,20,10,12,18,0,2.0,-8,1,0.5960189223059584,3.7742883647275676
1476,1476,2018,13,NCAAF_20181124_AUBURN@BAMA,Auburn,Tigers,Alabama,Crimson Tide,7-5,12-0,0.0,14,17,21,52,7,7,7,0,7,10,21,14,-5.0,-3,-31,0.19754914693218217,-13.20554673328536
1477,1477,2018,13,NCAAF_20181124_ILL@NWEST,Illinois,Fighting Illini,Northwestern,Wildcats,4-8,8-4,0.0,6,21,16,24,3,3,0,10,7,14,3,0,-4.0,-15,-8,0.06867754380786517,-23.07086806400025
1478,1478,2018,13,NCAAF_20181124_MD@PSU,Maryland,Terrapins,Penn State,Nittany Lions,5-7,9-3,0.0,3,17,3,38,3,0,0,0,14,3,7,14,-4.0,-14,-35,0.05162676253639098,-25.300265168556393
1479,1479,2018,13,NCAAF_20181124_MINN@WISC,Minnesota,Golden Gophers,Wisconsin,Badgers,6-6,7-5,0.0,17,7,37,15,3,14,6,14,0,7,0,8,-1.0,10,22,0.13351409642601086,-17.235566009367574
1480,1480,2018,13,NCAAF_20181124_PITT@MIAMI,Pittsburgh,,Miami (Fla.),,7-5,7-5,,0,10,3,24,0,0,3,0,3,7,7,7,0.0,-10,-21,0.30125653459100243,-8.087079093103853
1481,1481,2018,13,NCAAF_20181124_SMU@TULSA,SMU,,Tulsa,,5-7,3-9,,7,21,24,27,0,7,7,10,7,14,3,3,2.0,-14,-3,0.7209600530024269,9.09496919261727
1482,1482,2018,13,NCAAF_20181124_TEMPLE@UCONN,Temple,,UConn,,8-4,1-11,,40,7,57,7,13,27,7,10,7,0,0,0,7.0,33,50,0.9340579410345001,23.39697566233872
1483,1483,2018,13,NCAAF_20181124_ARKST@TXSTSM,Arkansas St.,,Texas St.,,8-4,3-9,,7,0,33,7,7,0,21,5,0,0,7,0,5.0,7,26,0.9003235504522137,19.929215067983932
1484,1484,2018,13,NCAAF_20181124_RUT@MICHST,Rutgers,,Michigan St.,,1-11,7-5,,7,7,10,14,7,0,0,3,0,7,0,7,-6.0,0,-4,0.08149947999829188,-21.663104131327714
1485,1485,2018,13,NCAAF_20181124_TENN@VANDY,Tennessee,,Vanderbilt,,5-7,6-6,,0,17,13,38,0,0,7,6,7,10,0,21,-1.0,-17,-25,0.44860432080920754,-2.0060986630882667
1486,1486,2018,13,NCAAF_20181124_CHARLO@FAU,Charlotte,,FAU,,5-7,5-7,,10,21,27,24,10,0,7,10,7,14,0,3,0.0,-11,3,0.04762021993794496,-25.90740208674913
1487,1487,2018,13,NCAAF_20181124_COLO@CAL,Colorado,,California,,5-7,7-4,,7,24,21,33,0,7,14,0,21,3,3,6,-2.0,-17,-12,0.4517206865366923,-1.8838412737724752
1488,1488,2018,13,NCAAF_20181124_KSTATE@IOWAST,Kansas State,Wildcats,Iowa St.,Cyclones,5-7,7-4,0.0,21,14,38,42,0,21,10,7,7,7,7,21,-2.0,7,-4,0.29200081300813263,-8.50260555131399
1489,1489,2018,13,NCAAF_20181124_NTEXAS@TXSA,North Texas,,UTSA,,9-3,3-9,,17,14,24,21,10,7,7,0,0,14,0,7,6.0,3,3,0.772645175465272,11.608883844886691
1490,1490,2018,13,NCAAF_20181124_SC@CLEM,South Carolina,Gamecocks,Clemson,Tigers,6-5,12-0,0.0,21,28,35,56,7,14,0,14,14,14,14,14,-6.0,-7,-21,0.064280377748543,-23.60022015575845
1491,1491,2018,13,NCAAF_20181124_SJST@FRESNO,San Jose St.,,Fresno St.,,1-11,10-2,,0,3,13,31,0,0,0,13,0,3,14,14,-9.0,-3,-18,0.014310386962628652,-33.98673943895494
1492,1492,2018,13,NCAAF_20181124_UK@LVILLE,Kentucky,Wildcats,Louisville,Cardinals,9-3,2-10,0.0,35,10,56,10,14,21,0,21,7,3,0,0,7.0,25,46,0.617963329856074,4.660658639057203
1493,1493,2018,13,NCAAF_20181124_ND@USC,Notre Dame,Fighting Irish,USC,Trojans,12-0,5-7,0.0,7,10,24,17,0,7,10,7,7,3,0,7,7.0,-3,7,0.818569491280187,14.129786437149107
1494,1494,2018,13,NCAAF_20181124_OKLAST@TCU,Oklahoma State,,TCU,,6-6,6-6,,3,7,24,31,3,0,7,14,0,7,17,7,0.0,-4,-7,0.5588334889371558,2.2984073696065934
1495,1495,2018,13,NCAAF_20181124_NEVADA@UNLV,Nevada,Wolf Pack,UNLV,Rebels,7-5,4-8,0.0,26,21,29,34,20,6,0,3,0,21,7,6,3.0,5,-5,0.6931829466194668,7.840220205870821
1496,1496,2018,13,NCAAF_20181124_BYU@UTAH,BYU,Cougars,Utah,Utes,6-6,9-3,0.0,20,0,27,35,13,7,7,0,0,0,14,21,-3.0,20,-8,0.15079733053559874,-16.04123028208022
1497,1497,2018,13,NCAAF_20181124_UTAHST@BOISE,Utah St.,Aggies,Boise St.,Broncos,10-2,10-2,0.0,14,17,24,33,7,7,0,10,7,10,3,13,0.0,-3,-9,0.3808992165673363,-4.706993595179711
1498,1498,2018,13,NCAAF_20181123_AKRON@OHIO,Akron,,Ohio,,4-7,8-4,,7,28,28,49,0,7,7,14,21,7,7,14,-4.0,-21,-21,0.17445265313652603,-14.545759832124531
1499,1499,2018,13,NCAAF_20181123_BUFF@BGREEN,Buffalo,,Bowling Green,,10-2,3-9,,34,7,44,14,13,21,7,3,7,0,0,7,7.0,27,30,0.8363578526107387,15.211681029099964
1500,1500,2018,13,NCAAF_20181123_CMICH@TOLEDO,C. Michigan,,Toledo,,1-11,7-5,,0,24,13,51,0,0,0,13,14,10,13,14,-6.0,-24,-38,0.2506332953753829,-10.442877273756096
1501,1501,2018,13,NCAAF_20181123_EMICH@KENTST,E. Michigan,,Kent St.,,7-5,2-10,,21,10,28,20,7,14,7,0,10,0,7,3,5.0,11,8,0.9216042475106249,21.987484456674906
1502,1502,2018,13,NCAAF_20181123_HOU@MEMP,Houston,,Memphis,,8-4,8-4,,21,17,31,52,7,14,10,0,3,14,14,21,0.0,4,-21,0.45392930564738665,-1.7972665680631508
1503,1503,2018,13,NCAAF_20181123_NEB@IOWA,Nebraska,Cornhuskers,Iowa,Hawkeyes,4-8,8-4,0.0,13,21,28,31,7,6,0,15,7,14,7,3,-4.0,-8,-3,0.1010252363288533,-19.810174897453294
1504,1504,2018,13,NCAAF_20181123_TEXAS@KANSAS,Texas,Longhorns,Kansas,Jayhawks,9-3,3-9,0.0,7,0,24,17,7,0,14,3,0,0,0,17,6.0,7,7,0.9482707412049177,25.28523325564157
1505,1505,2018,13,NCAAF_20181123_ARK@MIZZOU,Arkansas,Razorbacks,Missouri,Tigers,2-10,8-4,0.0,0,28,0,38,0,0,0,0,7,21,10,0,-6.0,-28,-38,0.10909160582998623,-19.121363097847166
1506,1506,2018,13,NCAAF_20181123_CSTCAR@SALA,C. Carolina,,South Alabama,,5-7,3-9,,7,24,28,31,0,7,7,14,10,14,7,0,2.0,-17,-3,0.5601733685448353,2.3511488049546756
1507,1507,2018,13,NCAAF_20181123_ECU@CINCY,East Carolina,Pirates,Cincinnati,Bearcats,3-8,10-2,0.0,6,42,6,56,0,6,0,0,21,21,7,7,-7.0,-36,-50,0.22186412857081006,-11.893462726809332
1508,1508,2018,13,NCAAF_20181123_OREG@OREGST,Oregon,Ducks,Oregon State,Beavers,8-4,2-10,0.0,21,3,55,15,14,7,13,21,0,3,6,6,6.0,18,40,0.9442830013882251,24.71794017363277
1509,1509,2018,13,NCAAF_20181123_UCF@SFLA,UCF,Knights,South Florida,Bulls,11-0,7-5,0.0,17,3,38,10,7,10,7,14,0,3,7,0,4.0,14,28,0.8860327867102256,18.72264292402656
1510,1510,2018,13,NCAAF_20181123_OKLA@WVU,Oklahoma,Sooners,West Virginia,Mountaineers,11-1,8-3,0.0,35,28,59,56,14,21,10,14,14,14,21,7,3.0,7,3,0.7831847385399746,12.158712612964507
1511,1511,2018,13,NCAAF_20181123_WASH@WASHST,Washington,Huskies,Washington St.,Cougars,9-3,10-2,0.0,14,7,28,15,7,7,6,8,0,7,8,0,-1.0,7,13,0.675125905225333,7.0516714166995484
1512,1512,2018,13,NCAAF_20181122_COLOST@AF,Colorado St.,Rams,Air Force,Falcons,3-9,5-7,0.0,13,17,19,27,0,13,0,6,7,10,0,10,-2.0,-4,-8,0.4236871359816615,-2.9887631739712788
1513,1513,2018,13,NCAAF_20181122_MISSST@MISS,Miss. State,Bulldogs,Ole Miss,Rebels,8-4,5-7,0.0,21,3,35,3,7,14,7,7,0,3,0,0,3.0,18,32,0.8494517621134707,16.057770574385188
1514,1514,2018,13,NCAAF_20181120_BALLST@MIAOH,Ball St.,Cardinals,Miami-OH,RedHawks,4-8,6-6,0.0,21,21,21,42,14,7,0,0,7,14,14,7,-2.0,0,-21,0.10691743853161673,-19.303294204441443
1515,1515,2018,13,NCAAF_20181120_NILL@WMICH,N. Illinois,Huskies,W. Michigan,Broncos,7-5,7-5,0.0,7,13,21,28,7,0,14,0,7,6,8,7,0.0,-6,-7,0.6724861799282396,6.937950887764032
1516,1516,2018,14,NCAAF_20181201_AKRON@SC,Akron,Zips,South Carolina,Gamecocks,4-8,7-5,0.0,3,28,3,28,3,0,0,0,14,14,0,0,-3.0,-25,-25,0.08858518718722341,-21.078404260098978
1517,1517,2018,14,NCAAF_20181201_DRA@IOWAST,Drake,Bulldogs,Iowa St.,Cyclones,7-4,8-4,0.0,14,20,24,27,7,7,10,0,7,13,7,0,-1.0,-6,-3,,
1518,1518,2018,14,NCAAF_20181201_ECU@NCST,East Carolina,Pirates,NC State,Wolfpack,3-9,9-3,0.0,0,27,3,58,0,0,0,3,17,10,14,17,-6.0,-27,-55,0.03693786334408433,-27.917480557504973
1519,1519,2018,14,NCAAF_20181201_LALAF@APLST,Louisiana,Ragin' Cajuns,App. St.,Mountaineers,7-6,10-2,0.0,6,14,19,30,3,3,10,3,7,7,6,10,-3.0,-8,-11,0.12406893802584307,-18.038366025748985
1520,1520,2018,14,NCAAF_20181201_MRSHL@VATECH,Marshall,Thundering Herd,Virginia Tech,Hokies,8-4,6-6,0.0,6,31,20,41,6,0,0,14,10,21,3,7,2.0,-25,-21,0.2534671540633757,-10.365194921186344
1521,1521,2018,14,NCAAF_20181201_TEXAS@OKLA,Texas,Longhorns,Oklahoma,Sooners,9-4,12-1,0.0,14,20,27,39,7,7,13,0,3,17,7,12,-3.0,-6,-12,0.2582835197947614,-10.131335687609408
1522,1522,2018,14,NCAAF_20181201_UAB@MTSU,UAB,Blazers,Middle Tenn.,Blue Raiders,10-3,8-5,0.0,24,16,27,25,3,21,0,3,13,3,6,3,2.0,8,2,0.40782729019391395,-3.641422305322749
1523,1523,2018,14,NCAAF_20181201_NRFST@LIB,Norfolk St.,Spartans,Liberty,Flames,4-7,6-6,0.0,10,38,17,52,3,7,0,7,10,28,7,7,-2.0,-28,-35,,
1524,1524,2018,14,NCAAF_20181201_STNFRD@CAL,Stanford,Cardinal,California,Golden Bears,8-4,7-5,0.0,13,6,23,13,10,3,0,10,0,6,0,7,1.0,7,10,0.7402260534146154,10.059428013148136
1525,1525,2018,14,NCAAF_20181201_MEMP@UCF,Memphis,Tigers,UCF,Knights,8-5,12-0,0.0,38,21,41,56,24,14,3,0,7,14,14,21,-4.0,17,-15,0.21628203855880912,-12.258128097847703
1526,1526,2018,14,NCAAF_20181201_BAMA@UGA,Alabama,Crimson Tide,Georgia,Bulldogs,13-0,11-2,0.0,14,21,35,28,0,14,7,14,7,14,7,0,2.0,-7,7,0.6351477733249788,5.396725611968691
1527,1527,2018,14,NCAAF_20181201_CLEM@PITT,Clemson,Tigers,Pittsburgh,Panthers,13-0,7-6,0.0,28,10,42,10,14,14,0,14,3,7,0,0,6.0,18,32,0.9560274647275179,26.65164214207664
1528,1528,2018,14,NCAAF_20181201_NWEST@OHIOST,Northwestern,Wildcats,Ohio State,Buckeyes,8-5,12-1,0.0,7,24,24,45,7,0,14,3,14,10,7,14,-4.0,-17,-21,0.14376683388254896,-16.611763202394627
1529,1529,2018,14,NCAAF_20181130_NILL@BUFF,N. Illinois,Huskies,Buffalo,Bulls,8-5,10-3,0.0,10,22,30,29,0,10,7,13,7,15,7,0,-2.0,-12,1,0.49143516384329644,-0.3353521836018558
1530,1530,2018,14,NCAAF_20181130_UTAH@WASH,Utah,Utes,Washington,Huskies,9-4,10-3,0.0,0,3,3,10,0,0,3,0,0,3,7,0,-1.0,-3,-7,0.31294021925709214,-7.614880255528192
1531,1531,2018,15,NCAAF_20181208_NAVY@ARMY,Navy,Midshipmen,Army,Black Knights,3-10,10-2,0.0,0,7,10,17,0,0,0,10,7,0,3,7,-7.0,-7,-7,0.3972628808450328,-4.053334893915462
1532,1532,2019,1,NCAAF_20190902_ND@LVILLE,Notre Dame,Fighting Irish,Louisville,Cardinals,1-0,0-1,1.0,21,14,35,17,14,7,7,7,14,0,0,3,1.0,7,18,0.9255830825002492,22.460152396730905
1533,1533,2019,1,NCAAF_20190901_HOU@OKLA,Houston,Cougars,Oklahoma,Sooners,0-1,1-0,1.0,10,21,31,49,0,10,7,14,7,14,21,7,-1.0,-11,-18,0.07839443019632941,-22.029070819880985
1534,1534,2019,1,NCAAF_20190831_AKRON@ILL,Akron,Zips,Illinois,Fighting Illini,0-1,1-0,0.0,3,28,3,42,3,0,0,0,14,14,14,0,-1.0,-25,-39,0.4455073820939639,-2.131727909077199
1535,1535,2019,1,NCAAF_20190831_BOISE@FSU,Boise St.,Broncos,Florida State,Seminoles,1-0,0-1,1.0,19,31,36,31,6,13,7,10,21,10,0,0,1.0,-12,5,0.5676238444539123,2.6499188705603274
1536,1536,2019,1,NCAAF_20190831_ECU@NCST,East Carolina,Pirates,NC State,Wolfpack,0-1,1-0,1.0,3,17,6,34,3,0,0,3,7,10,7,10,-1.0,-14,-28,0.02387952635259105,-30.796670221038426
1537,1537,2019,1,NCAAF_20190831_FAU@OHIOST,FAU,Owls,Ohio State,Buckeyes,0-1,1-0,0.0,3,28,21,45,0,3,3,15,28,0,7,10,-1.0,-25,-24,0.04031699473547701,-27.179697606018976
1538,1538,2019,1,NCAAF_20190831_HOW@MD,Howard,Bison,Maryland,Terrapins,0-1,1-0,0.0,0,56,0,79,0,0,0,0,28,28,16,7,-1.0,-56,-79,0.009073224465566798,-36.75700387189261
1539,1539,2019,1,NCAAF_20190831_IND@BALLST,Indiana,Hoosiers,Ball St.,Cardinals,1-0,0-1,0.0,16,10,34,24,10,6,7,11,3,7,7,7,1.0,6,10,0.9751971755598833,30.545300114243787
1540,1540,2019,1,NCAAF_20190831_INST@KANSAS,Indiana St.,Sycamores,Kansas,Jayhawks,0-1,1-0,0.0,3,10,17,24,0,3,0,14,7,3,6,8,-1.0,-7,-7,0.06278875524359873,-23.831008322722255
1541,1541,2019,1,NCAAF_20190831_MISS@MEMP,Ole Miss,Rebels,Memphis,Tigers,0-1,1-0,1.0,0,13,10,15,0,0,3,7,7,6,0,2,-1.0,-13,-5,0.32997257983126105,-6.845239049343377
1542,1542,2019,1,NCAAF_20190831_MISSST@LALAF,Miss. State,Bulldogs,Louisiana,Ragin' Cajuns,1-0,0-1,1.0,21,14,38,28,7,14,7,10,7,7,0,14,1.0,7,10,0.9888501279258851,35.55294155127001
1543,1543,2019,1,NCAAF_20190831_SALA@NEB,South Alabama,Jaguars,Nebraska,Cornhuskers,0-1,1-0,0.0,7,14,21,35,7,0,14,0,7,7,14,7,-1.0,-7,-14,0.052784818533451405,-25.179160163870392
1544,1544,2019,1,NCAAF_20190831_TOLEDO@UK,Toledo,Rockets,Kentucky,Wildcats,0-1,1-0,1.0,14,14,24,38,7,7,3,7,0,14,10,14,-1.0,0,-14,0.3596792125625423,-5.590155993416602
1545,1545,2019,1,NCAAF_20190831_JMAD@WVU,James Madison,Dukes,West Virginia,Mountaineers,0-1,1-0,1.0,7,3,13,20,7,0,3,3,0,3,7,10,-1.0,4,-7,0.2289658150318019,-11.547852482957751
1546,1546,2019,1,NCAAF_20190831_RI@OHIO,Rhode Island,Rams,Ohio,Bobcats,0-1,1-0,1.0,6,17,20,41,0,6,7,7,7,10,17,7,-1.0,-11,-21,0.016143816280866252,-33.30653035135265
1547,1547,2019,1,NCAAF_20190831_BUCK@TEMPLE,Bucknell,Bison,Temple,Owls,0-1,1-0,0.0,9,35,12,56,0,9,3,0,21,14,7,14,-1.0,-26,-44,,
1548,1548,2019,1,NCAAF_20190831_EWASH@WASH,E. Washington,Eagles,Washington,Huskies,0-1,1-0,1.0,7,28,14,47,0,7,0,7,21,7,14,5,-1.0,-21,-33,0.0011682156090849771,-47.35403762830367
1549,1549,2019,1,NCAAF_20190831_COLG@AF,Colgate,Raiders,Air Force,Falcons,0-2,1-0,1.0,0,35,7,48,0,0,7,0,7,28,13,0,-1.0,-35,-41,0.22204299408691852,-11.906530840056803
1550,1550,2019,1,NCAAF_20190831_DUKE@BAMA,Duke,Blue Devils,Alabama,Crimson Tide,0-1,1-0,0.0,3,14,3,42,0,3,0,0,0,14,21,7,-1.0,-11,-39,0.023970420509077717,-30.771565315420958
1551,1551,2019,1,NCAAF_20190831_EMICH@CSTCAR,E. Michigan,Eagles,C. Carolina,Chanticleers,1-0,0-1,0.0,7,13,30,23,0,7,16,7,10,3,0,10,1.0,-6,7,0.8838743244855023,18.58497515662077
1552,1552,2019,1,NCAAF_20190831_ETNST@APLST,ETSU,Buccaneers,App. St.,Mountaineers,0-1,1-0,1.0,0,14,7,42,0,0,7,0,7,7,14,14,-1.0,-14,-35,7.71103737376988e-05,-58.87322928227309
1553,1553,2019,1,NCAAF_20190831_GAST@TENN,Georgia St.,Panthers,Tennessee,Volunteers,1-0,0-1,0.0,14,17,38,30,7,7,7,17,14,3,3,10,1.0,-3,8,0.126601913961091,-17.77632326163257
1554,1554,2019,1,NCAAF_20190831_HOLY@NAVY,Holy Cross,Crusaders,Navy,Midshipmen,0-1,1-0,0.0,7,24,7,45,0,7,0,0,10,14,14,7,-1.0,-17,-38,0.017950556743266954,-32.64087924308842
1555,1555,2019,1,NCAAF_20190831_IDAHO@PSU,Idaho,Vandals,Penn State,Nittany Lions,0-1,1-0,1.0,0,44,7,79,0,0,0,7,20,24,14,21,-1.0,-44,-72,0.0011817674794631916,-47.30002533035986
1556,1556,2019,1,NCAAF_20190831_SC@UNC,South Carolina,Gamecocks,North Carolina,Tar Heels,0-1,1-0,1.0,13,6,20,24,10,3,7,0,3,3,3,15,-1.0,7,-4,0.8512894959382264,16.21086722740324
1557,1557,2019,1,NCAAF_20190831_MTST@TXTECH,Montana St.,Bobcats,Texas Tech,Red Raiders,0-1,1-0,1.0,7,28,10,45,0,7,0,3,14,14,3,14,-1.0,-21,-35,0.018705056806147424,-32.37973242765736
1558,1558,2019,1,NCAAF_20190831_NWEST@STNFRD,Northwestern,Wildcats,Stanford,Cardinal,0-1,1-0,0.0,0,10,7,17,0,0,0,7,0,10,0,7,-1.0,-10,-10,0.503704656914318,0.14447446239159945
1559,1559,2019,1,NCAAF_20190831_PORTST@ARK,Portland St.,Vikings,Arkansas,Razorbacks,0-1,1-0,1.0,6,10,13,20,3,3,0,7,10,0,7,3,-1.0,-4,-7,0.09102716257167076,-20.761145252245115
1560,1560,2019,1,NCAAF_20190831_VATECH@BC,Virginia Tech,Hokies,Boston College,Eagles,0-1,1-0,0.0,14,28,28,35,7,7,7,7,7,21,0,7,-1.0,-14,-7,0.4729792473168183,-1.054548973695887
1561,1561,2019,1,NCAAF_20190831_CAMP@TROY,Campbell,Fighting Camels,Troy,Trojans,0-1,1-0,0.0,7,20,14,43,7,0,0,7,17,3,16,7,-1.0,-13,-29,0.00025787959335732413,-54.02329724285687
1562,1562,2019,1,NCAAF_20190831_CUSE@LIB,Syracuse,Orange,Liberty,Flames,1-0,0-1,1.0,10,0,24,0,3,7,7,7,0,0,0,0,1.0,10,24,0.9539502339909437,26.205873238563754
1563,1563,2019,1,NCAAF_20190831_SAMST@NMEX,Sam Houston,Bearkats,New Mexico,Lobos,0-1,1-0,0.0,16,22,31,39,0,16,7,8,13,9,10,7,-1.0,-6,-8,,
1564,1564,2019,1,NCAAF_20190831_UIW@TXSA,Incarnate Word,Cardinals,UTSA,Roadrunners,0-1,1-0,0.0,7,21,7,35,0,7,0,0,7,14,7,7,-1.0,-14,-28,0.010147172917750913,-36.107386204304134
1565,1565,2019,1,NCAAF_20190831_DAVIS@CAL,UC-Davis,Aggies,California,Golden Bears,0-1,1-0,0.0,10,13,13,27,10,0,3,0,0,13,7,7,-1.0,-3,-14,0.15567572435475108,-15.750520669895195
1566,1566,2019,1,NCAAF_20190831_VMI@MRSHL,VMI,Keydets,Marshall,Thundering Herd,0-1,1-0,1.0,7,35,17,56,0,7,0,10,14,21,14,7,-1.0,-28,-39,1.60850706809601e-06,-72.44397557078605
1567,1567,2019,1,NCAAF_20190831_ALCORN@USM,Alcorn St.,Braves,So. Miss,Golden Eagles,0-1,1-0,0.0,0,13,10,38,0,0,10,0,10,3,15,10,-1.0,-13,-28,0.18918138604031487,-13.705089732592683
1568,1568,2019,1,NCAAF_20190831_ILST@NILL,Illinois St.,,N. Illinois,,0-1,1-0,,3,3,10,24,0,3,0,7,3,0,7,14,-1.0,0,-14,0.7032604269708349,8.30474666000407
1569,1569,2019,1,NCAAF_20190831_MONNJ@WMICH,Monmouth,,W. Michigan,,0-1,1-0,,7,31,13,48,0,7,6,0,21,10,14,3,-1.0,-24,-35,,
1570,1570,2019,1,NCAAF_20190831_NICHST@KSTATE,Nicholls St.,Colonels,Kansas State,Wildcats,0-1,1-0,0.0,0,28,14,49,0,0,7,7,14,14,0,21,-1.0,-28,-35,0.07766408259434121,-22.106958900653808
1571,1571,2019,1,NCAAF_20190831_NRFST@ODU,Norfolk St.,Spartans,Old Dominion,Monarchs,0-1,1-0,0.0,6,14,21,24,0,6,0,15,14,0,3,7,-1.0,-8,-3,0.015843891821118672,-33.42314498307485
1572,1572,2019,1,NCAAF_20190831_SFA@BAYLOR,S.F. Austin,Lumberjacks,Baylor,Bears,0-1,1-0,1.0,7,35,17,56,7,0,0,10,14,21,14,7,-1.0,-28,-39,0.0020319787358391572,-44.69982742109562
1573,1573,2019,1,NCAAF_20190831_SMU@ARKST,SMU,Mustangs,Arkansas St.,Red Wolves,1-0,0-1,1.0,16,9,37,30,3,13,14,7,7,2,14,7,1.0,7,7,0.631872445654445,5.240111032039863
1574,1574,2019,1,NCAAF_20190831_ABIL@NTEXAS,Abil Christian,Wildcats,North Texas,Mean Green,0-1,1-0,0.0,10,38,31,51,0,10,7,14,17,21,10,3,-1.0,-28,-20,0.022253672406335023,-31.259900239008743
1575,1575,2019,1,NCAAF_20190831_GAS@LSU,Ga. Southern,Eagles,LSU,Tigers,0-1,1-0,0.0,3,42,3,55,0,3,0,0,21,21,10,3,-1.0,-39,-52,0.033372673023175925,-28.52335291565703
1576,1576,2019,1,NCAAF_20190831_MIAOH@IOWA,Miami-OH,RedHawks,Iowa,Hawkeyes,0-1,1-0,0.0,7,10,14,38,0,7,0,7,3,7,14,14,-1.0,-3,-24,0.04961426775825106,-25.648595659439366
1577,1577,2019,1,NCAAF_20190831_MIZZOU@WYO,Missouri,Tigers,Wyoming,Cowboys,0-1,1-0,0.0,17,27,31,37,14,3,0,14,0,27,7,3,-1.0,-10,-6,0.8940077858448021,19.418058813506036
1578,1578,2019,1,NCAAF_20190831_MTSU@MICH,Middle Tenn.,Blue Raiders,Michigan,Wolverines,0-1,1-0,0.0,14,27,21,40,7,7,0,7,10,17,6,7,-1.0,-13,-19,0.03688966464383436,-27.816944916691682
1579,1579,2019,1,NCAAF_20190831_OREG@AUBURN,Oregon,Ducks,Auburn,Tigers,0-1,1-0,1.0,14,6,21,27,14,0,7,0,3,3,7,14,-1.0,8,-6,0.1884117535476839,-13.749386783405043
1580,1580,2019,1,NCAAF_20190831_UGA@VANDY,Georgia,Bulldogs,Vanderbilt,Commodores,1-0,0-1,1.0,21,6,30,6,14,7,3,6,0,6,0,0,1.0,15,24,0.9662477454875678,28.444245906337414
1581,1581,2019,1,NCAAF_20190831_UVA@PITT,Virginia,Cavaliers,Pittsburgh,Panthers,1-0,0-1,0.0,13,14,30,14,10,3,10,7,0,14,0,0,1.0,-1,16,0.4360919442357377,-2.5030110887065575
1582,1582,2019,1,NCAAF_20190831_ARPB@TCU,Ark.-Pine Bluff,Golden Lions,TCU,Horned Frogs,0-1,1-0,1.0,0,16,7,39,0,0,7,0,10,6,13,10,-1.0,-16,-32,3.204341333495897e-06,-70.20339501148044
1583,1583,2019,1,NCAAF_20190831_GRAM@LAMON,Grambling,Tigers,UL-Monroe,Warhawks,0-1,1-0,1.0,9,17,9,31,6,3,0,0,7,10,7,7,-1.0,-8,-22,0.1736398713596875,-14.622403412555741
1584,1584,2019,1,NCAAF_20190831_HOUBP@UTEP,Houston Christian,Huskies,UTEP,Miners,0-1,1-0,1.0,17,20,34,36,0,17,11,6,3,17,13,3,-1.0,-3,-2,0.3385739713619942,-6.47759801443965
1585,1585,2019,1,NCAAF_20190831_LATECH@TEXAS,Louisiana Tech,Bulldogs,Texas,Longhorns,0-1,1-0,0.0,0,24,14,45,0,0,0,14,7,17,14,7,-1.0,-24,-31,0.04175484464510726,-26.92542191383268
1586,1586,2019,1,NCAAF_20190831_WBRST@SDGST,Weber St.,Wildcats,San Diego St.,Aztecs,0-1,1-0,0.0,0,3,0,6,0,0,0,0,0,3,0,3,-1.0,-3,-6,0.21196452964376766,-12.440343717581413
1587,1587,2019,1,NCAAF_20190831_NMEXST@WASHST,New Mexico St.,Aggies,Washington St.,Cougars,0-1,1-0,1.0,7,35,7,58,7,0,0,0,14,21,13,10,-1.0,-28,-51,0.020580019070656985,-31.767600765886755
1588,1588,2019,1,NCAAF_20190831_SUT@UNLV,So. Utah,Thunderbirds,UNLV,Rebels,0-1,1-0,1.0,7,35,23,56,0,7,0,16,7,28,21,0,-1.0,-28,-33,0.05470944921735632,-24.905016817529827
1589,1589,2019,1,NCAAF_20190831_FRESNO@USC,Fresno St.,Bulldogs,USC,Trojans,0-1,1-0,0.0,10,17,23,31,3,7,3,10,14,3,14,0,-1.0,-7,-8,0.496569348407796,-0.13378851026868688
1590,1590,2019,1,NCAAF_20190830_RICE@ARMY,Rice,Owls,Army,Black Knights,0-1,1-0,1.0,7,7,7,14,0,7,0,0,0,7,0,7,-1.0,0,-7,0.024146214153684564,-30.723237340978017
1591,1591,2019,1,NCAAF_20190830_TULSA@MICHST,Tulsa,Golden Hurricane,Michigan St.,Spartans,0-1,1-0,0.0,7,25,7,28,0,7,0,0,7,18,3,0,-1.0,-18,-21,0.09164723842819722,-20.702385771324657
1592,1592,2019,1,NCAAF_20190830_WISC@SFLA,Wisconsin,Badgers,South Florida,Bulls,1-0,0-1,1.0,28,0,49,0,7,21,14,7,0,0,0,0,1.0,28,49,0.8846814369048748,18.64938007474825
1593,1593,2019,1,NCAAF_20190830_MA@RUT,UMass,Minutemen,Rutgers,Scarlet Knights,0-1,1-0,1.0,21,38,21,48,21,0,0,0,7,31,3,7,-1.0,-17,-27,0.3428880824923458,-6.29457002503807
1594,1594,2019,1,NCAAF_20190830_UTAHST@WAKE,Utah St.,Aggies,Wake Forest,Demon Deacons,0-1,1-0,0.0,21,17,35,38,7,14,7,7,10,7,14,7,-1.0,4,-3,0.39960381594400973,-3.9574681975025214
1595,1595,2019,1,NCAAF_20190830_PURDUE@NEVADA,Purdue,Boilermakers,Nevada,Wolf Pack,0-1,1-0,1.0,24,7,31,34,10,14,7,0,0,7,10,17,-1.0,17,-3,0.920723024097643,21.93568218338021
1596,1596,2019,1,NCAAF_20190830_COLOST@COLO,Colorado St.,Rams,Colorado,Buffaloes,0-1,1-0,0.0,21,24,31,52,7,14,3,7,7,17,14,14,-1.0,-3,-21,0.32295790955479253,-7.14790699605021
1597,1597,2019,1,NCAAF_20190830_OKLAST@OREGST,Oklahoma State,Cowboys,Oregon State,Beavers,1-0,0-1,0.0,31,16,52,36,7,24,14,7,10,6,7,13,1.0,15,16,0.9893112367606564,35.80227659865125
1598,1598,2019,1,NCAAF_20190829_ALBANY@CMICH,Albany,,C. Michigan,,0-1,1-0,,7,24,21,38,0,7,7,7,7,17,7,7,-1.0,-17,-17,0.06782691366441107,-23.214859626844145
1599,1599,2019,1,NCAAF_20190829_MRGNST@BGREEN,Morgan St.,,Bowling Green,,0-1,1-0,,3,30,3,46,0,3,0,0,13,17,7,9,-1.0,-27,-43,0.0032175304740050814,-42.39095849227681
1600,1600,2019,1,NCAAF_20190829_ROB@BUFF,Robert Morris,,Buffalo,,0-1,1-0,,10,28,10,38,7,3,0,0,21,7,10,0,-1.0,-18,-28,,
1601,1601,2019,1,NCAAF_20190829_UCLA@CINCY,UCLA,Bruins,Cincinnati,Bearcats,0-1,1-0,0.0,7,10,14,24,0,7,7,0,7,3,7,7,-1.0,-3,-10,0.51443902489094,0.5632089743967299
1602,1602,2019,1,NCAAF_20190829_WAG@UCONN,Wagner,Seahawks,UConn,Huskies,0-1,1-0,1.0,0,10,21,24,0,0,14,7,7,3,14,0,-1.0,-10,-3,0.09659365393794817,-20.243872902514454
1603,1603,2019,1,NCAAF_20190829_CAR@WKY,Cent. Ark.,,W. Kentucky,,1-0,0-1,,14,21,35,28,0,14,0,21,14,7,7,0,1.0,-7,7,0.22542368114140654,-11.73059513602243
1604,1604,2019,1,NCAAF_20190829_FAMU@UCF,Florida A&M,Rattlers,UCF,Knights,0-1,1-0,1.0,0,48,0,62,0,0,0,0,17,31,7,7,-1.0,-48,-62,1.4495256955848745e-06,-72.77676900840504
1605,1605,2019,1,NCAAF_20190829_GRDWB@CHARLO,Gardner-Webb,,Charlotte,,0-1,1-0,,14,35,28,49,0,14,7,7,7,28,7,7,-1.0,-21,-21,0.04412790371643893,-26.520852563623293
1606,1606,2019,1,NCAAF_20190829_ALST@UAB,Alabama St.,Hornets,UAB,Blazers,0-1,1-0,1.0,13,24,19,24,13,0,6,0,14,10,0,0,-1.0,-11,-5,0.013424068412384194,-34.440492011805304
1607,1607,2019,1,NCAAF_20190829_FIU@TULANE,FIU,Panthers,Tulane,Green Wave,0-1,1-0,0.0,7,28,14,42,0,7,7,0,7,21,14,0,-1.0,-21,-28,0.38024710054824296,-4.742499549214813
1608,1608,2019,1,NCAAF_20190829_GATECH@CLEM,Georgia Tech,Yellow Jackets,Clemson,Tigers,0-1,1-0,0.0,0,28,14,52,0,0,7,7,14,14,14,10,-1.0,-28,-38,0.0781466663419852,-22.055431718127693
1609,1609,2019,1,NCAAF_20190829_TXSTSM@TXAM,Texas St.,Bobcats,Texas A&M,Aggies,0-1,1-0,0.0,0,28,7,41,0,0,0,7,14,14,3,10,-1.0,-28,-34,0.007791549077737714,-37.62699149256764
1610,1610,2019,1,NCAAF_20190829_SDST@MINN,S. Dakota St.,Jackrabbits,Minnesota,Golden Gophers,0-1,1-0,0.0,7,13,21,28,0,7,14,0,0,13,7,8,-1.0,-6,-7,,
1611,1611,2019,1,NCAAF_20190829_KENTST@ARIZST,Kent St.,Golden Flashes,Arizona St.,Sun Devils,0-1,1-0,1.0,0,10,7,30,0,0,0,7,10,0,17,3,-1.0,-10,-23,0.033717677030763116,-28.451421658375693
1612,1612,2019,1,NCAAF_20190829_NCO@SJST,N. Colorado,Bears,San Jose St.,Spartans,0-1,1-0,0.0,6,21,18,35,3,3,9,3,14,7,7,7,-1.0,-15,-17,0.6016088057778977,4.006331970551628
1613,1613,2019,1,NCAAF_20190829_UTAH@BYU,Utah,Utes,BYU,Cougars,1-0,0-1,0.0,9,6,30,12,3,6,7,14,0,6,0,6,1.0,3,18,0.8408890956223611,15.528485608330811
1614,1614,2019,1,NCAAF_20190824_MIAMI@FLA,Miami (Fla.),Hurricanes,Florida,Gators,0-1,1-0,1.0,13,7,20,24,3,10,0,7,7,0,10,7,-1.0,6,-4,0.5853678655662422,3.3549561222658895
1615,1615,2019,1,NCAAF_20190824_ARIZ@HAWAII,Arizona,Wildcats,Hawaii,Rainbow Warriors,0-1,1-0,0.0,21,28,38,45,0,21,14,3,14,14,7,10,-1.0,-7,-7,0.9120250173051572,21.05478886910771
1616,1616,2019,2,NCAAF_20190908_OREGST@HAWAII,Oregon State,,Hawaii,,0-2,2-0,,28,21,28,31,14,14,0,0,7,14,7,3,-2.0,7,-3,0.50836258089238,0.32551092822586725
1617,1617,2019,2,NCAAF_20190907_OHIO@PITT,Ohio,Bobcats,Pittsburgh,Panthers,1-1,1-1,0.0,3,17,10,20,0,3,7,0,3,14,3,0,0.0,-14,-10,0.46129897709623213,-1.50868567365751
1618,1618,2019,2,NCAAF_20190907_BGREEN@KSTATE,Bowling Green,Falcons,Kansas State,Wildcats,1-1,2-0,0.0,0,38,0,52,0,0,0,0,17,21,7,7,-1.0,-38,-52,0.04645567347342583,-26.0899871401607
1619,1619,2019,2,NCAAF_20190907_CHARSO@SC,Charleston So.,Buccaneers,South Carolina,Gamecocks,0-2,1-1,0.0,3,44,10,72,3,0,0,7,21,23,7,21,-1.0,-41,-62,0.0107566997160633,-35.695570690529166
1620,1620,2019,2,NCAAF_20190907_CINCY@OHIOST,Cincinnati,Bearcats,Ohio State,Buckeyes,1-1,2-0,0.0,0,28,0,42,0,0,0,0,7,21,7,7,-1.0,-28,-42,0.03254663611999431,-28.642419805208192
1621,1621,2019,2,NCAAF_20190907_CUSE@MD,Syracuse,Orange,Maryland,Terrapins,1-1,2-0,1.0,13,42,20,63,7,6,7,0,21,21,7,14,-1.0,-29,-43,0.6348383520715843,5.352283661246474
1622,1622,2019,2,NCAAF_20190907_ODU@VATECH,Old Dominion,Monarchs,Virginia Tech,Hokies,1-1,1-1,0.0,3,17,17,31,3,0,7,7,10,7,7,7,0.0,-14,-14,0.03382333938812443,-28.37435517870972
1623,1623,2019,2,NCAAF_20190907_RUT@IOWA,Rutgers,Scarlet Knights,Iowa,Hawkeyes,1-1,2-0,0.0,0,20,0,30,0,0,0,0,7,13,7,3,-1.0,-20,-30,0.03571825191594813,-27.991435855268264
1624,1624,2019,2,NCAAF_20190907_SO@MEMP,Southern U.,Jaguars,Memphis,Tigers,0-2,2-0,1.0,17,27,24,55,7,10,7,0,17,10,21,7,-2.0,-10,-31,6.427485650406517e-05,-59.45849207668607
1625,1625,2019,2,NCAAF_20190907_UAB@AKRON,UAB,Blazers,Akron,Zips,2-0,0-2,0.0,17,6,31,20,7,10,14,0,6,0,0,14,2.0,11,11,0.6098681628723599,4.33181067596297
1626,1626,2019,2,NCAAF_20190907_VANDY@PURDUE,Vanderbilt,Commodores,Purdue,Boilermakers,0-2,1-1,1.0,10,14,24,42,7,3,0,14,7,7,14,14,-1.0,-4,-18,0.23032066709228705,-11.45610477850596
1627,1627,2019,2,NCAAF_20190907_WVU@MIZZOU,West Virginia,Mountaineers,Missouri,Tigers,1-1,1-1,0.0,0,31,7,38,0,0,0,7,10,21,0,7,0.0,-31,-31,0.5210470733252628,0.8195713352247367
1628,1628,2019,2,NCAAF_20190907_WCAR@NCST,W. Carolina,Catamounts,NC State,Wolfpack,0-2,2-0,1.0,0,24,0,41,0,0,0,0,3,21,10,7,-2.0,-24,-41,0.00012016999285369145,-57.022510915945986
1629,1629,2019,2,NCAAF_20190907_NILL@UTAH,N. Illinois,Huskies,Utah,Utes,1-1,2-0,1.0,17,21,17,35,7,10,0,0,0,21,7,7,-1.0,-4,-18,0.22248318266304445,-11.860480967488456
1630,1630,2019,2,NCAAF_20190907_FORD@BALLST,Fordham,Rams,Ball St.,Cardinals,0-2,1-1,0.0,14,28,29,57,14,0,15,0,14,14,22,7,-1.0,-14,-28,0.020669633481959826,-31.67796727875475
1631,1631,2019,2,NCAAF_20190907_SFLA@GATECH,South Florida,Bulls,Georgia Tech,Yellow Jackets,0-2,1-1,0.0,3,14,10,14,3,0,0,7,0,14,0,0,-1.0,-11,-4,0.2604214550098539,-9.969423991139138
1632,1632,2019,2,NCAAF_20190907_TNTECH@MIAOH,Tenn. Tech,Golden Eagles,Miami-OH,RedHawks,1-1,1-1,0.0,3,41,17,48,3,0,0,14,10,31,0,7,0.0,-38,-31,0.0035614382206665685,-41.785376962801365
1633,1633,2019,2,NCAAF_20190907_CHARLO@APLST,Charlotte,49ers,App. St.,Mountaineers,1-1,2-0,0.0,13,28,41,56,6,7,15,13,14,14,14,14,-1.0,-15,-15,0.07290325054243296,-22.584919802874538
1634,1634,2019,2,NCAAF_20190907_CMICH@WISC,C. Michigan,Chippewas,Wisconsin,Badgers,1-1,2-0,1.0,0,44,0,61,0,0,0,0,16,28,10,7,-1.0,-44,-61,0.019324370842706218,-32.10957545117117
1635,1635,2019,2,NCAAF_20190907_EIL@IND,E. Illinois,Panthers,Indiana,Hoosiers,0-2,2-0,0.0,0,35,0,52,0,0,0,0,21,14,7,10,-2.0,-35,-52,0.014975271190257433,-33.706376947533045
1636,1636,2019,2,NCAAF_20190907_GRAM@LATECH,Grambling,Tigers,Louisiana Tech,Bulldogs,0-2,1-1,1.0,0,20,14,20,0,0,7,7,7,13,0,0,-1.0,-20,-6,0.0628887877832619,-23.77219574720766
1637,1637,2019,2,NCAAF_20190907_ILL@UCONN,Illinois,Fighting Illini,UConn,Huskies,2-0,1-1,0.0,24,13,31,23,0,24,7,0,10,3,7,3,1.0,11,8,0.8395802682692395,15.414751173928835
1638,1638,2019,2,NCAAF_20190907_RICH@BC,Richmond,Spiders,Boston College,Eagles,1-1,2-0,0.0,10,35,13,45,0,10,0,3,21,14,10,0,-1.0,-25,-32,,
1639,1639,2019,2,NCAAF_20190907_SIL@MA,S. Illinois,Salukis,UMass,Minutemen,1-1,0-2,0.0,17,13,45,20,0,17,14,14,6,7,0,7,1.0,4,25,0.4105255441037823,-3.512232189365477
1640,1640,2019,2,NCAAF_20190907_TXAM@CLEM,Texas A&M,Aggies,Clemson,Tigers,1-1,2-0,1.0,3,17,10,24,0,3,0,7,0,17,7,0,-1.0,-14,-14,0.07273643677870356,-22.603635202327496
1641,1641,2019,2,NCAAF_20190907_USM@MISSST,So. Miss,Golden Eagles,Miss. State,Bulldogs,1-1,2-0,1.0,0,21,15,38,0,0,7,8,7,14,7,10,-1.0,-21,-23,0.04456145064990691,-26.397531619616984
1642,1642,2019,2,NCAAF_20190907_MURYST@UGA,Murray St.,Racers,Georgia,Bulldogs,1-1,2-0,0.0,7,42,17,63,7,0,10,0,7,35,7,14,-1.0,-35,-46,7.751976752845557e-06,-67.10090292351833
1643,1643,2019,2,NCAAF_20190907_NMEXST@BAMA,New Mexico St.,Aggies,Alabama,Crimson Tide,0-2,2-0,0.0,0,38,10,62,0,0,7,3,21,17,24,0,-2.0,-38,-52,0.00011122121579032473,-57.32876552343305
1644,1644,2019,2,NCAAF_20190907_TXSA@BAYLOR,UTSA,Roadrunners,Baylor,Bears,1-1,2-0,1.0,0,35,14,63,0,0,7,7,14,21,14,14,-1.0,-35,-49,0.13269510739985535,-17.2936950803728
1645,1645,2019,2,NCAAF_20190907_WIL@COLOST,W. Illinois,Leathernecks,Colorado St.,Rams,0-2,1-1,0.0,6,28,13,38,3,3,0,7,14,14,7,3,-1.0,-22,-25,0.6367936660742556,5.433119110479311
1646,1646,2019,2,NCAAF_20190907_SDGST@UCLA,San Diego St.,Aztecs,UCLA,Bruins,2-0,0-2,1.0,10,7,23,14,10,0,10,3,7,0,7,0,2.0,3,9,0.5278642268523894,1.0854104488103076
1647,1647,2019,2,NCAAF_20190907_NCO@WASHST,N. Colorado,Bears,Washington St.,Cougars,0-2,2-0,1.0,10,24,17,59,7,3,0,7,14,10,21,14,-2.0,-14,-42,0.0026949507449147703,-43.209467846556436
1648,1648,2019,2,NCAAF_20190907_GRDWB@ECU,Gardner-Webb,Runnin' Bulldogs,East Carolina,Pirates,0-2,1-1,0.0,7,31,9,48,0,7,2,0,17,14,7,10,-1.0,-24,-39,0.02956306806103348,-29.30447275715005
1649,1649,2019,2,NCAAF_20190907_ME@GAS,Maine,Black Bears,Ga. Southern,Eagles,1-1,1-1,1.0,3,10,18,26,3,0,0,15,0,10,6,10,0.0,-7,-8,0.2965073322066416,-8.299059359176226
1650,1650,2019,2,NCAAF_20190907_NCAT@DUKE,NC A&T,Aggies,Duke,Blue Devils,1-1,1-1,1.0,10,28,13,45,3,7,3,0,7,21,10,7,0.0,-18,-32,0.07466866926278637,-22.388831748961366
1651,1651,2019,2,NCAAF_20190907_CSTCAR@KANSAS,C. Carolina,Chanticleers,Kansas,Jayhawks,1-1,1-1,0.0,6,7,12,7,0,6,6,0,7,0,0,0,0.0,-1,5,0.22577250633122214,-11.689803119439603
1652,1652,2019,2,NCAAF_20190907_EKY@LVILLE,E. Kentucky,Colonels,Louisville,Cardinals,1-1,1-1,1.0,0,14,0,42,0,0,0,0,14,0,14,14,0.0,-14,-42,0.11104038561686302,-18.959378357018522
1653,1653,2019,2,NCAAF_20190907_FUR@GAST,Furman,,Georgia St.,,1-1,2-0,,20,17,42,48,13,7,8,14,3,14,21,10,-1.0,3,-6,0.4988937134468967,-0.04305877035130834
1654,1654,2019,2,NCAAF_20190907_JACKST@SALA,Jackson St.,,South Alabama,,0-2,1-1,,7,19,14,37,7,0,0,7,13,6,8,10,-1.0,-12,-23,0.03863609462303308,-27.433141404484104
1655,1655,2019,2,NCAAF_20190907_MCN@OKLAST,McNeese St.,Cowboys,Oklahoma State,Cowboys,1-1,2-0,1.0,0,28,14,56,0,0,7,7,14,14,28,0,-1.0,-28,-42,0.0013309938602293903,-46.649371254955895
1656,1656,2019,2,NCAAF_20190907_NTEXAS@SMU,North Texas,Mean Green,SMU,Mustangs,1-1,2-0,0.0,14,28,27,49,0,14,6,7,21,7,14,7,-1.0,-14,-22,0.3311326931175941,-6.782250219863727
1657,1657,2019,2,NCAAF_20190907_SD@OKLA,South Dakota,Coyotes,Oklahoma,Sooners,0-2,2-0,0.0,0,28,14,70,0,0,14,0,14,14,28,14,-2.0,-28,-56,0.011612440320226125,-35.24315881754046
1658,1658,2019,2,NCAAF_20190907_TNST@MTSU,Tennessee St.,,Middle Tenn.,,1-1,1-1,,6,10,26,45,6,0,13,7,0,10,14,21,0.0,-4,-19,0.42683492756406016,-2.86387410153975
1659,1659,2019,2,NCAAF_20190907_UCF@FAU,UCF,Knights,FAU,Owls,2-0,0-2,1.0,28,6,48,14,14,14,13,7,0,6,0,8,2.0,22,34,0.8844386818543699,18.593830379864357
1660,1660,2019,2,NCAAF_20190907_WKY@FIU,W. Kentucky,Hilltoppers,FIU,Panthers,1-1,0-2,1.0,14,7,20,14,7,7,3,3,7,0,7,0,1.0,7,6,0.3102641319824436,-7.687727898199228
1661,1661,2019,2,NCAAF_20190907_WYO@TXSTSM,Wyoming,Cowboys,Texas St.,Bobcats,2-0,0-2,1.0,10,14,23,14,0,10,10,3,7,7,0,0,2.0,-4,9,0.9348039279764291,23.486339731748103
1662,1662,2019,2,NCAAF_20190907_ARK@MISS,Arkansas,Razorbacks,Ole Miss,Rebels,1-1,1-1,0.0,3,10,17,31,0,3,0,14,7,3,7,14,0.0,-7,-14,0.29834112739867824,-8.216842270598136
1663,1663,2019,2,NCAAF_20190907_BUFF@PSU,Buffalo,Bulls,Penn State,Nittany Lions,1-1,2-0,1.0,10,7,13,45,0,10,3,0,7,0,28,10,-1.0,3,-32,0.026546731368030207,-30.032804505541662
1664,1664,2019,2,NCAAF_20190907_EMICH@UK,E. Michigan,Eagles,Kentucky,Wildcats,1-1,2-0,0.0,3,17,17,38,0,3,7,7,14,3,7,14,-1.0,-14,-21,0.2310475508485792,-11.418995978689509
1665,1665,2019,2,NCAAF_20190907_LIB@LALAF,Liberty,Flames,Louisiana,Ragin' Cajuns,0-2,1-1,1.0,14,21,14,35,7,7,0,0,7,14,14,0,-1.0,-7,-21,0.4872282631925732,-0.4971845198274423
1666,1666,2019,2,NCAAF_20190907_LSU@TEXAS,LSU,Tigers,Texas,Longhorns,2-0,1-1,0.0,20,7,45,38,3,17,3,22,0,7,14,17,1.0,13,7,0.5160890406849298,0.6263850161540176
1667,1667,2019,2,NCAAF_20190907_NEVADA@OREG,Nevada,Wolf Pack,Oregon,Ducks,1-1,1-1,0.0,6,35,6,77,3,3,0,0,7,28,28,14,0.0,-29,-71,0.16898328656722206,-14.878374286786766
1668,1668,2019,2,NCAAF_20190907_STONYBRK@UTAHST,Stony Brook,Seawolves,Utah St.,Aggies,1-1,1-1,1.0,0,34,7,62,0,0,7,0,17,17,14,14,0.0,-34,-55,0.1008753679233374,-19.822178012090262
1669,1669,2019,2,NCAAF_20190907_TNMART@FLA,UT Martin,Skyhawks,Florida,Gators,1-1,2-0,1.0,0,17,0,45,0,0,0,0,3,14,14,14,-1.0,-17,-45,0.010498871766060236,-35.83802071385753
1670,1670,2019,2,NCAAF_20190907_TULANE@AUBURN,Tulane,Green Wave,Auburn,Tigers,1-1,2-0,0.0,6,14,6,24,3,3,0,0,0,14,7,3,-1.0,-8,-18,0.06890085512536448,-23.043336077480035
1671,1671,2019,2,NCAAF_20190907_WMICH@MICHST,W. Michigan,Broncos,Michigan St.,Spartans,1-1,2-0,0.0,7,31,17,51,0,7,0,10,21,10,6,14,-1.0,-24,-34,0.11624119457784032,-18.539743221263052
1672,1672,2019,2,NCAAF_20190907_MIAMI@UNC,Miami (Fla.),Hurricanes,North Carolina,Tar Heels,0-2,2-0,0.0,13,17,25,28,3,10,6,6,17,0,3,8,-2.0,-4,-3,0.8935292380261708,19.339862969147816
1673,1673,2019,2,NCAAF_20190907_PRARIE@HOU,Prairie View,Panthers,Houston,Cougars,1-1,1-1,0.0,10,34,17,37,3,7,0,7,24,10,3,0,0.0,-24,-20,0.000981041786661696,-48.071995926258296
1674,1674,2019,2,NCAAF_20190907_UTEP@TXTECH,UTEP,Miners,Texas Tech,Red Raiders,1-1,2-0,1.0,0,21,3,38,0,0,0,3,7,14,10,7,-1.0,-21,-35,0.0033051955501668395,-42.170702970213824
1675,1675,2019,2,NCAAF_20190907_TULSA@SJST,Tulsa,Golden Hurricane,San Jose St.,Spartans,1-1,1-1,1.0,17,10,34,16,7,10,3,14,3,7,0,6,0.0,7,18,0.8298496167699625,14.806642846298928
1676,1676,2019,2,NCAAF_20190907_ARKST@UNLV,Arkansas St.,Red Wolves,UNLV,Rebels,1-1,1-1,0.0,23,3,43,17,10,13,10,10,0,3,7,7,0.0,20,26,0.7175770609080175,8.938581235998754
1677,1677,2019,2,NCAAF_20190907_CAL@WASH,California,Golden Bears,Washington,Huskies,2-0,1-1,0.0,3,10,20,19,0,3,14,3,0,10,3,6,1.0,-7,1,0.14880778024805297,-16.172901331438425
1678,1678,2019,2,NCAAF_20190907_STNFRD@USC,Stanford,Cardinal,USC,Trojans,1-1,2-0,0.0,20,24,20,45,7,13,0,0,3,21,7,14,-1.0,-4,-25,0.6050766987722807,4.138249817032374
1679,1679,2019,2,NCAAF_20190907_NAZ@ARIZ,N. Arizona,Lumberjacks,Arizona,Wildcats,1-1,1-1,0.0,13,51,41,65,7,6,14,14,21,30,7,7,0.0,-38,-24,0.0071973494580732655,-38.0
1680,1680,2019,2,NCAAF_20190906_WAKE@RICE,Wake Forest,Demon Deacons,Rice,Owls,2-0,0-2,1.0,24,14,41,21,14,10,10,7,14,0,0,7,2.0,10,20,0.9881793320804847,35.137469004368086
1681,1681,2019,2,NCAAF_20190906_WMMARY@UVA,William & Mary,Tribe,Virginia,Cavaliers,1-1,2-0,1.0,3,35,17,52,0,3,7,7,21,14,7,10,-1.0,-32,-35,0.030402297151624902,-29.112854238801447
1682,1682,2019,2,NCAAF_20190906_MRSHL@BOISE,Marshall,Thundering Herd,Boise St.,Broncos,1-1,2-0,1.0,7,7,7,14,7,0,0,0,0,7,7,0,-1.0,0,-7,0.18566874425462887,-13.881195033878612
1683,1683,2019,2,NCAAF_20190906_SACST@ARIZST,Sacramento St.,Hornets,Arizona St.,Sun Devils,1-1,2-0,0.0,0,3,7,19,0,0,0,7,0,3,6,10,-1.0,-3,-12,0.016396409040174698,-33.145318188867805
1684,1684,2019,3,NCAAF_20190914_ARKST@UGA,Arkansas St.,Red Wolves,Georgia,Bulldogs,1-2,3-0,1.0,0,34,0,55,0,0,0,0,13,21,14,7,-2.0,-34,-55,0.016450875344947602,-33.22350801505712
1685,1685,2019,3,NCAAF_20190914_EMICH@ILL,E. Michigan,Eagles,Illinois,Fighting Illini,2-1,2-1,1.0,23,17,34,31,14,9,0,11,17,0,0,14,0.0,6,3,0.5718978798083738,2.8221181302071727
1686,1686,2019,3,NCAAF_20190914_FUR@VATECH,Furman,Paladins,Virginia Tech,Hokies,1-2,2-1,0.0,14,3,17,24,0,14,0,3,3,0,14,7,-1.0,11,-7,0.027969679523688118,-29.769645326409204
1687,1687,2019,3,NCAAF_20190914_KSTATE@MISSST,Kansas State,Wildcats,Miss. State,Bulldogs,3-0,2-1,0.0,17,14,31,24,3,14,0,14,0,14,7,3,1.0,3,7,0.3102079421157762,-7.713149303021339
1688,1688,2019,3,NCAAF_20190914_MD@TEMPLE,Maryland,Terrapins,Temple,Owls,2-1,2-0,1.0,2,7,17,20,2,0,13,2,7,0,6,7,0.0,-5,-3,0.5642227838417987,2.5180570598661802
1689,1689,2019,3,NCAAF_20190914_MIAOH@CINCY,Miami-OH,RedHawks,Cincinnati,Bearcats,1-2,2-1,1.0,10,14,13,35,10,0,3,0,0,14,21,0,-1.0,-4,-22,0.335037082545681,-6.635204486766838
1690,1690,2019,3,NCAAF_20190914_NCST@WVU,NC State,Wolfpack,West Virginia,Mountaineers,2-1,2-1,1.0,21,21,27,44,7,14,6,0,14,7,10,13,0.0,0,-17,0.5068695241949885,0.2681857189250536
1691,1691,2019,3,NCAAF_20190914_OHIOST@IND,Ohio State,Buckeyes,Indiana,Hoosiers,3-0,2-1,0.0,30,10,51,10,7,23,21,0,3,7,0,0,1.0,20,41,0.9391727021218993,24.106319814527012
1692,1692,2019,3,NCAAF_20190914_PITT@PSU,Pittsburgh,Panthers,Penn State,Nittany Lions,1-2,3-0,1.0,10,10,10,17,0,10,0,0,7,3,7,0,-2.0,0,-7,0.057485602314553685,-24.548168637848903
1693,1693,2019,3,NCAAF_20190914_TNCHAT@TENN,Chattanooga,Mocs,Tennessee,Volunteers,1-2,1-2,0.0,0,38,0,45,0,0,0,0,21,17,7,0,0.0,-38,-45,0.08780252833721658,-21.0934831104218
1694,1694,2019,3,NCAAF_20190914_FAU@BALLST,FAU,Owls,Ball St.,Cardinals,1-2,1-2,1.0,21,17,41,31,7,14,13,7,14,3,7,7,0.0,4,10,0.9519741731710464,25.91971974528525
1695,1695,2019,3,NCAAF_20190914_NRFST@CSTCAR,Norfolk St.,Spartans,C. Carolina,Chanticleers,1-2,2-1,0.0,7,19,7,46,0,7,0,0,12,7,14,13,-1.0,-12,-39,0.12130069729641901,-18.198255644327503
1696,1696,2019,3,NCAAF_20190914_NMEX@ND,New Mexico,Lobos,Notre Dame,Fighting Irish,1-1,2-0,0.0,7,38,14,66,0,7,0,7,7,31,14,14,-1.0,-31,-52,0.009505030976753481,-36.52600869116873
1697,1697,2019,3,NCAAF_20190914_AKRON@CMICH,Akron,Zips,C. Michigan,Chippewas,0-3,2-1,1.0,10,27,24,45,0,10,0,14,3,24,3,15,-2.0,-17,-21,0.47700595222751274,-0.8981391542144479
1698,1698,2019,3,NCAAF_20190914_ARMY@TXSA,Army,Black Knights,UTSA,Roadrunners,2-1,1-2,1.0,10,0,31,13,10,0,7,14,0,0,7,6,1.0,10,18,0.9106161484552737,20.940036996689855
1699,1699,2019,3,NCAAF_20190914_BAMA@SC,Alabama,Crimson Tide,South Carolina,Gamecocks,3-0,1-2,1.0,24,10,47,23,14,10,10,13,10,0,3,10,2.0,14,24,0.9507269830114699,25.727218049930286
1700,1700,2019,3,NCAAF_20190914_ECU@NAVY,East Carolina,Pirates,Navy,Midshipmen,1-2,2-0,1.0,3,28,10,42,0,3,0,7,14,14,14,0,-1.0,-25,-32,0.1565363469930594,-15.710888693768652
1701,1701,2019,3,NCAAF_20190914_GAS@MINN,Ga. Southern,Eagles,Minnesota,Golden Gophers,1-2,3-0,1.0,20,21,32,35,10,10,0,12,14,7,0,14,-2.0,-1,-3,0.10331925325302582,-19.66770782642351
1702,1702,2019,3,NCAAF_20190914_MEMP@SALA,Memphis,Tigers,South Alabama,Jaguars,3-0,1-2,0.0,23,0,42,6,7,16,7,12,0,0,0,6,2.0,23,36,0.9712359046794857,29.579149566223066
1703,1703,2019,3,NCAAF_20190914_OKLAST@TULSA,Oklahoma State,Cowboys,Tulsa,Golden Hurricane,3-0,1-2,1.0,20,21,40,21,17,3,13,7,7,14,0,0,2.0,-1,19,0.9406163278391566,24.294803955001044
1704,1704,2019,3,NCAAF_20190914_STNFRD@UCF,Stanford,Cardinal,UCF,Knights,1-2,3-0,1.0,7,38,27,45,7,0,3,17,28,10,0,7,-2.0,-31,-18,0.29742149281462926,-8.282688278750754
1705,1705,2019,3,NCAAF_20190914_UNLV@NWEST,UNLV,Rebels,Northwestern,Wildcats,1-2,1-1,0.0,14,16,14,30,7,7,0,0,10,6,7,7,0.0,-2,-16,0.04469841461800539,-26.45365329841826
1706,1706,2019,3,NCAAF_20190914_ARIZST@MICHST,Arizona St.,Sun Devils,Michigan St.,Spartans,3-0,2-1,0.0,3,0,10,7,0,3,0,7,0,0,0,7,1.0,3,3,0.30950849684792603,-7.744032156390858
1707,1707,2019,3,NCAAF_20190914_BTHN@MIAMI,Bethune-Cook.,Wildcats,Miami (Fla.),Hurricanes,1-1,1-2,0.0,0,28,0,63,0,0,0,0,7,21,14,21,0.0,-28,-63,0.004156671924414601,-41.10065600462116
1708,1708,2019,3,NCAAF_20190914_COLOST@ARK,Colorado St.,Rams,Arkansas,Razorbacks,1-2,2-1,1.0,24,27,34,55,14,10,10,0,24,3,7,21,-1.0,-3,-21,0.487805114112026,-0.47613808274786606
1709,1709,2019,3,NCAAF_20190914_IOWA@IOWAST,Iowa,Hawkeyes,Iowa St.,Cyclones,3-0,1-1,1.0,6,7,18,17,3,3,3,9,7,0,7,3,2.0,-1,1,0.6460723974194522,5.836137548076579
1710,1710,2019,3,NCAAF_20190914_LVILLE@WKY,Louisville,Cardinals,W. Kentucky,Hilltoppers,2-1,1-2,0.0,31,7,38,21,7,24,7,0,0,7,7,7,1.0,24,17,0.8508363573109687,16.19728674827263
1711,1711,2019,3,NCAAF_20190914_SELOU@MISS,SE Louisiana,Lions,Ole Miss,Rebels,1-1,2-1,0.0,17,27,29,40,3,14,12,0,13,14,7,6,-1.0,-10,-11,0.12648555135232176,-17.80350807339181
1712,1712,2019,3,NCAAF_20190914_CPOLY@OREGST,Cal-Poly,Mustangs,Oregon State,Beavers,1-2,1-2,0.0,7,38,7,45,7,0,0,0,21,17,7,0,0.0,-31,-38,0.03643013132594042,-27.934996261296874
1713,1713,2019,3,NCAAF_20190914_IDST@UTAH,Idaho State,Bengals,Utah,Utes,1-1,3-0,0.0,0,24,0,31,0,0,0,0,17,7,7,0,-2.0,-24,-31,0.018774936606269277,-32.38959600340735
1714,1714,2019,3,NCAAF_20190914_NTEXAS@CAL,North Texas,Mean Green,California,Golden Bears,1-2,3-0,0.0,3,20,17,23,0,3,7,7,20,0,3,0,-2.0,-17,-6,0.2179200624531339,-12.13576482698727
1715,1715,2019,3,NCAAF_20190914_IDAHO@WYO,Idaho,Vandals,Wyoming,Cowboys,1-2,3-0,0.0,10,14,16,21,3,7,3,3,0,14,0,7,-2.0,-4,-5,0.12652456118749345,-17.80058131083001
1716,1716,2019,3,NCAAF_20190914_LATECH@BGREEN,Louisiana Tech,Bulldogs,Bowling Green,Falcons,2-1,1-2,0.0,21,7,35,7,14,7,0,14,7,0,0,0,1.0,14,28,0.7082547658594903,8.539070503348455
1717,1717,2019,3,NCAAF_20190914_BUFF@LIB,Buffalo,Bulls,Liberty,Flames,1-2,1-2,0.0,7,28,17,35,0,7,3,7,7,21,7,0,0.0,-21,-18,0.8415363945329228,15.586247472216257
1718,1718,2019,3,NCAAF_20190914_MA@CHARLO,UMass,Minutemen,Charlotte,49ers,0-3,2-1,0.0,10,31,17,52,0,10,0,7,21,10,14,7,-2.0,-21,-35,0.6366935208248918,5.445176575227833
1719,1719,2019,3,NCAAF_20190914_SCST@SFLA,SC State,Bulldogs,South Florida,Bulls,2-1,1-2,0.0,3,24,16,55,3,0,6,7,7,17,17,14,1.0,-21,-39,0.14410310920704605,-16.540500736854312
1720,1720,2019,3,NCAAF_20190914_USM@TROY,So. Miss,,Troy,,2-1,1-1,,17,14,47,42,14,3,9,21,7,7,7,21,1.0,3,5,0.3745365514209401,-4.9814979820635585
1721,1721,2019,3,NCAAF_20190914_OHIO@MRSHL,Ohio,Bobcats,Marshall,Thundering Herd,1-2,2-1,0.0,17,27,31,33,3,14,7,7,10,17,0,6,-1.0,-10,-2,0.6434542384565705,5.7266389476795325
1722,1722,2019,3,NCAAF_20190914_DUKE@MTSU,Duke,Blue Devils,Middle Tenn.,Blue Raiders,2-1,1-2,0.0,31,3,41,18,14,17,10,0,3,0,8,7,1.0,28,23,0.7033241624136539,8.316238358189366
1723,1723,2019,3,NCAAF_20190914_FLA@UK,Florida,Gators,Kentucky,Wildcats,3-0,2-1,1.0,7,14,29,21,7,0,3,19,0,14,7,0,1.0,-7,8,0.5844949026870172,3.323567439558701
1724,1724,2019,3,NCAAF_20190914_GAST@WMICH,Georgia St.,,W. Michigan,,2-1,2-1,,10,43,10,57,10,0,0,0,24,19,14,0,0.0,-33,-47,0.244869215097419,-10.757285941739497
1725,1725,2019,3,NCAAF_20190914_KENTST@AUBURN,Kent St.,Golden Flashes,Auburn,Tigers,1-2,3-0,1.0,10,24,16,55,3,7,0,6,14,10,14,17,-2.0,-14,-39,0.0014925512169285948,-46.24310346834926
1726,1726,2019,3,NCAAF_20190914_LAMAR@TXAM,Lamar,Cardinals,Texas A&M,Aggies,2-1,2-1,0.0,0,27,3,62,0,0,3,0,13,14,21,14,0.0,-27,-59,2.8964552478694117e-06,-70.60913993924038
1727,1727,2019,3,NCAAF_20190914_MURYST@TOLEDO,Murray St.,,Toledo,,1-2,1-1,,0,17,0,45,0,0,0,0,3,14,21,7,0.0,-17,-45,0.022992926154695614,-31.078092999597573
1728,1728,2019,3,NCAAF_20190914_NH@FIU,New Hamp.,,FIU,,0-2,1-2,,10,13,17,30,10,0,7,0,7,6,7,10,-1.0,-3,-13,0.31286397983997194,-7.596150798984922
1729,1729,2019,3,NCAAF_20190914_TXSTSM@SMU,Texas St.,Bobcats,SMU,Mustangs,0-3,3-0,0.0,3,13,17,47,3,0,7,7,7,6,21,13,-3.0,-10,-30,0.05275767498738548,-25.20922927763735
1730,1730,2019,3,NCAAF_20190914_WBRST@NEVADA,Weber St.,Wildcats,Nevada,Wolf Pack,1-2,2-1,0.0,10,9,13,19,0,10,3,0,3,6,7,3,-1.0,1,-6,0.5583293336217474,2.285234540229794
1731,1731,2019,3,NCAAF_20190914_CLEM@CUSE,Clemson,Tigers,Syracuse,Orange,3-0,1-2,1.0,17,6,41,6,14,3,10,14,0,6,0,0,2.0,11,35,0.9545894718041253,26.33676176225066
1732,1732,2019,3,NCAAF_20190914_FSU@UVA,Florida State,Seminoles,Virginia,Cavaliers,1-2,3-0,0.0,14,10,24,31,0,14,3,7,3,7,0,21,-2.0,4,-7,0.5568864741409439,2.2283136752960786
1733,1733,2019,3,NCAAF_20190914_HAWAII@WASH,Hawaii,Rainbow Warriors,Washington,Huskies,2-1,2-1,0.0,7,38,20,52,0,7,13,0,21,17,0,14,0.0,-31,-32,0.010857511664103203,-35.74703865339757
1734,1734,2019,3,NCAAF_20190914_NWST@LSU,Northwestern St.,Demons,LSU,Tigers,0-3,3-0,1.0,14,24,14,65,7,7,0,0,3,21,27,14,-3.0,-10,-51,0.00014563942270606756,-56.4232574303789
1735,1735,2019,3,NCAAF_20190914_SEMOST@MIZZOU,SE Missouri St.,Redhawks,Missouri,Tigers,1-2,2-1,0.0,0,37,0,50,0,0,0,0,27,10,10,3,-1.0,-37,-50,0.0015080496052155556,-46.19364785611674
1736,1736,2019,3,NCAAF_20190914_TCU@PURDUE,TCU,Horned Frogs,Purdue,Boilermakers,2-0,1-2,0.0,13,6,34,13,10,3,14,7,3,3,0,7,1.0,7,21,0.5084909149867842,0.3314933432986322
1737,1737,2019,3,NCAAF_20190914_TXSO@LALAF,Texas Southern,,Louisiana,,0-3,2-1,,6,56,6,77,3,3,0,0,28,28,7,14,-2.0,-50,-71,0.02044071552304927,-31.844444399849976
1738,1738,2019,3,NCAAF_20190914_MOST@TULANE,Missouri St.,Bears,Tulane,Green Wave,0-2,2-1,0.0,6,38,6,58,0,6,0,0,10,28,13,7,-2.0,-32,-52,0.21499512401233412,-12.291057737364099
1739,1739,2019,3,NCAAF_20190914_NILL@NEB,N. Illinois,Huskies,Nebraska,Cornhuskers,1-2,2-1,0.0,5,30,8,44,0,5,3,0,10,20,7,7,-1.0,-25,-36,0.3821611572322601,-4.669208582958788
1740,1740,2019,3,NCAAF_20190914_OKLA@UCLA,Oklahoma,Sooners,UCLA,Bruins,3-0,0-3,1.0,34,7,48,14,17,17,7,7,0,7,7,0,3.0,27,34,0.9459802398215058,25.028323619846446
1741,1741,2019,3,NCAAF_20190914_SDGST@NMEXST,San Diego St.,Aztecs,New Mexico St.,Aggies,3-0,0-3,1.0,17,0,31,10,7,10,7,7,0,0,10,0,3.0,17,21,0.9353916041426121,23.62869580720468
1742,1742,2019,3,NCAAF_20190914_TEXAS@RICE,Texas,Longhorns,Rice,Owls,2-1,0-3,1.0,31,0,48,13,14,17,7,10,0,0,0,13,2.0,31,35,0.996603068798417,42.1551901497474
1743,1743,2019,3,NCAAF_20190914_PORTST@BOISE,Portland St.,Vikings,Boise St.,Broncos,1-2,3-0,1.0,10,28,10,45,10,0,0,0,14,14,10,7,-2.0,-18,-35,0.02025818834512394,-31.902299324924
1744,1744,2019,3,NCAAF_20190914_TXTECH@ARIZ,Texas Tech,Red Raiders,Arizona,Wildcats,2-1,2-1,0.0,7,13,14,28,7,0,7,0,0,13,0,15,0.0,-6,-14,0.7355548748791636,9.806904636926674
1745,1745,2019,3,NCAAF_20190914_MT@OREG,Montana,Grizzlies,Oregon,Ducks,2-1,2-1,0.0,0,21,3,35,0,0,3,0,14,7,7,7,0.0,-21,-32,0.0009132592819072194,-48.54511936687351
1746,1746,2019,3,NCAAF_20190913_UNC@WAKE,North Carolina,Tar Heels,Wake Forest,Demon Deacons,2-1,3-0,1.0,0,21,18,24,0,0,3,15,7,14,0,3,-1.0,-21,-6,0.23246006853528278,-11.38093202571963
1747,1747,2019,3,NCAAF_20190913_KANSAS@BC,Kansas,Jayhawks,Boston College,Eagles,2-1,2-1,0.0,28,24,48,24,7,21,13,7,17,7,0,0,0.0,4,24,0.11508941292259678,-18.68710578060052
1748,1748,2019,3,NCAAF_20190913_WASHST@HOU,Washington St.,Cougars,Houston,Cougars,3-0,1-2,1.0,7,14,31,24,0,7,14,10,0,14,0,10,2.0,-7,7,0.715132210773897,8.852847098234918
1749,1749,2019,4,NCAAF_20190922_CAR@HAWAII,Cent. Ark.,,Hawaii,,3-1,3-1,,9,28,16,35,0,9,0,7,14,14,0,7,0.0,-19,-19,0.5095522455051769,0.3731040032262172
1750,1750,2019,4,NCAAF_20190921_BC@RUT,Boston College,Eagles,Rutgers,Scarlet Knights,3-1,1-2,1.0,17,13,30,16,7,10,7,6,7,6,0,3,2.0,4,14,0.8295402797359843,14.838487720063313
1751,1751,2019,4,NCAAF_20190921_CAL@MISS,California,Golden Bears,Ole Miss,Rebels,4-0,2-2,0.0,14,13,28,20,7,7,14,0,7,6,0,7,2.0,1,8,0.5420313219112196,1.6446057968037167
1752,1752,2019,4,NCAAF_20190921_ELON@WAKE,Elon,Phoenix,Wake Forest,Demon Deacons,2-2,4-0,0.0,7,28,7,49,7,0,0,0,14,14,14,7,-2.0,-21,-42,0.004944371534620129,-40.19402168603665
1753,1753,2019,4,NCAAF_20190921_LAMON@IOWAST,UL-Monroe,Warhawks,Iowa St.,Cyclones,1-2,2-1,1.0,13,27,20,72,0,13,7,0,14,13,21,24,-1.0,-14,-52,0.019110403366519257,-32.29111949735568
1754,1754,2019,4,NCAAF_20190921_LSU@VANDY,LSU,Tigers,Vanderbilt,Commodores,4-0,0-3,0.0,38,17,66,38,28,10,21,7,7,10,14,7,4.0,21,28,0.843142532408819,15.697112165781164
1755,1755,2019,4,NCAAF_20190921_MICH@WISC,Michigan,Wolverines,Wisconsin,Badgers,2-1,3-0,0.0,0,28,14,35,0,0,8,6,14,14,7,0,-1.0,-28,-21,0.5461171576637518,1.8051619653699618
1756,1756,2019,4,NCAAF_20190921_MICHST@NWEST,Michigan St.,Spartans,Northwestern,Wildcats,3-1,1-2,1.0,14,3,31,10,7,7,10,7,0,3,0,7,2.0,11,21,0.528582811782425,1.117274644053964
1757,1757,2019,4,NCAAF_20190921_MRGNST@ARMY,Morgan St.,Bears,Army,Black Knights,0-3,3-1,1.0,14,24,21,52,14,0,7,0,7,17,7,21,-3.0,-10,-31,2.208180149743111e-05,-63.640926321571214
1758,1758,2019,4,NCAAF_20190921_TENN@FLA,Tennessee,Volunteers,Florida,Gators,1-3,4-0,0.0,0,17,3,34,0,0,3,0,7,10,7,10,-3.0,-17,-31,0.18347490554550328,-14.057126857880803
1759,1759,2019,4,NCAAF_20190921_UCONN@IND,UConn,Huskies,Indiana,Hoosiers,1-2,3-1,0.0,3,17,3,38,3,0,0,0,7,10,14,7,-2.0,-14,-35,0.039115422704392944,-27.438689366812355
1760,1760,2019,4,NCAAF_20190921_USM@BAMA,So. Miss,Golden Eagles,Alabama,Crimson Tide,2-2,4-0,1.0,7,28,7,49,0,7,0,0,14,14,14,7,-2.0,-21,-42,0.002767094388386626,-43.22418955564308
1761,1761,2019,4,NCAAF_20190921_WMICH@CUSE,W. Michigan,Broncos,Syracuse,Orange,2-2,2-2,0.0,13,24,33,52,0,13,20,0,14,10,14,14,0.0,-11,-19,0.22385723010583436,-11.829512707832237
1762,1762,2019,4,NCAAF_20190921_CSTCAR@MA,C. Carolina,Chanticleers,UMass,Minutemen,3-1,0-4,1.0,42,14,62,28,14,28,14,6,7,7,7,7,3.0,28,34,0.4846738426319076,-0.598719052021238
1763,1763,2019,4,NCAAF_20190921_LALAF@OHIO,Louisiana,Ragin' Cajuns,Ohio,Bobcats,3-1,1-3,0.0,10,6,45,25,7,3,14,21,0,6,6,13,2.0,4,20,0.17555372972176508,-14.528321525043793
1764,1764,2019,4,NCAAF_20190921_CCTST@EMICH,CCSU,Blue Devils,E. Michigan,Eagles,3-1,3-1,1.0,15,21,29,34,15,0,0,14,7,14,0,13,0.0,-6,-5,0.01758848853166528,-32.81832170497421
1765,1765,2019,4,NCAAF_20190921_TROY@AKRON,Troy,Trojans,Akron,Zips,2-1,0-4,0.0,21,7,35,7,7,14,14,0,7,0,0,0,2.0,14,28,0.763516622482223,11.181805385699363
1766,1766,2019,4,NCAAF_20190921_APLST@UNC,App. St.,Mountaineers,North Carolina,Tar Heels,3-0,2-2,0.0,27,17,34,31,13,14,7,0,7,10,7,7,1.0,10,3,0.6074528304638835,4.24870297955556
1767,1767,2019,4,NCAAF_20190921_AUBURN@TXAM,Auburn,Tigers,Texas A&M,Aggies,4-0,2-2,1.0,14,3,28,20,14,0,7,7,0,3,0,17,2.0,11,8,0.7386419121966477,9.958762544961473
1768,1768,2019,4,NCAAF_20190921_BGREEN@KENTST,Bowling Green,Falcons,Kent St.,Golden Flashes,1-3,2-2,0.0,7,24,20,62,7,0,0,13,21,3,17,21,-1.0,-17,-42,0.6149997737379242,4.55545956572189
1769,1769,2019,4,NCAAF_20190921_LVILLE@FSU,Louisville,Cardinals,Florida State,Seminoles,2-2,2-2,0.0,7,21,24,35,0,7,10,7,21,0,0,14,0.0,-14,-11,0.36176984999642503,-5.51146948965561
1770,1770,2019,4,NCAAF_20190921_MIAOH@OHIOST,Miami-OH,RedHawks,Ohio State,Buckeyes,1-3,4-0,1.0,5,49,5,76,5,0,0,0,7,42,14,13,-3.0,-44,-71,0.007112137171358501,-38.19738274653571
1771,1771,2019,4,NCAAF_20190921_SALA@UAB,South Alabama,Jaguars,UAB,Blazers,1-3,3-0,1.0,3,28,3,35,3,0,0,0,14,14,7,0,-2.0,-25,-32,0.18228413234685248,-14.127134302540753
1772,1772,2019,4,NCAAF_20190921_SMU@TCU,SMU,Mustangs,TCU,Horned Frogs,4-0,2-1,1.0,31,17,41,38,18,13,0,10,7,10,7,14,2.0,14,3,0.1737062777759053,-14.640139308814355
1773,1773,2019,4,NCAAF_20190921_TEMPLE@BUFF,Temple,Owls,Buffalo,Bulls,2-1,2-2,0.0,7,24,22,38,7,0,3,12,0,24,7,7,0.0,-17,-16,0.681756442296348,7.363791431035793
1774,1774,2019,4,NCAAF_20190921_UCF@PITT,UCF,Knights,Pittsburgh,Panthers,3-1,2-2,1.0,10,21,34,35,0,10,21,3,7,14,7,7,1.0,-11,-1,0.8389727849796411,15.428922945422869
1775,1775,2019,4,NCAAF_20190921_WASH@BYU,Washington,Huskies,BYU,Cougars,3-1,2-2,1.0,24,12,45,19,21,3,21,0,3,9,7,0,1.0,12,26,0.9271898263811498,22.672986506904067
1776,1776,2019,4,NCAAF_20190921_WYO@TULSA,Wyoming,Cowboys,Tulsa,Golden Hurricane,3-1,2-2,0.0,7,14,21,24,7,0,0,14,0,14,3,7,1.0,-7,-3,0.6106793976205478,4.379643140624921
1777,1777,2019,4,NCAAF_20190921_CMICH@MIAMI,C. Michigan,Chippewas,Miami (Fla.),Hurricanes,2-2,2-2,1.0,2,7,12,17,0,2,3,7,7,0,7,3,0.0,-5,-5,0.04835336485630137,-25.88042309956427
1778,1778,2019,4,NCAAF_20190921_SC@MIZZOU,South Carolina,Gamecocks,Missouri,Tigers,1-3,3-1,0.0,7,17,14,34,0,7,7,0,7,10,14,3,-2.0,-10,-20,0.3871357516887035,-4.4684838883200655
1779,1779,2019,4,NCAAF_20190921_UK@MISSST,Kentucky,Wildcats,Miss. State,Bulldogs,2-2,3-1,1.0,3,21,13,28,3,0,7,3,7,14,0,7,-1.0,-18,-15,0.2860581077344687,-8.802245291028271
1780,1780,2019,4,NCAAF_20190921_NMEXST@NMEX,New Mexico St.,Aggies,New Mexico,Lobos,0-4,2-1,1.0,31,31,52,55,17,14,7,14,14,17,17,7,-2.0,0,-3,0.3817733615066803,-4.687154088055308
1781,1781,2019,4,NCAAF_20190921_WVU@KANSAS,West Virginia,Mountaineers,Kansas,Jayhawks,3-1,2-2,0.0,10,7,29,24,7,3,10,9,0,7,10,7,1.0,3,5,0.9146519533454687,21.34539656328832
1782,1782,2019,4,NCAAF_20190921_HAMP@LIB,Hampton,Pirates,Liberty,Flames,2-2,2-2,0.0,12,41,27,62,12,0,8,7,27,14,7,14,0.0,-29,-35,0.0035103844188897337,-42.00393052743141
1783,1783,2019,4,NCAAF_20190921_WAG@FAU,Wagner,Seahawks,FAU,Owls,0-4,2-2,0.0,7,28,7,42,0,7,0,0,14,14,7,7,-2.0,-21,-35,0.007235911043441234,-38.10053782429907
1784,1784,2019,4,NCAAF_20190921_WMMARY@ECU,William & Mary,Tribe,East Carolina,Pirates,2-2,2-2,0.0,7,10,7,19,0,7,0,0,7,3,3,6,0.0,-3,-12,0.24178026747610115,-10.915793869867116
1785,1785,2019,4,NCAAF_20190921_BALLST@NCST,Ball St.,Cardinals,NC State,Wolfpack,1-3,3-1,1.0,7,20,23,34,7,0,6,10,6,14,7,7,-2.0,-13,-11,0.00833935138474351,-37.29627315805908
1786,1786,2019,4,NCAAF_20190921_BAYLOR@RICE,Baylor,Bears,Rice,Owls,3-0,0-4,1.0,21,3,21,13,7,14,0,0,0,3,3,7,3.0,18,8,0.9571438930709596,26.775226795925505
1787,1787,2019,4,NCAAF_20190921_ODU@UVA,Old Dominion,Monarchs,Virginia,Cavaliers,1-2,4-0,1.0,17,7,17,28,10,7,0,0,0,7,7,14,-3.0,10,-11,0.06477197243470356,-23.619153876399537
1788,1788,2019,4,NCAAF_20190921_OREG@STNFRD,Oregon,Ducks,Stanford,Cardinal,3-1,1-3,0.0,14,3,21,6,7,7,0,7,3,0,0,3,2.0,11,15,0.4689043104767462,-1.2156920930668775
1789,1789,2019,4,NCAAF_20190921_SIL@ARKST,S. Illinois,Salukis,Arkansas St.,Red Wolves,2-2,2-2,0.0,14,31,28,41,14,0,14,0,14,17,7,3,0.0,-17,-13,0.36138765111269033,-5.527363065337568
1790,1790,2019,4,NCAAF_20190921_CHARLO@CLEM,Charlotte,49ers,Clemson,Tigers,2-2,4-0,1.0,3,38,10,52,0,3,7,0,17,21,7,7,-2.0,-35,-42,0.00035104396916496583,-52.80002479703728
1791,1791,2019,4,NCAAF_20190921_OKLAST@TEXAS,Oklahoma State,Cowboys,Texas,Longhorns,3-1,3-1,1.0,20,21,30,36,3,17,3,7,0,21,7,8,0.0,-1,-6,0.49245702262585267,-0.2946128005810351
1792,1792,2019,4,NCAAF_20190921_SJST@ARK,San Jose St.,Spartans,Arkansas,Razorbacks,2-1,2-2,1.0,24,7,31,24,7,17,0,7,7,0,3,14,0.0,17,7,0.12170869389572592,-18.174944565160217
1793,1793,2019,4,NCAAF_20190921_TXSA@NTEXAS,UTSA,Roadrunners,North Texas,Mean Green,1-3,2-2,1.0,3,24,3,45,0,3,0,0,7,17,14,7,-1.0,-21,-42,0.2414392171512284,-10.932825199919307
1794,1794,2019,4,NCAAF_20190921_ND@UGA,Notre Dame,Fighting Irish,Georgia,Bulldogs,2-1,4-0,1.0,10,7,17,23,0,10,0,7,0,7,6,10,-2.0,3,-6,0.30732371769028566,-7.844223179659139
1795,1795,2019,4,NCAAF_20190921_NEB@ILL,Nebraska,Cornhuskers,Illinois,Fighting Illini,3-1,2-2,0.0,14,21,42,38,7,7,13,15,14,7,14,3,1.0,-7,4,0.7688736187388321,11.454192506570848
1796,1796,2019,4,NCAAF_20190921_NEVADA@UTEP,Nevada,Wolf Pack,UTEP,Miners,3-1,1-2,1.0,21,14,37,21,0,21,3,13,7,7,7,0,2.0,7,16,0.9093874654203244,20.83156900110305
1797,1797,2019,4,NCAAF_20190921_COLO@ARIZST,Colorado,Buffaloes,Arizona St.,Sun Devils,3-1,3-1,1.0,24,21,34,31,14,10,7,3,0,21,3,7,0.0,3,3,0.35998620043903984,-5.585691172677798
1798,1798,2019,4,NCAAF_20190921_SACST@FRESNO,Sacramento St.,Hornets,Fresno St.,Bulldogs,2-2,1-2,0.0,12,14,20,34,6,6,0,8,7,7,0,20,1.0,-2,-14,0.03550866708545608,-28.12926589215988
1799,1799,2019,4,NCAAF_20190921_TOLEDO@COLOST,Toledo,Rockets,Colorado St.,Rams,2-1,1-3,0.0,14,13,41,35,7,7,21,6,7,6,14,8,1.0,1,6,0.7225019371941259,9.197261803562583
1800,1800,2019,4,NCAAF_20190921_UCLA@WASHST,UCLA,Bruins,Washington St.,Cougars,1-3,3-1,0.0,17,35,67,63,10,7,21,29,7,28,14,14,-2.0,-18,4,0.21996807763226167,-12.033157718967686
1801,1801,2019,4,NCAAF_20190921_UTAHST@SDGST,Utah St.,Aggies,San Diego St.,Aztecs,2-1,3-1,0.0,20,3,23,17,7,13,3,0,3,0,0,14,-1.0,17,6,0.6030471113978866,4.07039203764964
1802,1802,2019,4,NCAAF_20190920_FIU@LATECH,FIU,Panthers,Louisiana Tech,Bulldogs,1-3,3-1,0.0,10,13,31,43,0,10,14,7,0,13,14,16,-2.0,-3,-12,0.5301351009677255,1.1780649024080958
1803,1803,2019,4,NCAAF_20190920_AF@BOISE,Air Force,Falcons,Boise St.,Broncos,2-1,4-0,0.0,10,10,19,30,0,10,3,6,0,10,7,13,-2.0,0,-11,0.19927382856853837,-13.153688350590528
1804,1804,2019,4,NCAAF_20190920_UTAH@USC,Utah,Utes,USC,Trojans,3-1,3-1,0.0,10,14,23,30,7,3,7,6,14,0,7,9,0.0,-4,-7,0.5434410680839601,1.6999823014126605
1805,1805,2019,4,NCAAF_20190919_HOU@TULANE,Houston,Cougars,Tulane,Green Wave,1-3,3-1,1.0,28,14,31,38,14,14,0,3,7,7,7,17,-2.0,14,-7,0.6217867437337595,4.832838750327028
1806,1806,2019,5,NCAAF_20190928_BUFF@MIAOH,Buffalo,Bulls,Miami-OH,RedHawks,2-3,2-3,1.0,14,13,20,34,7,7,0,6,0,13,21,0,0.0,1,-14,0.6386573663536397,5.53668826056014
1807,1807,2019,5,NCAAF_20190928_BYU@TOLEDO,BYU,Cougars,Toledo,Rockets,2-3,3-1,0.0,7,3,21,28,0,7,14,0,0,3,11,14,-1.0,4,-7,0.3837209346704009,-4.613841014665752
1808,1808,2019,5,NCAAF_20190928_CMICH@WMICH,C. Michigan,Chippewas,W. Michigan,Broncos,2-3,3-2,1.0,0,17,15,31,0,0,0,15,10,7,7,7,-1.0,-17,-16,0.3782830497914813,-4.836488941487062
1809,1809,2019,5,NCAAF_20190928_HOLY@CUSE,Holy Cross,Crusaders,Syracuse,Orange,1-3,3-2,1.0,3,24,3,41,0,3,0,0,17,7,10,7,-2.0,-21,-38,0.003355648856644966,-42.29430432060997
1810,1810,2019,5,NCAAF_20190928_KANSAS@TCU,Kansas,Jayhawks,TCU,Horned Frogs,2-3,3-1,1.0,0,38,14,51,0,0,0,14,21,17,0,13,-1.0,-38,-37,0.08753480364102062,-21.15764992717476
1811,1811,2019,5,NCAAF_20190928_MTSU@IOWA,Middle Tenn.,Blue Raiders,Iowa,Hawkeyes,1-3,4-0,0.0,0,24,3,48,0,0,3,0,17,7,10,14,-3.0,-24,-45,0.04918279978638196,-25.787307317952866
1812,1812,2019,5,NCAAF_20190928_NILL@VANDY,N. Illinois,Huskies,Vanderbilt,Commodores,1-3,1-3,0.0,0,14,18,24,0,0,10,8,14,0,7,3,0.0,-14,-6,0.40271453260051193,-3.8431744804497043
1813,1813,2019,5,NCAAF_20190928_NWEST@WISC,Northwestern,Wildcats,Wisconsin,Badgers,1-3,4-0,0.0,3,7,15,24,3,0,0,12,7,0,7,10,-3.0,-4,-9,0.20521885518760663,-12.842306575019222
1814,1814,2019,5,NCAAF_20190928_RUT@MICH,Rutgers,Scarlet Knights,Michigan,Wolverines,1-3,3-1,0.0,0,24,0,52,0,0,0,0,14,10,14,14,-2.0,-24,-52,0.02529418162147734,-30.50104933457743
1815,1815,2019,5,NCAAF_20190928_TXAM@ARK,Texas A&M,Aggies,Arkansas,Razorbacks,3-2,2-3,0.0,21,17,31,27,7,14,0,10,0,17,7,3,1.0,4,4,0.8732679964217664,17.817015052764077
1816,1816,2019,5,NCAAF_20190928_TXTECH@OKLA,Texas Tech,Red Raiders,Oklahoma,Sooners,2-2,4-0,1.0,10,34,16,55,0,10,6,0,17,17,14,7,-2.0,-24,-39,0.15274449181052707,-15.987806595062523
1817,1817,2019,5,NCAAF_20190928_DE@PITT,Delaware,Fightin' Blue Hens,Pittsburgh,Panthers,3-2,3-2,1.0,7,10,14,17,0,7,7,0,0,10,0,7,0.0,-3,-3,0.047380995362735434,-26.06762062265659
1818,1818,2019,5,NCAAF_20190928_AKRON@MA,Akron,Zips,UMass,Minutemen,0-5,1-4,0.0,14,20,29,37,7,7,7,8,7,13,14,3,-1.0,-6,-8,0.6177934379424304,4.67574897865137
1819,1819,2019,5,NCAAF_20190928_CLEM@UNC,Clemson,Tigers,North Carolina,Tar Heels,5-0,2-3,0.0,14,14,21,20,0,14,0,7,7,7,0,6,3.0,0,1,0.9887716777816419,35.6122217950948
1820,1820,2019,5,NCAAF_20190928_CSTCAR@APLST,C. Carolina,Chanticleers,App. St.,Mountaineers,3-2,4-0,1.0,21,35,37,56,14,7,9,7,14,21,7,14,-1.0,-14,-19,0.11750552324143981,-18.528045404591126
1821,1821,2019,5,NCAAF_20190928_FAU@CHARLO,FAU,Owls,Charlotte,49ers,3-2,2-3,0.0,24,14,45,27,14,10,14,7,7,7,7,6,1.0,10,18,0.9067173907130819,20.60714570391832
1822,1822,2019,5,NCAAF_20190928_GATECH@TEMPLE,Georgia Tech,Yellow Jackets,Temple,Owls,1-3,3-1,0.0,0,14,2,24,0,0,2,0,0,14,10,0,-2.0,-14,-22,0.6705999476319728,6.8893450631172755
1823,1823,2019,5,NCAAF_20190928_IND@MICHST,Indiana,Hoosiers,Michigan St.,Spartans,3-2,4-1,0.0,14,21,31,40,7,7,3,14,7,14,0,19,-1.0,-7,-9,0.3087131747247156,-7.793176401078824
1824,1824,2019,5,NCAAF_20190928_IOWAST@BAYLOR,Iowa St.,Cyclones,Baylor,Bears,2-2,4-0,1.0,0,7,21,23,0,0,0,21,0,7,13,3,-2.0,-7,-2,0.8614807945517726,16.95922792850945
1825,1825,2019,5,NCAAF_20190928_MINN@PURDUE,Minnesota,Golden Gophers,Purdue,Boilermakers,4-0,1-3,1.0,28,10,38,31,14,14,10,0,3,7,7,14,3.0,18,7,0.3381642378747558,-6.513464555452572
1826,1826,2019,5,NCAAF_20190928_MISS@BAMA,Ole Miss,Rebels,Alabama,Crimson Tide,2-3,5-0,0.0,10,38,31,59,10,0,7,14,7,31,14,7,-3.0,-28,-28,0.014569844870421234,-34.037011931477934
1827,1827,2019,5,NCAAF_20190928_USC@WASH,USC,Trojans,Washington,Huskies,3-2,4-1,1.0,7,17,14,28,0,7,7,0,14,3,11,0,-1.0,-10,-14,0.29740749333891325,-8.29821557444103
1828,1828,2019,5,NCAAF_20190928_UVA@ND,Virginia,Cavaliers,Notre Dame,Fighting Irish,4-1,3-1,1.0,17,14,20,35,7,10,0,3,14,0,14,7,1.0,3,-15,0.11853488402574652,-18.446812664650906
1829,1829,2019,5,NCAAF_20190928_WAKE@BC,Wake Forest,Demon Deacons,Boston College,Eagles,5-0,3-2,0.0,17,17,27,24,10,7,3,7,0,17,0,7,2.0,0,3,0.49416110028631,-0.22835705671366213
1830,1830,2019,5,NCAAF_20190928_SMU@SFLA,SMU,,South Florida,,5-0,1-3,,34,0,48,21,14,20,7,7,0,0,7,14,4.0,34,27,0.5475396954540971,1.8636144270731734
1831,1831,2019,5,NCAAF_20190928_TWST@FLA,Towson,Tigers,Florida,Gators,3-2,5-0,0.0,0,17,0,38,0,0,0,0,7,10,14,7,-2.0,-17,-38,0.001963470902740738,-44.995487151907525
1832,1832,2019,5,NCAAF_20190928_CINCY@MRSHL,Cincinnati,Bearcats,Marshall,Thundering Herd,3-1,2-2,1.0,28,0,52,14,14,14,17,7,0,0,0,14,1.0,28,38,0.5979403352383599,3.8695796010495087
1833,1833,2019,5,NCAAF_20190928_ARKST@TROY,Arkansas St.,Red Wolves,Troy,Trojans,3-2,2-2,0.0,31,31,50,43,21,10,14,5,10,21,6,6,1.0,0,7,0.46048736668276535,-1.5478034011738941
1834,1834,2019,5,NCAAF_20190928_ECU@ODU,East Carolina,Pirates,Old Dominion,Monarchs,3-2,1-3,1.0,17,3,24,21,10,7,0,7,3,0,10,8,2.0,14,3,0.5479509637144804,1.8798145506052606
1835,1835,2019,5,NCAAF_20190928_LALAF@GAS,Louisiana,Ragin' Cajuns,Ga. Southern,Eagles,4-1,1-3,0.0,17,13,37,24,7,10,7,13,3,10,8,3,3.0,4,13,0.5131515314933446,0.5144260218053773
1836,1836,2019,5,NCAAF_20190928_NMEX@LIB,New Mexico,Lobos,Liberty,Flames,2-2,3-2,0.0,3,14,10,17,0,3,0,7,7,7,3,0,-1.0,-11,-7,0.5004379045818527,0.01712566684511785
1837,1837,2019,5,NCAAF_20190928_KSTATE@OKLAST,Kansas State,Wildcats,Oklahoma State,Cowboys,3-1,4-1,0.0,3,16,13,26,0,3,0,10,10,6,7,3,-1.0,-13,-13,0.3686166877416561,-5.234744744940372
1838,1838,2019,5,NCAAF_20190928_MISSST@AUBURN,Miss. State,Bulldogs,Auburn,Tigers,3-2,5-0,1.0,9,42,23,56,6,3,7,7,21,21,7,7,-2.0,-33,-33,0.4100860792650032,-3.5466833735885075
1839,1839,2019,5,NCAAF_20190928_NICHST@TXSTSM,Nicholls St.,Colonels,Texas St.,Bobcats,2-2,2-3,1.0,3,3,3,24,0,3,0,0,3,0,14,7,0.0,0,-21,0.7241031361987788,9.284302055416845
1840,1840,2019,5,NCAAF_20190928_SALA@LAMON,South Alabama,Jaguars,UL-Monroe,Warhawks,1-4,2-2,1.0,7,17,17,30,7,0,3,7,7,10,0,13,-1.0,-10,-13,0.3508961318027768,-5.974008928830813
1841,1841,2019,5,NCAAF_20190928_STNFRD@OREGST,Stanford,Cardinal,Oregon State,Beavers,2-3,1-3,1.0,14,0,31,28,7,7,7,10,0,0,7,21,1.0,14,3,0.963830320226241,28.036278440586955
1842,1842,2019,5,NCAAF_20190928_UAB@WKY,UAB,Blazers,W. Kentucky,Hilltoppers,3-1,2-2,0.0,10,13,13,20,3,7,3,0,3,10,0,7,1.0,-3,-7,0.7301814658950873,9.569621937166744
1843,1843,2019,5,NCAAF_20190928_UCONN@UCF,UConn,Huskies,UCF,Knights,1-3,4-1,1.0,0,42,21,56,0,0,7,14,28,14,14,0,-3.0,-42,-35,0.0028996220162841313,-43.04446803322486
1844,1844,2019,5,NCAAF_20190928_UTEP@USM,UTEP,Miners,So. Miss,Golden Eagles,1-3,3-2,1.0,6,24,13,31,0,6,7,0,14,10,7,0,-2.0,-18,-18,0.08143084265479827,-21.772653602943308
1845,1845,2019,5,NCAAF_20190928_COLOST@UTAHST,Colorado St.,Rams,Utah St.,Aggies,1-4,3-1,1.0,21,24,24,34,7,14,3,0,7,17,3,7,-2.0,-3,-10,0.17631083404056447,-14.502234144456509
1846,1846,2019,5,NCAAF_20190928_NCST@FSU,NC State,Wolfpack,Florida State,Seminoles,3-2,3-2,1.0,6,17,13,31,0,6,0,7,3,14,7,7,0.0,-11,-18,0.6534590340788928,6.157704241521401
1847,1847,2019,5,NCAAF_20190928_OHIOST@NEB,Ohio State,Buckeyes,Nebraska,Cornhuskers,5-0,3-2,0.0,38,0,48,7,14,24,10,0,0,0,7,0,2.0,38,41,0.9642521737445728,28.119590733718667
1848,1848,2019,5,NCAAF_20190928_UK@SC,Kentucky,Wildcats,South Carolina,Gamecocks,2-3,2-3,0.0,0,10,7,24,0,0,0,7,7,3,7,7,0.0,-10,-17,0.4677877486672708,-1.261135415182025
1849,1849,2019,5,NCAAF_20190928_FRESNO@NMEXST,Fresno St.,Bulldogs,New Mexico St.,Aggies,2-2,0-5,0.0,24,3,30,17,7,17,6,0,0,3,7,7,2.0,21,13,0.9657845351132748,28.429167807945362
1850,1850,2019,5,NCAAF_20190928_HOU@NTEXAS,Houston,Cougars,North Texas,Mean Green,2-3,2-3,0.0,17,6,46,25,14,3,14,15,0,6,12,7,0.0,11,21,0.7371748471428126,9.901910198346116
1851,1851,2019,5,NCAAF_20190928_UNLV@WYO,UNLV,Rebels,Wyoming,Cowboys,1-3,4-1,0.0,10,33,17,53,10,0,0,7,7,26,0,20,-3.0,-23,-36,0.26125126458696046,-9.977310792274409
1852,1852,2019,5,NCAAF_20190928_WASHST@UTAH,Washington St.,Cougars,Utah,Utes,3-2,4-1,1.0,13,21,13,38,7,6,0,0,7,14,10,7,-1.0,-8,-25,0.5191756629328255,0.7502148124887071
1853,1853,2019,5,NCAAF_20190928_HAWAII@NEVADA,Hawaii,Rainbow Warriors,Nevada,Wolf Pack,4-1,3-2,1.0,31,3,54,3,7,24,14,9,0,3,0,0,1.0,28,51,0.30564240027084033,-7.929523987579273
1854,1854,2019,5,NCAAF_20190928_UCLA@ARIZ,UCLA,Bruins,Arizona,Wildcats,1-4,3-1,0.0,7,6,17,20,7,0,10,0,0,6,7,7,-2.0,1,-3,0.4707946284368786,-1.1431918581750438
1855,1855,2019,5,NCAAF_20190927_DUKE@VATECH,Duke,Blue Devils,Virginia Tech,Hokies,3-1,2-2,0.0,21,3,45,10,0,21,10,14,3,0,7,0,1.0,18,35,0.44440764656077725,-2.181201796546077
1856,1856,2019,5,NCAAF_20190927_PSU@MD,Penn State,Nittany Lions,Maryland,Terrapins,4-0,2-2,0.0,38,0,59,0,14,24,7,14,0,0,0,0,2.0,38,59,0.9359316921776021,23.7381805116824
1857,1857,2019,5,NCAAF_20190927_SJST@AF,San Jose St.,Spartans,Air Force,Falcons,2-2,3-1,1.0,10,21,24,41,7,3,0,14,7,14,13,7,-1.0,-11,-17,0.1036393399316804,-19.67532455603856
1858,1858,2019,5,NCAAF_20190927_ARIZST@CAL,Arizona St.,Sun Devils,California,Golden Bears,4-1,4-1,1.0,7,7,24,17,7,0,7,10,7,0,7,3,0.0,0,7,0.5465226211366279,1.8235597997175432
1859,1859,2019,5,NCAAF_20190926_NAVY@MEMP,Navy,Midshipmen,Memphis,Tigers,2-1,4-0,1.0,20,14,23,35,13,7,0,3,7,7,14,7,-2.0,6,-12,0.30072480574800486,-8.149147326907382
1860,1860,2019,6,NCAAF_20191005_IOWA@MICH,Iowa,Hawkeyes,Michigan,Wolverines,4-1,4-1,0.0,3,10,3,10,0,3,0,0,10,0,0,0,0.0,-7,-7,0.43081251216740146,-2.734984395072672
1861,1861,2019,6,NCAAF_20191005_KENTST@WISC,Kent St.,Golden Flashes,Wisconsin,Badgers,2-3,5-0,1.0,0,28,0,48,0,0,0,0,7,21,13,7,-3.0,-28,-48,0.0012260411986212416,-47.53018909444688
1862,1862,2019,6,NCAAF_20191005_MD@RUT,Maryland,Terrapins,Rutgers,Scarlet Knights,3-2,1-4,0.0,27,7,48,7,7,20,21,0,0,7,0,0,2.0,20,41,0.7658974972280228,11.382084948786485
1863,1863,2019,6,NCAAF_20191005_OKLA@KANSAS,Oklahoma,Sooners,Kansas,Jayhawks,5-0,2-4,0.0,21,7,45,20,7,14,14,10,7,0,0,13,3.0,14,25,0.9878832564372199,35.3575624917645
1864,1864,2019,6,NCAAF_20191005_OKLAST@TXTECH,Oklahoma State,Cowboys,Texas Tech,Red Raiders,4-2,3-2,1.0,7,20,35,45,0,7,14,14,13,7,14,11,1.0,-13,-10,0.6383238583998249,5.554231396960688
1865,1865,2019,6,NCAAF_20191005_PURDUE@PSU,Purdue,Boilermakers,Penn State,Nittany Lions,1-4,5-0,1.0,7,28,7,35,0,7,0,0,21,7,0,7,-4.0,-21,-28,0.1228386675617591,-18.215549156683096
1866,1866,2019,6,NCAAF_20191005_SFLA@UCONN,South Florida,Bulls,UConn,Huskies,2-3,1-4,0.0,27,14,48,22,7,20,7,14,0,14,0,8,1.0,13,26,0.912726965836381,21.303913426069755
1867,1867,2019,6,NCAAF_20191005_TULANE@ARMY,Tulane,Green Wave,Army,Black Knights,4-1,3-2,1.0,21,14,42,33,14,7,7,14,7,7,7,12,1.0,7,9,0.47244419046392716,-1.0846547589798092
1868,1868,2019,6,NCAAF_20191005_UTAHST@LSU,Utah St.,Aggies,LSU,Tigers,3-2,5-0,0.0,6,21,6,42,6,0,0,0,7,14,14,7,-2.0,-15,-36,0.2441691802963103,-10.872942932372041
1869,1869,2019,6,NCAAF_20191005_BC@LVILLE,Boston College,Eagles,Louisville,Cardinals,3-3,3-2,1.0,22,28,39,41,7,15,7,10,14,14,3,10,0.0,-6,-2,0.6914697006448307,7.845678506464026
1870,1870,2019,6,NCAAF_20191005_TCU@IOWAST,TCU,Horned Frogs,Iowa St.,Cyclones,3-2,3-2,1.0,3,21,24,49,0,3,7,14,7,14,14,14,0.0,-18,-25,0.4702515368031198,-1.1711167394701647
1871,1871,2019,6,NCAAF_20191005_EMICH@CMICH,E. Michigan,Eagles,C. Michigan,Chippewas,3-2,3-3,0.0,3,21,16,42,3,0,7,6,7,14,14,7,0.0,-18,-26,0.6598327132910548,6.464677052927527
1872,1872,2019,6,NCAAF_20191005_AF@NAVY,Air Force,Falcons,Navy,Midshipmen,3-2,3-1,0.0,6,14,25,34,3,3,3,16,0,14,7,13,0.0,-8,-9,0.4010503383714422,-3.9325531053359555
1873,1873,2019,6,NCAAF_20191005_ARKST@GAST,Arkansas St.,Red Wolves,Georgia St.,Panthers,3-3,3-2,0.0,21,31,38,52,0,21,7,10,7,24,7,14,0.0,-10,-14,0.8365621146294789,15.38358523724628
1874,1874,2019,6,NCAAF_20191005_AUBURN@FLA,Auburn,Tigers,Florida,Gators,5-1,6-0,1.0,13,17,13,24,6,7,0,0,7,10,0,7,-1.0,-4,-11,0.7267664478975239,9.462480024856973
1875,1875,2019,6,NCAAF_20191005_BALLST@NILL,Ball St.,Cardinals,N. Illinois,Huskies,2-3,1-4,1.0,3,17,27,20,0,3,14,10,14,3,0,3,1.0,-14,7,0.09502941014806066,-20.56118908450543
1876,1876,2019,6,NCAAF_20191005_BAYLOR@KSTATE,Baylor,Bears,Kansas State,Wildcats,5-0,3-2,1.0,10,3,31,12,0,10,7,14,3,0,3,6,2.0,7,19,0.2809470422876962,-9.101090563715275
1877,1877,2019,6,NCAAF_20191005_BGREEN@ND,Bowling Green,Falcons,Notre Dame,Fighting Irish,1-4,4-1,0.0,0,35,0,52,0,0,0,0,21,14,10,7,-3.0,-35,-52,0.0024976094278881256,-44.04919293460841
1878,1878,2019,6,NCAAF_20191005_ILL@MINN,Illinois,Fighting Illini,Minnesota,Golden Gophers,2-3,5-0,1.0,10,16,17,40,7,3,7,0,3,13,14,10,-3.0,-6,-23,0.1909462065185874,-13.720190191854442
1879,1879,2019,6,NCAAF_20191005_MRSHL@MTSU,Marshall,Thundering Herd,Middle Tenn.,Blue Raiders,2-3,2-3,1.0,13,17,13,24,7,6,0,0,10,7,0,7,0.0,-4,-11,0.5086018387104795,0.3383432585969217
1880,1880,2019,6,NCAAF_20191005_TEXAS@WVU,Texas,Longhorns,West Virginia,Mountaineers,4-1,3-2,0.0,21,14,42,31,7,14,0,21,7,7,3,14,1.0,7,11,0.5845581489907724,3.3510390304131192
1881,1881,2019,6,NCAAF_20191005_VATECH@MIAMI,Virginia Tech,Hokies,Miami (Fla.),Hurricanes,3-2,2-3,0.0,28,7,42,35,21,7,0,14,0,7,7,21,1.0,21,7,0.32774499510145916,-7.000387299068393
1882,1882,2019,6,NCAAF_20191005_WMICH@TOLEDO,W. Michigan,Broncos,Toledo,Rockets,3-3,4-1,0.0,7,24,24,31,7,0,10,7,14,10,0,7,-1.0,-17,-7,0.3365709500697657,-6.618967834238219
1883,1883,2019,6,NCAAF_20191005_MEMP@LAMON,Memphis,Tigers,UL-Monroe,Warhawks,5-0,2-3,0.0,29,17,52,33,7,22,10,13,3,14,9,7,3.0,12,19,0.9386281886546554,24.216405884852293
1884,1884,2019,6,NCAAF_20191005_NWEST@NEB,Northwestern,Wildcats,Nebraska,Cornhuskers,1-4,4-2,1.0,3,10,10,13,0,3,7,0,7,3,0,3,-3.0,-7,-3,0.6842573266076009,7.5258499896550575
1885,1885,2019,6,NCAAF_20191005_TROY@MIZZOU,Troy,Trojans,Missouri,Tigers,2-3,4-1,1.0,7,42,10,42,7,0,3,0,21,21,0,0,-2.0,-35,-32,0.13134115932721613,-17.57475495092524
1886,1886,2019,6,NCAAF_20191005_UNC@GATECH,North Carolina,Tar Heels,Georgia Tech,Yellow Jackets,3-3,1-4,1.0,17,0,38,22,3,14,0,21,0,0,7,15,2.0,17,16,0.26257723264278043,-9.97019354216792
1887,1887,2019,6,NCAAF_20191005_ARIZ@COLO,Arizona,Wildcats,Colorado,Buffaloes,4-1,3-2,0.0,14,20,35,30,7,7,14,7,3,17,7,3,1.0,-6,5,0.5589878125275323,2.328555804296684
1888,1888,2019,6,NCAAF_20191005_WKY@ODU,W. Kentucky,Hilltoppers,Old Dominion,Monarchs,3-2,1-4,1.0,10,3,20,3,0,10,3,7,0,3,0,0,2.0,7,17,0.5946783164112039,3.7594337669282254
1889,1889,2019,6,NCAAF_20191005_MA@FIU,UMass,Minutemen,FIU,Panthers,1-5,2-3,1.0,0,34,0,44,0,0,0,0,17,17,10,0,-1.0,-34,-44,0.2687874016460937,-9.673080465897158
1890,1890,2019,6,NCAAF_20191005_RICE@UAB,Rice,Owls,UAB,Blazers,0-6,4-1,1.0,20,21,20,35,7,13,0,0,0,21,14,0,-4.0,-1,-15,0.13268447763424218,-17.476169980816906
1891,1891,2019,6,NCAAF_20191005_UGA@TENN,Georgia,Bulldogs,Tennessee,Volunteers,5-0,1-4,0.0,26,14,43,14,10,16,3,14,7,7,0,0,4.0,12,29,0.9796741748043181,32.11991519371014
1892,1892,2019,6,NCAAF_20191005_MICHST@OHIOST,Michigan St.,Spartans,Ohio State,Buckeyes,4-2,6-0,0.0,10,27,10,34,0,10,0,0,3,24,0,7,-2.0,-17,-24,0.11533868431534355,-18.807135111310856
1893,1893,2019,6,NCAAF_20191005_VANDY@MISS,Vanderbilt,Commodores,Ole Miss,Rebels,1-4,3-3,0.0,6,10,6,31,0,6,0,0,10,0,14,7,-2.0,-4,-25,0.4646781166852647,-1.39105734486958
1894,1894,2019,6,NCAAF_20191005_CAL@OREG,California,Golden Bears,Oregon,Ducks,4-2,4-1,1.0,7,0,7,17,7,0,0,0,0,0,10,7,0.0,7,-10,0.30956479973490336,-7.799606589795701
1895,1895,2019,6,NCAAF_20191005_LIB@NMEXST,Liberty,Flames,New Mexico St.,Aggies,4-2,0-6,1.0,10,0,20,13,3,7,3,7,0,0,6,7,4.0,10,7,0.6086793661148961,4.32873246789984
1896,1896,2019,6,NCAAF_20191005_PITT@DUKE,Pittsburgh,Panthers,Duke,Blue Devils,4-2,3-2,1.0,19,3,33,30,10,9,7,7,3,0,7,20,1.0,16,3,0.4873169437109871,-0.4989185771896132
1897,1897,2019,6,NCAAF_20191005_TXSA@UTEP,UTSA,Roadrunners,UTEP,Miners,2-3,1-4,0.0,10,3,26,16,7,3,6,10,0,3,7,6,1.0,7,10,0.7298380817974313,9.607789343455124
1898,1898,2019,6,NCAAF_20191005_OREGST@UCLA,Oregon State,Beavers,UCLA,Bruins,2-3,1-5,1.0,27,10,48,31,21,6,14,7,0,10,14,7,1.0,17,17,0.1342548274882176,-17.361790989279484
1899,1899,2019,6,NCAAF_20191005_SDGST@COLOST,San Diego St.,Aztecs,Colorado St.,Rams,4-1,1-5,1.0,10,3,24,10,3,7,7,7,3,0,0,7,3.0,7,14,0.7360418515728359,9.903820403180816
1900,1900,2019,6,NCAAF_20191005_BOISE@UNLV,Boise St.,Broncos,UNLV,Rebels,5-0,1-4,0.0,17,0,38,13,7,10,7,14,0,0,7,6,4.0,17,25,0.9379586285700487,24.13012477014155
1901,1901,2019,6,NCAAF_20191005_WASH@STNFRD,Washington,Huskies,Stanford,Cardinal,4-2,3-3,0.0,10,13,13,23,7,3,3,0,3,10,7,3,1.0,-3,-10,0.7058476844714845,8.493295498092664
1902,1902,2019,6,NCAAF_20191004_UCF@CINCY,UCF,Knights,Cincinnati,Bearcats,4-2,4-1,1.0,16,10,24,27,3,13,0,8,0,10,10,7,0.0,6,-3,0.875255657878568,18.069301384443918
1903,1903,2019,6,NCAAF_20191004_NMEX@SJST,New Mexico,Lobos,San Jose St.,Spartans,2-3,3-2,0.0,7,26,21,32,0,7,7,7,6,20,0,6,-1.0,-19,-11,0.6698886102626698,6.897724843113451
1904,1904,2019,6,NCAAF_20191003_TEMPLE@ECU,Temple,Owls,East Carolina,Pirates,4-1,3-3,0.0,17,10,27,17,0,17,7,3,7,3,0,7,1.0,7,10,0.9001871168118567,20.12519710159296
1905,1905,2019,7,NCAAF_20191012_MD@PURDUE,Maryland,Terrapins,Purdue,Boilermakers,3-3,2-4,1.0,14,30,14,40,0,14,0,0,13,17,3,7,1.0,-16,-26,0.3444514644814638,-6.286392827112934
1906,1906,2019,7,NCAAF_20191012_MEMP@TEMPLE,Memphis,Tigers,Temple,Owls,5-1,5-1,1.0,14,23,28,30,0,14,7,7,13,10,0,7,0.0,-9,-2,0.6420527247351818,5.714929023352397
1907,1907,2019,7,NCAAF_20191012_MIAOH@WMICH,Miami-OH,RedHawks,W. Michigan,Broncos,2-4,4-3,0.0,6,21,16,38,6,0,3,7,0,21,0,17,-2.0,-15,-22,0.4485580305079413,-2.0304123333176562
1908,1908,2019,7,NCAAF_20191012_MICH@ILL,Michigan,Wolverines,Illinois,Fighting Illini,5-1,2-4,0.0,28,7,42,25,14,14,0,14,0,7,10,8,3.0,21,17,0.9816678165692424,32.81001701686478
1909,1909,2019,7,NCAAF_20191012_MISSST@TENN,Miss. State,Bulldogs,Tennessee,Volunteers,3-3,2-4,1.0,3,10,10,20,0,3,0,7,7,3,3,7,1.0,-7,-10,0.8850629612644731,18.85368785681112
1910,1910,2019,7,NCAAF_20191012_OKLA@TEXAS,Oklahoma,Sooners,Texas,Longhorns,6-0,4-2,1.0,10,3,34,27,7,3,10,14,0,3,14,10,2.0,7,7,0.7518174729418563,10.681133899520319
1911,1911,2019,7,NCAAF_20191012_RUT@IND,Rutgers,Scarlet Knights,Indiana,Hoosiers,1-5,4-2,1.0,0,21,0,35,0,0,0,0,21,0,14,0,-3.0,-21,-35,0.18363868096302172,-14.157107273607835
1912,1912,2019,7,NCAAF_20191012_TOLEDO@BGREEN,Toledo,Rockets,Bowling Green,Falcons,4-2,2-4,0.0,7,17,7,20,0,7,0,0,10,7,3,0,2.0,-10,-13,0.9309692686495071,23.287521463610574
1913,1913,2019,7,NCAAF_20191012_GATECH@DUKE,Georgia Tech,Yellow Jackets,Duke,Blue Devils,1-5,4-2,1.0,14,38,23,41,7,7,3,6,10,28,3,0,-3.0,-24,-18,0.5138342209593874,0.5446274866382055
1914,1914,2019,7,NCAAF_20191012_BALLST@EMICH,Ball St.,Cardinals,E. Michigan,Eagles,3-3,3-3,0.0,14,17,29,23,0,14,7,8,7,10,6,0,0.0,-3,6,0.15408614166330148,-16.001827134591963
1915,1915,2019,7,NCAAF_20191012_ODU@MRSHL,Old Dominion,Monarchs,Marshall,Thundering Herd,1-5,3-3,1.0,10,17,17,31,0,10,7,0,7,10,7,7,-2.0,-7,-14,0.18012018741257252,-14.366297906838952
1916,1916,2019,7,NCAAF_20191012_NMEXST@CMICH,New Mexico St.,Aggies,C. Michigan,Chippewas,0-7,4-3,1.0,21,28,28,42,7,14,0,7,14,14,6,8,-4.0,-7,-14,0.28455097429068155,-8.94058499733751
1917,1917,2019,7,NCAAF_20191012_BAMA@TXAM,Alabama,Crimson Tide,Texas A&M,Aggies,6-0,3-3,0.0,24,13,47,28,14,10,10,13,7,6,7,8,3.0,11,19,0.9473782687799368,25.437176335346408
1918,1918,2019,7,NCAAF_20191012_BYU@SFLA,BYU,Cougars,South Florida,Bulls,2-4,3-3,1.0,16,7,23,27,3,13,7,0,0,7,7,13,-1.0,9,-4,0.42176087945903784,-3.0995215974102734
1919,1919,2019,7,NCAAF_20191012_CINCY@HOU,Cincinnati,Bearcats,Houston,Cougars,5-1,2-4,1.0,21,10,38,23,14,7,0,17,3,7,7,6,3.0,11,15,0.4516113064606162,-1.909284986043474
1920,1920,2019,7,NCAAF_20191012_FSU@CLEM,Florida State,Seminoles,Clemson,Tigers,3-3,6-0,0.0,0,28,14,45,0,0,7,7,14,14,14,3,-3.0,-28,-31,0.05972581520385911,-24.449985724342696
1921,1921,2019,7,NCAAF_20191012_KENTST@AKRON,Kent St.,Golden Flashes,Akron,Zips,3-3,0-6,1.0,17,3,26,3,7,10,0,9,0,3,0,0,3.0,14,23,0.3002017271290933,-8.225271907392425
1922,1922,2019,7,NCAAF_20191012_MICHST@WISC,Michigan St.,Spartans,Wisconsin,Badgers,4-3,6-0,0.0,0,17,0,38,0,0,0,0,7,10,0,21,-2.0,-17,-38,0.2620730875765167,-10.00195622961121
1923,1923,2019,7,NCAAF_20191012_NILL@OHIO,N. Illinois,Huskies,Ohio,Bobcats,2-4,2-4,0.0,10,21,39,36,10,0,12,17,7,14,0,15,0.0,-11,3,0.39982279032052725,-3.9853770314900885
1924,1924,2019,7,NCAAF_20191012_WASHST@ARIZST,Washington St.,Cougars,Arizona St.,Sun Devils,3-3,5-1,1.0,17,17,34,38,10,7,14,3,0,17,7,14,-2.0,0,-4,0.6403635855250908,5.643949869334051
1925,1925,2019,7,NCAAF_20191012_UCONN@TULANE,UConn,Huskies,Tulane,Green Wave,1-5,5-1,0.0,0,28,7,49,0,0,0,7,14,14,14,7,-4.0,-28,-42,0.07008773317435424,-23.163302214775456
1926,1926,2019,7,NCAAF_20191012_IOWAST@WVU,Iowa St.,Cyclones,West Virginia,Mountaineers,4-2,3-3,1.0,14,14,38,14,0,14,7,17,7,7,0,0,1.0,0,24,0.604105884117673,4.145281462961407
1927,1927,2019,7,NCAAF_20191012_MTSU@FAU,Middle Tenn.,Blue Raiders,FAU,Owls,2-4,4-2,0.0,13,12,13,28,6,7,0,0,2,10,10,6,-2.0,1,-15,0.37275858291347197,-5.096328673871142
1928,1928,2019,7,NCAAF_20191012_RI@VATECH,Rhode Island,Rams,Virginia Tech,Hokies,1-5,4-2,0.0,6,17,17,34,0,6,11,0,10,7,7,10,-3.0,-11,-17,0.022438574752592255,-31.49607000204884
1929,1929,2019,7,NCAAF_20191012_SJST@NEVADA,San Jose St.,Spartans,Nevada,Wolf Pack,3-3,4-2,1.0,10,24,38,41,3,7,14,14,14,10,7,10,-1.0,-14,-3,0.2254588899630221,-11.837866159983207
1930,1930,2019,7,NCAAF_20191012_UNLV@VANDY,UNLV,Rebels,Vanderbilt,Commodores,2-4,1-5,0.0,24,10,34,10,7,17,0,10,7,3,0,0,1.0,14,24,0.172920587465194,-14.80250539097949
1931,1931,2019,7,NCAAF_20191012_GAST@CSTCAR,Georgia St.,Panthers,C. Carolina,Chanticleers,4-2,3-3,1.0,17,6,31,21,3,14,14,0,3,3,7,8,1.0,11,10,0.48860024720931006,-0.44875812824858485
1932,1932,2019,7,NCAAF_20191012_UAB@TXSA,UAB,Blazers,UTSA,Roadrunners,5-1,2-4,0.0,16,7,33,14,3,13,7,10,0,7,7,0,3.0,9,19,0.7782861544186326,12.034650404035915
1933,1933,2019,7,NCAAF_20191012_ARMY@WKY,Army,Black Knights,W. Kentucky,Hilltoppers,3-3,4-2,1.0,0,7,8,17,0,0,0,8,7,0,3,7,-1.0,-7,-9,0.8394536685859434,15.5802215133304
1934,1934,2019,7,NCAAF_20191012_CHARLO@FIU,Charlotte,49ers,FIU,Panthers,2-4,3-3,1.0,17,28,23,48,10,7,6,0,7,21,13,7,-1.0,-11,-25,0.22285202741232468,-11.974645622034814
1935,1935,2019,7,NCAAF_20191012_FRESNO@AF,Fresno St.,Bulldogs,Air Force,Falcons,2-3,4-2,1.0,24,22,24,43,14,10,0,0,7,15,7,14,-2.0,2,-19,0.7654396075682364,11.367176981518242
1936,1936,2019,7,NCAAF_20191012_MA@LATECH,UMass,,Louisiana Tech,,1-6,5-1,,14,52,21,69,0,14,7,0,28,24,10,7,-4.0,-38,-48,0.23551555852289474,-11.318374275077588
1937,1937,2019,7,NCAAF_20191012_MISS@MIZZOU,Ole Miss,Rebels,Missouri,Tigers,3-4,5-1,1.0,7,12,27,38,7,0,7,13,3,9,23,3,-2.0,-5,-11,0.21325912783594658,-12.486031261484754
1938,1938,2019,7,NCAAF_20191012_NTEXAS@USM,North Texas,Mean Green,So. Miss,Golden Eagles,2-4,4-2,0.0,20,28,27,45,7,13,0,7,13,15,10,7,-2.0,-8,-18,0.5284722080521528,1.1216261197477593
1939,1939,2019,7,NCAAF_20191012_ARK@UK,Arkansas,Razorbacks,Kentucky,Wildcats,2-4,3-3,1.0,13,7,20,24,7,6,0,7,0,7,10,7,-1.0,6,-4,0.19992041484502987,-13.219992595066799
1940,1940,2019,7,NCAAF_20191012_LVILLE@WAKE,Louisville,Cardinals,Wake Forest,Demon Deacons,4-2,5-1,0.0,31,21,62,59,21,10,14,17,7,14,10,28,-1.0,10,3,0.31356173661786135,-7.6279366145718654
1941,1941,2019,7,NCAAF_20191012_NAVY@TULSA,Navy,Midshipmen,Tulsa,Golden Hurricane,4-1,2-4,1.0,28,3,45,17,7,21,0,17,3,0,7,7,2.0,25,28,0.6952220513517328,8.019366645065872
1942,1942,2019,7,NCAAF_20191012_NEB@MINN,Nebraska,Cornhuskers,Minnesota,Golden Gophers,4-3,6-0,1.0,0,14,7,34,0,0,0,7,7,7,20,0,-2.0,-14,-27,0.42204720749915736,-3.088030776281471
1943,1943,2019,7,NCAAF_20191012_PSU@IOWA,Penn State,Nittany Lions,Iowa,Hawkeyes,6-0,4-2,0.0,7,6,17,12,0,7,3,7,3,3,0,6,2.0,1,5,0.7043697210527297,8.432384323871872
1944,1944,2019,7,NCAAF_20191012_USC@ND,USC,Trojans,Notre Dame,Fighting Irish,3-3,5-1,1.0,3,17,27,30,3,0,10,14,0,17,3,10,-2.0,-14,-3,0.23844845012870697,-11.169200422971983
1945,1945,2019,7,NCAAF_20191012_FLA@LSU,Florida,Gators,LSU,Tigers,6-1,6-0,0.0,21,21,28,42,7,14,7,0,7,14,14,7,0.0,0,-14,0.3640228659001332,-5.460160434115778
1946,1946,2019,7,NCAAF_20191012_UTAH@OREGST,Utah,Utes,Oregon State,Beavers,5-1,2-4,0.0,35,0,52,7,21,14,14,3,0,0,0,7,3.0,35,45,0.9558356342362717,26.76140261280125
1947,1947,2019,7,NCAAF_20191012_HAWAII@BOISE,Hawaii,Rainbow Warriors,Boise St.,Broncos,4-2,6-0,1.0,14,31,37,59,7,7,7,16,14,17,21,7,-2.0,-17,-22,0.06631688195660568,-23.6133130428874
1948,1948,2019,7,NCAAF_20191012_WYO@SDGST,Wyoming,Cowboys,San Diego St.,Aztecs,4-2,5-1,0.0,14,6,22,26,0,14,0,8,3,3,13,7,-1.0,8,-4,0.38029741727397426,-4.784537394766176
1949,1949,2019,7,NCAAF_20191012_WASH@ARIZ,Washington,Huskies,Arizona,Wildcats,5-2,4-2,0.0,13,17,51,27,6,7,14,24,0,17,0,10,1.0,-4,24,0.8353359555530568,15.317255004751757
1950,1950,2019,7,NCAAF_20191011_COLOST@NMEX,Colorado St.,Rams,New Mexico,Lobos,2-5,2-4,1.0,21,14,35,21,7,14,7,7,6,8,0,7,0.0,7,14,0.7148360373908,8.912226493569051
1951,1951,2019,7,NCAAF_20191011_UVA@MIAMI,Virginia,Cavaliers,Miami (Fla.),Hurricanes,4-2,3-3,0.0,3,7,9,17,0,3,0,6,7,0,0,10,1.0,-4,-8,0.28742295418996233,-8.807968931275468
1952,1952,2019,7,NCAAF_20191011_COLO@OREG,Colorado,Buffaloes,Oregon,Ducks,3-3,5-1,0.0,3,24,3,45,3,0,0,0,7,17,14,7,-2.0,-21,-42,0.23882734104563452,-11.150002727495632
1953,1953,2019,7,NCAAF_20191010_CUSE@NCST,Syracuse,Orange,NC State,Wolfpack,3-3,4-2,1.0,0,13,10,16,0,0,3,7,6,7,3,0,-1.0,-13,-6,0.38105722828824906,-4.753219536491258
1954,1954,2019,7,NCAAF_20191010_LAMON@TXSTSM,UL-Monroe,Warhawks,Texas St.,Bobcats,3-3,2-4,1.0,17,7,24,14,7,10,0,7,0,7,7,0,1.0,10,10,0.7140961607836793,8.878036456084658
1955,1955,2019,7,NCAAF_20191009_APLST@LALAF,App. St.,Mountaineers,Louisiana,Ragin' Cajuns,5-0,4-2,0.0,7,7,17,7,7,0,3,7,0,7,0,0,1.0,0,10,0.7904314395627913,12.68632265090497
1956,1956,2019,8,NCAAF_20191019_AUBURN@ARK,Auburn,Tigers,Arkansas,Razorbacks,6-1,2-5,0.0,17,0,51,10,17,0,14,20,0,0,10,0,4.0,17,41,0.9578807535620093,27.175754224246248
1957,1957,2019,8,NCAAF_20191019_CLEM@LVILLE,Clemson,Tigers,Louisville,Cardinals,7-0,4-3,0.0,17,3,45,10,3,14,7,21,0,3,0,7,3.0,14,35,0.9740693502545112,30.601869985530925
1958,1958,2019,8,NCAAF_20191019_FLA@SC,Florida,Gators,South Carolina,Gamecocks,7-1,3-4,0.0,10,10,38,27,3,7,7,21,7,3,10,7,4.0,0,11,0.5799711205707253,3.17652123619348
1959,1959,2019,8,NCAAF_20191019_HOU@UCONN,Houston,Cougars,UConn,Huskies,3-4,1-6,1.0,10,7,24,17,3,7,7,7,0,7,3,7,2.0,3,7,0.9576864090993462,27.1417765605986
1960,1960,2019,8,NCAAF_20191019_IOWAST@TXTECH,Iowa St.,Cyclones,Texas Tech,Red Raiders,5-2,3-4,1.0,20,7,34,24,7,13,7,7,0,7,10,7,2.0,13,10,0.6684188574610014,6.855320658757137
1961,1961,2019,8,NCAAF_20191019_KENTST@OHIO,Kent St.,Golden Flashes,Ohio,Bobcats,3-4,3-4,1.0,24,24,38,45,14,10,0,14,10,14,7,14,0.0,0,-7,0.0778270460921533,-22.34745205617537
1962,1962,2019,8,NCAAF_20191019_NCST@BC,NC State,Wolfpack,Boston College,Eagles,4-3,4-3,0.0,3,24,24,45,0,3,7,14,7,17,7,14,0.0,-21,-21,0.6008503651117398,4.0221868568198715
1963,1963,2019,8,NCAAF_20191019_PURDUE@IOWA,Purdue,Boilermakers,Iowa,Hawkeyes,2-5,5-2,0.0,7,9,20,26,0,7,0,13,6,3,7,10,-3.0,-2,-6,0.2588599752669082,-10.18125752519154
1964,1964,2019,8,NCAAF_20191019_WISC@ILL,Wisconsin,Badgers,Illinois,Fighting Illini,6-1,3-4,1.0,13,7,23,24,7,6,7,3,0,7,7,10,3.0,6,-1,0.9781832659709835,31.755751587339546
1965,1965,2019,8,NCAAF_20191019_WVU@OKLA,West Virginia,Mountaineers,Oklahoma,Sooners,3-4,7-0,1.0,14,28,14,52,0,14,0,0,14,14,21,3,-4.0,-14,-38,0.1664934938047926,-15.23755651793681
1966,1966,2019,8,NCAAF_20191019_CMICH@BGREEN,C. Michigan,Chippewas,Bowling Green,Falcons,5-3,2-5,1.0,21,7,38,20,7,14,7,10,7,0,7,6,3.0,14,18,0.7563646417537024,10.933479789474404
1967,1967,2019,8,NCAAF_20191019_TOLEDO@BALLST,Toledo,Rockets,Ball St.,Cardinals,4-3,4-3,0.0,0,38,14,52,0,0,7,7,17,21,14,0,0.0,-38,-38,0.9113789787582431,21.237115240711262
1968,1968,2019,8,NCAAF_20191019_NILL@MIAOH,N. Illinois,Huskies,Miami-OH,RedHawks,2-5,3-4,1.0,10,7,24,27,3,7,7,7,0,7,14,6,-1.0,3,-3,0.6142735976436661,4.571906279474888
1969,1969,2019,8,NCAAF_20191019_OREGST@CAL,Oregon State,Beavers,California,Golden Bears,3-4,4-3,1.0,14,3,21,17,7,7,0,7,0,3,14,0,-1.0,11,4,0.11829906849820826,-18.62810367011207
1970,1970,2019,8,NCAAF_20191019_TCU@KSTATE,TCU,Horned Frogs,Kansas State,Wildcats,3-3,4-2,1.0,10,14,17,24,0,10,7,0,7,7,3,7,-1.0,-4,-7,0.6407506632850091,5.673521938856766
1971,1971,2019,8,NCAAF_20191019_NMEX@WYO,New Mexico,Lobos,Wyoming,Cowboys,2-5,5-2,0.0,0,7,10,23,0,0,0,10,7,0,6,10,-3.0,-7,-13,0.17919693009474158,-14.455543407887603
1972,1972,2019,8,NCAAF_20191019_BUFF@AKRON,Buffalo,Bulls,Akron,Zips,3-4,0-7,1.0,7,0,21,0,7,0,7,7,0,0,0,0,3.0,7,21,0.7853837773074823,12.442093936654715
1973,1973,2019,8,NCAAF_20191019_DUKE@UVA,Duke,Blue Devils,Virginia,Cavaliers,4-3,5-2,0.0,0,17,14,48,0,0,7,7,0,17,24,7,-1.0,-17,-34,0.5710629268018343,2.8186282035450176
1974,1974,2019,8,NCAAF_20191019_IND@MD,Indiana,Hoosiers,Maryland,Terrapins,5-2,3-4,1.0,24,21,34,28,14,10,7,3,7,14,7,0,2.0,3,6,0.550333098197932,1.991081889833481
1975,1975,2019,8,NCAAF_20191019_LAMON@APLST,UL-Monroe,Warhawks,App. St.,Mountaineers,3-4,6-0,1.0,7,31,7,52,7,0,0,0,21,10,7,14,-3.0,-24,-45,0.14768753574615645,-16.469762742204807
1976,1976,2019,8,NCAAF_20191019_LSU@MISSST,LSU,Tigers,Miss. State,Bulldogs,7-0,3-4,0.0,22,7,36,13,3,19,14,0,0,7,0,6,4.0,15,23,0.5890143682900922,3.5415291236961366
1977,1977,2019,8,NCAAF_20191019_MINN@RUT,Minnesota,Golden Gophers,Rutgers,Scarlet Knights,7-0,1-6,0.0,14,0,42,7,7,7,7,21,0,0,0,7,6.0,14,35,0.8572417364296513,16.80982795229943
1978,1978,2019,8,NCAAF_20191019_OREG@WASH,Oregon,Ducks,Washington,Huskies,6-1,5-3,1.0,14,21,35,31,7,7,14,7,7,14,10,0,1.0,-7,4,0.35333613077711334,-5.923197374112533
1979,1979,2019,8,NCAAF_20191019_SFLA@NAVY,South Florida,Bulls,Navy,Midshipmen,3-4,5-1,1.0,3,21,3,35,0,3,0,0,7,14,0,14,-2.0,-18,-32,0.44311693524250606,-2.2518577314299364
1980,1980,2019,8,NCAAF_20191019_TEMPLE@SMU,Temple,Owls,SMU,Mustangs,5-2,7-0,0.0,7,24,21,45,0,7,7,7,10,14,7,14,-2.0,-17,-24,0.5072269590585778,0.2851397126911479
1981,1981,2019,8,NCAAF_20191019_TULSA@CINCY,Tulsa,Golden Hurricane,Cincinnati,Bearcats,2-5,6-1,1.0,7,10,13,24,0,7,3,3,10,0,7,7,-4.0,-3,-11,0.22859426414577255,-11.702003426215697
1982,1982,2019,8,NCAAF_20191019_USM@LATECH,So. Miss,Golden Eagles,Louisiana Tech,Bulldogs,4-3,6-1,1.0,27,24,30,45,14,13,0,3,7,17,0,21,-2.0,3,-15,0.5263925555329609,1.0420221852447185
1983,1983,2019,8,NCAAF_20191019_BAYLOR@OKLAST,Baylor,Bears,Oklahoma State,Cowboys,7-0,4-3,0.0,10,13,45,27,7,3,14,21,6,7,7,7,3.0,-3,18,0.19335604288569508,-13.623959922315521
1984,1984,2019,8,NCAAF_20191019_CHARLO@WKY,Charlotte,49ers,W. Kentucky,Hilltoppers,2-5,5-2,1.0,14,17,14,30,7,7,0,0,7,10,13,0,-3.0,-3,-16,0.33125300985441775,-6.86955729420913
1985,1985,2019,8,NCAAF_20191019_MIZZOU@VANDY,Missouri,Tigers,Vanderbilt,Commodores,5-2,2-5,0.0,7,14,14,21,0,7,7,0,0,14,0,7,3.0,-7,-7,0.8543740440663229,16.61104567210384
1986,1986,2019,8,NCAAF_20191019_MTSU@NTEXAS,Middle Tenn.,Blue Raiders,North Texas,Mean Green,2-5,3-4,0.0,16,17,30,33,3,13,0,14,7,10,3,13,-1.0,-1,-3,0.5432583646346941,1.710023904887521
1987,1987,2019,8,NCAAF_20191019_ODU@UAB,Old Dominion,Monarchs,UAB,Blazers,1-6,6-1,1.0,3,28,14,38,0,3,11,0,14,14,7,3,-5.0,-25,-24,0.20998457524027092,-12.693436316287148
1988,1988,2019,8,NCAAF_20191019_ARIZST@UTAH,Arizona St.,Sun Devils,Utah,Utes,5-2,6-1,1.0,0,14,3,21,0,0,3,0,0,14,0,7,-1.0,-14,-18,0.3339477418673199,-6.752806483999734
1989,1989,2019,8,NCAAF_20191019_ME@LIB,Maine,Black Bears,Liberty,Flames,2-5,5-2,0.0,17,45,44,59,3,14,7,20,17,28,7,7,-3.0,-28,-15,0.3306010537776053,-6.897860298050773
1990,1990,2019,8,NCAAF_20191019_RICE@TXSA,Rice,,UTSA,,0-7,3-4,,10,7,27,31,3,7,14,3,7,0,17,7,-3.0,3,-4,0.37297227107398423,-5.099433251890105
1991,1991,2019,8,NCAAF_20191019_UK@UGA,Kentucky,Wildcats,Georgia,Bulldogs,3-4,6-1,0.0,0,0,0,21,0,0,0,0,0,0,14,7,-3.0,0,-21,0.0786114848734839,-22.26297455696431
1992,1992,2019,8,NCAAF_20191019_ARMY@GAST,Army,Black Knights,Georgia St.,Panthers,3-4,5-2,0.0,14,14,21,28,7,7,7,0,7,7,6,8,-2.0,0,-7,0.8671667953543827,17.519502343107433
1993,1993,2019,8,NCAAF_20191019_COLO@WASHST,Colorado,Buffaloes,Washington St.,Cougars,3-4,4-3,1.0,3,24,10,41,3,0,7,0,21,3,7,10,-1.0,-21,-31,0.2231485571212818,-11.987177748296745
1994,1994,2019,8,NCAAF_20191019_ECU@UCF,East Carolina,Pirates,UCF,Knights,3-4,5-2,1.0,6,35,28,41,0,6,16,6,21,14,6,0,-2.0,-29,-13,0.011142510646932502,-35.972017787954314
1995,1995,2019,8,NCAAF_20191019_KANSAS@TEXAS,Kansas,Jayhawks,Texas,Longhorns,2-5,5-2,0.0,17,21,48,50,3,14,7,24,14,7,3,26,-3.0,-4,-2,0.06229520461272853,-24.172393988062026
1996,1996,2019,8,NCAAF_20191019_SDGST@SJST,San Diego St.,Aztecs,San Jose St.,Spartans,6-1,3-4,1.0,13,7,27,17,7,6,14,0,7,0,3,7,3.0,6,10,0.939302142071221,24.379428369139987
1997,1997,2019,8,NCAAF_20191019_TULANE@MEMP,Tulane,Green Wave,Memphis,Tigers,5-2,6-1,1.0,10,34,17,47,3,7,0,7,13,21,6,7,-1.0,-24,-30,0.3284849576408586,-6.989879661896566
1998,1998,2019,8,NCAAF_20191019_UTEP@FIU,UTEP,Miners,FIU,Panthers,1-5,4-3,1.0,7,18,17,32,7,0,0,10,3,15,0,14,-3.0,-11,-15,0.09286300163336891,-20.82841595446382
1999,1999,2019,8,NCAAF_20191019_WMICH@EMICH,W. Michigan,Broncos,E. Michigan,Eagles,4-4,4-3,1.0,14,10,27,34,7,7,7,6,3,7,10,14,0.0,4,-7,0.5611424766119206,2.4217668289794574
2000,2000,2019,8,NCAAF_20191019_FSU@WAKE,Florida State,Seminoles,Wake Forest,Demon Deacons,3-4,6-1,0.0,14,12,20,22,0,14,0,6,6,6,0,10,-3.0,2,-2,0.4727119169396208,-1.0774334775909438
2001,2001,2019,8,NCAAF_20191019_MICH@PSU,Michigan,Wolverines,Penn State,Nittany Lions,5-2,7-0,1.0,7,21,21,28,0,7,7,7,7,14,0,7,-2.0,-14,-7,0.3568641098966727,-5.7740589729776275
2002,2002,2019,8,NCAAF_20191019_TXAM@MISS,Texas A&M,Aggies,Ole Miss,Rebels,4-3,3-5,1.0,10,7,24,17,3,7,7,7,7,0,7,3,1.0,3,7,0.6876860788814705,7.701325753779997
2003,2003,2019,8,NCAAF_20191019_TENN@BAMA,Tennessee,Volunteers,Alabama,Crimson Tide,2-5,7-0,1.0,10,21,13,35,7,3,3,0,14,7,7,7,-5.0,-11,-22,0.008999254920687538,-37.233913955766525
2004,2004,2019,8,NCAAF_20191019_ARIZ@USC,Arizona,Wildcats,USC,Trojans,4-3,4-3,0.0,0,17,14,41,0,0,0,14,10,7,10,14,0.0,-17,-27,0.3088938591658982,-7.853778937802758
2005,2005,2019,8,NCAAF_20191019_BOISE@BYU,Boise St.,Broncos,BYU,Cougars,6-1,3-4,1.0,10,7,25,28,7,3,0,15,7,0,21,0,3.0,3,-3,0.8016366601554777,13.33886127343817
2006,2006,2019,8,NCAAF_20191019_NEVADA@UTAHST,Nevada,Wolf Pack,Utah St.,Aggies,4-3,4-2,1.0,3,22,10,36,3,0,0,7,9,13,0,14,0.0,-19,-26,0.14473942340366874,-16.672214275463944
2007,2007,2019,8,NCAAF_20191019_AF@HAWAII,Air Force,Falcons,Hawaii,Rainbow Warriors,5-2,4-3,0.0,28,20,56,26,7,21,7,21,3,17,0,6,1.0,8,30,0.7686100149155359,11.557085126740844
2008,2008,2019,8,NCAAF_20191018_MRSHL@FAU,Marshall,Thundering Herd,FAU,Owls,4-3,4-3,1.0,17,17,36,31,10,7,5,14,14,3,0,14,0.0,0,5,0.35680105028522036,-5.776720109375901
2009,2009,2019,8,NCAAF_20191018_PITT@CUSE,Pittsburgh,Panthers,Syracuse,Orange,5-2,3-4,1.0,24,6,27,20,10,14,0,3,3,3,7,7,2.0,18,7,0.4939183342470749,-0.23994832791572662
2010,2010,2019,8,NCAAF_20191018_OHIOST@NWEST,Ohio State,Buckeyes,Northwestern,Wildcats,7-0,1-5,1.0,31,3,52,3,7,24,7,14,3,0,0,0,6.0,28,49,0.9177987264127676,21.88432849573246
2011,2011,2019,8,NCAAF_20191018_UNLV@FRESNO,UNLV,Rebels,Fresno St.,Bulldogs,2-5,3-3,1.0,17,28,27,56,3,14,3,7,7,21,7,21,-1.0,-11,-29,0.10321671668122545,-19.885696633617954
2012,2012,2019,8,NCAAF_20191017_LALAF@ARKST,Louisiana,Ragin' Cajuns,Arkansas St.,Red Wolves,5-2,3-4,0.0,24,10,37,20,7,17,0,13,7,3,3,7,2.0,14,17,0.3386203619033683,-6.551235447826684
2013,2013,2019,8,NCAAF_20191017_UCLA@STNFRD,UCLA,Bruins,Stanford,Cardinal,2-5,3-4,0.0,21,10,34,16,14,7,6,7,10,0,0,6,-1.0,11,18,0.2458904206691197,-10.820515436440473
2014,2014,2019,8,NCAAF_20191016_SALA@TROY,South Alabama,Jaguars,Troy,Trojans,1-6,3-3,0.0,10,16,13,37,3,7,3,0,3,13,7,14,-2.0,-6,-24,0.11753210714381979,-18.689200550273654
2015,2015,2019,9,NCAAF_20191026_APLST@SALA,App. St.,Mountaineers,South Alabama,Jaguars,7-0,1-7,1.0,13,0,30,3,7,6,10,7,0,0,0,3,6.0,13,27,0.940683643731877,24.694559410129045
2016,2016,2019,9,NCAAF_20191026_BGREEN@WMICH,Bowling Green,Falcons,W. Michigan,Broncos,2-6,5-4,1.0,3,21,10,49,3,0,7,0,0,21,28,0,-3.0,-18,-39,0.15050663109647155,-16.366574525207966
2017,2017,2019,9,NCAAF_20191026_ILL@PURDUE,Illinois,Fighting Illini,Purdue,Boilermakers,4-4,2-6,0.0,17,0,24,6,3,14,7,0,0,0,0,6,2.0,17,18,0.1218941386474961,-18.444430706836783
2018,2018,2019,9,NCAAF_20191026_IOWA@NWEST,Iowa,Hawkeyes,Northwestern,Wildcats,6-2,1-6,1.0,10,0,20,0,7,3,7,3,0,0,0,0,5.0,10,20,0.7887014144697579,12.689947109995842
2019,2019,2019,9,NCAAF_20191026_LIB@RUT,Liberty,Flames,Rutgers,Scarlet Knights,5-3,2-6,1.0,21,21,34,44,14,7,3,10,7,14,17,6,3.0,0,-10,0.37091126900009674,-5.213197874730895
2020,2020,2019,9,NCAAF_20191026_MIAMI@PITT,Miami (Fla.),Hurricanes,Pittsburgh,Panthers,4-4,5-3,0.0,10,6,16,12,3,7,0,6,3,3,3,3,-1.0,4,4,0.6589042989215306,6.479683638897313
2021,2021,2019,9,NCAAF_20191026_MISSST@TXAM,Miss. State,Bulldogs,Texas A&M,Aggies,3-5,5-3,1.0,10,28,30,49,0,10,7,13,14,14,14,7,-2.0,-18,-19,0.6106862163301435,4.448361107888559
2022,2022,2019,9,NCAAF_20191026_OKLA@KSTATE,Oklahoma,Sooners,Kansas State,Wildcats,7-1,5-2,1.0,23,24,41,48,17,6,0,18,7,17,17,7,2.0,-1,-7,0.8861459168908954,19.088695506498425
2023,2023,2019,9,NCAAF_20191026_SJST@ARMY,San Jose St.,Spartans,Army,Black Knights,4-4,3-5,1.0,23,10,34,29,7,16,0,11,7,3,7,12,1.0,13,5,0.09323886403673709,-20.905134053813526
2024,2024,2019,9,NCAAF_20191026_WISC@OHIOST,Wisconsin,Badgers,Ohio State,Buckeyes,6-2,8-0,1.0,0,10,7,38,0,0,7,0,0,10,14,14,-2.0,-10,-31,0.2673333177707352,-9.825331287294148
2025,2025,2019,9,NCAAF_20191026_USM@RICE,So. Miss,Golden Eagles,Rice,Owls,5-3,0-8,1.0,10,0,20,6,0,10,3,7,0,0,6,0,5.0,10,14,0.8601120015638308,17.103353967334556
2026,2026,2019,9,NCAAF_20191026_NEVADA@WYO,Nevada,Wolf Pack,Wyoming,Cowboys,4-4,6-2,1.0,3,24,3,31,3,0,0,0,14,10,7,0,-2.0,-21,-28,0.2895949905388253,-8.775702048504058
2027,2027,2019,9,NCAAF_20191026_OHIO@BALLST,Ohio,Bobcats,Ball St.,Cardinals,4-4,4-4,0.0,13,7,34,21,7,6,14,7,7,0,7,7,0.0,6,13,0.8886980660646657,19.2999486418243
2028,2028,2019,9,NCAAF_20191026_WKY@MRSHL,W. Kentucky,Hilltoppers,Marshall,Thundering Herd,5-3,5-3,1.0,7,20,23,26,0,7,6,10,14,6,3,3,0.0,-13,-3,0.2937134785334067,-8.585812125066013
2029,2029,2019,9,NCAAF_20191026_NMEXST@GAS,New Mexico St.,Aggies,Ga. Southern,Eagles,0-8,4-3,0.0,7,28,7,41,7,0,0,0,7,21,13,0,-4.0,-21,-34,0.3203010311165383,-7.387727653381717
2030,2030,2019,9,NCAAF_20191026_AKRON@NILL,Akron,Zips,N. Illinois,Huskies,0-8,3-5,1.0,0,21,0,49,0,0,0,0,7,14,14,14,-3.0,-21,-49,0.20688684915714295,-12.9328073529461
2031,2031,2019,9,NCAAF_20191026_ARIZ@STNFRD,Arizona,Wildcats,Stanford,Cardinal,4-4,4-4,1.0,24,31,31,41,10,14,7,0,7,24,7,3,0.0,-7,-10,0.2976397683411983,-8.40592816825722
2032,2032,2019,9,NCAAF_20191026_AUBURN@LSU,Auburn,Tigers,LSU,Tigers,6-2,8-0,1.0,10,10,20,23,3,7,3,7,0,10,6,7,-2.0,0,-3,0.5509523361573454,2.0265939487323976
2033,2033,2019,9,NCAAF_20191026_CMICH@BUFF,C. Michigan,Chippewas,Buffalo,Bulls,5-4,4-4,1.0,14,30,20,43,7,7,0,6,3,27,3,10,1.0,-16,-23,0.33818877696530536,-6.6052778121668325
2034,2034,2019,9,NCAAF_20191026_CUSE@FSU,Syracuse,Orange,Florida State,Seminoles,3-5,4-4,1.0,3,21,17,35,0,3,0,14,13,8,14,0,-1.0,-18,-18,0.4990908800372412,-0.03606104750895156
2035,2035,2019,9,NCAAF_20191026_FAU@ODU,FAU,Owls,Old Dominion,Monarchs,5-3,1-7,0.0,24,3,41,3,14,10,7,10,0,3,0,0,4.0,21,38,0.9003518055616339,20.311527595708014
2036,2036,2019,9,NCAAF_20191026_FIU@MTSU,FIU,Panthers,Middle Tenn.,Blue Raiders,4-4,3-5,1.0,17,14,17,50,7,10,0,0,14,0,23,13,1.0,3,-33,0.4271671724557644,-2.9052142004502457
2037,2037,2019,9,NCAAF_20191026_IND@NEB,Indiana,Hoosiers,Nebraska,Cornhuskers,6-2,4-4,0.0,16,21,38,31,9,7,15,7,14,7,3,7,2.0,-5,7,0.5956779735921818,3.8322808509694823
2038,2038,2019,9,NCAAF_20191026_MD@MINN,Maryland,Terrapins,Minnesota,Golden Gophers,3-5,8-0,1.0,3,28,10,52,0,3,0,7,14,14,10,14,-5.0,-25,-42,0.3992082287315175,-4.041501010486513
2039,2039,2019,9,NCAAF_20191026_MIAOH@KENTST,Miami-OH,RedHawks,Kent St.,Golden Flashes,4-4,3-5,0.0,9,6,23,16,6,3,7,7,0,6,0,10,1.0,3,7,0.8139455205270518,14.123736976798
2040,2040,2019,9,NCAAF_20191026_NTEXAS@CHARLO,North Texas,Mean Green,Charlotte,49ers,3-5,3-5,0.0,21,7,38,39,14,7,14,3,0,7,14,18,0.0,14,-1,0.8148295510234862,14.176037591823388
2041,2041,2019,9,NCAAF_20191026_OKLAST@IOWAST,Oklahoma State,Cowboys,Iowa St.,Cyclones,5-3,5-3,0.0,21,13,34,27,7,14,3,10,0,13,7,7,0.0,8,7,0.41300743227300507,-3.478444702030515
2042,2042,2019,9,NCAAF_20191026_PSU@MICHST,Penn State,Nittany Lions,Michigan St.,Spartans,8-0,4-4,1.0,21,0,28,7,7,14,7,0,0,0,7,0,4.0,21,21,0.8692660118924235,17.769648384635047
2043,2043,2019,9,NCAAF_20191026_TEXAS@TCU,Texas,Longhorns,TCU,Horned Frogs,5-3,4-3,0.0,17,13,27,37,3,14,3,7,3,10,14,10,1.0,4,-10,0.5586333673515709,2.3341792445413603
2044,2044,2019,9,NCAAF_20191026_TULANE@NAVY,Tulane,Green Wave,Navy,Midshipmen,5-3,6-1,0.0,14,31,38,41,0,14,14,10,21,10,0,10,-1.0,-17,-3,0.45809413734821836,-1.6653003530676642
2045,2045,2019,9,NCAAF_20191026_UCONN@MA,UConn,Huskies,UMass,Minutemen,2-6,1-7,0.0,35,21,56,35,14,21,7,14,7,14,7,7,1.0,14,21,0.49401181278197404,-0.2375354574493258
2046,2046,2019,9,NCAAF_20191026_UVA@LVILLE,Virginia,Cavaliers,Louisville,Cardinals,5-3,5-3,0.0,14,7,21,28,7,7,0,7,7,0,7,14,0.0,7,-7,0.6209636554880372,4.87411104901355
2047,2047,2019,9,NCAAF_20191026_SFLA@ECU,South Florida,Bulls,East Carolina,Pirates,4-4,3-5,0.0,35,10,45,20,14,21,3,7,7,3,0,10,1.0,25,25,0.8101463173798895,13.900703111095368
2048,2048,2019,9,NCAAF_20191026_DUKE@UNC,Duke,Blue Devils,North Carolina,Tar Heels,4-4,4-4,1.0,3,7,17,20,3,0,14,0,7,0,10,3,0.0,-4,-3,0.6660857842416721,6.790722352263401
2049,2049,2019,9,NCAAF_20191026_HAWAII@NMEX,Hawaii,Rainbow Warriors,New Mexico,Lobos,5-3,2-6,0.0,35,3,45,31,21,14,3,7,3,0,7,21,3.0,32,14,0.5457662149000795,1.8193560807761742
2050,2050,2019,9,NCAAF_20191026_SC@TENN,South Carolina,Gamecocks,Tennessee,Volunteers,3-5,3-5,1.0,21,17,21,41,7,14,0,0,3,14,14,10,0.0,4,-20,0.7445749342137666,10.404762896653665
2051,2051,2019,9,NCAAF_20191026_ARK@BAMA,Arkansas,Razorbacks,Alabama,Crimson Tide,2-6,8-0,1.0,0,41,7,48,0,0,0,7,17,24,7,0,-6.0,-41,-41,0.004459208070705656,-41.38338920054582
2052,2052,2019,9,NCAAF_20191026_MEMP@TULSA,Memphis,Tigers,Tulsa,Golden Hurricane,7-1,2-6,1.0,28,17,42,41,14,14,7,7,0,17,14,10,5.0,11,1,0.8638328720622882,17.37047256664073
2053,2053,2019,9,NCAAF_20191026_TROY@GAST,Troy,Trojans,Georgia St.,Panthers,3-4,6-2,0.0,14,28,33,52,0,14,0,19,7,21,7,17,-3.0,-14,-19,0.8030960342029312,13.493959524482307
2054,2054,2019,9,NCAAF_20191026_TXSTSM@ARKST,Texas St.,Bobcats,Arkansas St.,Red Wolves,2-5,4-4,1.0,14,17,14,38,0,14,0,0,7,10,14,7,-2.0,-3,-24,0.1177988124246242,-18.76870907881039
2055,2055,2019,9,NCAAF_20191026_TXTECH@KANSAS,Texas Tech,Red Raiders,Kansas,Jayhawks,3-5,3-5,0.0,17,14,34,37,7,10,10,7,0,14,6,17,0.0,3,-3,0.8601838963824855,17.108469098661317
2056,2056,2019,9,NCAAF_20191026_UCF@TEMPLE,UCF,,Temple,,6-2,5-3,,28,21,63,21,14,14,28,7,7,14,0,0,1.0,7,42,0.8536004530952377,16.647268479656077
2057,2057,2019,9,NCAAF_20191026_ARIZST@UCLA,Arizona St.,Sun Devils,UCLA,Bruins,5-3,3-5,1.0,7,28,32,42,7,0,3,22,14,14,14,0,2.0,-21,-10,0.6120906830213992,4.506345643356553
2058,2058,2019,9,NCAAF_20191026_BC@CLEM,Boston College,Eagles,Clemson,Tigers,4-4,8-0,1.0,7,38,7,59,0,7,0,0,17,21,14,7,-4.0,-31,-52,0.07175060901665298,-23.14911811367699
2059,2059,2019,9,NCAAF_20191026_COLOST@FRESNO,Colorado St.,Rams,Fresno St.,Bulldogs,3-5,3-4,1.0,21,14,41,31,14,7,3,17,7,7,14,3,0.0,7,10,0.1790846648610026,-14.540378280596428
2060,2060,2019,9,NCAAF_20191026_MIZZOU@UK,Missouri,Tigers,Kentucky,Wildcats,5-3,4-4,1.0,0,22,7,29,0,0,7,0,0,22,0,7,1.0,-22,-22,0.6922059209741747,7.945626558093295
2061,2061,2019,9,NCAAF_20191026_ND@MICH,Notre Dame,Fighting Irish,Michigan,Wolverines,5-2,6-2,1.0,0,17,14,45,0,0,7,7,3,14,7,21,-1.0,-17,-31,0.4300828401842236,-2.787675270732848
2062,2062,2019,9,NCAAF_20191026_LATECH@UTEP,Louisiana Tech,,UTEP,,7-1,1-6,,28,7,42,21,7,21,14,0,7,0,0,14,6.0,21,21,0.9100852590615043,21.224934625809624
2063,2063,2019,9,NCAAF_20191026_CAL@UTAH,California,Golden Bears,Utah,Utes,4-4,7-1,0.0,0,28,0,35,0,0,0,0,7,21,7,0,-3.0,-28,-35,0.2542664652060207,-10.461877205980045
2064,2064,2019,9,NCAAF_20191026_UTAHST@AF,Utah St.,Aggies,Air Force,Falcons,4-3,6-2,0.0,0,17,7,31,0,0,7,0,0,17,7,7,-2.0,-17,-24,0.7001556438789969,8.305400061559908
2065,2065,2019,9,NCAAF_20191026_SDGST@UNLV,San Diego St.,Aztecs,UNLV,Rebels,7-1,2-6,1.0,17,7,20,17,14,3,3,0,0,7,3,7,5.0,10,3,0.8356864469046945,15.458571575869996
2066,2066,2019,9,NCAAF_20191026_WASHST@OREG,Washington St.,Cougars,Oregon,Ducks,4-4,7-1,0.0,17,17,35,37,3,14,3,15,9,8,7,13,-3.0,0,-2,0.4703738577968032,-1.1762283265143196
2067,2067,2019,9,NCAAF_20191025_USC@COLO,USC,Trojans,Colorado,Buffaloes,5-3,3-5,1.0,14,17,35,31,7,7,7,14,3,14,14,0,2.0,-3,4,0.7842471670145961,12.447741912393326
2068,2068,2019,9,NCAAF_20191024_SMU@HOU,SMU,Mustangs,Houston,Cougars,8-0,3-5,1.0,21,13,34,31,7,14,10,3,0,13,7,11,5.0,8,3,0.5012245546046583,0.04857307584040882
2069,2069,2019,10,NCAAF_20191103_FRESNO@HAWAII,Fresno St.,,Hawaii,,4-4,5-4,,14,24,41,38,7,7,17,10,0,24,0,14,-1.0,-10,3,0.9022350632523997,20.599206796022486
2070,2070,2019,10,NCAAF_20191102_BC@CUSE,Boston College,,Syracuse,,5-4,3-6,,44,20,58,27,10,34,7,7,17,3,7,0,2.0,24,31,0.5375694539695118,1.5009034870494133
2071,2071,2019,10,NCAAF_20191102_BUFF@EMICH,Buffalo,Bulls,E. Michigan,Eagles,5-4,4-5,0.0,29,7,43,14,2,27,7,7,7,0,0,7,1.0,22,29,0.5925069723885958,3.7238980877092445
2072,2072,2019,10,NCAAF_20191102_HOU@UCF,Houston,Cougars,UCF,Knights,3-6,7-2,1.0,23,21,29,44,17,6,0,6,14,7,21,2,-4.0,2,-15,0.15245913688289958,-16.32705653238048
2073,2073,2019,10,NCAAF_20191102_LIB@MA,Liberty,Flames,UMass,Minutemen,6-3,1-8,1.0,49,14,63,21,28,21,14,0,7,7,7,0,5.0,35,42,0.6792827767361943,7.41114444253185
2074,2074,2019,10,NCAAF_20191102_MICH@MD,Michigan,Wolverines,Maryland,Terrapins,7-2,3-6,1.0,21,0,38,7,14,7,14,3,0,0,7,0,4.0,21,31,0.920130180086024,22.374517845071068
2075,2075,2019,10,NCAAF_20191102_NCST@WAKE,NC State,Wolfpack,Wake Forest,Demon Deacons,4-4,7-1,1.0,10,34,10,44,0,10,0,0,21,13,10,0,-3.0,-24,-34,0.5818851767534801,3.289758481566764
2076,2076,2019,10,NCAAF_20191102_NEB@PURDUE,Nebraska,Cornhuskers,Purdue,Boilermakers,4-5,3-6,1.0,10,14,27,31,10,0,3,14,0,14,3,14,1.0,-4,-4,0.3076904821906602,-7.9954064034430985
2077,2077,2019,10,NCAAF_20191102_NILL@CMICH,N. Illinois,Huskies,C. Michigan,Chippewas,3-6,6-4,1.0,10,38,10,48,3,7,0,0,21,17,0,10,-3.0,-28,-38,0.7011231362622079,8.396859302249027
2078,2078,2019,10,NCAAF_20191102_ODU@FIU,Old Dominion,Monarchs,FIU,Panthers,1-8,5-4,1.0,7,9,17,24,7,0,0,10,3,6,7,8,-4.0,-2,-7,0.23792345846385687,-11.346786716940983
2079,2079,2019,10,NCAAF_20191102_TXSA@TXAM,UTSA,Roadrunners,Texas A&M,Aggies,3-5,6-3,1.0,7,21,14,45,7,0,0,7,14,7,14,10,-3.0,-14,-31,0.027801872134637806,-30.461801462502308
2080,2080,2019,10,NCAAF_20191102_AKRON@BGREEN,Akron,Zips,Bowling Green,Falcons,0-9,3-6,1.0,6,21,6,35,6,0,0,0,7,14,7,7,-3.0,-15,-29,0.6181896069450803,4.785865711154656
2081,2081,2019,10,NCAAF_20191102_VATECH@ND,Virginia Tech,Hokies,Notre Dame,Fighting Irish,5-3,6-2,0.0,14,14,20,21,7,7,3,3,7,7,0,7,-1.0,0,-1,0.16873752964550814,-15.264350819153947
2082,2082,2019,10,NCAAF_20191102_TROY@CSTCAR,Troy,Trojans,C. Carolina,Chanticleers,3-5,4-4,1.0,21,17,35,36,21,0,7,7,14,3,11,8,-1.0,4,-1,0.800599167951415,13.427809037695852
2083,2083,2019,10,NCAAF_20191102_ARKST@LAMON,Arkansas St.,Red Wolves,UL-Monroe,Warhawks,5-4,3-5,0.0,31,28,48,41,3,28,3,14,14,14,6,7,2.0,3,7,0.7525794105772878,10.863489880214047
2084,2084,2019,10,NCAAF_20191102_ARMY@AF,Army,Black Knights,Air Force,Falcons,3-6,7-2,1.0,6,3,13,17,0,6,7,0,0,3,7,7,-4.0,3,-4,0.4855487454481764,-0.5766004805733473
2085,2085,2019,10,NCAAF_20191102_KSTATE@KANSAS,Kansas State,Wildcats,Kansas,Jayhawks,6-2,3-6,0.0,17,3,38,10,7,10,7,14,3,0,0,7,3.0,14,28,0.8409037430187541,15.885210725564889
2086,2086,2019,10,NCAAF_20191102_MIAMI@FSU,Miami (Fla.),Hurricanes,Florida State,Seminoles,5-4,4-5,1.0,17,3,27,10,7,10,0,10,0,3,7,0,1.0,14,17,0.6393888914847807,5.678593187004026
2087,2087,2019,10,NCAAF_20191102_MRSHL@RICE,Marshall,Thundering Herd,Rice,Owls,6-3,0-9,1.0,17,7,20,7,3,14,3,0,0,7,0,0,6.0,10,13,0.8921112889838619,19.69913229498991
2088,2088,2019,10,NCAAF_20191102_MTSU@CHARLO,Middle Tenn.,Blue Raiders,Charlotte,49ers,3-6,4-5,1.0,7,24,20,34,7,0,6,7,14,10,10,0,-1.0,-17,-14,0.8436479318131964,16.066394931506125
2089,2089,2019,10,NCAAF_20191102_RUT@ILL,Rutgers,Scarlet Knights,Illinois,Fighting Illini,2-7,5-4,0.0,10,10,10,38,0,10,0,0,10,0,21,7,-3.0,0,-28,0.3853241653625017,-4.639414991441299
2090,2090,2019,10,NCAAF_20191102_TCU@OKLAST,TCU,Horned Frogs,Oklahoma State,Cowboys,4-4,6-3,0.0,17,17,27,34,3,14,0,10,10,7,7,10,-2.0,0,-7,0.49416313313498716,-0.23284650318635158
2091,2091,2019,10,NCAAF_20191102_UGA@FLA,Georgia,Bulldogs,Florida,Gators,7-1,7-2,0.0,13,3,24,17,3,10,3,8,0,3,0,14,0.0,10,7,0.8377062770355777,15.676662514279371
2092,2092,2019,10,NCAAF_20191102_UNLV@COLOST,UNLV,Rebels,Colorado St.,Rams,2-7,4-5,0.0,0,24,17,37,0,0,3,14,21,3,3,10,-2.0,-24,-20,0.34433131994387456,-6.376347951783828
2093,2093,2019,10,NCAAF_20191102_UTEP@NTEXAS,UTEP,Miners,North Texas,Mean Green,1-7,4-5,0.0,14,38,26,52,7,7,6,6,21,17,7,7,-3.0,-24,-26,0.08946849548795344,-21.38923046319644
2094,2094,2019,10,NCAAF_20191102_FAU@WKY,FAU,Owls,W. Kentucky,Hilltoppers,6-3,5-4,0.0,21,14,35,24,0,21,7,7,14,0,7,3,1.0,7,11,0.816176612694476,14.336934478202352
2095,2095,2019,10,NCAAF_20191102_MISSST@ARK,Miss. State,Bulldogs,Arkansas,Razorbacks,4-5,2-7,1.0,38,10,54,24,14,24,7,9,0,10,7,7,2.0,28,30,0.9031115832965959,20.68028219525695
2096,2096,2019,10,NCAAF_20191102_PITT@GATECH,Pittsburgh,Panthers,Georgia Tech,Yellow Jackets,6-3,2-6,1.0,17,7,20,10,10,7,0,3,0,7,3,0,4.0,10,10,0.5031195548599431,0.12444329189168002
2097,2097,2019,10,NCAAF_20191102_TULSA@TULANE,Tulsa,Golden Hurricane,Tulane,Green Wave,2-7,6-3,1.0,16,24,26,38,0,16,0,10,10,14,7,7,-4.0,-8,-12,0.30335805204685373,-8.192093344550585
2098,2098,2019,10,NCAAF_20191102_UTAH@WASH,Utah,Utes,Washington,Huskies,8-1,5-4,1.0,13,14,33,28,0,13,6,14,7,7,7,7,3.0,-1,5,0.3988858631557569,-4.077723873053628
2099,2099,2019,10,NCAAF_20191102_WOFF@CLEM,Wofford,Terriers,Clemson,Tigers,5-3,9-0,0.0,0,42,14,59,0,0,14,0,21,21,14,3,-4.0,-42,-45,0.005834741310510538,-40.13533838105366
2100,2100,2019,10,NCAAF_20191102_OREGST@ARIZ,Oregon State,Beavers,Arizona,Wildcats,4-4,4-5,1.0,35,19,56,38,7,28,7,14,6,13,12,7,0.0,16,18,0.15226980430726222,-16.33984561249622
2101,2101,2019,10,NCAAF_20191102_TXSTSM@LALAF,Texas St.,Bobcats,Louisiana,Ragin' Cajuns,2-6,6-2,1.0,3,10,3,31,0,3,0,0,0,10,21,0,-4.0,-7,-28,0.19211671905795047,-13.847294380088442
2102,2102,2019,10,NCAAF_20191102_CINCY@ECU,Cincinnati,Bearcats,East Carolina,Pirates,7-1,3-6,0.0,21,31,46,43,21,0,7,18,14,17,9,3,4.0,-10,3,0.8955315276439346,19.99608153053464
2103,2103,2019,10,NCAAF_20191102_MISS@AUBURN,Ole Miss,Rebels,Auburn,Tigers,3-6,7-2,1.0,7,10,14,20,0,7,0,7,0,10,10,0,-4.0,-3,-6,0.11817933273322412,-18.844586513021113
2104,2104,2019,10,NCAAF_20191102_NWEST@IND,Northwestern,Wildcats,Indiana,Hoosiers,1-7,7-2,0.0,3,24,3,34,0,3,0,0,10,14,7,3,-6.0,-21,-31,0.5546859177073089,2.1883505119679967
2105,2105,2019,10,NCAAF_20191102_UAB@TENN,UAB,Blazers,Tennessee,Volunteers,6-2,4-5,1.0,0,23,7,30,0,0,0,7,6,17,7,0,2.0,-23,-23,0.3499736601294984,-6.133194320756957
2106,2106,2019,10,NCAAF_20191102_SMU@MEMP,SMU,Mustangs,Memphis,Tigers,8-1,8-1,1.0,17,23,48,54,7,10,7,24,7,16,17,14,0.0,-6,-6,0.3780638087663759,-4.942467891688807
2107,2107,2019,10,NCAAF_20191102_UVA@UNC,Virginia,Cavaliers,North Carolina,Tar Heels,6-3,4-5,0.0,17,17,38,31,7,10,21,0,3,14,14,0,2.0,0,7,0.6434698871890816,5.852430705634561
2108,2108,2019,10,NCAAF_20191102_VANDY@SC,Vanderbilt,Commodores,South Carolina,Gamecocks,2-6,4-5,0.0,7,14,7,24,7,0,0,0,0,14,0,10,-2.0,-7,-17,0.28582901099471625,-9.00124548641179
2109,2109,2019,10,NCAAF_20191102_OREG@USC,Oregon,Ducks,USC,Trojans,8-1,5-4,0.0,28,17,56,24,0,28,14,14,10,7,0,7,3.0,11,32,0.5585452349632503,2.34387171321373
2110,2110,2019,10,NCAAF_20191102_COLO@UCLA,Colorado,Buffaloes,UCLA,Bruins,3-6,4-5,1.0,7,17,14,31,0,7,0,7,17,0,7,7,-1.0,-10,-17,0.43143522746858354,-2.748720282228078
2111,2111,2019,10,NCAAF_20191102_BYU@UTAHST,BYU,Cougars,Utah St.,Aggies,4-4,4-4,0.0,21,14,42,14,7,14,14,7,7,7,0,0,0.0,7,28,0.28629067252051765,-8.97964316425373
2112,2112,2019,10,NCAAF_20191102_BOISE@SJST,Boise St.,Broncos,San Jose St.,Spartans,7-1,4-5,0.0,17,24,52,42,7,10,14,21,14,10,10,8,3.0,-7,10,0.9691555394639975,29.736060326720235
2113,2113,2019,10,NCAAF_20191102_NMEX@NEVADA,New Mexico,Lobos,Nevada,Wolf Pack,2-7,5-4,0.0,7,14,10,21,7,0,3,0,0,14,0,7,-3.0,-7,-11,0.3657618302949279,-5.460149058385582
2114,2114,2019,10,NCAAF_20191101_NAVY@UCONN,Navy,Midshipmen,UConn,Huskies,7-1,2-7,0.0,28,10,56,10,14,14,14,14,7,3,0,0,5.0,18,46,0.9343799183783116,24.018161852182516
2115,2115,2019,10,NCAAF_20191031_GAS@APLST,Ga. Southern,Eagles,App. St.,Mountaineers,5-3,7-1,0.0,10,7,24,21,7,3,14,0,0,7,0,14,-2.0,3,3,0.18332770566192746,-14.366629238955852
2116,2116,2019,10,NCAAF_20191031_WVU@BAYLOR,West Virginia,Mountaineers,Baylor,Bears,3-5,8-0,1.0,0,7,14,17,0,0,14,0,7,0,7,3,-5.0,-7,-3,0.7090844602289381,8.764135561807848
2117,2117,2019,11,NCAAF_20191109_ECU@SMU,East Carolina,Pirates,SMU,Mustangs,3-7,9-1,0.0,20,28,51,59,7,13,17,14,14,14,17,14,-6.0,-8,-8,0.11147886528291973,-19.48511304517865
2118,2118,2019,11,NCAAF_20191109_FSU@BC,Florida State,Seminoles,Boston College,Eagles,5-5,5-5,0.0,10,14,38,31,3,7,14,14,7,7,0,17,0.0,-4,7,0.4604169940449614,-1.588981902827868
2119,2119,2019,11,NCAAF_20191109_MA@ARMY,UMass,Minutemen,Army,Black Knights,1-9,4-6,1.0,7,35,7,63,7,0,0,0,14,21,14,14,-3.0,-28,-56,0.08167236652546106,-22.286433765117522
2120,2120,2019,11,NCAAF_20191109_MD@OHIOST,Maryland,Terrapins,Ohio State,Buckeyes,3-7,9-0,1.0,0,42,14,73,0,0,7,7,21,21,10,21,-6.0,-42,-59,0.025498467006868086,-31.201508273069066
2121,2121,2019,11,NCAAF_20191109_PSU@MINN,Penn State,Nittany Lions,Minnesota,Golden Gophers,8-1,9-0,1.0,13,24,26,31,10,3,6,7,14,10,0,7,-1.0,-11,-5,0.9049777473574818,20.951996253043376
2122,2122,2019,11,NCAAF_20191109_PURDUE@NWEST,Purdue,Boilermakers,Northwestern,Wildcats,4-6,1-8,1.0,7,16,24,22,0,7,14,3,14,2,0,6,3.0,-9,2,0.5774924311948451,3.125460088404452
2123,2123,2019,11,NCAAF_20191109_TXTECH@WVU,Texas Tech,Red Raiders,West Virginia,Mountaineers,4-5,3-6,1.0,35,10,38,17,21,14,0,3,3,7,0,7,1.0,25,21,0.4713852078635493,-1.1477815006803667
2124,2124,2019,11,NCAAF_20191109_VANDY@FLA,Vanderbilt,Commodores,Florida,Gators,2-7,8-2,0.0,0,14,0,56,0,0,0,0,0,14,28,14,-6.0,-14,-56,0.18318881297548995,-14.442018574660324
2125,2125,2019,11,NCAAF_20191109_WKY@ARK,W. Kentucky,Hilltoppers,Arkansas,Razorbacks,6-4,2-8,0.0,35,7,45,19,14,21,3,7,7,0,0,12,4.0,28,26,0.3443782427071258,-6.404056212211572
2126,2126,2019,11,NCAAF_20191109_GATECH@UVA,Georgia Tech,Yellow Jackets,Virginia,Cavaliers,2-7,7-3,1.0,21,24,28,33,14,7,0,7,14,10,0,9,-5.0,-3,-5,0.5195781494189171,0.784949651692159
2127,2127,2019,11,NCAAF_20191109_TXSA@ODU,UTSA,Roadrunners,Old Dominion,Monarchs,4-5,1-9,1.0,10,20,24,23,10,0,0,14,10,10,3,0,3.0,-10,1,0.5196528807078082,0.7879482865999989
2128,2128,2019,11,NCAAF_20191109_CHARLO@UTEP,Charlotte,49ers,UTEP,Miners,5-5,1-8,0.0,7,21,28,21,0,7,14,7,14,7,0,0,4.0,-14,7,0.7215391576499643,9.391922487188936
2129,2129,2019,11,NCAAF_20191109_SALA@TXSTSM,South Alabama,Jaguars,Texas St.,Bobcats,1-8,3-6,1.0,14,13,28,30,7,7,7,7,3,10,14,3,-2.0,1,-2,0.5597722940434253,2.4045306106031603
2130,2130,2019,11,NCAAF_20191109_STNFRD@COLO,Stanford,Cardinal,Colorado,Buffaloes,4-5,4-6,0.0,6,10,13,16,3,3,0,7,7,3,0,6,0.0,-4,-3,0.7739251266409433,12.020674986056633
2131,2131,2019,11,NCAAF_20191109_GAS@TROY,Ga. Southern,Eagles,Troy,Trojans,5-4,4-5,0.0,14,27,28,49,0,14,0,14,14,13,0,22,1.0,-13,-21,0.34539775157845587,-6.3598091391414755
2132,2132,2019,11,NCAAF_20191109_ILL@MICHST,Illinois,Fighting Illini,Michigan St.,Spartans,6-4,4-5,1.0,10,28,37,34,3,7,0,27,14,14,3,3,2.0,-18,3,0.1462060010503088,-16.833338738606926
2133,2133,2019,11,NCAAF_20191109_KSTATE@TEXAS,Kansas State,Wildcats,Texas,Longhorns,6-3,6-3,1.0,14,7,24,27,14,0,0,10,0,7,10,10,0.0,7,-3,0.36748402714499373,-5.412473088574984
2134,2134,2019,11,NCAAF_20191109_LSU@BAMA,LSU,Tigers,Alabama,Crimson Tide,9-0,8-1,0.0,33,13,46,41,10,23,0,13,7,6,7,21,1.0,20,5,0.168555274585934,-15.34713407475374
2135,2135,2019,11,NCAAF_20191109_LVILLE@MIAMI,Louisville,Cardinals,Miami (Fla.),Hurricanes,5-4,6-4,1.0,14,35,27,52,7,7,7,6,21,14,17,0,-1.0,-21,-25,0.22616017700040425,-12.016140155712037
2136,2136,2019,11,NCAAF_20191109_UAB@USM,UAB,Blazers,So. Miss,Golden Eagles,6-3,6-3,1.0,2,20,2,37,0,2,0,0,7,13,10,7,0.0,-18,-35,0.512762778464113,0.5115817676680763
2137,2137,2019,11,NCAAF_20191109_UCONN@CINCY,UConn,Huskies,Cincinnati,Bearcats,2-8,8-1,1.0,0,38,3,48,0,0,0,3,14,24,3,7,-6.0,-38,-45,0.055468820524108176,-25.48544116541177
2138,2138,2019,11,NCAAF_20191109_USC@ARIZST,USC,Trojans,Arizona St.,Sun Devils,6-4,5-4,1.0,28,13,31,26,28,0,3,0,7,6,7,6,1.0,15,5,0.6060876189829241,4.303067354904215
2139,2139,2019,11,NCAAF_20191109_WAKE@VATECH,Wake Forest,Demon Deacons,Virginia Tech,Hokies,7-2,6-3,0.0,10,6,17,36,3,7,7,0,3,3,17,13,1.0,4,-19,0.5392924500623411,1.577280055496658
2140,2140,2019,11,NCAAF_20191109_IOWA@WISC,Iowa,Hawkeyes,Wisconsin,Badgers,6-3,7-2,0.0,6,14,22,24,3,3,0,16,0,14,7,3,-1.0,-8,-2,0.4822348256588176,-0.7122112174181439
2141,2141,2019,11,NCAAF_20191109_NMEXST@MISS,New Mexico St.,Aggies,Ole Miss,Rebels,0-9,4-6,0.0,3,24,3,41,0,3,0,0,10,14,7,10,-4.0,-21,-38,0.0669595784425665,-23.96384971371981
2142,2142,2019,11,NCAAF_20191109_NTEXAS@LATECH,North Texas,Mean Green,Louisiana Tech,Bulldogs,4-6,8-1,1.0,3,17,17,52,3,0,0,14,7,10,14,21,-4.0,-14,-35,0.5089941471690275,0.360489410361879
2143,2143,2019,11,NCAAF_20191109_GAST@LAMON,Georgia St.,Panthers,UL-Monroe,Warhawks,6-3,4-5,0.0,24,24,31,45,10,14,7,0,14,10,7,14,2.0,0,-14,0.5103993085621175,0.4168208011038814
2144,2144,2019,11,NCAAF_20191109_FIU@FAU,FIU,Panthers,FAU,Owls,5-5,7-3,1.0,7,13,7,37,0,7,0,0,7,6,15,9,-2.0,-6,-30,0.2575179372189238,-10.408730127383706
2145,2145,2019,11,NCAAF_20191109_APLST@SC,App. St.,Mountaineers,South Carolina,Gamecocks,8-1,4-6,0.0,13,6,20,15,3,10,7,0,6,0,3,6,4.0,7,5,0.3468545685015342,-6.296667055484704
2146,2146,2019,11,NCAAF_20191109_MIZZOU@UGA,Missouri,Tigers,Georgia,Bulldogs,5-4,8-1,1.0,0,16,0,27,0,0,0,0,7,9,3,8,-3.0,-16,-27,0.17238905854124686,-15.105331509912617
2147,2147,2019,11,NCAAF_20191109_UTAHST@FRESNO,Utah St.,Aggies,Fresno St.,Bulldogs,5-4,4-5,0.0,21,14,37,35,7,14,10,6,7,7,14,7,1.0,7,2,0.4730908168284129,-1.079259695401447
2148,2148,2019,11,NCAAF_20191109_WASHST@CAL,Washington St.,Cougars,California,Golden Bears,4-5,5-4,1.0,11,13,20,33,5,6,3,6,6,7,7,13,-1.0,-2,-13,0.7253151267971703,9.572349407807451
2149,2149,2019,11,NCAAF_20191109_CLEM@NCST,Clemson,Tigers,NC State,Wolfpack,10-0,4-5,1.0,42,0,55,10,28,14,7,6,0,0,7,3,6.0,42,45,0.923679781698021,22.867720459871407
2150,2150,2019,11,NCAAF_20191109_LIB@BYU,Liberty,Flames,BYU,Cougars,6-4,5-4,1.0,7,17,24,31,7,0,10,7,7,10,7,7,1.0,-10,-7,0.24583323797573797,-10.994614221357665
2151,2151,2019,11,NCAAF_20191109_ND@DUKE,Notre Dame,Fighting Irish,Duke,Blue Devils,7-2,4-5,1.0,21,7,38,7,14,7,7,10,0,7,0,0,3.0,14,31,0.8316056844963411,15.357362803220553
2152,2152,2019,11,NCAAF_20191109_TENN@UK,Tennessee,Volunteers,Kentucky,Wildcats,5-5,4-5,0.0,3,13,17,13,0,3,14,0,13,0,0,0,1.0,-10,4,0.33083045302942327,-6.996875361968478
2153,2153,2019,11,NCAAF_20191109_IOWAST@OKLA,Iowa St.,Cyclones,Oklahoma,Sooners,5-4,8-1,0.0,14,35,41,42,7,7,7,20,14,21,7,0,-3.0,-21,-1,0.26405528206818796,-10.08698609986584
2154,2154,2019,11,NCAAF_20191109_NEVADA@SDGST,Nevada,Wolf Pack,San Diego St.,Aztecs,6-4,7-2,0.0,3,3,17,13,3,0,7,7,0,3,7,3,-1.0,0,4,0.21118514762483898,-12.827769471442366
2155,2155,2019,11,NCAAF_20191109_SJST@HAWAII,San Jose St.,Spartans,Hawaii,Rainbow Warriors,4-6,6-4,1.0,23,21,40,42,3,20,3,14,7,14,7,14,-2.0,2,-2,0.3495775713771472,-6.178907238422539
2156,2156,2019,11,NCAAF_20191108_UCF@TULSA,UCF,Knights,Tulsa,Golden Hurricane,7-3,3-7,0.0,28,17,31,34,14,14,3,0,7,10,7,10,4.0,11,-3,0.9561405455657288,27.301124917234574
2157,2157,2019,11,NCAAF_20191108_WASH@OREGST,Washington,Huskies,Oregon State,Beavers,6-4,4-5,0.0,10,0,19,7,3,7,9,0,0,0,7,0,2.0,10,12,0.9750631855226949,31.35404858484378
2158,2158,2019,11,NCAAF_20191107_LALAF@CSTCAR,Louisiana,Ragin' Cajuns,C. Carolina,Chanticleers,7-2,4-5,1.0,24,0,48,7,14,10,21,3,0,0,0,7,3.0,24,41,0.6807252776409183,7.510210891816996
2159,2159,2019,11,NCAAF_20191107_TEMPLE@SFLA,Temple,Owls,South Florida,Bulls,6-3,4-5,0.0,7,0,17,7,0,7,7,3,0,0,7,0,2.0,7,10,0.5670440260196612,2.6997007229693963
2160,2160,2019,11,NCAAF_20191106_MIAOH@OHIO,Miami-OH,RedHawks,Ohio,Bobcats,5-4,4-5,0.0,7,7,24,21,0,7,7,10,0,7,0,14,1.0,0,3,0.32525068548384883,-7.24381015415554
2161,2161,2019,11,NCAAF_20191105_KENTST@TOLEDO,Kent St.,Golden Flashes,Toledo,Rockets,3-6,6-3,1.0,17,28,33,35,10,7,10,6,14,14,0,7,-3.0,-11,-2,0.11197703450214402,-19.44322466040319
2162,2162,2019,11,NCAAF_20191105_BALLST@WMICH,Ball St.,Cardinals,W. Michigan,Broncos,4-5,6-4,0.0,10,21,31,35,7,3,7,14,7,14,0,14,-2.0,-11,-4,0.17745986929585977,-14.790715973377473
2163,2163,2019,12,NCAAF_20191116_ALST@FSU,Alabama St.,Hornets,Florida State,Seminoles,5-5,6-5,1.0,6,21,12,49,3,3,6,0,14,7,14,14,-1.0,-15,-37,0.00612730688730978,-40.20228080729191
2164,2164,2019,12,NCAAF_20191116_BAMA@MISSST,Alabama,Crimson Tide,Miss. State,Bulldogs,9-1,4-6,1.0,35,7,38,7,21,14,3,0,7,0,0,0,5.0,28,31,0.8901810055916232,19.701932093209848
2165,2165,2019,12,NCAAF_20191116_FLA@MIZZOU,Florida,Gators,Missouri,Tigers,9-2,5-5,1.0,6,3,23,6,3,3,14,3,0,3,3,0,4.0,3,17,0.5460636839341511,1.8574085958620117
2166,2166,2019,12,NCAAF_20191116_IND@PSU,Indiana,Hoosiers,Penn State,Nittany Lions,7-3,9-1,0.0,14,20,27,34,14,0,3,10,17,3,7,7,-2.0,-6,-7,0.0881859755030665,-21.7005361546764
2167,2167,2019,12,NCAAF_20191116_KANSAS@OKLAST,Kansas,Jayhawks,Oklahoma State,Cowboys,3-7,7-3,1.0,0,24,13,31,0,0,0,13,14,10,7,0,-4.0,-24,-18,0.09242227785742618,-21.282817181756172
2168,2168,2019,12,NCAAF_20191116_MA@NWEST,UMass,Minutemen,Northwestern,Wildcats,1-10,2-8,0.0,6,21,6,45,3,3,0,0,0,21,3,21,-1.0,-15,-39,0.017975996659501448,-33.6655833884538
2169,2169,2019,12,NCAAF_20191116_MICHST@MICH,Michigan St.,Spartans,Michigan,Wolverines,4-6,8-2,0.0,7,17,10,44,7,0,3,0,0,17,10,17,-4.0,-10,-34,0.1968920260629251,-13.687523862986382
2170,2170,2019,12,NCAAF_20191116_TCU@TXTECH,TCU,Horned Frogs,Texas Tech,Red Raiders,5-5,4-6,1.0,27,16,33,31,17,10,0,6,0,16,12,3,1.0,11,2,0.5892931526784074,3.6230477536598755
2171,2171,2019,12,NCAAF_20191116_TULANE@TEMPLE,Tulane,Green Wave,Temple,Owls,6-4,7-3,0.0,7,13,21,29,0,7,0,14,3,10,9,7,-1.0,-6,-8,0.48611947485499085,-0.5585652047607255
2172,2172,2019,12,NCAAF_20191116_VMI@ARMY,VMI,Keydets,Army,Black Knights,4-7,5-6,0.0,6,14,6,47,3,3,0,0,7,7,19,14,-1.0,-8,-41,4.414611152903092e-05,-62.929455922857755
2173,2173,2019,12,NCAAF_20191116_WISC@NEB,Wisconsin,Badgers,Nebraska,Cornhuskers,8-2,4-6,0.0,27,14,37,21,7,20,7,3,7,7,7,0,4.0,13,16,0.8903293317083139,19.714614214922108
2174,2174,2019,12,NCAAF_20191116_UTEP@UAB,UTEP,Miners,UAB,Blazers,1-9,7-3,1.0,7,23,10,37,0,7,0,3,17,6,7,7,-6.0,-16,-27,0.09918390764894236,-20.64449099025626
2175,2175,2019,12,NCAAF_20191116_NAVY@ND,Navy,Midshipmen,Notre Dame,Fighting Irish,7-2,8-2,0.0,3,38,20,52,0,3,7,10,14,24,7,7,-1.0,-35,-32,0.13735554490738533,-17.531675905802786
2176,2176,2019,12,NCAAF_20191116_CSTCAR@ARKST,C. Carolina,Chanticleers,Arkansas St.,Red Wolves,4-6,6-4,1.0,13,7,27,28,3,10,0,14,7,0,14,7,-2.0,6,-1,0.20214645797882036,-13.385833492714369
2177,2177,2019,12,NCAAF_20191116_IDST@BYU,Idaho State,Bengals,BYU,Cougars,3-8,6-4,0.0,3,28,10,42,0,3,7,0,7,21,14,0,-3.0,-25,-32,0.1473587537038663,-16.818246382582174
2178,2178,2019,12,NCAAF_20191116_LAMON@GAS,UL-Monroe,Warhawks,Ga. Southern,Eagles,4-6,6-4,0.0,7,24,29,51,7,0,7,15,7,17,7,20,-2.0,-17,-22,0.40796985282017684,-3.7360968964043195
2179,2179,2019,12,NCAAF_20191116_TROY@TXSTSM,Troy,Trojans,Texas St.,Bobcats,5-5,3-7,1.0,35,10,63,27,14,21,7,21,3,7,10,7,2.0,25,36,0.8944296198910013,20.070188190176168
2180,2180,2019,12,NCAAF_20191116_CMICH@BALLST,C. Michigan,Chippewas,Ball St.,Cardinals,7-4,4-6,0.0,11,27,45,44,3,8,20,14,3,24,14,3,3.0,-16,1,0.7228932162062731,9.493237094648748
2181,2181,2019,12,NCAAF_20191116_MEMP@HOU,Memphis,Tigers,Houston,Cougars,9-1,3-7,0.0,28,20,45,27,7,21,14,3,17,3,0,7,6.0,8,18,0.6333975569212056,5.47108371518766
2182,2182,2019,12,NCAAF_20191116_OHIOST@RUT,Ohio State,Buckeyes,Rutgers,Scarlet Knights,10-0,2-8,0.0,35,7,56,21,21,14,14,7,7,0,7,7,8.0,28,35,0.9975065413647523,45.0680296220433
2183,2183,2019,12,NCAAF_20191116_TEXAS@IOWAST,Texas,Longhorns,Iowa St.,Cyclones,6-4,6-4,1.0,7,10,21,23,0,7,0,14,7,3,10,3,0.0,-3,-2,0.45523544271989347,-1.8047998204820033
2184,2184,2019,12,NCAAF_20191116_UGA@AUBURN,Georgia,Bulldogs,Auburn,Tigers,9-1,7-3,0.0,14,0,21,14,7,7,7,0,0,0,0,14,2.0,14,7,0.6779488557242459,7.414892912599726
2185,2185,2019,12,NCAAF_20191116_UK@VANDY,Kentucky,Wildcats,Vanderbilt,Commodores,5-5,2-8,0.0,24,14,38,14,3,21,14,0,14,0,0,0,3.0,10,24,0.7176277802984821,9.242057704819103
2186,2186,2019,12,NCAAF_20191116_VATECH@GATECH,Virginia Tech,Hokies,Georgia Tech,Yellow Jackets,7-3,2-8,0.0,31,0,45,0,14,17,14,0,0,0,0,0,5.0,31,45,0.5408249232415485,1.6453785106079977
2187,2187,2019,12,NCAAF_20191116_WAKE@CLEM,Wake Forest,Demon Deacons,Clemson,Tigers,7-3,11-0,1.0,3,31,3,52,3,0,0,0,14,17,14,7,-4.0,-28,-49,0.05882704102546632,-25.11426741420655
2188,2188,2019,12,NCAAF_20191116_WVU@KSTATE,West Virginia,Mountaineers,Kansas State,Wildcats,4-6,6-4,1.0,14,13,24,20,14,0,0,10,10,3,7,0,-2.0,1,4,0.4954330164645179,-0.18374657830213437
2189,2189,2019,12,NCAAF_20191116_CUSE@DUKE,Syracuse,Orange,Duke,Blue Devils,4-6,4-6,0.0,14,6,49,6,14,0,21,14,0,6,0,0,0.0,8,43,0.4866632627884676,-0.5366743508760692
2190,2190,2019,12,NCAAF_20191116_HAWAII@UNLV,Hawaii,Rainbow Warriors,UNLV,Rebels,7-4,2-8,0.0,7,7,21,7,0,7,7,7,7,0,0,0,5.0,0,14,0.4919958897798844,-0.3220494254055666
2191,2191,2019,12,NCAAF_20191116_MINN@IOWA,Minnesota,Golden Gophers,Iowa,Hawkeyes,9-1,7-3,0.0,6,20,19,23,0,6,7,6,13,7,0,3,2.0,-14,-4,0.2277060794804615,-11.980506704503114
2192,2192,2019,12,NCAAF_20191116_UIW@NMEXST,Incarnate Word,,New Mexico St.,,5-6,1-9,,7,24,28,41,0,7,7,14,14,10,3,14,4.0,-17,-13,0.02530933765626009,-31.374019259627175
2193,2193,2019,12,NCAAF_20191116_WYO@UTAHST,Wyoming,Cowboys,Utah St.,Aggies,6-4,6-4,0.0,14,20,21,26,0,14,0,7,0,20,3,3,0.0,-6,-5,0.34732837293149554,-6.300544469889587
2194,2194,2019,12,NCAAF_20191116_RICE@MTSU,Rice,Owls,Middle Tenn.,Blue Raiders,1-9,3-7,0.0,31,14,31,28,10,21,0,0,0,14,7,7,-2.0,17,3,0.1188071199048335,-18.955255002195827
2195,2195,2019,12,NCAAF_20191116_STNFRD@WASHST,Stanford,Cardinal,Washington St.,Cougars,4-6,5-5,0.0,14,22,22,49,0,14,8,0,13,9,10,17,-1.0,-8,-27,0.46863925153638786,-1.2630332184207873
2196,2196,2019,12,NCAAF_20191116_LALAF@SALA,Louisiana,Ragin' Cajuns,South Alabama,Jaguars,8-2,1-9,1.0,17,14,37,27,3,14,6,14,7,7,7,6,7.0,3,10,0.800134723846842,13.51622393026912
2197,2197,2019,12,NCAAF_20191116_USM@TXSA,So. Miss,Golden Eagles,UTSA,Roadrunners,7-3,4-6,0.0,16,10,36,17,7,9,13,7,7,3,7,0,3.0,6,19,0.793833070844101,13.158150370314502
2198,2198,2019,12,NCAAF_20191116_AF@COLOST,Air Force,Falcons,Colorado St.,Rams,8-2,4-6,0.0,10,14,38,21,0,10,0,28,14,0,0,7,4.0,-4,17,0.6402993965109932,5.766313772497483
2199,2199,2019,12,NCAAF_20191116_CINCY@SFLA,Cincinnati,Bearcats,South Florida,Bulls,9-1,4-6,1.0,0,10,20,17,0,0,10,10,7,3,7,0,5.0,-10,3,0.6348094003004572,5.531322445253181
2200,2200,2019,12,NCAAF_20191116_LSU@MISS,LSU,Tigers,Ole Miss,Rebels,10-0,4-7,1.0,31,7,58,37,14,17,13,14,0,7,16,14,6.0,24,21,0.8558681769438539,17.044714216782154
2201,2201,2019,12,NCAAF_20191116_APLST@GAST,App. St.,Mountaineers,Georgia St.,Panthers,9-1,6-4,0.0,35,21,56,27,14,21,7,14,21,0,0,6,3.0,14,29,0.8780373320579075,18.702625431048432
2202,2202,2019,12,NCAAF_20191116_ARIZST@OREGST,Arizona St.,Sun Devils,Oregon State,Beavers,5-5,5-5,0.0,21,28,34,35,14,7,7,6,14,14,7,0,0.0,-7,-1,0.8676062982424565,17.89874340069582
2203,2203,2019,12,NCAAF_20191116_LVILLE@NCST,Louisville,Cardinals,NC State,Wolfpack,6-4,4-6,0.0,7,10,34,20,0,7,20,7,0,10,0,10,2.0,-3,14,0.3097567608969656,-7.96974771709165
2204,2204,2019,12,NCAAF_20191116_OKLA@BAYLOR,Oklahoma,Sooners,Baylor,Bears,9-1,9-1,0.0,10,31,34,31,3,7,7,17,14,17,0,0,0.0,-21,3,0.9336782706655729,24.1361837484302
2205,2205,2019,12,NCAAF_20191116_SC@TXAM,South Carolina,Gamecocks,Texas A&M,Aggies,4-7,7-3,1.0,3,13,6,30,3,0,0,3,3,10,0,17,-3.0,-10,-24,0.4241741473519618,-3.0692907454036913
2206,2206,2019,12,NCAAF_20191116_UCLA@UTAH,UCLA,Bruins,Utah,Utes,4-6,9-1,1.0,3,28,3,49,3,0,0,0,7,21,7,14,-5.0,-25,-46,0.22146697043479135,-12.314769597174859
2207,2207,2019,12,NCAAF_20191116_NMEX@BOISE,New Mexico,Lobos,Boise St.,Broncos,2-8,9-1,1.0,0,28,9,42,0,0,3,6,28,0,14,0,-7.0,-28,-33,0.05558758976742917,-25.56748181017531
2208,2208,2019,12,NCAAF_20191116_ARIZ@OREG,Arizona,Wildcats,Oregon,Ducks,4-6,9-1,0.0,6,21,6,34,0,6,0,0,14,7,7,6,-5.0,-15,-28,0.2071594653516815,-13.102349010445437
2209,2209,2019,12,NCAAF_20191116_USC@CAL,USC,Trojans,California,Golden Bears,7-4,5-5,0.0,17,10,41,17,10,7,17,7,7,3,0,7,2.0,7,24,0.6637443052094683,6.784635754318742
2210,2210,2019,12,NCAAF_20191115_LATECH@MRSHL,Louisiana Tech,Bulldogs,Marshall,Thundering Herd,8-2,7-3,1.0,7,17,10,31,7,0,3,0,0,17,7,7,1.0,-10,-21,0.4702337181313542,-1.1986944045381733
2211,2211,2019,12,NCAAF_20191115_FRESNO@SDGST,Fresno St.,Bulldogs,San Diego St.,Aztecs,4-6,8-2,0.0,7,10,7,17,7,0,0,0,7,3,0,7,-4.0,-3,-10,0.6107341664153393,4.513949858095657
2212,2212,2019,12,NCAAF_20191114_BUFF@KENTST,Buffalo,Bulls,Kent St.,Golden Flashes,5-5,4-6,1.0,17,6,27,30,7,10,7,3,0,6,0,24,1.0,11,-3,0.8788764691854625,18.76935230090703
2213,2213,2019,12,NCAAF_20191113_BGREEN@MIAOH,Bowling Green,Falcons,Miami-OH,RedHawks,3-7,6-4,1.0,3,37,3,44,3,0,0,0,10,27,7,0,-3.0,-34,-41,0.18773304364963495,-14.225314196365275
2214,2214,2019,12,NCAAF_20191113_NILL@TOLEDO,N. Illinois,Huskies,Toledo,Rockets,4-6,6-4,1.0,14,7,31,28,7,7,14,3,7,0,0,21,-2.0,7,3,0.47224348552059703,-1.117624962040054
2215,2215,2019,12,NCAAF_20191112_EMICH@AKRON,E. Michigan,Eagles,Akron,Zips,5-5,0-10,0.0,21,0,42,14,7,14,14,7,0,0,7,7,5.0,21,28,0.7560742634034577,11.13476216901961
2216,2216,2019,13,NCAAF_20191123_BALLST@KENTST,Ball St.,Cardinals,Kent St.,Golden Flashes,4-7,5-6,1.0,24,21,38,41,7,17,0,14,7,14,10,10,-1.0,3,-3,0.5434557547753489,1.7526578054415722
2217,2217,2019,13,NCAAF_20191123_BYU@MA,BYU,Cougars,UMass,Minutemen,7-4,1-11,1.0,49,0,56,24,7,42,7,0,0,0,10,14,6.0,49,32,0.9229272704644352,22.883665118397175
2218,2218,2019,13,NCAAF_20191123_ECU@UCONN,East Carolina,Pirates,UConn,Huskies,4-7,2-9,1.0,17,7,31,24,10,7,7,7,7,0,7,10,2.0,10,7,0.6787196339841444,7.452980465362771
2219,2219,2019,13,NCAAF_20191123_ILL@IOWA,Illinois,Fighting Illini,Iowa,Hawkeyes,6-5,8-3,0.0,7,13,10,19,7,0,0,3,7,6,0,6,-2.0,-6,-9,0.05437656020082826,-25.75459463302866
2220,2220,2019,13,NCAAF_20191123_KANSAS@IOWAST,Kansas,Jayhawks,Iowa St.,Cyclones,3-8,7-4,0.0,9,14,31,41,6,3,15,7,7,7,7,20,-4.0,-5,-10,0.06975501437760567,-23.72796753624732
2221,2221,2019,13,NCAAF_20191123_LIB@UVA,Liberty,Flames,Virginia,Cavaliers,6-5,8-3,1.0,14,24,27,55,7,7,7,6,10,14,14,17,-2.0,-10,-28,0.12793535328713213,-18.245471923076366
2222,2222,2019,13,NCAAF_20191123_MICHST@RUT,Michigan St.,Spartans,Rutgers,Scarlet Knights,5-6,2-9,1.0,17,0,27,0,10,7,3,7,0,0,0,0,3.0,17,27,0.9057336692293287,21.115517394409835
2223,2223,2019,13,NCAAF_20191123_MINN@NWEST,Minnesota,Golden Gophers,Northwestern,Wildcats,10-1,2-9,0.0,21,9,38,22,14,7,7,10,0,9,7,6,8.0,12,16,0.5630761810811066,2.5496189687989954
2224,2224,2019,13,NCAAF_20191123_OKLAST@WVU,Oklahoma State,Cowboys,West Virginia,Mountaineers,8-3,4-7,0.0,7,10,20,13,7,0,3,10,0,10,3,0,4.0,-3,7,0.610750909641041,4.51681284381516
2225,2225,2019,13,NCAAF_20191123_PSU@OHIOST,Penn State,Nittany Lions,Ohio State,Buckeyes,9-2,11-0,1.0,0,14,17,28,0,0,17,0,7,7,7,7,-2.0,-14,-11,0.36917329862121984,-5.364158477126239
2226,2226,2019,13,NCAAF_20191123_SAMF@AUBURN,Samford,Bulldogs,Auburn,Tigers,5-7,8-3,1.0,0,31,0,52,0,0,0,0,7,24,7,14,-3.0,-31,-52,0.07454454446386272,-23.1681505198801
2227,2227,2019,13,NCAAF_20191123_UCF@TULANE,UCF,Knights,Tulane,Green Wave,8-3,6-5,0.0,17,7,34,31,10,7,14,3,0,7,10,14,2.0,10,3,0.8707686311872699,18.14634168204725
2228,2228,2019,13,NCAAF_20191123_WCAR@BAMA,W. Carolina,Catamounts,Alabama,Crimson Tide,3-9,10-1,0.0,0,38,3,66,0,0,0,3,17,21,21,7,-7.0,-38,-63,2.9266355912049846e-06,-72.76992854656692
2229,2229,2019,13,NCAAF_20191123_AF@NMEX,Air Force,Falcons,New Mexico,Lobos,9-2,2-9,0.0,14,10,44,22,7,7,16,14,7,3,6,6,7.0,4,22,0.8581282225793706,17.213607968259453
2230,2230,2019,13,NCAAF_20191123_SALA@GAST,South Alabama,Jaguars,Georgia St.,Panthers,1-10,7-4,0.0,3,14,15,28,3,0,0,12,0,14,7,7,-6.0,-11,-13,0.3563238847921786,-5.914293569880783
2231,2231,2019,13,NCAAF_20191123_BC@ND,Boston College,Eagles,Notre Dame,Fighting Irish,5-6,9-2,0.0,7,16,7,40,0,7,0,0,3,13,17,7,-4.0,-9,-33,0.19714402336302062,-13.679493343085596
2232,2232,2019,13,NCAAF_20191123_TXSTSM@APLST,Texas St.,Bobcats,App. St.,Mountaineers,3-8,10-1,1.0,10,14,13,35,0,10,3,0,7,7,14,7,-7.0,-4,-22,0.040678023235403704,-27.98747582858391
2233,2233,2019,13,NCAAF_20191123_GAS@ARKST,Ga. Southern,Eagles,Arkansas St.,Red Wolves,6-5,7-4,0.0,19,35,33,38,3,16,8,6,14,21,3,0,-1.0,-16,-5,0.37121120700478805,-5.277499422615847
2234,2234,2019,13,NCAAF_20191123_ETNST@VANDY,ETSU,Buccaneers,Vanderbilt,Commodores,3-9,3-8,1.0,0,14,0,38,0,0,0,0,7,7,17,7,0.0,-14,-38,0.005333023071111498,-41.00400945739011
2235,2235,2019,13,NCAAF_20191123_LATECH@UAB,Louisiana Tech,Bulldogs,UAB,Blazers,8-3,8-3,0.0,7,13,14,20,0,7,0,7,3,10,7,0,0.0,-6,-6,0.5227679875450737,0.9169568079560122
2236,2236,2019,13,NCAAF_20191123_MERCER@UNC,Mercer,Bears,North Carolina,Tar Heels,4-8,5-6,1.0,0,42,7,56,0,0,0,7,21,21,14,0,-1.0,-42,-49,0.3753467378527333,-5.102110427023376
2237,2237,2019,13,NCAAF_20191123_MICH@IND,Michigan,Wolverines,Indiana,Hoosiers,9-2,7-4,0.0,21,14,39,14,7,14,18,0,7,7,0,0,2.0,7,25,0.8657773105508035,17.770863806182433
2238,2238,2019,13,NCAAF_20191123_MRSHL@CHARLO,Marshall,Thundering Herd,Charlotte,49ers,7-4,6-5,1.0,10,7,13,24,7,3,3,0,0,7,3,14,1.0,3,-11,0.8297320853508765,15.305235831464188
2239,2239,2019,13,NCAAF_20191123_NEB@MD,Nebraska,Cornhuskers,Maryland,Terrapins,5-6,3-8,1.0,34,0,54,7,17,17,10,10,0,0,0,7,2.0,34,47,0.5422735061726456,1.7047932735589484
2240,2240,2019,13,NCAAF_20191123_NTEXAS@RICE,North Texas,Mean Green,Rice,Owls,4-7,2-9,1.0,0,20,14,20,0,0,7,7,10,10,0,0,2.0,-20,-6,0.836875269406529,15.76433002146996
2241,2241,2019,13,NCAAF_20191123_PITT@VATECH,Pittsburgh,Panthers,Virginia Tech,Hokies,7-4,8-3,0.0,0,21,0,28,0,0,0,0,14,7,0,7,-1.0,-21,-28,0.4420200733088032,-2.3420894556875282
2242,2242,2019,13,NCAAF_20191123_SMU@NAVY,SMU,Mustangs,Navy,Midshipmen,9-2,8-2,1.0,21,10,28,35,7,14,0,7,7,3,10,15,1.0,11,-7,0.509378907032743,0.3775552516862035
2243,2243,2019,13,NCAAF_20191123_TEXAS@BAYLOR,Texas,Longhorns,Baylor,Bears,6-5,10-1,0.0,3,7,10,24,0,3,0,7,0,7,14,3,-4.0,-4,-14,0.7759858579675865,12.183498482980212
2244,2244,2019,13,NCAAF_20191123_TNMART@UK,UT Martin,Skyhawks,Kentucky,Wildcats,7-5,6-5,1.0,0,29,7,50,0,0,0,7,16,13,7,14,1.0,-29,-43,0.01839277548057494,-33.53182263777967
2245,2245,2019,13,NCAAF_20191123_TXAM@UGA,Texas A&M,Aggies,Georgia,Bulldogs,7-4,10-1,0.0,3,13,13,19,0,3,3,7,3,10,3,3,-3.0,-10,-6,0.1485248712186451,-16.745242460974623
2246,2246,2019,13,NCAAF_20191123_UCLA@USC,UCLA,Bruins,USC,Trojans,4-7,8-4,1.0,14,24,35,52,7,7,14,7,10,14,14,14,-4.0,-10,-17,0.2833630618546671,-9.199448707435295
2247,2247,2019,13,NCAAF_20191123_WKY@USM,W. Kentucky,Hilltoppers,So. Miss,Golden Eagles,7-4,7-4,1.0,21,7,28,10,7,14,0,7,7,0,0,3,0.0,14,18,0.35741772992560517,-5.8671995822768395
2248,2248,2019,13,NCAAF_20191123_CAL@STNFRD,California,Golden Bears,Stanford,Cardinal,6-5,4-7,0.0,10,10,24,20,7,3,0,14,7,3,7,3,2.0,0,4,0.33462181780578804,-6.859866442429734
2249,2249,2019,13,NCAAF_20191123_CUSE@LVILLE,Syracuse,Orange,Louisville,Cardinals,4-7,7-4,0.0,10,28,34,56,3,7,17,7,21,7,21,7,-3.0,-18,-22,0.6136243449949905,4.637269778244558
2250,2250,2019,13,NCAAF_20191123_MEMP@SFLA,Memphis,Tigers,South Florida,Bulls,10-1,4-7,1.0,28,10,49,10,7,21,14,7,10,0,0,0,6.0,18,39,0.7475599340303978,10.70814089041869
2251,2251,2019,13,NCAAF_20191123_PURDUE@WISC,Purdue,Boilermakers,Wisconsin,Badgers,4-7,9-2,0.0,17,24,24,45,3,14,7,0,14,10,14,7,-5.0,-7,-21,0.22687955266644777,-12.03024650334578
2252,2252,2019,13,NCAAF_20191123_SJST@UNLV,San Jose St.,Spartans,UNLV,Rebels,4-7,3-8,1.0,6,21,35,38,6,0,22,7,7,14,3,14,1.0,-15,-3,0.3604099086440278,-5.738631505001649
2253,2253,2019,13,NCAAF_20191123_UTEP@NMEXST,UTEP,Miners,New Mexico St.,Aggies,1-10,2-9,0.0,13,14,35,44,0,13,3,19,7,7,7,23,-1.0,-1,-9,0.3307745656780149,-7.029908252831774
2254,2254,2019,13,NCAAF_20191123_ODU@MTSU,Old Dominion,Monarchs,Middle Tenn.,Blue Raiders,1-10,4-7,0.0,10,28,17,38,7,3,7,0,14,14,7,3,-3.0,-18,-21,0.19344358543897067,-13.894826677583296
2255,2255,2019,13,NCAAF_20191123_CSTCAR@LAMON,C. Carolina,Chanticleers,UL-Monroe,Warhawks,4-7,5-6,1.0,14,21,42,45,14,0,14,14,14,7,10,14,-1.0,-7,-3,0.44300166827726417,-2.3021629342736105
2256,2256,2019,13,NCAAF_20191123_TROY@LALAF,Troy,Trojans,Louisiana,Ragin' Cajuns,5-6,9-2,0.0,3,31,3,53,3,0,0,0,14,17,19,3,-4.0,-28,-50,0.6235588895798612,5.055800303646151
2257,2257,2019,13,NCAAF_20191123_FAU@TXSA,FAU,Owls,UTSA,Roadrunners,8-3,4-7,0.0,17,3,40,26,7,10,16,7,3,0,8,15,4.0,14,14,0.9056638022770032,21.108843195107738
2258,2258,2019,13,NCAAF_20191123_ARK@LSU,Arkansas,Razorbacks,LSU,Tigers,2-9,11-0,0.0,6,28,20,56,3,3,0,14,7,21,21,7,-9.0,-22,-36,0.03830097922219211,-28.435185737918232
2259,2259,2019,13,NCAAF_20191123_KSTATE@TXTECH,Kansas State,Wildcats,Texas Tech,Red Raiders,7-4,4-7,0.0,6,3,30,27,3,3,17,7,0,3,14,10,3.0,3,3,0.4944764783988179,-0.22234030969502783
2260,2260,2019,13,NCAAF_20191123_MIAMI@FIU,Miami (Fla.),Hurricanes,FIU,Panthers,6-5,6-5,0.0,0,13,24,30,0,0,3,21,10,3,3,14,0.0,-13,-6,0.9192284586105998,22.479960437812792
2261,2261,2019,13,NCAAF_20191123_TEMPLE@CINCY,Temple,Owls,Cincinnati,Bearcats,7-4,10-1,1.0,0,6,13,15,0,0,0,13,0,6,7,2,-3.0,-6,-2,0.4415718541126342,-2.36032563953097
2262,2262,2019,13,NCAAF_20191123_ABIL@MISSST,Abil Christian,Wildcats,Miss. State,Bulldogs,5-7,5-6,0.0,7,21,7,45,0,7,0,0,7,14,7,17,0.0,-14,-38,0.0010354012945359425,-49.4575838582773
2263,2263,2019,13,NCAAF_20191123_DUKE@WAKE,Duke,Blue Devils,Wake Forest,Demon Deacons,4-7,8-3,1.0,10,13,27,39,7,3,3,14,3,10,10,16,-4.0,-3,-12,0.41613079242470197,-3.401168861500537
2264,2264,2019,13,NCAAF_20191123_HOU@TULSA,Houston,Cougars,Tulsa,Golden Hurricane,4-7,3-8,1.0,14,7,24,14,0,14,3,7,7,0,0,7,1.0,7,10,0.7304134651287193,9.860795236300419
2265,2265,2019,13,NCAAF_20191123_OREG@ARIZST,Oregon,Ducks,Arizona St.,Sun Devils,9-2,6-5,1.0,7,10,28,31,7,0,0,21,7,3,3,18,3.0,-3,-3,0.7288229369592599,9.783603488358267
2266,2266,2019,13,NCAAF_20191123_TENN@MIZZOU,Tennessee,Volunteers,Missouri,Tigers,6-5,5-6,1.0,17,10,24,20,0,17,7,0,3,7,7,3,1.0,7,4,0.23279726103420673,-11.717158368261721
2267,2267,2019,13,NCAAF_20191123_TCU@OKLA,TCU,Horned Frogs,Oklahoma,Sooners,5-6,10-1,1.0,10,21,24,28,0,10,7,7,14,7,7,0,-5.0,-11,-4,0.21933894508147256,-12.435957664106127
2268,2268,2019,13,NCAAF_20191123_OREGST@WASHST,Oregon State,Beavers,Washington St.,Cougars,5-6,6-5,0.0,24,21,53,54,7,17,0,29,7,14,14,19,-1.0,3,-1,0.06712477963128571,-24.048079099456913
2269,2269,2019,13,NCAAF_20191123_UTAH@ARIZ,Utah,Utes,Arizona,Wildcats,10-1,4-7,0.0,14,0,35,7,14,0,14,7,0,0,0,7,6.0,14,28,0.8203363346672421,14.719760598652783
2270,2270,2019,13,NCAAF_20191123_WASH@COLO,Washington,Huskies,Colorado,Buffaloes,6-5,5-6,0.0,0,13,14,20,0,0,7,7,3,10,7,0,1.0,-13,-6,0.8804226046875443,18.90220385713451
2271,2271,2019,13,NCAAF_20191123_BOISE@UTAHST,Boise St.,Broncos,Utah St.,Aggies,10-1,6-5,1.0,42,7,56,21,21,21,14,0,7,0,7,7,4.0,35,35,0.6037587543725572,4.2247395359586335
2272,2272,2019,13,NCAAF_20191123_NEVADA@FRESNO,Nevada,Wolf Pack,Fresno St.,Bulldogs,7-4,4-7,1.0,14,21,35,28,14,0,14,7,7,14,7,0,3.0,-7,7,0.15786818303840822,-16.11057335479211
2273,2273,2019,13,NCAAF_20191123_SDGST@HAWAII,San Diego St.,Aztecs,Hawaii,Rainbow Warriors,8-3,8-4,1.0,3,7,11,14,0,3,0,8,7,0,7,0,0.0,-4,-3,0.8218381801164112,14.812021015350524
2274,2274,2019,13,NCAAF_20191122_COLOST@WYO,Colorado St.,Rams,Wyoming,Cowboys,4-7,7-4,1.0,7,7,7,17,0,7,0,0,0,7,7,3,-3.0,0,-10,0.37889207633017363,-4.952235477797217
2275,2275,2019,13,NCAAF_20191121_NCST@GATECH,NC State,Wolfpack,Georgia Tech,Yellow Jackets,4-7,3-8,0.0,3,21,26,28,0,3,10,13,7,14,7,0,1.0,-18,-2,0.5993720182368086,4.042215701507757
2276,2276,2019,13,NCAAF_20191120_AKRON@MIAOH,Akron,Zips,Miami-OH,RedHawks,0-11,7-4,1.0,3,17,17,20,0,3,7,7,3,14,3,0,-7.0,-14,-3,0.21278754981063652,-12.79499874109274
2277,2277,2019,13,NCAAF_20191120_TOLEDO@BUFF,Toledo,Rockets,Buffalo,Bulls,6-5,6-5,0.0,20,28,30,49,7,13,3,7,14,14,7,14,0.0,-8,-19,0.5031226924788852,0.125696135462249
2278,2278,2019,13,NCAAF_20191119_EMICH@NILL,E. Michigan,Eagles,N. Illinois,Huskies,6-5,4-7,0.0,14,7,45,17,7,7,24,7,0,7,3,7,2.0,7,28,0.41414037629074196,-3.483149265743805
2279,2279,2019,13,NCAAF_20191119_OHIO@BGREEN,Ohio,Bobcats,Bowling Green,Falcons,5-6,3-8,0.0,38,24,66,24,24,14,28,0,14,10,0,0,2.0,14,42,0.91098315940803,21.627804298732485
2280,2280,2019,14,NCAAF_20191201_ARMY@HAWAII,Army,,Hawaii,,5-7,9-4,,17,24,31,52,10,7,14,0,10,14,14,14,-4.0,-7,-21,0.7836759864455285,12.634516014459791
2281,2281,2019,14,NCAAF_20191130_CLEM@SC,Clemson,Tigers,South Carolina,Gamecocks,12-0,4-8,1.0,24,3,38,3,14,10,7,7,0,3,0,0,8.0,21,35,0.9402507013726248,25.068482576245515
2282,2282,2019,14,NCAAF_20191130_LVILLE@UK,Louisville,Cardinals,Kentucky,Wildcats,7-5,7-5,1.0,13,17,13,45,6,7,0,0,7,10,14,14,0.0,-4,-32,0.35068532480727477,-6.174543588443726
2283,2283,2019,14,NCAAF_20191130_NWEST@ILL,Northwestern,Wildcats,Illinois,Fighting Illini,3-9,6-6,1.0,10,7,29,10,3,7,7,12,0,7,3,0,-3.0,3,19,0.7494018676665969,10.830161674097667
2284,2284,2019,14,NCAAF_20191130_OHIOST@MICH,Ohio State,Buckeyes,Michigan,Wolverines,12-0,9-3,0.0,28,16,56,27,14,14,14,14,13,3,3,8,3.0,12,29,0.6997581555291885,8.432556053790222
2285,2285,2019,14,NCAAF_20191130_TULSA@ECU,Tulsa,Golden Hurricane,East Carolina,Pirates,4-8,4-8,0.0,21,3,49,24,7,14,14,14,3,0,7,14,0.0,18,25,0.702876042409286,8.577235329955215
2286,2286,2019,14,NCAAF_20191130_TXSTSM@CSTCAR,Texas St.,Bobcats,C. Carolina,Chanticleers,3-9,5-7,0.0,7,7,21,24,0,7,0,14,0,7,7,10,-2.0,0,-3,0.3429112672133594,-6.513642291198494
2287,2287,2019,14,NCAAF_20191130_UGA@GATECH,Georgia,Bulldogs,Georgia Tech,Yellow Jackets,11-1,3-9,0.0,17,7,52,7,17,0,21,14,0,7,0,0,8.0,10,45,0.9355373993820711,24.448120307165482
2288,2288,2019,14,NCAAF_20191130_CHARLO@ODU,Charlotte,49ers,Old Dominion,Monarchs,7-5,1-11,0.0,24,7,38,22,14,10,14,0,7,0,7,8,6.0,17,16,0.5294061825221595,1.1879410279411786
2289,2289,2019,14,NCAAF_20191130_MTSU@WKY,Middle Tenn.,Blue Raiders,W. Kentucky,Hilltoppers,4-8,8-4,1.0,13,10,26,31,3,10,0,13,3,7,7,14,-4.0,3,-5,0.6292208055343457,5.310193975750053
2290,2290,2019,14,NCAAF_20191130_NMEXST@LIB,New Mexico St.,Aggies,Liberty,Flames,2-10,7-5,1.0,14,20,28,49,7,7,7,7,10,10,15,14,-5.0,-6,-21,0.318229261826915,-7.610580106959901
2291,2291,2019,14,NCAAF_20191130_WYO@AF,Wyoming,Cowboys,Air Force,Falcons,7-5,10-2,0.0,0,7,6,20,0,0,0,6,0,7,3,10,-3.0,-7,-14,0.4586829109918483,-1.6705932213551478
2292,2292,2019,14,NCAAF_20191130_RICE@UTEP,Rice,Owls,UTEP,Miners,3-9,1-11,0.0,14,16,30,16,14,0,10,6,6,10,0,0,2.0,-2,14,0.6434462422354188,5.920376679286051
2293,2293,2019,14,NCAAF_20191130_BAMA@AUBURN,Alabama,Crimson Tide,Auburn,Tigers,10-2,9-3,0.0,31,27,45,48,3,28,7,7,7,20,13,8,1.0,4,-3,0.7831920254636996,12.607958318126975
2294,2294,2019,14,NCAAF_20191130_BAYLOR@KANSAS,Baylor,Bears,Kansas,Jayhawks,11-1,3-9,0.0,34,0,61,6,21,13,14,13,0,0,6,0,8.0,34,55,0.7370939953497471,10.21512810365357
2295,2295,2019,14,NCAAF_20191130_BC@PITT,Boston College,Eagles,Pittsburgh,Panthers,6-6,7-5,1.0,13,9,26,19,6,7,10,3,0,9,7,3,-1.0,4,7,0.5449079344518828,1.816376091683992
2296,2296,2019,14,NCAAF_20191130_MD@MICHST,Maryland,Terrapins,Michigan St.,Spartans,3-9,6-6,0.0,7,13,16,19,7,0,9,0,3,10,0,6,-3.0,-6,-3,0.2515006000887431,-10.78453501389697
2297,2297,2019,14,NCAAF_20191130_MIAMI@DUKE,Miami (Fla.),Hurricanes,Duke,Blue Devils,6-6,5-7,0.0,14,13,17,27,0,14,3,0,3,10,0,14,1.0,1,-10,0.7179192555170362,9.285404661145776
2298,2298,2019,14,NCAAF_20191130_RUT@PSU,Rutgers,Scarlet Knights,Penn State,Nittany Lions,2-10,10-2,0.0,3,7,6,27,3,0,0,3,7,0,6,14,-8.0,-4,-21,0.007734551748017848,-38.98559982591837
2299,2299,2019,14,NCAAF_20191130_TXSA@LATECH,UTSA,Roadrunners,Louisiana Tech,Bulldogs,4-8,9-3,1.0,17,24,27,41,10,7,3,7,14,10,10,7,-5.0,-7,-14,0.22894731841950655,-11.952603145913258
2300,2300,2019,14,NCAAF_20191130_UCONN@TEMPLE,UConn,Huskies,Temple,Owls,2-10,8-4,1.0,17,14,17,49,14,3,0,0,7,7,28,7,-6.0,3,-32,0.06511944237762468,-24.36449790469078
2301,2301,2019,14,NCAAF_20191130_USM@FAU,So. Miss,Golden Eagles,FAU,Owls,7-5,9-3,1.0,10,17,17,34,0,10,7,0,10,7,7,10,-2.0,-7,-17,0.2999007591706281,-8.448350097334469
2302,2302,2019,14,NCAAF_20191130_WISC@MINN,Wisconsin,Badgers,Minnesota,Golden Gophers,10-2,10-2,1.0,10,7,38,17,0,10,14,14,7,0,3,7,0.0,3,21,0.7802831587978923,12.449048332599318
2303,2303,2019,14,NCAAF_20191130_ND@STNFRD,Notre Dame,Fighting Irish,Stanford,Cardinal,10-2,4-8,0.0,21,17,45,24,7,14,7,17,10,7,0,7,6.0,4,21,0.7772222802089804,12.283132742001726
2304,2304,2019,14,NCAAF_20191130_OREGST@OREG,Oregon State,Beavers,Oregon,Ducks,5-7,10-2,0.0,3,17,10,24,3,0,0,7,10,7,0,7,-5.0,-14,-14,0.05602430267410363,-25.586484891929217
2305,2305,2019,14,NCAAF_20191130_TULANE@SMU,Tulane,Green Wave,SMU,Mustangs,6-6,10-2,0.0,10,21,20,37,7,3,7,3,14,7,0,16,-4.0,-11,-17,0.45020134197734263,-2.0151741739629188
2306,2306,2019,14,NCAAF_20191130_UAB@NTEXAS,UAB,,North Texas,,9-3,4-8,,17,14,26,21,3,14,9,0,7,7,7,0,5.0,3,5,0.5233598701946837,0.9433681679989832
2307,2307,2019,14,NCAAF_20191130_UTAHST@NMEX,Utah St.,Aggies,New Mexico,Lobos,7-5,2-10,1.0,31,6,38,25,7,24,7,0,0,6,12,7,5.0,25,13,0.9057840701818842,21.177510613333766
2308,2308,2019,14,NCAAF_20191130_VANDY@TENN,Vanderbilt,Commodores,Tennessee,Volunteers,3-9,7-5,0.0,3,21,10,28,3,0,0,7,7,14,0,7,-4.0,-18,-18,0.40471251213975123,-3.883218946480497
2309,2309,2019,14,NCAAF_20191130_GAST@GAS,Georgia St.,Panthers,Ga. Southern,Eagles,7-5,7-5,1.0,7,17,10,38,7,0,3,0,7,10,14,7,0.0,-10,-28,0.3745177998787079,-5.151123812709102
2310,2310,2019,14,NCAAF_20191130_IOWAST@KSTATE,Iowa St.,Cyclones,Kansas State,Wildcats,7-5,8-4,0.0,14,14,17,27,0,14,3,0,7,7,3,10,-1.0,0,-10,0.6603813832119976,6.658132006909568
2311,2311,2019,14,NCAAF_20191130_NAVY@HOU,Navy,Midshipmen,Houston,Cougars,9-2,4-8,0.0,28,27,56,41,21,7,14,14,14,13,7,7,5.0,1,15,0.5052157518404848,0.21051918769171607
2312,2312,2019,14,NCAAF_20191130_TXAM@LSU,Texas A&M,Aggies,LSU,Tigers,7-5,12-0,0.0,0,31,7,50,0,0,7,0,21,10,10,9,-5.0,-31,-43,0.2980209692089896,-8.53554081922266
2313,2313,2019,14,NCAAF_20191130_UNC@NCST,North Carolina,Tar Heels,NC State,Wolfpack,6-6,4-8,1.0,6,10,41,10,0,6,28,7,3,7,0,0,2.0,-4,31,0.31362940702108744,-7.818816578997598
2314,2314,2019,14,NCAAF_20191130_COLO@UTAH,Colorado,Buffaloes,Utah,Utes,5-7,11-1,1.0,7,17,15,45,7,0,0,8,0,17,14,14,-6.0,-10,-30,0.16105383873788437,-15.94289862363678
2315,2315,2019,14,NCAAF_20191130_FSU@FLA,Florida State,Seminoles,Florida,Gators,6-6,10-2,0.0,7,30,17,40,7,0,10,0,7,23,7,3,-4.0,-23,-23,0.2807925052533945,-9.346872818912857
2316,2316,2019,14,NCAAF_20191130_LAMON@LALAF,UL-Monroe,,Louisiana,,5-7,10-2,,14,21,30,31,7,7,10,6,7,14,7,3,-5.0,-7,-1,0.29960906290780953,-8.461863619332462
2317,2317,2019,14,NCAAF_20191130_OKLA@OKLAST,Oklahoma,Sooners,Oklahoma State,Cowboys,11-1,8-4,1.0,20,13,34,16,10,10,7,7,7,6,3,0,3.0,7,18,0.756276912958906,11.1806596245616
2318,2318,2019,14,NCAAF_20191130_BYU@SDGST,BYU,Cougars,San Diego St.,Aztecs,7-5,9-3,0.0,3,7,3,13,3,0,0,0,0,7,3,3,-2.0,-4,-10,0.43538392278376103,-2.61948107803903
2319,2319,2019,14,NCAAF_20191130_ARIZ@ARIZST,Arizona,Wildcats,Arizona St.,Sun Devils,4-8,7-5,1.0,7,6,14,24,0,7,0,7,0,6,15,3,-3.0,1,-10,0.3798249244172238,-4.926172521258309
2320,2320,2019,14,NCAAF_20191130_CAL@UCLA,California,Golden Bears,UCLA,Bruins,7-5,4-8,0.0,14,10,28,18,7,7,7,7,7,3,8,0,3.0,4,10,0.5478666949830414,1.9366087354121646
2321,2321,2019,14,NCAAF_20191130_FRESNO@SJST,Fresno St.,Bulldogs,San Jose St.,Spartans,4-8,5-7,0.0,16,3,16,17,14,2,0,0,3,0,7,7,-1.0,13,-1,0.9349918341002997,24.37861827742813
2322,2322,2019,14,NCAAF_20191129_BGREEN@BUFF,Bowling Green,Falcons,Buffalo,Bulls,3-9,7-5,0.0,7,35,7,49,0,7,0,0,21,14,0,14,-4.0,-28,-42,0.0987686566078525,-20.748679386577123
2323,2323,2019,14,NCAAF_20191129_KENTST@EMICH,Kent St.,Golden Flashes,E. Michigan,Eagles,6-6,6-6,0.0,24,14,34,26,14,10,7,3,7,7,6,6,0.0,10,8,0.18755027782080702,-14.28158420116415
2324,2324,2019,14,NCAAF_20191129_MIAOH@BALLST,Miami-OH,RedHawks,Ball St.,Cardinals,7-5,5-7,0.0,27,14,27,41,7,20,0,0,7,7,6,21,2.0,13,-14,0.7686595901252545,11.825746972804723
2325,2325,2019,14,NCAAF_20191129_TOLEDO@CMICH,Toledo,Rockets,C. Michigan,Chippewas,6-6,8-4,1.0,7,35,7,49,0,7,0,0,14,21,7,7,-2.0,-28,-42,0.6535072108463748,6.357069076051403
2326,2326,2019,14,NCAAF_20191129_TXTECH@TEXAS,Texas Tech,Red Raiders,Texas,Longhorns,4-8,7-5,0.0,21,28,24,49,14,7,3,0,6,22,14,7,-3.0,-7,-25,0.3874436115572245,-4.604902576516906
2327,2327,2019,14,NCAAF_20191129_VATECH@UVA,Virginia Tech,Hokies,Virginia,Cavaliers,8-4,9-3,0.0,6,13,30,39,3,3,21,3,13,0,7,19,-1.0,-7,-9,0.5946151497389077,3.8552877715682143
2328,2328,2019,14,NCAAF_20191129_IOWA@NEB,Iowa,Hawkeyes,Nebraska,Cornhuskers,9-3,5-7,1.0,24,10,27,24,14,10,0,3,3,7,14,0,4.0,14,3,0.8487224899773884,16.600392948817444
2329,2329,2019,14,NCAAF_20191129_MIZZOU@ARK,Missouri,Tigers,Arkansas,Razorbacks,6-6,2-10,0.0,10,7,24,14,0,10,7,7,7,0,7,0,4.0,3,10,0.8907162001479096,19.81069391973415
2330,2330,2019,14,NCAAF_20191129_BOISE@COLOST,Boise St.,Broncos,Colorado St.,Rams,11-1,4-8,0.0,24,14,31,24,7,17,0,7,7,7,7,3,7.0,10,7,0.8450918760809458,16.353037532843246
2331,2331,2019,14,NCAAF_20191129_CINCY@MEMP,Cincinnati,Bearcats,Memphis,Tigers,10-2,11-1,0.0,17,20,24,34,3,14,0,7,17,3,0,14,-1.0,-3,-10,0.3527866731185201,-6.083358756762323
2332,2332,2019,14,NCAAF_20191129_WASHST@WASH,Washington St.,Cougars,Washington,Huskies,6-6,7-5,1.0,10,21,13,31,7,3,3,0,7,14,7,3,-1.0,-11,-18,0.3628604553042407,-5.648861112206305
2333,2333,2019,14,NCAAF_20191129_WVU@TCU,West Virginia,Mountaineers,TCU,Horned Frogs,5-7,5-7,0.0,10,10,20,17,7,3,3,7,7,3,7,0,0.0,0,3,0.40417111728392785,-3.9057187921152945
2334,2334,2019,14,NCAAF_20191129_ARKST@SALA,Arkansas St.,Red Wolves,South Alabama,Jaguars,7-5,2-10,1.0,7,14,30,34,7,0,10,13,14,0,6,14,5.0,-7,-4,0.8504655239736126,16.720549457972197
2335,2335,2019,14,NCAAF_20191129_APLST@TROY,App. St.,Mountaineers,Troy,Trojans,11-1,5-7,0.0,34,13,48,13,20,14,7,7,10,3,0,0,6.0,21,35,0.7015896312308705,8.517458731739225
2336,2336,2019,14,NCAAF_20191129_SFLA@UCF,South Florida,Bulls,UCF,Knights,4-8,9-3,0.0,0,24,7,34,0,0,7,0,7,17,7,3,-5.0,-24,-27,0.10074282797780698,-20.567223975345996
2337,2337,2019,14,NCAAF_20191128_MISS@MISSST,Ole Miss,Rebels,Miss. State,Bulldogs,4-8,6-6,0.0,14,14,20,21,0,14,0,6,7,7,7,0,-2.0,0,-1,0.24701976985198704,-11.01193983460621
2338,2338,2019,14,NCAAF_20191126_OHIO@AKRON,Ohio,Bobcats,Akron,Zips,6-6,0-12,0.0,31,3,52,3,14,17,7,14,3,0,0,0,6.0,28,49,0.8798131354926488,18.904283622825233
2339,2339,2019,14,NCAAF_20191126_WMICH@NILL,W. Michigan,Broncos,N. Illinois,Huskies,7-5,5-7,0.0,0,10,14,17,0,0,7,7,3,7,0,7,2.0,-10,-3,0.48478512407145236,-0.614237220931841
2340,2340,2019,15,NCAAF_20191207_LALAF@APLST,Louisiana,Ragin' Cajuns,App. St.,Mountaineers,10-3,12-1,0.0,17,35,38,45,7,10,7,14,21,14,7,3,-2.0,-18,-7,0.2403753767141419,-11.387928534271396
2341,2341,2019,15,NCAAF_20191207_MIAOH@CMICH,Miami-OH,RedHawks,C. Michigan,Chippewas,8-5,8-5,1.0,10,14,26,21,7,3,7,9,0,14,0,7,0.0,-4,5,0.5255546624993601,1.0352712278562421
2342,2342,2019,15,NCAAF_20191207_UAB@FAU,UAB,Blazers,FAU,Owls,9-4,10-3,1.0,6,35,6,49,3,3,0,0,14,21,7,7,-1.0,-29,-43,0.2798260483069426,-9.421762407984716
2343,2343,2019,15,NCAAF_20191207_CINCY@MEMP,Cincinnati,Bearcats,Memphis,Tigers,10-3,12-1,1.0,14,10,24,29,7,7,7,3,10,0,10,9,-2.0,4,-5,0.3437993002907884,-6.494536702496362
2344,2344,2019,15,NCAAF_20191207_HAWAII@BOISE,Hawaii,Rainbow Warriors,Boise St.,Broncos,9-5,12-1,0.0,3,17,10,31,3,0,0,7,3,14,14,0,-3.0,-14,-21,0.09516024593567307,-21.15172950529916
2345,2345,2019,15,NCAAF_20191207_UGA@LSU,Georgia,Bulldogs,LSU,Tigers,11-2,13-0,1.0,3,17,10,37,0,3,0,7,14,3,17,3,-2.0,-14,-27,0.6637806669121078,6.828656475533876
2346,2346,2019,15,NCAAF_20191207_UVA@CLEM,Virginia,Cavaliers,Clemson,Tigers,9-4,13-0,1.0,7,31,17,62,7,0,7,3,14,17,14,17,-4.0,-24,-45,0.04484027578143457,-27.409454127499657
2347,2347,2019,15,NCAAF_20191207_OHIOST@WISC,Ohio State,Buckeyes,Wisconsin,Badgers,13-0,10-3,0.0,7,21,34,21,0,7,17,10,7,14,0,0,3.0,-14,13,0.7601007079656772,11.412655014941038
2348,2348,2019,15,NCAAF_20191206_UTAH@OREG,Utah,Utes,Oregon,Ducks,11-2,11-2,1.0,0,20,15,37,0,0,15,0,10,10,3,14,0.0,-20,-22,0.5481604830753435,1.954503659136435
2349,2349,2020,1,NCAAF_20200907_BYU@NAVY,BYU,Cougars,Navy,Midshipmen,1-0,0-1,0.0,31,0,55,3,14,17,17,7,0,0,3,0,1.0,31,52,0.36315935217454687,-5.656657628382277
2350,2350,2020,1,NCAAF_20200905_EKY@MRSHL,E. Kentucky,Colonels,Marshall,Thundering Herd,0-1,1-0,0.0,0,38,0,59,0,0,0,0,21,17,14,7,-1.0,-38,-59,0.11227365039118509,-19.627512394201972
2351,2351,2020,1,NCAAF_20200905_MTSU@ARMY,Middle Tenn.,Blue Raiders,Army,Black Knights,0-1,1-0,1.0,0,21,0,42,0,0,0,0,7,14,14,7,-1.0,-21,-42,0.4013703565459016,-4.036957385911137
2352,2352,2020,1,NCAAF_20200905_SMU@TXSTSM,SMU,Mustangs,Texas St.,Bobcats,1-0,0-1,0.0,14,14,31,24,0,14,14,3,0,14,7,3,1.0,0,7,0.9578609210312222,27.899503069737648
2353,2353,2020,1,NCAAF_20200905_HOUBP@NTEXAS,Houston Christian,Huskies,North Texas,Mean Green,0-1,1-0,0.0,10,23,31,57,0,10,7,14,14,9,20,14,-1.0,-13,-26,0.06695698375280801,-24.22230024148314
2354,2354,2020,1,NCAAF_20200905_ARKST@MEMP,Arkansas St.,Red Wolves,Memphis,Tigers,0-1,1-0,1.0,14,21,24,37,14,0,3,7,7,14,13,3,-1.0,-7,-13,0.16390135628552382,-15.813991882434038
2355,2355,2020,1,NCAAF_20200905_SFA@UTEP,S.F. Austin,Lumberjacks,UTEP,Miners,0-1,1-0,1.0,14,17,14,24,7,7,0,0,3,14,0,7,-1.0,-3,-10,0.3115700384318988,-7.941422542069972
2356,2356,2020,1,NCAAF_20200903_CAR@UAB,Cent. Ark.,Bears,UAB,Blazers,1-1,1-0,1.0,21,28,35,45,7,14,0,14,14,14,3,14,0.0,-7,-10,0.2351635706938615,-11.667129901367844
2357,2357,2020,1,NCAAF_20200903_SALA@USM,South Alabama,Jaguars,So. Miss,Golden Eagles,1-0,0-1,1.0,13,10,32,21,13,0,10,9,0,10,3,8,1.0,3,11,0.17485454128723954,-15.112690965344427
2358,2358,2020,2,NCAAF_20200912_ARKST@KSTATE,Arkansas St.,Red Wolves,Kansas State,Wildcats,1-1,0-1,1.0,14,21,35,31,7,7,7,14,7,14,0,10,1.0,-7,4,0.1475661675292319,-16.986376291588385
2359,2359,2020,2,NCAAF_20200912_CHARLO@APLST,Charlotte,49ers,App. St.,Mountaineers,0-1,1-0,1.0,10,14,20,35,7,3,10,0,0,14,7,14,-1.0,-4,-15,0.08882152133866039,-21.87201411502201
2360,2360,2020,2,NCAAF_20200912_CUSE@UNC,Syracuse,Orange,North Carolina,Tar Heels,0-1,1-0,0.0,3,7,6,31,0,3,3,0,7,0,3,21,-1.0,-4,-25,0.5865131208211869,3.546523193972689
2361,2361,2020,2,NCAAF_20200912_EKY@WVU,E. Kentucky,Colonels,West Virginia,Mountaineers,0-2,1-0,0.0,7,42,10,56,0,7,3,0,14,28,7,7,-1.0,-35,-46,0.005564035801525313,-41.18950270913592
2362,2362,2020,2,NCAAF_20200912_LALAF@IOWAST,Louisiana,Ragin' Cajuns,Iowa St.,Cyclones,1-0,0-1,1.0,10,14,31,14,0,10,7,14,0,14,0,0,1.0,-4,17,0.07093536140097279,-23.83219098355835
2363,2363,2020,2,NCAAF_20200912_LAMON@ARMY,UL-Monroe,Warhawks,Army,Black Knights,0-1,2-0,1.0,7,17,7,37,0,7,0,0,14,3,13,7,-2.0,-10,-30,0.17733497882397986,-15.01731763545422
2364,2364,2020,2,NCAAF_20200912_DUKE@ND,Duke,Blue Devils,Notre Dame,Fighting Irish,0-1,1-0,1.0,6,10,13,27,3,3,7,0,0,10,7,10,-1.0,-4,-14,0.1302652734143137,-18.25531472357443
2365,2365,2020,2,NCAAF_20200912_AP@PITT,Austin Peay,Governors,Pittsburgh,Panthers,0-2,1-0,1.0,0,42,0,55,0,0,0,0,21,21,0,13,-1.0,-42,-55,0.06516376752645547,-24.545300296031428
2366,2366,2020,2,NCAAF_20200912_GATECH@FSU,Georgia Tech,Yellow Jackets,Florida State,Seminoles,1-0,0-1,1.0,0,10,16,13,0,0,7,9,10,0,3,0,1.0,-10,3,0.4470999726328668,-2.157784425579621
2367,2367,2020,2,NCAAF_20200912_CAMP@GAS,Campbell,Fighting Camels,Ga. Southern,Eagles,0-1,1-0,1.0,13,6,26,27,13,0,7,6,3,3,7,14,-1.0,7,-1,0.015400725385098735,-35.03987451039757
2368,2368,2020,2,NCAAF_20200912_CIT@SFLA,The Citadel,Bulldogs,South Florida,Bulls,0-1,1-0,1.0,6,20,6,27,3,3,0,0,7,13,0,7,-1.0,-14,-21,0.2969850095205899,-8.649391205327447
2369,2369,2020,2,NCAAF_20200912_MOST@OKLA,Missouri St.,Bears,Oklahoma,Sooners,0-1,1-0,1.0,0,41,0,48,0,0,0,0,31,10,0,7,-1.0,-41,-48,7.870319047542651e-05,-61.31546893009158
2370,2370,2020,2,NCAAF_20200912_CLEM@WAKE,Clemson,Tigers,Wake Forest,Demon Deacons,1-0,0-1,1.0,27,0,37,13,14,13,10,0,0,0,3,10,1.0,27,24,0.9503571751171815,26.74402756431573
2371,2371,2020,2,NCAAF_20200912_TULANE@SALA,Tulane,Green Wave,South Alabama,Jaguars,1-0,1-1,1.0,6,14,27,24,0,6,7,14,0,14,10,0,0.0,-8,3,0.8996965496673857,20.765094161794423
2372,2372,2020,2,NCAAF_20200912_HOUBP@TXTECH,Houston Christian,Huskies,Texas Tech,Red Raiders,0-2,1-0,0.0,10,21,33,35,3,7,10,13,14,7,7,7,-1.0,-11,-2,0.004014927033884064,-43.00930608545332
2373,2373,2020,2,NCAAF_20200912_UTEP@TEXAS,UTEP,Miners,Texas,Longhorns,1-1,1-0,0.0,3,45,3,59,0,3,0,0,21,24,7,7,0.0,-42,-56,0.0027664483751137503,-45.01209988849428
2374,2374,2020,2,NCAAF_20200912_WKY@LVILLE,W. Kentucky,Hilltoppers,Louisville,Cardinals,0-1,1-0,0.0,7,28,21,35,7,0,7,7,7,21,7,0,-1.0,-21,-14,0.25162589073110775,-10.860694540699797
2375,2375,2020,2,NCAAF_20200912_CSTCAR@KANSAS,C. Carolina,Chanticleers,Kansas,Jayhawks,1-0,0-1,0.0,28,3,38,23,14,14,0,10,0,3,14,6,1.0,25,15,0.2404823816232564,-11.434565308797573
2376,2376,2020,2,NCAAF_20200910_UAB@MIAMI,UAB,Blazers,Miami (Fla.),Hurricanes,1-1,1-0,1.0,7,14,14,31,7,0,7,0,7,7,17,0,0.0,-7,-17,0.11315823623302745,-19.630607481477455
2377,2377,2020,3,NCAAF_20200919_AP@CINCY,Austin Peay,Governors,Cincinnati,Bearcats,0-3,1-0,0.0,3,28,20,55,3,0,3,14,14,14,14,13,-1.0,-25,-35,0.03082884839381217,-30.37206684975922
2378,2378,2020,3,NCAAF_20200919_BC@DUKE,Boston College,Eagles,Duke,Blue Devils,1-0,0-2,0.0,7,6,26,6,7,0,16,3,6,0,0,0,1.0,1,20,0.5678243655594899,2.776562064992504
2379,2379,2020,3,NCAAF_20200919_CUSE@PITT,Syracuse,Orange,Pittsburgh,Panthers,0-2,2-0,1.0,10,14,10,21,3,7,0,0,7,7,7,0,-2.0,-4,-11,0.44931827204151387,-2.070322008184121
2380,2380,2020,3,NCAAF_20200919_LIB@WKY,Liberty,Flames,W. Kentucky,Hilltoppers,1-0,0-2,0.0,17,10,30,24,10,7,7,6,0,10,7,7,1.0,7,6,0.4427971573360172,-2.3384453260748614
2381,2381,2020,3,NCAAF_20200919_NAVY@TULANE,Navy,Midshipmen,Tulane,Green Wave,1-1,1-1,1.0,0,24,27,24,0,0,16,11,10,14,0,0,0.0,-24,3,0.546607945148385,1.9031137472616138
2382,2382,2020,3,NCAAF_20200919_TULSA@OKLAST,Tulsa,Golden Hurricane,Oklahoma State,Cowboys,0-1,1-0,1.0,7,3,7,16,0,7,0,0,3,0,0,13,-1.0,4,-9,0.09563421038204589,-21.239504508276696
2383,2383,2020,3,NCAAF_20200919_SFLA@ND,South Florida,Bulls,Notre Dame,Fighting Irish,1-1,2-0,0.0,0,35,0,52,0,0,0,0,14,21,10,7,-1.0,-35,-52,0.06551900797180488,-24.541795866927714
2384,2384,2020,3,NCAAF_20200919_APLST@MRSHL,App. St.,Mountaineers,Marshall,Thundering Herd,1-1,2-0,0.0,7,10,7,17,7,0,0,0,7,3,7,0,-1.0,-3,-10,0.696852378522596,8.376093658733907
2385,2385,2020,3,NCAAF_20200919_SFA@TXSA,S.F. Austin,Lumberjacks,UTSA,Roadrunners,0-2,2-0,0.0,7,17,10,24,0,7,3,0,3,14,0,7,-2.0,-10,-14,0.11571633183241448,-19.449124871312506
2386,2386,2020,3,NCAAF_20200919_TROY@MTSU,Troy,Trojans,Middle Tenn.,Blue Raiders,1-0,0-2,1.0,26,7,47,14,7,19,14,7,7,0,0,7,1.0,19,33,0.5428776211253004,1.7501796539063434
2387,2387,2020,3,NCAAF_20200919_UCF@GATECH,UCF,Knights,Georgia Tech,Yellow Jackets,1-0,1-1,0.0,28,14,49,21,7,21,0,21,7,7,0,7,0.0,14,28,0.8081962926309791,14.160397564812683
2388,2388,2020,3,NCAAF_20200919_CIT@CLEM,The Citadel,Bulldogs,Clemson,Tigers,0-2,2-0,0.0,0,49,0,49,0,0,0,0,28,21,0,0,-2.0,-49,-49,0.0013053021227360517,-48.92391624144693
2389,2389,2020,3,NCAAF_20200919_SMU@NTEXAS,SMU,Mustangs,North Texas,Mean Green,2-0,1-1,0.0,34,7,65,35,21,13,21,10,0,7,14,14,1.0,27,30,0.7413127310887111,10.52190790638997
2390,2390,2020,3,NCAAF_20200919_LATECH@USM,Louisiana Tech,Bulldogs,So. Miss,Golden Eagles,1-0,0-2,0.0,10,13,31,30,7,3,14,7,0,13,14,3,1.0,-3,1,0.5157439533248394,0.6415637260347467
2391,2391,2020,3,NCAAF_20200919_MIAMI@LVILLE,Miami (Fla.),Hurricanes,Louisville,Cardinals,2-0,1-1,1.0,20,6,47,34,14,6,17,10,3,3,14,14,1.0,14,13,0.7545808560224103,11.197665061445832
2392,2392,2020,3,NCAAF_20200919_TXSTSM@LAMON,Texas St.,Bobcats,UL-Monroe,Warhawks,1-2,0-2,1.0,31,14,38,17,14,17,0,7,7,7,3,0,1.0,17,21,0.31592054992113094,-7.787231646960436
2393,2393,2020,3,NCAAF_20200919_WAKE@NCST,Wake Forest,Demon Deacons,NC State,Wolfpack,0-2,1-0,0.0,21,21,42,45,7,14,14,7,14,7,14,10,-1.0,0,-3,0.5101862464037401,0.41502533143693654
2394,2394,2020,3,NCAAF_20200919_ABIL@UTEP,Abil Christian,Wildcats,UTEP,Miners,0-1,2-1,1.0,7,10,13,17,7,0,3,3,0,10,0,7,-2.0,-3,-4,0.43733239620652675,-2.563623575674683
2395,2395,2020,3,NCAAF_20200918_CAMP@CSTCAR,Campbell,Fighting Camels,C. Carolina,Chanticleers,0-2,2-0,1.0,9,21,21,43,0,9,0,12,14,7,7,15,-2.0,-12,-22,0.1591756539418795,-16.21770024845364
2396,2396,2020,4,NCAAF_20200926_CAMP@APLST,Campbell,Fighting Camels,App. St.,Mountaineers,0-3,2-1,1.0,13,17,21,52,7,6,0,8,7,10,21,14,-2.0,-4,-31,0.00937032905623747,-38.16724838395862
2397,2397,2020,4,NCAAF_20200926_FLA@MISS,Florida,Gators,Ole Miss,Rebels,1-0,0-1,0.0,28,14,51,35,14,14,13,10,7,7,7,14,1.0,14,16,0.757126868722511,11.318580490283694
2398,2398,2020,4,NCAAF_20200926_GAS@LALAF,Ga. Southern,Eagles,Louisiana,Ragin' Cajuns,1-1,3-0,1.0,7,7,18,20,0,7,3,8,0,7,3,10,-2.0,0,-2,0.38807019671456966,-4.616997938625218
2399,2399,2020,4,NCAAF_20200926_GATECH@CUSE,Georgia Tech,Yellow Jackets,Syracuse,Orange,1-2,1-2,0.0,13,23,20,37,0,13,7,0,17,6,7,7,0.0,-10,-17,0.49264899757009994,-0.2992016477132893
2400,2400,2020,4,NCAAF_20200926_KSTATE@OKLA,Kansas State,Wildcats,Oklahoma,Sooners,1-1,1-1,0.0,7,21,38,35,0,7,14,17,7,14,14,0,0.0,-14,3,0.16697891333067405,-15.687639995830068
2401,2401,2020,4,NCAAF_20200926_LVILLE@PITT,Louisville,Cardinals,Pittsburgh,Panthers,1-2,3-0,0.0,17,20,20,23,7,10,3,0,13,7,3,0,-2.0,-3,-3,0.374441727096011,-5.1976234431151624
2402,2402,2020,4,NCAAF_20200926_UCF@ECU,UCF,Knights,East Carolina,Pirates,2-0,0-1,0.0,27,7,51,28,10,17,14,10,7,0,7,14,2.0,20,23,0.9829051614278491,34.386936870647105
2403,2403,2020,4,NCAAF_20200926_UK@AUBURN,Kentucky,Wildcats,Auburn,Tigers,0-1,1-0,0.0,7,8,13,29,7,0,6,0,8,0,7,14,-1.0,-1,-16,0.18823991432492226,-14.35992217441435
2404,2404,2020,4,NCAAF_20200926_FIU@LIB,FIU,Panthers,Liberty,Flames,0-1,2-0,1.0,14,14,34,36,14,0,14,6,14,0,13,9,-2.0,0,-2,0.5936388750567042,3.8467733817035423
2405,2405,2020,4,NCAAF_20200926_IOWAST@TCU,Iowa St.,Cyclones,TCU,Horned Frogs,1-1,0-1,0.0,16,7,37,34,0,16,7,14,0,7,14,13,1.0,9,3,0.5325621253131467,1.3267486404097326
2406,2406,2020,4,NCAAF_20200926_TULANE@USM,Tulane,Green Wave,So. Miss,Golden Eagles,2-1,0-3,0.0,31,21,66,24,7,24,21,14,14,7,3,0,2.0,10,42,0.6698345370224943,7.135404801773802
2407,2407,2020,4,NCAAF_20200926_ARMY@CINCY,Army,Black Knights,Cincinnati,Bearcats,2-1,2-0,0.0,7,10,10,24,7,0,0,3,3,7,7,7,0.0,-3,-14,0.43127535983923626,-2.811062640255386
2408,2408,2020,4,NCAAF_20200926_MISSST@LSU,Miss. State,Bulldogs,LSU,Tigers,1-0,0-1,1.0,17,14,44,34,3,14,10,17,0,14,10,10,1.0,3,10,0.29729323761619064,-8.641297559308214
2409,2409,2020,4,NCAAF_20200926_UTEP@LAMON,UTEP,Miners,UL-Monroe,Warhawks,3-1,0-3,1.0,24,0,31,6,7,17,0,7,0,0,6,0,3.0,24,25,0.20656538838340088,-13.288216817117245
2410,2410,2020,4,NCAAF_20200926_WVU@OKLAST,West Virginia,Mountaineers,Oklahoma State,Cowboys,1-1,2-0,1.0,7,20,13,27,0,7,3,3,0,20,0,7,-1.0,-13,-14,0.3964175694606511,-4.264308346168264
2411,2411,2020,4,NCAAF_20200926_DUKE@UVA,Duke,Blue Devils,Virginia,Cavaliers,0-3,1-0,0.0,10,17,20,38,10,0,10,0,0,17,0,21,-1.0,-7,-18,0.45557966173343645,-1.8116531755279084
2412,2412,2020,4,NCAAF_20200926_UGA@ARK,Georgia,Bulldogs,Arkansas,Razorbacks,1-0,0-1,0.0,5,7,37,10,0,5,22,10,7,0,3,0,1.0,-2,27,0.9849147270129953,35.19905146572205
2413,2413,2020,4,NCAAF_20200926_TXSTSM@BC,Texas St.,Bobcats,Boston College,Eagles,1-3,2-0,1.0,14,7,21,24,7,7,7,0,0,7,7,10,-1.0,7,-3,0.03657877027806944,-29.094019885892067
2414,2414,2020,4,NCAAF_20200926_BAMA@MIZZOU,Alabama,Crimson Tide,Missouri,Tigers,1-0,0-1,1.0,28,3,38,19,14,14,7,3,0,3,3,13,1.0,25,19,0.9151178398273179,22.29262738317948
2415,2415,2020,4,NCAAF_20200926_HOUBP@LATECH,Houston Christian,Huskies,Louisiana Tech,Bulldogs,0-3,2-0,0.0,17,38,38,66,14,3,7,14,17,21,14,14,-2.0,-21,-28,0.13339640411684994,-18.030722491663937
2416,2416,2020,4,NCAAF_20200926_SFA@SMU,S.F. Austin,Lumberjacks,SMU,Mustangs,0-3,3-0,0.0,0,29,7,50,0,0,7,0,22,7,7,14,-3.0,-29,-43,0.006891810018597955,-39.98908727624894
2417,2417,2020,4,NCAAF_20200926_FSU@MIAMI,Florida State,Seminoles,Miami (Fla.),Hurricanes,0-2,3-0,0.0,3,38,10,52,3,0,7,0,14,24,0,14,-3.0,-35,-42,0.33878586254408727,-6.750958766817348
2418,2418,2020,4,NCAAF_20200926_KANSAS@BAYLOR,Kansas,Jayhawks,Baylor,Bears,0-2,1-0,1.0,7,17,14,47,7,0,0,7,7,10,14,16,-1.0,-10,-33,0.2065727275021636,-13.287799302647272
2419,2419,2020,4,NCAAF_20200926_TENN@SC,Tennessee,Volunteers,South Carolina,Gamecocks,1-0,0-1,0.0,14,7,31,27,7,7,10,7,7,0,14,6,1.0,7,4,0.3583966325515644,-5.889897378440082
2420,2420,2020,4,NCAAF_20200926_VANDY@TXAM,Vanderbilt,Commodores,Texas A&M,Aggies,0-1,1-0,1.0,5,7,12,17,3,2,7,0,7,0,7,3,-1.0,-2,-5,0.18277127061613374,-14.692022762075112
2421,2421,2020,4,NCAAF_20200926_NCST@VATECH,NC State,Wolfpack,Virginia Tech,Hokies,1-1,1-0,0.0,10,31,24,45,0,10,7,7,17,14,6,8,0.0,-21,-21,0.4442598357845541,-2.2760485172518656
2422,2422,2020,4,NCAAF_20200926_TROY@BYU,Troy,Trojans,BYU,Cougars,1-1,2-0,1.0,7,24,7,48,0,7,0,0,7,17,14,10,-1.0,-17,-41,0.4106929121768148,-3.665688022515951
2423,2423,2020,4,NCAAF_20200925_MTSU@TXSA,Middle Tenn.,Blue Raiders,UTSA,Roadrunners,0-3,3-0,1.0,10,17,35,37,3,7,13,12,0,17,17,3,-3.0,-7,-2,0.7593089207450763,11.432091686053354
2424,2424,2020,4,NCAAF_20200924_UAB@SALA,UAB,Blazers,South Alabama,Jaguars,2-1,1-2,1.0,28,10,42,10,14,14,0,14,0,10,0,0,1.0,18,32,0.7618838139085502,11.566761723262516
2425,2425,2020,5,NCAAF_20201003_ARKST@CSTCAR,Arkansas St.,Red Wolves,C. Carolina,Chanticleers,1-2,3-0,1.0,14,24,23,52,14,0,0,9,7,17,7,21,-2.0,-10,-29,0.7679032208096862,11.897195666509901
2426,2426,2020,5,NCAAF_20201003_ECU@GAST,East Carolina,Pirates,Georgia St.,Panthers,0-2,1-1,0.0,13,35,29,49,7,6,3,13,21,14,0,14,-1.0,-22,-20,0.5095878590117316,0.3906710258589783
2427,2427,2020,5,NCAAF_20201003_MIZZOU@TENN,Missouri,Tigers,Tennessee,Volunteers,0-2,2-0,0.0,6,21,12,35,0,6,6,0,7,14,7,7,-2.0,-15,-23,0.7317117382269525,10.044886347993497
2428,2428,2020,5,NCAAF_20201003_NCST@PITT,NC State,Wolfpack,Pittsburgh,Panthers,2-1,3-1,0.0,17,13,30,29,10,7,0,13,7,6,7,9,-1.0,4,1,0.4980835547285344,-0.0780810853427738
2429,2429,2020,5,NCAAF_20201003_SC@FLA,South Carolina,Gamecocks,Florida,Gators,0-2,2-0,1.0,14,24,24,38,7,7,3,7,14,10,14,0,-2.0,-10,-14,0.3029006897449398,-8.38825101428506
2430,2430,2020,5,NCAAF_20201003_TCU@TEXAS,TCU,Horned Frogs,Texas,Longhorns,1-1,2-1,0.0,20,14,33,31,7,13,3,10,7,7,7,10,-1.0,6,2,0.451358992190537,-1.9866923459644568
2431,2431,2020,5,NCAAF_20201003_TXSA@UAB,UTSA,Roadrunners,UAB,Blazers,3-1,3-1,1.0,6,14,13,21,3,3,0,7,7,7,7,0,0.0,-8,-8,0.2512107835955061,-10.901243901588145
2432,2432,2020,5,NCAAF_20201003_NAL@LIB,North Alabama,Lions,Liberty,Flames,0-1,3-0,1.0,0,7,7,28,0,0,0,7,0,7,14,7,-3.0,-7,-21,,
2433,2433,2020,5,NCAAF_20201003_ABIL@ARMY,Abil Christian,Wildcats,Army,Black Knights,0-2,3-1,1.0,3,23,23,55,0,3,7,13,7,16,15,17,-3.0,-20,-32,0.025869811587409863,-31.618628424984877
2434,2434,2020,5,NCAAF_20201003_MEMP@SMU,Memphis,Tigers,SMU,Mustangs,1-1,4-0,0.0,20,24,27,30,3,17,7,0,17,7,3,3,-3.0,-4,-3,0.6481749467986727,6.182952003019409
2435,2435,2020,5,NCAAF_20201003_OKLAST@KANSAS,Oklahoma State,Cowboys,Kansas,Jayhawks,3-0,0-3,0.0,31,0,47,7,10,21,13,3,0,0,0,7,3.0,31,40,0.9222189918894335,23.083100114347644
2436,2436,2020,5,NCAAF_20201003_SFLA@CINCY,South Florida,Bulls,Cincinnati,Bearcats,1-2,3-0,1.0,0,14,7,28,0,0,7,0,7,7,14,0,-2.0,-14,-21,0.33466542595058324,-6.941500792583383
2437,2437,2020,5,NCAAF_20201003_TXAM@BAMA,Texas A&M,Aggies,Alabama,Crimson Tide,1-1,2-0,1.0,14,35,24,52,7,7,3,7,14,21,7,10,-1.0,-21,-28,0.08201401594655688,-22.619772306517007
2438,2438,2020,5,NCAAF_20201003_TXTECH@KSTATE,Texas Tech,Red Raiders,Kansas State,Wildcats,1-2,2-1,0.0,0,14,21,31,0,0,14,7,7,7,3,14,-1.0,-14,-10,0.4467569696216366,-2.1757346846915198
2439,2439,2020,5,NCAAF_20201003_UNC@BC,North Carolina,Tar Heels,Boston College,Eagles,2-0,2-1,0.0,21,16,26,22,14,7,3,2,3,13,0,6,0.0,5,4,0.39179421880585974,-4.464066440528768
2440,2440,2020,5,NCAAF_20201003_CHARLO@FAU,Charlotte,49ers,FAU,Owls,0-2,1-0,0.0,10,0,17,21,10,0,0,7,0,0,21,0,-1.0,10,-4,0.10046730921394031,-20.787015554529717
2441,2441,2020,5,NCAAF_20201003_JAXST@FSU,Jacksonville St.,Gamecocks,Florida State,Seminoles,0-1,1-2,1.0,21,14,24,41,14,7,3,0,0,14,20,7,-1.0,7,-17,0.04013808594281598,-28.429482518520672
2442,2442,2020,5,NCAAF_20201003_VATECH@DUKE,Virginia Tech,Hokies,Duke,Blue Devils,2-0,0-4,0.0,10,7,38,31,7,3,14,14,7,0,7,17,2.0,3,7,0.6498559223529065,6.2566417094624285
2443,2443,2020,5,NCAAF_20201003_WKY@MTSU,W. Kentucky,Hilltoppers,Middle Tenn.,Blue Raiders,1-2,0-4,0.0,10,10,20,17,0,10,3,7,0,10,0,7,1.0,0,3,0.4274830189943596,-2.9709847967676524
2444,2444,2020,5,NCAAF_20201003_NAVY@AF,Navy,Midshipmen,Air Force,Falcons,1-2,1-0,1.0,7,16,7,40,0,7,0,0,3,13,3,21,0.0,-9,-33,0.5340588434531236,1.3893326287911805
2445,2445,2020,5,NCAAF_20201003_GAS@LAMON,Ga. Southern,Eagles,UL-Monroe,Warhawks,2-1,0-4,0.0,21,17,35,30,7,14,14,0,3,14,6,7,2.0,4,5,0.6687846675931131,7.095802163556868
2446,2446,2020,5,NCAAF_20201003_ARK@MISSST,Arkansas,Razorbacks,Miss. State,Bulldogs,1-1,1-1,0.0,14,7,21,14,7,7,7,0,7,0,7,0,0.0,7,7,0.0875529867085556,-22.03995252523123
2447,2447,2020,5,NCAAF_20201003_AUBURN@UGA,Auburn,Tigers,Georgia,Bulldogs,1-1,2-0,0.0,3,24,6,27,0,3,3,0,10,14,3,0,-1.0,-21,-21,0.36944043392819914,-5.418008593095692
2448,2448,2020,5,NCAAF_20201003_LSU@VANDY,LSU,Tigers,Vanderbilt,Commodores,1-1,0-2,0.0,21,7,41,7,7,14,13,7,0,7,0,0,1.0,14,34,0.9417430725911653,25.511740142111876
2449,2449,2020,5,NCAAF_20201003_OKLA@IOWAST,Oklahoma,Sooners,Iowa St.,Cyclones,1-2,2-1,1.0,17,13,30,37,10,7,3,10,3,10,10,14,-1.0,4,-7,0.737632288851003,10.33850837318073
2450,2450,2020,5,NCAAF_20201003_TULSA@UCF,Tulsa,Golden Hurricane,UCF,Knights,1-1,2-1,1.0,12,23,34,26,2,10,13,9,16,7,3,0,-1.0,-11,8,0.0686837925692636,-24.14787353634722
2451,2451,2020,5,NCAAF_20201003_USM@NTEXAS,So. Miss,Golden Eagles,North Texas,Mean Green,1-3,1-2,0.0,20,10,41,31,17,3,7,14,3,7,7,14,0.0,10,10,0.5047289306293283,0.19267300180820257
2452,2452,2020,5,NCAAF_20201003_UVA@CLEM,Virginia,Cavaliers,Clemson,Tigers,1-1,3-0,0.0,10,24,23,41,0,10,7,6,10,14,10,7,-2.0,-14,-18,0.04689860893551001,-27.236654207112565
2453,2453,2020,5,NCAAF_20201002_CAMP@WAKE,Campbell,Fighting Camels,Wake Forest,Demon Deacons,0-4,1-2,1.0,7,24,14,66,0,7,7,0,14,10,28,14,-1.0,-17,-52,0.008133370663839679,-39.05611279057871
2454,2454,2020,5,NCAAF_20201002_LATECH@BYU,Louisiana Tech,Bulldogs,BYU,Cougars,2-1,3-0,1.0,7,28,14,45,7,0,0,7,7,21,10,7,-1.0,-21,-31,0.32611700254552467,-7.325000254677889
2455,2455,2020,6,NCAAF_20201010_FLA@TXAM,Florida,Gators,Texas A&M,Aggies,2-1,2-1,1.0,21,17,38,41,14,7,7,10,7,10,7,17,0.0,4,-3,0.6110942771431529,4.589429605354212
2456,2456,2020,6,NCAAF_20201010_LAMON@LIB,UL-Monroe,Warhawks,Liberty,Flames,0-5,4-0,1.0,0,24,7,40,0,0,0,7,14,10,7,9,-4.0,-24,-33,0.3752883623643294,-5.170187182690029
2457,2457,2020,6,NCAAF_20201010_LSU@MIZZOU,LSU,Tigers,Missouri,Tigers,1-2,1-2,1.0,24,24,41,45,14,10,17,0,14,10,14,7,0.0,0,-4,0.7662565385426638,11.817464921099372
2458,2458,2020,6,NCAAF_20201010_NCST@UVA,NC State,Wolfpack,Virginia,Cavaliers,3-1,1-2,1.0,24,7,38,21,14,10,0,14,0,7,7,7,2.0,17,17,0.4952024097604453,-0.19559961117954572
2459,2459,2020,6,NCAAF_20201010_SC@VANDY,South Carolina,Gamecocks,Vanderbilt,Commodores,1-2,0-3,1.0,10,0,41,7,3,7,17,14,0,0,7,0,1.0,10,34,0.7302031276658999,9.9771760113058
2460,2460,2020,6,NCAAF_20201010_VATECH@UNC,Virginia Tech,Hokies,North Carolina,Tar Heels,2-1,3-0,0.0,14,35,45,56,0,14,23,8,21,14,7,14,-1.0,-21,-11,0.6680968598067825,7.069654286125342
2461,2461,2020,6,NCAAF_20201010_DUKE@CUSE,Duke,Blue Devils,Syracuse,Orange,1-4,1-3,1.0,24,14,38,24,10,14,6,8,7,7,7,3,0.0,10,14,0.4887275743162094,-0.4596312506500908
2462,2462,2020,6,NCAAF_20201010_CIT@ARMY,The Citadel,Bulldogs,Army,Black Knights,0-4,4-1,0.0,3,7,9,14,3,0,0,6,0,7,7,0,-4.0,-4,-5,0.15391212409684119,-16.586647289304437
2463,2463,2020,6,NCAAF_20201010_CAR@ARKST,Cent. Ark.,Bears,Arkansas St.,Red Wolves,2-3,2-2,1.0,13,23,27,50,3,10,0,14,2,21,20,7,0.0,-10,-23,0.2033498762986019,-13.495020420765286
2464,2464,2020,6,NCAAF_20201010_TENN@UGA,Tennessee,Volunteers,Georgia,Bulldogs,2-1,3-0,0.0,21,17,21,44,7,14,0,0,7,10,13,14,-1.0,4,-23,0.05987747825024348,-25.304573566155227
2465,2465,2020,6,NCAAF_20201010_TXSA@BYU,UTSA,Roadrunners,BYU,Cougars,3-2,4-0,0.0,3,14,20,27,3,0,3,14,0,14,7,6,-1.0,-11,-7,0.10748929283313324,-20.16801220464606
2466,2466,2020,6,NCAAF_20201010_TXSTSM@TROY,Texas St.,Bobcats,Troy,Trojans,1-4,2-1,0.0,3,23,17,37,3,0,7,7,6,17,7,7,-1.0,-20,-20,0.15168016322314126,-16.74044513227045
2467,2467,2020,6,NCAAF_20201010_TXTECH@IOWAST,Texas Tech,Red Raiders,Iowa St.,Cyclones,1-3,3-1,1.0,7,21,15,31,7,0,0,8,7,14,7,3,-2.0,-14,-16,0.32677681766672284,-7.300072875262003
2468,2468,2020,6,NCAAF_20201010_ARK@AUBURN,Arkansas,Razorbacks,Auburn,Tigers,1-2,2-1,1.0,12,20,28,30,0,12,6,10,10,10,0,10,-1.0,-8,-2,0.041465106450004896,-28.20177245518653
2469,2469,2020,6,NCAAF_20201010_KSTATE@TCU,Kansas State,Wildcats,TCU,Horned Frogs,3-1,1-2,0.0,14,7,21,14,6,8,7,0,7,0,0,7,2.0,7,7,0.4263464612475468,-3.020076075307202
2470,2470,2020,6,NCAAF_20201010_MTSU@FIU,Middle Tenn.,Blue Raiders,FIU,Panthers,1-4,0-2,1.0,17,14,31,28,0,17,7,7,7,7,14,0,1.0,3,3,0.5173929096812142,0.7093233537027572
2471,2471,2020,6,NCAAF_20201010_TEMPLE@NAVY,Temple,Owls,Navy,Midshipmen,0-1,2-2,0.0,10,21,29,31,0,10,7,12,7,14,7,3,-2.0,-11,-2,0.49634707361964525,-0.14892971385927467
2472,2472,2020,6,NCAAF_20201010_ECU@SFLA,East Carolina,Pirates,South Florida,Bulls,1-2,1-3,1.0,31,17,44,24,17,14,7,6,7,10,0,7,0.0,14,20,0.21727190734519675,-12.709837905426184
2473,2473,2020,6,NCAAF_20201010_BAMA@MISS,Alabama,Crimson Tide,Ole Miss,Rebels,3-0,1-2,0.0,21,21,63,48,7,14,21,21,7,14,14,13,2.0,0,15,0.9681214670344248,30.152605560412326
2474,2474,2020,6,NCAAF_20201010_FSU@ND,Florida State,Seminoles,Notre Dame,Fighting Irish,1-3,3-0,0.0,20,35,26,42,17,3,6,0,14,21,7,0,-2.0,-15,-16,0.12566097521823916,-18.657889551840412
2475,2475,2020,6,NCAAF_20201010_MIAMI@CLEM,Miami (Fla.),Hurricanes,Clemson,Tigers,3-1,4-0,0.0,10,21,17,42,0,10,0,7,7,14,14,7,-1.0,-11,-25,0.11013312338686809,-19.937527411732503
2476,2476,2020,6,NCAAF_20201010_MISSST@UK,Miss. State,Bulldogs,Kentucky,Wildcats,1-2,1-2,0.0,0,14,2,24,0,0,2,0,0,14,0,10,0.0,-14,-22,0.652901743071916,6.394711176793066
2477,2477,2020,6,NCAAF_20201010_MRSHL@WKY,Marshall,Thundering Herd,W. Kentucky,Hilltoppers,3-0,1-3,1.0,28,0,38,14,14,14,10,0,0,0,7,7,2.0,28,24,0.6722436650552861,7.255933456109005
2478,2478,2020,6,NCAAF_20201010_UTEP@LATECH,UTEP,Miners,Louisiana Tech,Bulldogs,3-2,3-1,0.0,7,14,17,21,0,7,3,7,7,7,0,7,0.0,-7,-4,0.09697658567947987,-21.12732824366708
2479,2479,2020,6,NCAAF_20201010_CHARLO@NTEXAS,Charlotte,49ers,North Texas,Mean Green,1-2,1-3,0.0,21,7,49,21,7,14,14,14,0,7,7,7,0.0,14,28,0.30239152867122,-8.417512696836297
2480,2480,2020,6,NCAAF_20201009_LVILLE@GATECH,Louisville,Cardinals,Georgia Tech,Yellow Jackets,1-3,2-2,1.0,21,14,27,46,7,14,6,0,7,7,12,20,-1.0,7,-19,0.4470959735295684,-2.16322648677135
2481,2481,2020,6,NCAAF_20201008_TULANE@HOU,Tulane,Green Wave,Houston,Cougars,2-2,1-0,0.0,24,21,31,49,17,7,7,0,7,14,21,7,1.0,3,-18,0.46812193178362305,-1.3010360064558881
2482,2482,2020,7,NCAAF_20201017_AUBURN@SC,Auburn,Tigers,South Carolina,Gamecocks,2-1,1-2,0.0,16,14,22,30,9,7,3,3,0,14,13,3,1.0,2,-8,0.7948029660265965,13.39757234385138
2483,2483,2020,7,NCAAF_20201017_CLEM@GATECH,Clemson,Tigers,Georgia Tech,Yellow Jackets,4-0,2-2,0.0,52,7,73,7,17,35,7,14,7,0,0,0,2.0,45,66,0.9665675601156903,29.82522877750239
2484,2484,2020,7,NCAAF_20201017_KANSAS@WVU,Kansas,Jayhawks,West Virginia,Mountaineers,0-3,2-1,0.0,10,17,17,38,10,0,0,7,7,10,7,14,-2.0,-7,-21,0.12526141359962661,-18.701264887281127
2485,2485,2020,7,NCAAF_20201017_LIB@CUSE,Liberty,Flames,Syracuse,Orange,4-0,1-3,0.0,21,14,38,21,14,7,14,3,7,7,0,7,3.0,7,17,0.19446852627695121,-14.021657315659127
2486,2486,2020,7,NCAAF_20201017_NAVY@ECU,Navy,Midshipmen,East Carolina,Pirates,3-2,1-2,1.0,13,13,27,23,7,6,14,0,6,7,0,10,2.0,0,4,0.8516300989723474,16.98213613256769
2487,2487,2020,7,NCAAF_20201017_PITT@MIAMI,Pittsburgh,Panthers,Miami (Fla.),Hurricanes,3-2,3-1,1.0,6,14,19,31,0,6,13,0,7,7,14,3,0.0,-8,-12,0.3369391719356474,-6.849020997171465
2488,2488,2020,7,NCAAF_20201017_SFLA@TEMPLE,South Florida,Bulls,Temple,Owls,1-4,1-1,1.0,21,17,37,39,7,14,10,6,10,7,9,13,0.0,4,-2,0.36236187868321057,-5.73127924423909
2489,2489,2020,7,NCAAF_20201017_TXSTSM@SALA,Texas St.,Bobcats,South Alabama,Jaguars,1-4,1-2,1.0,10,17,20,30,7,3,7,3,3,14,0,13,0.0,-7,-10,0.4686646149942967,-1.279654804437314
2490,2490,2020,7,NCAAF_20201017_UK@TENN,Kentucky,Wildcats,Tennessee,Volunteers,1-2,2-1,1.0,17,7,34,7,0,17,10,7,0,7,0,0,-1.0,10,27,0.6391654362989662,5.79762004942495
2491,2491,2020,7,NCAAF_20201017_ARMY@TXSA,Army,Black Knights,UTSA,Roadrunners,4-1,3-2,0.0,14,10,28,16,7,7,7,7,0,10,0,6,1.0,4,12,0.8648625230640872,17.942023599611275
2492,2492,2020,7,NCAAF_20201017_WKY@UAB,W. Kentucky,Hilltoppers,UAB,Blazers,1-3,3-1,1.0,14,24,14,37,7,7,0,0,10,14,10,3,-2.0,-10,-23,0.4204997808021249,-3.265007243867217
2493,2493,2020,7,NCAAF_20201017_LVILLE@ND,Louisville,Cardinals,Notre Dame,Fighting Irish,1-3,3-0,0.0,0,6,7,12,0,0,7,0,6,0,6,0,-2.0,-6,-5,0.08644111035694402,-22.18281777063794
2494,2494,2020,7,NCAAF_20201017_DUKE@NCST,Duke,Blue Devils,NC State,Wolfpack,1-4,3-1,1.0,20,14,20,31,7,13,0,0,0,14,7,10,-2.0,6,-11,0.43027351518235557,-2.859154301142894
2495,2495,2020,7,NCAAF_20201017_EKY@TROY,E. Kentucky,Colonels,Troy,Trojans,1-3,2-1,0.0,17,21,29,31,7,10,0,12,14,7,7,3,-1.0,-4,-2,0.05454352039845778,-26.07757170388561
2496,2496,2020,7,NCAAF_20201017_MISS@ARK,Ole Miss,Rebels,Arkansas,Razorbacks,1-2,1-2,0.0,0,20,21,33,0,0,7,14,7,13,0,13,0.0,-20,-12,0.7289371949065147,9.921259581840445
2497,2497,2020,7,NCAAF_20201017_UCF@MEMP,UCF,Knights,Memphis,Tigers,2-2,2-1,0.0,27,14,49,50,7,20,8,14,7,7,15,21,0.0,13,-1,0.6784176245473196,7.539850127049704
2498,2498,2020,7,NCAAF_20201017_TXAM@MISSST,Texas A&M,Aggies,Miss. State,Bulldogs,2-1,1-2,0.0,14,0,28,14,0,14,14,0,0,0,7,7,1.0,14,14,0.44236986972847825,-2.35927758407513
2499,2499,2020,7,NCAAF_20201017_UMASS@GAS,UMass,Minutemen,Ga. Southern,Eagles,0-0,2-1,0.0,0,28,0,41,0,0,0,0,14,14,10,3,-2.0,-28,-41,0.1906653853039204,-14.247884633678723
2500,2500,2020,7,NCAAF_20201017_UVA@WAKE,Virginia,Cavaliers,Wake Forest,Demon Deacons,1-2,1-2,0.0,20,20,23,40,3,17,0,3,14,6,3,17,0.0,0,-17,0.47334940863200614,-1.0880296990648048
2501,2501,2020,7,NCAAF_20201017_NTEXAS@MTSU,North Texas,Mean Green,Middle Tenn.,Blue Raiders,1-3,1-4,0.0,21,28,52,35,7,14,21,10,21,7,0,7,0.0,-7,17,0.4541191795515124,-1.8758686528360613
2502,2502,2020,7,NCAAF_20201017_MRSHL@LATECH,Marshall,Thundering Herd,Louisiana Tech,Bulldogs,3-0,3-1,1.0,14,3,35,17,7,7,14,7,0,3,7,7,0.0,11,18,0.6179712897662917,4.885049906420136
2503,2503,2020,7,NCAAF_20201017_UNC@FSU,North Carolina,Tar Heels,Florida State,Seminoles,3-0,1-3,1.0,7,31,28,31,0,7,14,7,7,24,0,0,2.0,-24,-3,0.47482640708488233,-1.0276476048989025
2504,2504,2020,7,NCAAF_20201017_BC@VATECH,Boston College,Eagles,Virginia Tech,Hokies,3-1,2-1,1.0,7,17,14,40,0,7,7,0,3,14,10,13,1.0,-10,-26,0.43086554431769675,-2.834629922764748
2505,2505,2020,7,NCAAF_20201017_UGA@BAMA,Georgia,Bulldogs,Alabama,Crimson Tide,3-0,3-0,0.0,24,20,24,41,7,17,0,0,7,13,14,7,0.0,4,-17,0.3633173917045799,-5.689823803263835
2506,2506,2020,7,NCAAF_20201016_BYU@HOU,BYU,Cougars,Houston,Cougars,4-0,1-1,1.0,14,20,43,26,14,0,7,22,3,17,6,0,3.0,-6,17,0.4774871336199815,-0.9189079066367185
2507,2507,2020,7,NCAAF_20201015_GAST@ARKST,Georgia St.,Panthers,Arkansas St.,Red Wolves,1-1,2-2,1.0,28,28,52,59,7,21,14,10,14,14,17,14,-1.0,0,-7,0.2695470801707417,-9.995824368074295
2508,2508,2020,7,NCAAF_20201014_CSTCAR@LALAF,C. Carolina,Chanticleers,Louisiana,Ragin' Cajuns,3-0,3-0,0.0,13,13,30,27,7,6,7,10,7,6,7,7,0.0,0,3,0.26876169048396303,-10.034543525552522
2509,2509,2020,8,NCAAF_20201024_AUBURN@MISS,Auburn,Tigers,Ole Miss,Rebels,3-2,1-4,0.0,14,14,35,28,7,7,7,14,0,14,7,7,2.0,0,7,0.8529127209379179,17.08210429241649
2510,2510,2020,8,NCAAF_20201024_CUSE@CLEM,Syracuse,Orange,Clemson,Tigers,1-5,6-0,0.0,14,27,21,47,0,14,7,0,17,10,7,13,-5.0,-13,-26,0.02673626518234118,-31.44590436260239
2511,2511,2020,8,NCAAF_20201024_FSU@LVILLE,Florida State,Seminoles,Louisville,Cardinals,2-4,2-4,1.0,14,31,16,48,7,7,2,0,21,10,7,10,0.0,-17,-32,0.5798389584395919,3.280936936672333
2512,2512,2020,8,NCAAF_20201024_GAS@CSTCAR,Ga. Southern,Eagles,C. Carolina,Chanticleers,3-2,5-0,1.0,14,14,14,28,7,7,0,0,7,7,0,14,-2.0,0,-14,0.6383432462337183,5.76510841785273
2513,2513,2020,8,NCAAF_20201024_KANSAS@KSTATE,Kansas,Jayhawks,Kansas State,Wildcats,0-5,4-1,1.0,7,34,14,55,0,7,0,7,7,27,21,0,-4.0,-27,-41,0.1123541122567866,-19.77053263868254
2514,2514,2020,8,NCAAF_20201024_MERCER@ARMY,Mercer,Bears,Army,Black Knights,0-2,6-1,1.0,3,21,3,49,3,0,0,0,7,14,21,7,-6.0,-18,-46,0.10828884525270255,-20.12187970972616
2515,2515,2020,8,NCAAF_20201024_NCST@UNC,NC State,Wolfpack,North Carolina,Tar Heels,4-2,4-1,1.0,7,17,21,48,0,7,7,7,7,10,21,10,0.0,-10,-27,0.5933537926108831,3.8459813972397114
2516,2516,2020,8,NCAAF_20201024_NEB@OHIOST,Nebraska,Cornhuskers,Ohio State,Buckeyes,0-1,1-0,1.0,14,24,17,52,7,7,3,0,14,10,14,14,-1.0,-10,-35,0.034164364917312784,-29.683116376566318
2517,2517,2020,8,NCAAF_20201024_OKLA@TCU,Oklahoma,Sooners,TCU,Horned Frogs,3-2,1-3,1.0,17,7,33,14,10,7,10,6,0,7,0,7,2.0,10,19,0.7582286815300017,11.408873968595913
2518,2518,2020,8,NCAAF_20201024_RUT@MICHST,Rutgers,Scarlet Knights,Michigan St.,Spartans,1-0,0-1,1.0,28,13,38,27,14,14,0,10,7,6,7,7,1.0,15,11,0.10040664759317153,-20.831185880629732
2519,2519,2020,8,NCAAF_20201024_TEMPLE@MEMP,Temple,Owls,Memphis,Tigers,1-2,3-1,1.0,15,10,29,41,3,12,7,7,7,3,17,14,-2.0,5,-12,0.2994224115321096,-8.56643205693581
2520,2520,2020,8,NCAAF_20201024_UTEP@CHARLO,UTEP,Miners,Charlotte,49ers,3-3,2-2,1.0,14,14,28,38,7,7,0,14,7,7,7,17,1.0,0,-10,0.23553941264830447,-11.736326139673906
2521,2521,2020,8,NCAAF_20201024_USM@LIB,So. Miss,Golden Eagles,Liberty,Flames,1-4,6-0,1.0,7,35,35,56,7,0,21,7,14,21,7,14,-5.0,-28,-21,0.5449065892093821,1.8368890757366216
2522,2522,2020,8,NCAAF_20201024_TULANE@UCF,Tulane,Green Wave,UCF,Knights,2-4,3-2,0.0,14,37,34,51,14,0,14,6,10,27,14,0,-1.0,-23,-17,0.15767795820437347,-16.34996246976607
2523,2523,2020,8,NCAAF_20201024_FAU@MRSHL,FAU,Owls,Marshall,Thundering Herd,1-1,5-0,0.0,6,7,9,20,0,6,3,0,7,0,10,3,-4.0,-1,-11,0.61938668176441,4.948243498120291
2524,2524,2020,8,NCAAF_20201024_BAMA@TENN,Alabama,Crimson Tide,Tennessee,Volunteers,5-0,2-3,1.0,28,10,48,17,14,14,14,6,0,10,7,0,3.0,18,31,0.9734139233905175,31.48555700640793
2525,2525,2020,8,NCAAF_20201024_BAYLOR@TEXAS,Baylor,Bears,Texas,Longhorns,1-2,3-2,1.0,3,13,16,27,3,0,0,13,0,13,14,0,-2.0,-10,-11,0.2809779742650035,-9.443756446493467
2526,2526,2020,8,NCAAF_20201024_HOU@NAVY,Houston,Cougars,Navy,Midshipmen,2-1,3-3,1.0,16,13,37,21,3,13,7,14,7,6,0,8,-1.0,3,16,0.526092913209746,1.0658232179131346
2527,2527,2020,8,NCAAF_20201024_IOWA@PURDUE,Iowa,Hawkeyes,Purdue,Boilermakers,0-1,1-0,1.0,17,14,20,24,0,17,0,3,7,7,0,10,-1.0,3,-4,0.7306468441615421,10.010958906581664
2528,2528,2020,8,NCAAF_20201024_IOWAST@OKLAST,Iowa St.,Cyclones,Oklahoma State,Cowboys,3-2,4-0,0.0,7,14,21,24,7,0,7,7,7,7,7,3,-1.0,-7,-3,0.5136296964601645,0.5564463638929737
2529,2529,2020,8,NCAAF_20201024_ND@PITT,Notre Dame,Fighting Irish,Pittsburgh,Panthers,5-0,3-4,1.0,28,3,45,3,7,21,17,0,3,0,0,0,2.0,25,42,0.8419752169829506,16.326544040430804
2530,2530,2020,8,NCAAF_20201024_VATECH@WAKE,Virginia Tech,Hokies,Wake Forest,Demon Deacons,3-2,3-2,1.0,10,17,16,23,0,10,3,3,10,7,3,3,0.0,-7,-7,0.5544658014838998,2.2301414872506484
2531,2531,2020,8,NCAAF_20201024_GAST@TROY,Georgia St.,Panthers,Troy,Trojans,2-2,3-2,1.0,13,21,36,34,7,6,20,3,7,14,0,13,-1.0,-8,2,0.26862764793966576,-10.046756824282966
2532,2532,2020,8,NCAAF_20201024_GATECH@BC,Georgia Tech,Yellow Jackets,Boston College,Eagles,2-4,4-2,1.0,14,34,27,48,0,14,7,6,14,20,14,0,-2.0,-20,-21,0.41752591108433956,-3.390778868268285
2533,2533,2020,8,NCAAF_20201024_TNCHAT@WKY,Chattanooga,Mocs,W. Kentucky,Hilltoppers,0-1,2-4,1.0,7,3,10,13,7,0,3,0,3,0,3,7,-2.0,4,-3,0.14077569657021782,-17.53533961228368
2534,2534,2020,8,NCAAF_20201024_UK@MIZZOU,Kentucky,Wildcats,Missouri,Tigers,2-3,2-2,1.0,3,10,10,20,0,3,0,7,0,10,7,3,0.0,-7,-10,0.44279588258440605,-2.3430218981500275
2535,2535,2020,8,NCAAF_20201024_WVU@TXTECH,West Virginia,Mountaineers,Texas Tech,Red Raiders,3-2,2-3,1.0,13,20,27,34,7,6,14,0,13,7,7,7,1.0,-7,-7,0.5517061468437767,2.1164897424728224
2536,2536,2020,8,NCAAF_20201024_LAMON@SALA,UL-Monroe,Warhawks,South Alabama,Jaguars,0-6,3-2,0.0,6,17,14,38,0,6,0,8,17,0,14,7,-3.0,-11,-24,0.5634504417054,2.600942243434588
2537,2537,2020,8,NCAAF_20201024_SC@LSU,South Carolina,Gamecocks,LSU,Tigers,2-3,2-2,0.0,10,31,24,52,7,3,7,7,10,21,14,7,0.0,-21,-28,0.1983946335025627,-13.798613303284469
2538,2538,2020,8,NCAAF_20201024_UTAHST@BOISE,Utah St.,Aggies,Boise St.,Broncos,0-1,1-0,0.0,0,28,13,42,0,0,7,6,7,21,0,14,-1.0,-28,-29,0.3648191388147273,-5.627880738956719
2539,2539,2020,8,NCAAF_20201024_HAWAII@FRESNO,Hawaii,Rainbow Warriors,Fresno St.,Bulldogs,1-0,0-1,1.0,17,13,34,19,7,10,7,10,7,6,3,3,1.0,4,15,0.166244149074406,-15.781110448881691
2540,2540,2020,8,NCAAF_20201024_MD@NWEST,Maryland,Terrapins,Northwestern,Wildcats,0-1,1-0,1.0,3,30,3,43,3,0,0,0,14,16,7,6,-1.0,-27,-40,0.3237239486715219,-7.446871043259648
2541,2541,2020,8,NCAAF_20201024_MICH@MINN,Michigan,Wolverines,Minnesota,Golden Gophers,1-0,0-1,1.0,35,17,49,24,21,14,7,7,10,7,7,0,1.0,18,25,0.8194575076340942,14.87222519492866
2542,2542,2020,8,NCAAF_20201024_LATECH@TXSA,Louisiana Tech,Bulldogs,UTSA,Roadrunners,3-3,4-3,1.0,19,6,26,27,3,16,7,0,3,3,7,14,-1.0,13,-1,0.7300407726598765,9.981091255773777
2543,2543,2020,8,NCAAF_20201024_UVA@MIAMI,Virginia,Cavaliers,Miami (Fla.),Hurricanes,1-4,5-1,0.0,7,10,14,19,7,0,0,7,7,3,3,6,-4.0,-3,-5,0.3234001043406568,-7.4615498620316885
2544,2544,2020,8,NCAAF_20201024_CINCY@SMU,Cincinnati,Bearcats,SMU,Mustangs,4-0,5-1,0.0,14,10,42,13,14,0,14,14,0,10,0,3,-1.0,4,29,0.5073531857940479,0.30015995008204754
2545,2545,2020,8,NCAAF_20201024_TXSTSM@BYU,Texas St.,Bobcats,BYU,Cougars,1-6,6-0,1.0,7,35,14,52,7,0,0,7,14,21,14,3,-5.0,-28,-38,0.07105025470445558,-23.905221840762692
2546,2546,2020,8,NCAAF_20201024_AF@SJST,Air Force,Falcons,San Jose St.,Spartans,1-1,1-0,0.0,0,0,6,17,0,0,0,6,0,0,14,3,0.0,0,-11,0.890754179244234,20.038330775629788
2547,2547,2020,8,NCAAF_20201024_UNLV@SDGST,UNLV,Rebels,San Diego St.,Aztecs,0-1,1-0,0.0,0,27,6,34,0,0,6,0,7,20,0,7,-1.0,-27,-28,0.17458830116022872,-15.244934630803414
2548,2548,2020,8,NCAAF_20201023_JAXST@FIU,Jacksonville St.,Gamecocks,FIU,Panthers,3-1,0-3,0.0,13,3,19,10,3,10,3,3,3,0,7,0,3.0,10,9,0.258726535791886,-10.540287381766689
2549,2549,2020,8,NCAAF_20201023_TULSA@SFLA,Tulsa,Golden Hurricane,South Florida,Bulls,2-1,1-5,0.0,21,6,42,13,7,14,21,0,6,0,7,0,1.0,15,29,0.4763552873596768,-0.9656976020035017
2550,2550,2020,8,NCAAF_20201023_ILL@WISC,Illinois,Fighting Illini,Wisconsin,Badgers,0-1,1-0,1.0,7,28,7,45,0,7,0,0,7,21,0,17,-1.0,-21,-38,0.04635283834381532,-27.378303638506964
2551,2551,2020,8,NCAAF_20201023_LALAF@UAB,Louisiana,Ragin' Cajuns,UAB,Blazers,4-1,4-2,0.0,10,13,24,20,0,10,7,7,3,10,7,0,0.0,-3,4,0.5305924780183475,1.2499526967569636
2552,2552,2020,8,NCAAF_20201022_ARKST@APLST,Arkansas St.,Red Wolves,App. St.,Mountaineers,3-3,3-1,1.0,7,31,17,45,7,0,10,0,14,17,7,7,0.0,-24,-28,0.2748010511897899,-9.743672359899847
2553,2553,2020,9,NCAAF_20201031_BC@CLEM,Boston College,Eagles,Clemson,Tigers,4-3,7-0,1.0,28,13,28,34,14,14,0,0,7,6,13,8,-3.0,15,-6,0.04500028783109844,-27.665042133505494
2554,2554,2020,9,NCAAF_20201031_CSTCAR@GAST,C. Carolina,Chanticleers,Georgia St.,Panthers,6-0,2-3,0.0,34,0,51,0,7,27,14,3,0,0,0,0,4.0,34,51,0.5073124466009371,0.29911451211262374
2555,2555,2020,9,NCAAF_20201031_IOWAST@KANSAS,Iowa St.,Cyclones,Kansas,Jayhawks,4-2,0-6,0.0,20,7,52,22,13,7,15,17,0,7,7,8,4.0,13,30,0.9361258720280481,24.852628917887046
2556,2556,2020,9,NCAAF_20201031_KSTATE@WVU,Kansas State,Wildcats,West Virginia,Mountaineers,4-2,4-2,1.0,10,24,10,37,3,7,0,0,3,21,10,3,0.0,-14,-27,0.5390706320021825,1.6006519977640892
2557,2557,2020,9,NCAAF_20201031_MEMP@CINCY,Memphis,Tigers,Cincinnati,Bearcats,3-2,5-0,0.0,10,21,10,49,7,3,0,0,7,14,14,14,-2.0,-11,-39,0.6198532297756685,4.978472305003265
2558,2558,2020,9,NCAAF_20201031_MICHST@MICH,Michigan St.,Spartans,Michigan,Wolverines,1-1,1-1,1.0,14,10,27,24,7,7,6,7,7,3,7,7,0.0,4,3,0.17020548477820452,-15.556593660453473
2559,2559,2020,9,NCAAF_20201031_PURDUE@ILL,Purdue,Boilermakers,Illinois,Fighting Illini,2-0,0-2,0.0,17,10,31,24,7,10,14,0,0,10,0,14,2.0,7,7,0.8211068906396759,15.005674321862443
2560,2560,2020,9,NCAAF_20201031_TEMPLE@TULANE,Temple,,Tulane,,1-3,3-4,,3,10,3,38,3,0,0,0,0,10,14,14,-2.0,-7,-35,0.5133689768515848,0.546927721070233
2561,2561,2020,9,NCAAF_20201031_TXSA@FAU,UTSA,,FAU,,4-4,2-1,,3,17,3,24,0,3,0,0,10,7,0,7,2.0,-14,-21,0.1123907089628231,-19.80832002182865
2562,2562,2020,9,NCAAF_20201031_UGA@UK,Georgia,Bulldogs,Kentucky,Wildcats,4-1,2-4,0.0,7,3,14,3,7,0,7,0,0,3,0,0,2.0,4,11,0.8701439433858569,18.39128676062387
2563,2563,2020,9,NCAAF_20201031_WAKE@CUSE,Wake Forest,Demon Deacons,Syracuse,Orange,4-2,1-6,1.0,17,7,38,14,10,7,21,0,0,7,0,7,3.0,10,24,0.616695942909614,4.8433479936715
2564,2564,2020,9,NCAAF_20201031_UCF@HOU,UCF,,Houston,,4-2,2-2,,23,7,44,21,10,13,0,21,7,0,6,8,2.0,16,23,0.806014602339174,14.0871734861488
2565,2565,2020,9,NCAAF_20201031_RICE@USM,Rice,,So. Miss,,1-1,1-5,,23,6,30,6,3,20,0,7,0,6,0,0,0.0,17,24,0.1998387781201273,-13.742771875168955
2566,2566,2020,9,NCAAF_20201031_TROY@ARKST,Troy,,Arkansas St.,,4-2,3-4,,24,3,38,10,14,10,0,14,0,3,7,0,1.0,21,28,0.5108768216255892,0.444944944939607
2567,2567,2020,9,NCAAF_20201031_IND@RUT,Indiana,Hoosiers,Rutgers,Scarlet Knights,2-0,1-1,0.0,20,7,37,21,3,17,10,7,7,0,8,6,1.0,13,16,0.8502816967061934,16.931997611979796
2568,2568,2020,9,NCAAF_20201031_LSU@AUBURN,LSU,Tigers,Auburn,Tigers,2-3,4-2,1.0,3,21,11,48,0,3,0,8,0,21,21,6,-2.0,-18,-37,0.5573467222932065,2.35376452915159
2569,2569,2020,9,NCAAF_20201031_ND@GATECH,Notre Dame,Fighting Irish,Georgia Tech,Yellow Jackets,6-0,2-5,1.0,17,7,31,13,7,10,7,7,0,7,0,6,4.0,10,18,0.898005437895486,20.72793010023338
2570,2570,2020,9,NCAAF_20201031_NWEST@IOWA,Northwestern,Wildcats,Iowa,Hawkeyes,2-0,0-2,1.0,14,20,21,20,0,14,7,0,17,3,0,0,2.0,-6,1,0.2379299288521023,-11.634190521497771
2571,2571,2020,9,NCAAF_20201031_TCU@BAYLOR,TCU,Horned Frogs,Baylor,Bears,2-3,1-3,1.0,30,7,33,23,20,10,3,0,0,7,7,9,1.0,23,10,0.6731009036469965,7.31838371200422
2572,2572,2020,9,NCAAF_20201031_APLST@LAMON,App. St.,,UL-Monroe,,4-1,0-7,,21,7,31,13,14,7,7,3,0,7,0,6,4.0,14,18,0.9212737476392123,23.068277420601703
2573,2573,2020,9,NCAAF_20201031_MISS@VANDY,Ole Miss,Rebels,Vanderbilt,Commodores,2-4,0-4,1.0,33,14,54,21,21,12,21,0,0,14,0,7,2.0,19,33,0.6722263451052972,7.278848699706828
2574,2574,2020,9,NCAAF_20201031_VATECH@LVILLE,Virginia Tech,Hokies,Louisville,Cardinals,4-2,2-5,0.0,21,14,42,35,14,7,7,14,0,14,0,21,2.0,7,7,0.6824907532563433,7.745635723095575
2575,2575,2020,9,NCAAF_20201031_BOISE@AF,Boise St.,Broncos,Air Force,Falcons,2-0,1-2,1.0,28,17,49,30,7,21,7,14,14,3,0,13,1.0,11,19,0.7287193920090786,9.936610018405531
2576,2576,2020,9,NCAAF_20201031_CHARLO@DUKE,Charlotte,49ers,Duke,Blue Devils,2-3,2-5,0.0,7,24,19,53,0,7,6,6,17,7,13,16,0.0,-17,-34,0.11956104386650712,-19.20900452862793
2577,2577,2020,9,NCAAF_20201031_MISSST@BAMA,Miss. State,Bulldogs,Alabama,Crimson Tide,1-4,6-0,0.0,0,27,0,41,0,0,0,0,17,10,0,14,-5.0,-27,-41,0.10413951372072794,-20.532828478008128
2578,2578,2020,9,NCAAF_20201031_NMEX@SJST,New Mexico,Lobos,San Jose St.,Spartans,0-1,2-0,1.0,14,21,21,38,0,14,7,0,7,14,10,7,-2.0,-7,-17,0.5286919809331365,1.1745889344954321
2579,2579,2020,9,NCAAF_20201031_ARK@TXAM,Arkansas,Razorbacks,Texas A&M,Aggies,2-3,4-1,0.0,14,28,31,42,7,7,3,14,14,14,14,0,-2.0,-14,-11,0.15153474605622963,-16.8052243614286
2580,2580,2020,9,NCAAF_20201031_MIZZOU@FLA,Missouri,Tigers,Florida,Gators,2-3,3-1,1.0,7,20,17,41,0,7,0,10,6,14,14,7,-1.0,-13,-24,0.40958329892876544,-3.730517431337489
2581,2581,2020,9,NCAAF_20201031_NAVY@SMU,Navy,Midshipmen,SMU,Mustangs,3-4,6-1,0.0,17,31,37,51,7,10,0,20,0,31,14,6,-3.0,-14,-14,0.44961949063044704,-2.0661997308889113
2582,2582,2020,9,NCAAF_20201031_OHIOST@PSU,Ohio State,Buckeyes,Penn State,Nittany Lions,2-0,0-2,1.0,21,6,38,25,14,7,10,7,3,3,7,12,2.0,15,13,0.6675959108591143,7.070230341211868
2583,2583,2020,9,NCAAF_20201031_LALAF@TXSTSM,Louisiana,,Texas St.,,5-1,1-7,,34,21,44,34,14,20,3,7,14,7,6,7,4.0,13,10,0.8474157133471976,16.73243498276622
2584,2584,2020,9,NCAAF_20201031_OKLA@TXTECH,Oklahoma,Sooners,Texas Tech,Red Raiders,4-2,2-4,0.0,48,14,62,28,21,27,7,7,7,7,0,14,2.0,34,34,0.8503074556992416,16.933802735992344
2585,2585,2020,9,NCAAF_20201031_UNC@UVA,North Carolina,Tar Heels,Virginia,Cavaliers,4-2,2-4,1.0,20,27,41,44,10,10,7,14,13,14,14,3,2.0,-7,-3,0.450165766410051,-2.043677771005946
2586,2586,2020,9,NCAAF_20201031_SDGST@UTAHST,San Diego St.,Aztecs,Utah St.,Aggies,2-0,0-2,1.0,10,7,38,7,7,3,14,14,0,7,0,0,2.0,3,31,0.4569969421276322,-1.7623551912208768
2587,2587,2020,9,NCAAF_20201031_WKY@BYU,W. Kentucky,Hilltoppers,BYU,Cougars,2-5,7-0,0.0,3,35,10,41,3,0,7,0,14,21,3,3,-5.0,-32,-31,0.1971368192302967,-13.900980299407252
2588,2588,2020,9,NCAAF_20201031_NEVADA@UNLV,Nevada,Wolf Pack,UNLV,Rebels,2-0,0-2,1.0,24,12,37,19,10,14,3,10,3,9,7,0,2.0,12,18,0.6022154173069458,4.227697076552431
2589,2589,2020,9,NCAAF_20201030_ECU@TULSA,East Carolina,Pirates,Tulsa,Golden Hurricane,1-4,3-1,1.0,17,3,30,34,7,10,3,10,3,0,17,14,-2.0,14,-4,0.2579739017090603,-10.600087878657177
2590,2590,2020,9,NCAAF_20201030_HAWAII@WYO,Hawaii,Rainbow Warriors,Wyoming,Cowboys,1-1,1-1,0.0,7,10,7,31,0,7,0,0,10,0,7,14,0.0,-3,-24,0.2923362342563097,-8.918838420842349
2591,2591,2020,9,NCAAF_20201029_SALA@GAS,South Alabama,Jaguars,Ga. Southern,Eagles,3-3,4-2,1.0,10,10,17,24,3,7,7,0,0,10,0,14,-1.0,0,-7,0.2746536433030098,-9.771049183206628
2592,2592,2020,9,NCAAF_20201029_COLOST@FRESNO,Colorado St.,Rams,Fresno St.,Bulldogs,0-1,1-1,1.0,10,24,17,38,3,7,0,7,7,17,7,7,-1.0,-14,-21,0.2752093913370617,-9.7438677590535
2593,2593,2020,10,NCAAF_20201107_ARIZST@USC,Arizona St.,Sun Devils,USC,Trojans,0-1,1-0,1.0,17,14,27,28,3,14,7,3,7,7,0,14,-1.0,3,-1,0.3784194100964968,-5.072926090790702
2594,2594,2020,10,NCAAF_20201107_ARKST@LALAF,Arkansas St.,Red Wolves,Louisiana,Ragin' Cajuns,3-5,6-1,1.0,6,0,20,27,3,3,0,14,0,0,14,13,-3.0,6,-7,0.47932303021374145,-0.8495333217425696
2595,2595,2020,10,NCAAF_20201107_LAMON@GAST,UL-Monroe,,Georgia St.,,0-8,3-3,,14,42,34,52,7,7,6,14,21,21,3,7,-3.0,-28,-18,0.4526709668079718,-1.9482701372879774
2596,2596,2020,10,NCAAF_20201107_LIB@VATECH,Liberty,Flames,Virginia Tech,Hokies,7-0,4-3,1.0,14,20,38,35,7,7,7,17,3,17,0,15,3.0,-6,3,0.1337315830161252,-18.168146165191956
2597,2597,2020,10,NCAAF_20201107_MICH@IND,Michigan,Wolverines,Indiana,Hoosiers,1-2,3-0,1.0,7,24,21,38,7,0,7,7,14,10,7,7,-2.0,-17,-17,0.8566813276538277,17.457161210202912
2598,2598,2020,10,NCAAF_20201107_MICHST@IOWA,Michigan St.,Spartans,Iowa,Hawkeyes,1-2,1-2,0.0,0,35,7,49,0,0,7,0,14,21,7,7,0.0,-35,-42,0.28369926910279597,-9.369560676769652
2599,2599,2020,10,NCAAF_20201107_NEB@NWEST,Nebraska,Cornhuskers,Northwestern,Wildcats,0-2,3-0,1.0,13,7,13,21,0,13,0,0,7,0,7,7,-3.0,6,-8,0.4044599884914706,-3.961872079934551
2600,2600,2020,10,NCAAF_20201107_SFLA@MEMP,South Florida,,Memphis,,1-6,4-2,,27,13,33,34,3,24,3,3,6,7,7,14,-3.0,14,-1,0.20271045466268744,-13.630797701947813
2601,2601,2020,10,NCAAF_20201107_SMU@TEMPLE,SMU,Mustangs,Temple,Owls,7-1,1-4,0.0,10,13,47,23,7,3,10,27,13,0,3,7,6.0,-3,24,0.5734867274778117,3.035193490759184
2602,2602,2020,10,NCAAF_20201107_TULANE@ECU,Tulane,,East Carolina,,4-4,1-5,,21,7,38,21,7,14,10,7,7,0,0,14,3.0,14,17,0.8393020163222,16.245855535049486
2603,2603,2020,10,NCAAF_20201107_UNC@DUKE,North Carolina,Tar Heels,Duke,Blue Devils,5-2,2-6,1.0,42,10,56,24,21,21,7,7,0,10,7,7,3.0,32,32,0.4953288208931663,-0.19183833156967012
2604,2604,2020,10,NCAAF_20201107_WVU@TEXAS,West Virginia,Mountaineers,Texas,Longhorns,4-3,5-2,0.0,7,10,13,17,7,0,6,0,7,3,7,0,-1.0,-3,-4,0.37858495295593486,-5.06579429611611
2605,2605,2020,10,NCAAF_20201107_TROY@GAS,Troy,,Ga. Southern,,4-3,5-2,,10,6,13,20,0,10,3,0,0,6,14,0,-1.0,4,-7,0.6220178415555906,5.091768069605223
2606,2606,2020,10,NCAAF_20201107_BC@CUSE,Boston College,,Syracuse,,5-3,1-7,,10,3,16,13,3,7,0,6,0,3,3,7,4.0,7,3,0.6066163364750203,4.431937045075983
2607,2607,2020,10,NCAAF_20201107_UMASS@MRSHL,UMass,Minutemen,Marshall,Thundering Herd,0-2,6-0,0.0,10,31,10,51,7,3,0,0,14,17,13,7,-6.0,-21,-41,0.08058182685603099,-22.956169108111112
2608,2608,2020,10,NCAAF_20201107_APLST@TXSTSM,App. St.,,Texas St.,,5-1,1-8,,24,10,38,17,14,10,0,14,7,3,0,7,4.0,14,21,0.9484883184012304,26.711306659426214
2609,2609,2020,10,NCAAF_20201107_NAL@USM,North Alabama,,So. Miss,,0-3,2-5,,10,7,13,24,7,3,3,0,0,7,0,17,-2.0,3,-11,0.10764695506031063,-20.30154764416352
2610,2610,2020,10,NCAAF_20201107_FLA@UGA,Florida,Gators,Georgia,Bulldogs,4-1,4-2,0.0,38,21,44,28,14,24,3,3,14,7,7,0,0.0,17,16,0.24233952114539115,-11.448798316839088
2611,2611,2020,10,NCAAF_20201107_FRESNO@UNLV,Fresno St.,Bulldogs,UNLV,Rebels,2-1,0-3,1.0,20,17,40,27,6,14,7,13,7,10,10,0,2.0,3,13,0.8700547619244533,18.458569653775157
2612,2612,2020,10,NCAAF_20201107_HOU@CINCY,Houston,Cougars,Cincinnati,Bearcats,2-3,6-0,1.0,10,28,10,38,0,10,0,0,7,21,3,7,-4.0,-18,-28,0.41382414121956645,-3.567013635928788
2613,2613,2020,10,NCAAF_20201107_KANSAS@OKLA,Kansas,Jayhawks,Oklahoma,Sooners,0-7,5-2,1.0,3,31,9,62,0,3,0,6,14,17,10,21,-5.0,-28,-53,0.016585538551332712,-34.89714827379487
2614,2614,2020,10,NCAAF_20201107_MD@PSU,Maryland,,Penn State,,2-1,0-3,,28,7,35,19,14,14,7,0,0,7,0,12,2.0,21,16,0.04090324211352281,-28.512345565516284
2615,2615,2020,10,NCAAF_20201107_MINN@ILL,Minnesota,Golden Gophers,Illinois,Fighting Illini,1-2,0-3,1.0,28,7,41,14,7,21,7,6,0,7,0,7,1.0,21,27,0.8030447902703819,13.967782847184253
2616,2616,2020,10,NCAAF_20201107_TXTECH@TCU,Texas Tech,Red Raiders,TCU,Horned Frogs,2-5,3-3,1.0,3,10,18,34,0,3,7,8,3,7,17,7,-1.0,-7,-16,0.3664268328118312,-5.592242649976924
2617,2617,2020,10,NCAAF_20201107_VANDY@MISSST,Vanderbilt,Commodores,Miss. State,Bulldogs,0-5,2-4,1.0,0,17,17,24,0,0,7,10,14,3,0,7,-2.0,-17,-7,0.15217068325045258,-16.828696926834255
2618,2618,2020,10,NCAAF_20201107_OKLAST@KSTATE,Oklahoma State,Cowboys,Kansas State,Wildcats,5-1,4-3,1.0,0,12,20,18,0,0,13,7,3,9,0,6,1.0,-12,2,0.6112816771225749,4.631002769179645
2619,2619,2020,10,NCAAF_20201107_PITT@FSU,Pittsburgh,,Florida State,,4-4,2-5,,24,17,41,17,10,14,7,10,14,3,0,0,2.0,7,24,0.539119756300347,1.6091364423081131
2620,2620,2020,10,NCAAF_20201107_WKY@FAU,W. Kentucky,,FAU,,2-6,3-1,,0,0,6,10,0,0,3,3,0,0,3,7,-1.0,0,-4,0.1956669300775311,-14.04402629164315
2621,2621,2020,10,NCAAF_20201107_BAYLOR@IOWAST,Baylor,Bears,Iowa St.,Cyclones,1-4,5-2,0.0,21,10,31,38,14,7,3,7,0,10,21,7,-4.0,11,-7,0.2772665135378857,-9.68239210204706
2622,2622,2020,10,NCAAF_20201107_TXAM@SC,Texas A&M,Aggies,South Carolina,Gamecocks,5-1,2-4,0.0,21,0,48,3,7,14,13,14,0,0,0,3,3.0,21,45,0.583640823745647,3.4604837109617392
2623,2623,2020,10,NCAAF_20201107_UCLA@COLO,UCLA,Bruins,Colorado,Buffaloes,0-1,1-0,0.0,14,35,42,48,7,7,21,7,14,21,10,3,-1.0,-21,-6,0.5309322692676487,1.2715884480871864
2624,2624,2020,10,NCAAF_20201107_RUT@OHIOST,Rutgers,Scarlet Knights,Ohio State,Buckeyes,1-2,3-0,1.0,3,35,27,49,3,0,6,18,7,28,7,7,-2.0,-32,-22,0.00336793225783405,-44.393433174656025
2625,2625,2020,10,NCAAF_20201107_STNFRD@OREG,Stanford,Cardinal,Oregon,Ducks,0-1,1-0,1.0,7,14,14,35,7,0,0,7,7,7,14,7,-1.0,-7,-21,0.35955704924450416,-5.892243174428927
2626,2626,2020,10,NCAAF_20201107_TENN@ARK,Tennessee,Volunteers,Arkansas,Razorbacks,2-4,3-3,1.0,13,0,13,24,3,10,0,0,0,0,24,0,-1.0,13,-11,0.6717566827825701,7.2869133981876075
2627,2627,2020,10,NCAAF_20201107_SALA@CSTCAR,South Alabama,Jaguars,C. Carolina,Chanticleers,3-4,7-0,1.0,6,17,6,23,3,3,0,0,14,3,0,6,-4.0,-11,-17,0.35505729221817806,-6.089815653652977
2628,2628,2020,10,NCAAF_20201107_WASHST@OREGST,Washington St.,Cougars,Oregon State,Beavers,1-0,0-1,1.0,14,7,38,28,7,7,14,10,0,7,7,14,1.0,7,10,0.9100895757535663,21.975418351674648
2629,2629,2020,10,NCAAF_20201107_NMEX@HAWAII,New Mexico,,Hawaii,,0-2,2-1,,20,14,33,39,17,3,7,6,7,7,14,11,-2.0,6,-6,0.3485864915467033,-6.375500512512417
2630,2630,2020,10,NCAAF_20201106_MIAMI@NCST,Miami (Fla.),Hurricanes,NC State,Wolfpack,6-1,4-3,0.0,21,24,44,41,14,7,10,13,14,10,14,3,2.0,-3,3,0.6594701858108285,6.733942927211501
2631,2631,2020,10,NCAAF_20201106_SJST@SDGST,San Jose St.,Spartans,San Diego St.,Aztecs,3-0,2-1,1.0,7,10,28,17,0,7,7,14,3,7,0,7,1.0,-3,11,0.1091072026141302,-20.17294840479633
2632,2632,2020,10,NCAAF_20201106_BYU@BOISE,BYU,Cougars,Boise St.,Broncos,8-0,2-1,0.0,16,3,51,17,7,9,22,13,3,0,0,14,6.0,13,34,0.30058713877789944,-8.56390752659047
2633,2633,2020,10,NCAAF_20201105_UTAHST@NEVADA,Utah St.,Aggies,Nevada,Wolf Pack,0-3,3-0,0.0,9,21,9,34,9,0,0,0,7,14,10,3,-3.0,-12,-25,0.7717341158633793,12.198726318334252
2634,2634,2020,10,NCAAF_20201105_WYO@COLOST,Wyoming,Cowboys,Colorado St.,Rams,1-2,1-1,0.0,14,24,24,34,0,14,3,7,14,10,7,3,0.0,-10,-10,0.6222250877216338,5.100701039969067
2635,2635,2020,10,NCAAF_20201104_EMICH@KENTST,E. Michigan,,Kent St.,,0-1,1-0,,9,20,23,27,9,0,6,8,13,7,0,7,-1.0,-11,-4,0.7889922483939653,13.154865358895677
2636,2636,2020,10,NCAAF_20201104_WMICH@AKRON,W. Michigan,,Akron,,1-0,0-1,,30,13,58,13,16,14,21,7,7,6,0,0,1.0,17,45,0.8144916782256008,14.656276829336434
2637,2637,2020,10,NCAAF_20201104_BALLST@MIAOH,Ball St.,Cardinals,Miami-OH,RedHawks,0-1,1-0,0.0,14,10,31,38,7,7,7,10,0,10,14,14,-1.0,4,-7,0.25877185812325254,-10.602414781243738
2638,2638,2020,10,NCAAF_20201104_BUFF@NILL,Buffalo,Bulls,N. Illinois,Huskies,1-0,0-1,0.0,21,16,49,30,14,7,21,7,3,13,0,14,1.0,5,19,0.5609693523879604,2.5136900909978976
2639,2639,2020,10,NCAAF_20201104_OHIO@CMICH,Ohio,Bobcats,C. Michigan,Chippewas,0-1,1-0,0.0,20,20,27,30,7,13,7,0,14,6,7,3,-1.0,0,-3,0.7193100682270372,9.515475735950417
2640,2640,2020,10,NCAAF_20201104_BGREEN@TOLEDO,Bowling Green,,Toledo,,0-1,1-0,,0,21,3,38,0,0,3,0,21,0,7,10,-1.0,-21,-35,0.11444144593112338,-19.713412154960793
2641,2641,2020,11,NCAAF_20201115_CAL@UCLA,California,Golden Bears,UCLA,Bruins,0-1,1-1,0.0,10,27,10,34,3,7,0,0,7,20,0,7,-1.0,-17,-24,0.5716662010833025,2.971584619156829
2642,2642,2020,11,NCAAF_20201114_ARMY@TULANE,Army,Black Knights,Tulane,Green Wave,6-2,5-4,1.0,12,14,12,38,0,12,0,0,14,0,10,14,1.0,-2,-26,0.4912096278291388,-0.36254334869295235
2643,2643,2020,11,NCAAF_20201114_IND@MICHST,Indiana,Hoosiers,Michigan St.,Spartans,4-0,1-3,1.0,24,0,24,0,14,10,0,0,0,0,0,0,3.0,24,24,0.4726377877412882,-1.1293008797990751
2644,2644,2020,11,NCAAF_20201114_MIAMI@VATECH,Miami (Fla.),Hurricanes,Virginia Tech,Hokies,7-1,4-4,0.0,13,14,25,24,3,10,6,6,7,7,10,0,3.0,-1,1,0.5903616689062134,3.7589546319525198
2645,2645,2020,11,NCAAF_20201114_MTSU@MRSHL,Middle Tenn.,Blue Raiders,Marshall,Thundering Herd,2-6,7-0,0.0,7,21,14,42,0,7,7,0,7,14,21,0,-5.0,-14,-28,0.3416605391626746,-6.711491239434167
2646,2646,2020,11,NCAAF_20201114_PSU@NEB,Penn State,Nittany Lions,Nebraska,Cornhuskers,0-4,1-2,0.0,6,27,23,30,0,6,10,7,10,17,0,3,-1.0,-21,-7,0.9072849572300576,21.786509063799713
2647,2647,2020,11,NCAAF_20201114_TCU@WVU,TCU,Horned Frogs,West Virginia,Mountaineers,3-4,5-3,1.0,3,14,6,24,0,3,3,0,7,7,3,7,-2.0,-11,-18,0.5768593520726456,3.1895384970190435
2648,2648,2020,11,NCAAF_20201114_VANDY@UK,Vanderbilt,Commodores,Kentucky,Wildcats,0-6,3-4,0.0,14,24,35,38,0,14,7,14,14,10,7,7,-3.0,-10,-3,0.21446674826327272,-13.01409450522533
2649,2649,2020,11,NCAAF_20201114_WAKE@UNC,Wake Forest,Demon Deacons,North Carolina,Tar Heels,4-3,6-2,0.0,35,24,53,59,14,21,10,8,17,7,7,28,-2.0,11,-6,0.5875508014276081,3.640066520211917
2650,2650,2020,11,NCAAF_20201114_WCAR@LIB,W. Carolina,Catamounts,Liberty,Flames,0-1,8-0,1.0,7,28,14,58,0,7,7,0,7,21,14,16,-8.0,-21,-44,0.0614423390382729,-25.382301694032094
2651,2651,2020,11,NCAAF_20201114_ILL@RUT,Illinois,Fighting Illini,Rutgers,Scarlet Knights,1-3,1-3,0.0,7,13,23,20,0,7,10,6,10,3,7,0,0.0,-6,3,0.6113202705437292,4.652092011158857
2652,2652,2020,11,NCAAF_20201114_SALA@LALAF,South Alabama,Jaguars,Louisiana,Ragin' Cajuns,3-5,7-1,1.0,10,28,10,38,3,7,0,0,14,14,3,7,-4.0,-18,-28,0.1911059992033357,-14.376510705323085
2653,2653,2020,11,NCAAF_20201114_FRESNO@UTAHST,Fresno St.,Bulldogs,Utah St.,Aggies,3-1,0-4,1.0,28,16,35,16,7,21,0,7,13,3,0,0,3.0,12,19,0.5514912009958779,2.1294220914937796
2654,2654,2020,11,NCAAF_20201114_GAST@APLST,Georgia St.,Panthers,App. St.,Mountaineers,3-4,6-1,1.0,10,3,13,17,7,3,0,3,3,0,7,7,-3.0,7,-4,0.10744086578430267,-20.405064795127828
2655,2655,2020,11,NCAAF_20201114_UTEP@TXSA,UTEP,Miners,UTSA,Roadrunners,3-4,5-4,0.0,21,24,21,52,7,14,0,0,3,21,14,14,-2.0,-3,-31,0.266711544414476,-10.24633702057315
2656,2656,2020,11,NCAAF_20201114_COLO@STNFRD,Colorado,Buffaloes,Stanford,Cardinal,2-0,0-2,0.0,14,9,35,32,7,7,14,7,3,6,7,16,2.0,5,3,0.2932566442937815,-8.948354412720391
2657,2657,2020,11,NCAAF_20201114_LVILLE@UVA,Louisville,Cardinals,Virginia,Cavaliers,2-6,3-4,0.0,10,14,17,31,3,7,7,0,7,7,7,10,-1.0,-4,-14,0.40126470149019033,-4.114317039943671
2658,2658,2020,11,NCAAF_20201114_ND@BC,Notre Dame,Fighting Irish,Boston College,Eagles,8-0,5-4,1.0,31,16,45,31,10,21,7,7,10,6,7,8,3.0,15,14,0.8337330280228279,15.942685418477822
2659,2659,2020,11,NCAAF_20201114_SFLA@HOU,South Florida,Bulls,Houston,Cougars,1-7,3-3,0.0,0,28,21,56,0,0,7,14,14,14,14,14,-2.0,-28,-35,0.3483705954516575,-6.41185851972466
2660,2660,2020,11,NCAAF_20201114_TXSTSM@GAS,Texas St.,Bobcats,Ga. Southern,Eagles,1-9,6-2,1.0,21,27,38,40,7,14,7,10,17,10,3,10,-5.0,-6,-2,0.2273217012479809,-12.301350477607457
2661,2661,2020,11,NCAAF_20201114_USC@ARIZ,USC,Trojans,Arizona,Wildcats,2-0,0-1,0.0,17,13,34,30,10,7,3,14,7,6,7,10,2.0,4,4,0.7336841932113262,10.266157401447686
2662,2662,2020,11,NCAAF_20201114_USM@WKY,So. Miss,Golden Eagles,W. Kentucky,Hilltoppers,2-6,3-6,1.0,0,10,7,10,0,0,0,7,7,3,0,0,-1.0,-10,-3,0.5470576394119693,1.9451743227966745
2663,2663,2020,11,NCAAF_20201114_BAYLOR@TXTECH,Baylor,Bears,Texas Tech,Red Raiders,1-5,3-5,1.0,13,6,23,24,7,6,10,0,3,3,6,12,-2.0,7,-1,0.4633981642396855,-1.5115797138934113
2664,2664,2020,11,NCAAF_20201114_HAWAII@SDGST,Hawaii,Rainbow Warriors,San Diego St.,Aztecs,2-2,3-1,0.0,0,28,10,34,0,0,3,7,14,14,0,6,-1.0,-28,-24,0.21661279508638265,-12.89343227540985
2665,2665,2020,11,NCAAF_20201114_NWEST@PURDUE,Northwestern,Wildcats,Purdue,Boilermakers,4-0,2-1,1.0,17,10,27,20,7,10,7,3,3,7,3,7,2.0,7,7,0.45683555165381373,-1.783584704474265
2666,2666,2020,11,NCAAF_20201114_NEVADA@NMEX,Nevada,Wolf Pack,New Mexico,Lobos,4-0,0-3,0.0,10,13,27,20,0,10,10,7,7,6,0,7,4.0,-3,7,0.7052205967631643,8.875632550710293
2667,2667,2020,11,NCAAF_20201114_ARK@FLA,Arkansas,Razorbacks,Florida,Gators,3-4,5-1,0.0,14,35,35,63,7,7,7,14,7,28,7,21,-2.0,-21,-28,0.1028404302827286,-20.820950944876245
2668,2668,2020,11,NCAAF_20201114_OREG@WASHST,Oregon,Ducks,Washington St.,Cougars,2-0,1-1,0.0,14,19,43,29,7,7,7,22,13,6,0,10,1.0,-5,14,0.6037413019621032,4.32767295996166
2669,2669,2020,11,NCAAF_20201114_SMU@TULSA,SMU,Mustangs,Tulsa,Golden Hurricane,7-2,4-1,1.0,24,7,24,28,14,10,0,0,0,7,7,14,3.0,17,-4,0.69380278797887,8.335717114529643
2670,2670,2020,11,NCAAF_20201114_FSU@NCST,Florida State,Seminoles,NC State,Wolfpack,2-6,5-3,0.0,3,21,22,38,0,3,6,13,7,14,14,3,-3.0,-18,-16,0.4219407855437707,-3.2399744129181727
2671,2671,2020,11,NCAAF_20201114_SC@MISS,South Carolina,Gamecocks,Ole Miss,Rebels,2-5,3-4,1.0,21,24,42,59,7,14,14,7,14,10,14,21,-1.0,-3,-17,0.5573910247007179,2.375022928529006
2672,2672,2020,11,NCAAF_20201114_TEMPLE@UCF,Temple,Owls,UCF,Knights,1-5,5-2,1.0,3,21,13,38,0,3,0,10,21,0,17,0,-4.0,-18,-25,0.14610105296309017,-17.32929735978007
2673,2673,2020,11,NCAAF_20201114_WISC@MICH,Wisconsin,Badgers,Michigan,Wolverines,2-0,1-3,1.0,28,0,49,11,14,14,7,14,0,0,11,0,1.0,28,38,0.4912406736628542,-0.3612627120306797
2674,2674,2020,11,NCAAF_20201114_UNLV@SJST,UNLV,Rebels,San Jose St.,Spartans,0-4,4-0,0.0,10,24,17,34,3,7,7,0,10,14,7,3,-4.0,-14,-17,0.5532965713307094,2.2045240558129535
2675,2675,2020,11,NCAAF_20201114_OREGST@WASH,Oregon State,Beavers,Washington,Huskies,0-2,1-0,0.0,21,24,21,27,7,14,0,0,10,14,0,3,-1.0,-3,-6,0.04301721373320355,-28.243688567085655
2676,2676,2020,11,NCAAF_20201113_FAU@FIU,FAU,Owls,FIU,Panthers,4-1,0-4,1.0,24,10,38,19,7,17,0,14,0,10,0,9,4.0,14,19,0.7461346374689675,10.89762180390801
2677,2677,2020,11,NCAAF_20201113_IOWA@MINN,Iowa,Hawkeyes,Minnesota,Golden Gophers,2-2,1-3,1.0,14,0,35,7,7,7,0,21,0,0,0,7,1.0,14,28,0.7299200600546841,10.078228504452113
2678,2678,2020,11,NCAAF_20201113_ECU@CINCY,East Carolina,Pirates,Cincinnati,Bearcats,1-6,7-0,1.0,10,35,17,55,0,10,0,7,7,28,7,13,-6.0,-25,-38,0.0954631642897179,-21.517085369189886
2679,2679,2020,11,NCAAF_20201112_COLOST@BOISE,Colorado St.,Rams,Boise St.,Broncos,1-2,3-1,1.0,7,42,21,52,0,7,14,0,21,21,10,0,-2.0,-35,-31,0.1729752425790112,-15.505884845765763
2680,2680,2020,11,NCAAF_20201111_EMICH@BALLST,E. Michigan,Eagles,Ball St.,Cardinals,0-2,1-1,0.0,21,13,31,38,14,7,3,7,7,6,8,17,-1.0,8,-7,0.7499308289607682,11.09335176177467
2681,2681,2020,11,NCAAF_20201111_CMICH@NILL,C. Michigan,Chippewas,N. Illinois,Huskies,2-0,0-2,0.0,9,0,40,10,7,2,17,14,0,0,0,10,2.0,9,30,0.4060227032823345,-3.91217086506947
2682,2682,2020,11,NCAAF_20201111_TOLEDO@WMICH,Toledo,Rockets,W. Michigan,Broncos,1-1,2-0,0.0,24,14,38,41,14,10,7,7,14,0,7,20,-1.0,10,-3,0.518020108297781,0.7434002307526271
2683,2683,2020,11,NCAAF_20201110_AKRON@OHIO,Akron,Zips,Ohio,Bobcats,0-2,1-1,0.0,7,14,10,24,0,7,3,0,7,7,3,7,-1.0,-7,-14,0.09767242514874241,-21.304602316461
2684,2684,2020,11,NCAAF_20201110_KENTST@BGREEN,Kent St.,Golden Flashes,Bowling Green,Falcons,2-0,0-2,1.0,38,10,62,24,10,28,7,17,10,0,0,14,2.0,28,38,0.6282608038070632,5.38403630699554
2685,2685,2020,11,NCAAF_20201110_MIAOH@BUFF,Miami-OH,RedHawks,Buffalo,Bulls,1-1,2-0,1.0,7,14,10,42,0,7,0,3,0,14,21,7,-1.0,-7,-32,0.3541674334926286,-6.15470986367427
2686,2686,2020,12,NCAAF_20201121_APLST@CSTCAR,App. St.,Mountaineers,C. Carolina,Chanticleers,6-2,8-0,1.0,17,9,23,34,7,10,3,3,6,3,12,13,-2.0,8,-11,0.8550810264867815,17.43242293787523
2687,2687,2020,12,NCAAF_20201121_ARKST@TXSTSM,Arkansas St.,Red Wolves,Texas St.,Bobcats,3-6,2-9,0.0,24,27,45,47,3,21,7,14,10,17,0,20,1.0,-3,-2,0.8192936481675521,15.031181676548044
2688,2688,2020,12,NCAAF_20201121_ECU@TEMPLE,East Carolina,Pirates,Temple,Owls,2-6,1-6,0.0,21,3,28,3,7,14,7,0,0,3,0,0,1.0,18,25,0.18641537969602484,-14.677205246790209
2689,2689,2020,12,NCAAF_20201121_FLA@VANDY,Florida,Gators,Vanderbilt,Commodores,6-1,0-7,0.0,17,10,38,17,7,10,14,7,10,0,7,0,6.0,7,21,0.8908482576984993,20.27461361875271
2690,2690,2020,12,NCAAF_20201121_GAS@ARMY,Ga. Southern,Eagles,Army,Black Knights,6-3,7-2,1.0,21,7,27,28,14,7,6,0,0,7,14,7,-1.0,14,-1,0.2752491922611908,-9.832419192694033
2691,2691,2020,12,NCAAF_20201121_ILL@NEB,Illinois,Fighting Illini,Nebraska,Cornhuskers,2-3,1-3,0.0,28,10,41,23,14,14,10,3,7,3,7,6,1.0,18,18,0.27789892790155823,-9.701999554976283
2692,2692,2020,12,NCAAF_20201121_IND@OHIOST,Indiana,Hoosiers,Ohio State,Buckeyes,4-1,4-0,1.0,7,28,35,42,0,7,14,14,7,21,14,0,0.0,-21,-7,0.060672504633578095,-25.513526416664035
2693,2693,2020,12,NCAAF_20201121_LSU@ARK,LSU,Tigers,Arkansas,Razorbacks,3-3,3-5,0.0,20,14,27,24,3,17,0,7,7,7,7,3,0.0,6,3,0.9456873663859122,26.423460719092418
2694,2694,2020,12,NCAAF_20201121_SFA@MEMP,S.F. Austin,Lumberjacks,Memphis,Tigers,6-4,5-2,1.0,14,20,14,56,0,14,0,0,14,6,15,21,1.0,-6,-42,0.003210847096657088,-44.886111211602156
2695,2695,2020,12,NCAAF_20201121_FIU@WKY,FIU,Panthers,W. Kentucky,Hilltoppers,0-5,4-6,0.0,13,10,21,38,7,6,0,8,0,10,14,14,-4.0,3,-17,0.5574116914159808,2.378339863436395
2696,2696,2020,12,NCAAF_20201121_RICE@NTEXAS,Rice,Owls,North Texas,Mean Green,1-2,3-3,1.0,10,14,17,27,10,0,0,7,0,14,3,10,-2.0,-4,-10,0.22682118581217692,-12.341408350629422
2697,2697,2020,12,NCAAF_20201121_NAL@BYU,North Alabama,Lions,BYU,Cougars,0-4,9-0,1.0,7,42,14,66,0,7,0,7,14,28,14,10,-9.0,-35,-52,0.04244570181506957,-28.376414410903863
2698,2698,2020,12,NCAAF_20201121_TXSA@USM,UTSA,Roadrunners,So. Miss,Golden Eagles,6-4,2-7,0.0,9,10,23,20,0,9,14,0,3,7,3,7,4.0,-1,3,0.3276346584808747,-7.3528040687639304
2699,2699,2020,12,NCAAF_20201121_CAL@OREGST,California,Golden Bears,Oregon State,Beavers,0-2,1-2,0.0,20,14,27,31,7,13,0,7,14,0,3,14,-1.0,6,-4,0.777392343845225,12.572960113574254
2700,2700,2020,12,NCAAF_20201121_CINCY@UCF,Cincinnati,Bearcats,UCF,Knights,8-0,5-3,0.0,19,17,36,33,3,16,3,14,14,3,8,8,3.0,2,3,0.26851684317398894,-10.16660435347967
2701,2701,2020,12,NCAAF_20201121_GAST@SALA,Georgia St.,Panthers,South Alabama,Jaguars,4-4,3-6,1.0,7,7,31,14,0,7,14,10,7,0,7,0,1.0,0,17,0.6093703653708644,4.5731800224717745
2702,2702,2020,12,NCAAF_20201121_IOWA@PSU,Iowa,Hawkeyes,Penn State,Nittany Lions,3-2,0-5,0.0,24,7,41,21,3,21,7,10,7,0,14,0,3.0,17,20,0.3852288447215301,-4.805363239987287
2703,2703,2020,12,NCAAF_20201121_MTSU@TROY,Middle Tenn.,Blue Raiders,Troy,Trojans,3-6,4-4,0.0,17,10,20,17,7,10,0,3,3,7,0,7,-1.0,7,3,0.41262639386663,-3.6363329487805913
2704,2704,2020,12,NCAAF_20201121_SDGST@NEVADA,San Diego St.,Aztecs,Nevada,Wolf Pack,3-2,5-0,0.0,21,16,21,26,7,14,0,0,6,10,10,0,-2.0,5,-5,0.7439492255607895,10.796788339856334
2705,2705,2020,12,NCAAF_20201121_UCLA@OREG,UCLA,Bruins,Oregon,Ducks,1-2,3-0,1.0,21,24,35,38,7,14,7,7,14,10,14,0,-2.0,-3,-3,0.19040334826174377,-14.433910947225058
2706,2706,2020,12,NCAAF_20201121_WISC@NWEST,Wisconsin,Badgers,Northwestern,Wildcats,2-1,5-0,1.0,7,14,7,17,7,0,0,0,7,7,0,3,-3.0,-7,-10,0.8278400924380133,15.57446963664313
2707,2707,2020,12,NCAAF_20201121_ABIL@UVA,Abil Christian,Wildcats,Virginia,Cavaliers,1-5,4-4,0.0,7,28,15,55,0,7,0,8,14,14,14,13,-3.0,-21,-40,0.010910697270804182,-37.77181793261502
2708,2708,2020,12,NCAAF_20201121_KSTATE@IOWAST,Kansas State,Wildcats,Iowa St.,Cyclones,4-4,6-2,0.0,0,35,0,45,0,0,0,0,7,28,3,7,-2.0,-35,-45,0.38264231439899077,-4.916896028893348
2709,2709,2020,12,NCAAF_20201121_UK@BAMA,Kentucky,Wildcats,Alabama,Crimson Tide,3-5,7-0,1.0,3,28,3,63,3,0,0,0,7,21,21,14,-4.0,-25,-60,0.061212623725214854,-25.43975713002078
2710,2710,2020,12,NCAAF_20201121_VATECH@PITT,Virginia Tech,Hokies,Pittsburgh,Panthers,4-5,5-4,0.0,14,23,14,47,0,14,0,0,6,17,17,7,-1.0,-9,-33,0.5856050556998117,3.561558475599327
2711,2711,2020,12,NCAAF_20201121_TENN@AUBURN,Tennessee,Volunteers,Auburn,Tigers,2-5,5-2,1.0,10,10,17,30,7,3,0,7,0,10,10,10,-3.0,0,-13,0.11490261330136209,-19.777386391817345
2712,2712,2020,12,NCAAF_20201121_LIB@NCST,Liberty,Flames,NC State,Wolfpack,8-1,6-3,0.0,7,7,14,15,0,7,7,0,0,7,2,6,2.0,0,-1,0.20726864002226597,-13.437913652935435
2713,2713,2020,12,NCAAF_20201121_MISSST@UGA,Miss. State,Bulldogs,Georgia,Bulldogs,2-5,5-2,1.0,17,17,24,31,3,14,7,0,0,17,7,7,-3.0,0,-7,0.19903486303979256,-13.917806904265603
2714,2714,2020,12,NCAAF_20201121_MIZZOU@SC,Missouri,Tigers,South Carolina,Gamecocks,3-3,2-6,0.0,17,0,17,10,7,10,0,0,0,0,3,7,1.0,17,7,0.6099199286284401,4.596763810550442
2715,2715,2020,12,NCAAF_20201121_OKLAST@OKLA,Oklahoma State,Cowboys,Oklahoma,Sooners,5-2,6-2,0.0,13,27,13,41,7,6,0,0,21,6,0,14,-1.0,-14,-28,0.2580518154502154,-10.69458507897707
2716,2716,2020,12,NCAAF_20201121_ARIZ@WASH,Arizona,Wildcats,Washington,Huskies,0-2,2-0,0.0,0,24,27,44,0,0,0,27,17,7,13,7,-2.0,-24,-17,0.15227073464085772,-16.909782718500423
2717,2717,2020,12,NCAAF_20201121_USC@UTAH,USC,Trojans,Utah,Utes,3-0,0-1,0.0,24,17,33,17,3,21,6,3,3,14,0,0,3.0,7,16,0.3650787164226451,-5.680541571197978
2718,2718,2020,12,NCAAF_20201121_BOISE@HAWAII,Boise St.,Broncos,Hawaii,Rainbow Warriors,4-1,2-3,1.0,19,3,40,32,3,16,21,0,3,0,14,15,2.0,16,8,0.8992746157700552,21.038418264411348
2719,2719,2020,12,NCAAF_20201120_CUSE@LVILLE,Syracuse,Orange,Louisville,Cardinals,1-8,3-6,1.0,0,20,0,30,0,0,0,0,3,17,7,3,-2.0,-20,-30,0.5243490074684373,1.0058132502163062
2720,2720,2020,12,NCAAF_20201120_PURDUE@MINN,Purdue,Boilermakers,Minnesota,Golden Gophers,2-2,2-3,0.0,10,21,31,34,7,3,14,7,14,7,7,6,0.0,-11,-3,0.5109288484678246,0.45122683777481143
2721,2721,2020,12,NCAAF_20201120_UMASS@FAU,UMass,Minutemen,FAU,Owls,0-3,5-1,1.0,0,7,2,24,0,0,2,0,7,0,14,3,-5.0,-7,-22,0.0466165522255414,-27.6451778571942
2722,2722,2020,12,NCAAF_20201120_NMEX@AF,New Mexico,Lobos,Air Force,Falcons,0-4,2-2,1.0,0,21,0,28,0,0,0,0,7,14,0,7,-2.0,-21,-28,0.1492987728817765,-17.118985261646685
2723,2723,2020,12,NCAAF_20201118_NILL@BALLST,N. Illinois,Huskies,Ball St.,Cardinals,0-3,2-1,1.0,14,14,25,31,7,7,0,11,0,14,6,11,-2.0,0,-6,0.7668093920227999,11.995933715516458
2724,2724,2020,12,NCAAF_20201118_TOLEDO@EMICH,Toledo,Rockets,E. Michigan,Eagles,2-1,0-3,1.0,24,7,45,28,7,17,14,7,0,7,6,15,2.0,17,17,0.5791764575258005,3.2903622320676504
2725,2725,2020,12,NCAAF_20201118_WMICH@CMICH,W. Michigan,Broncos,C. Michigan,Chippewas,3-0,2-1,0.0,31,14,52,44,14,17,14,7,14,0,16,14,1.0,17,8,0.574398824741299,3.0893938894112125
2726,2726,2020,12,NCAAF_20201117_BUFF@BGREEN,Buffalo,Bulls,Bowling Green,Falcons,3-0,0-3,1.0,21,3,42,17,7,14,14,7,3,0,0,14,3.0,18,25,0.931669389803032,24.51198265519315
2727,2727,2020,12,NCAAF_20201117_AKRON@KENTST,Akron,Zips,Kent St.,Golden Flashes,0-3,3-0,1.0,28,35,35,69,7,21,0,7,14,21,20,14,-3.0,-7,-34,0.43473451199698576,-2.70645600133696
2728,2728,2020,13,NCAAF_20201128_BALLST@TOLEDO,Ball St.,Cardinals,Toledo,Rockets,3-1,2-2,1.0,17,3,27,24,14,3,7,3,0,3,6,15,1.0,14,3,0.21073034505280486,-13.273120296732259
2729,2729,2020,13,NCAAF_20201128_BGREEN@OHIO,Bowling Green,Falcons,Ohio,Bobcats,0-4,2-1,0.0,10,45,10,52,3,7,0,0,21,24,7,0,-2.0,-35,-42,0.06165894519072346,-25.44356350359908
2730,2730,2020,13,NCAAF_20201128_GAS@GAST,Ga. Southern,Eagles,Georgia St.,Panthers,6-4,5-4,0.0,14,13,24,30,0,14,3,7,3,10,0,17,1.0,1,-6,0.6334435305833378,5.63008725133875
2731,2731,2020,13,NCAAF_20201128_KENTST@BUFF,Kent St.,Golden Flashes,Buffalo,Bulls,3-1,4-0,0.0,24,35,41,70,10,14,7,10,21,14,14,21,-1.0,-11,-29,0.15854804393763933,-16.51843883236029
2732,2732,2020,13,NCAAF_20201128_MD@IND,Maryland,Terrapins,Indiana,Hoosiers,2-2,5-1,1.0,3,7,11,27,0,3,0,8,7,0,10,10,-3.0,-4,-16,0.28359075999890315,-9.447784874776175
2733,2733,2020,13,NCAAF_20201128_NCST@CUSE,NC State,Wolfpack,Syracuse,Orange,7-3,1-9,0.0,14,22,36,29,7,7,13,9,7,15,7,0,6.0,-8,7,0.6082212365747472,4.535373119358269
2734,2734,2020,13,NCAAF_20201128_NILL@WMICH,N. Illinois,Huskies,W. Michigan,Broncos,0-4,4-0,1.0,17,20,27,30,3,14,7,3,7,13,0,10,-4.0,-3,-3,0.4651618183260602,-1.4436938180614334
2735,2735,2020,13,NCAAF_20201128_PSU@MICH,Penn State,Nittany Lions,Michigan,Wolverines,1-5,2-4,1.0,17,7,27,17,7,10,3,7,7,0,3,7,-1.0,10,10,0.5542480651981117,2.2521421394068284
2736,2736,2020,13,NCAAF_20201128_SMU@ECU,SMU,Mustangs,East Carolina,Pirates,7-3,3-6,1.0,7,45,38,52,7,0,17,14,21,24,0,7,4.0,-38,-14,0.8586727010577277,17.739137948765688
2737,2737,2020,13,NCAAF_20201128_TXTECH@OKLAST,Texas Tech,Red Raiders,Oklahoma State,Cowboys,3-6,6-2,1.0,17,21,44,50,7,10,14,13,7,14,20,9,-3.0,-4,-6,0.3301535145660466,-7.25646138397417
2738,2738,2020,13,NCAAF_20201128_UK@FLA,Kentucky,Wildcats,Florida,Gators,3-6,7-1,1.0,10,14,10,34,0,10,0,0,7,7,17,3,-4.0,-4,-24,0.3041393309508398,-8.462479807028785
2739,2739,2020,13,NCAAF_20201128_VANDY@MIZZOU,Vanderbilt,Commodores,Missouri,Tigers,0-8,4-3,1.0,0,21,0,41,0,0,0,0,7,14,6,14,-4.0,-21,-41,0.17962974960906175,-15.137016806458064
2740,2740,2020,13,NCAAF_20201128_MIAOH@AKRON,Miami-OH,RedHawks,Akron,Zips,2-1,0-4,0.0,24,0,38,7,7,17,7,7,0,0,0,7,2.0,24,31,0.7951031819099469,13.609404947798453
2741,2741,2020,13,NCAAF_20201128_CSTCAR@TXSTSM,C. Carolina,Chanticleers,Texas St.,Bobcats,9-0,2-10,0.0,35,7,49,14,14,21,7,7,7,0,0,7,7.0,28,35,0.7009955483535459,8.705752538677302
2742,2742,2020,13,NCAAF_20201128_LALAF@LAMON,Louisiana,Ragin' Cajuns,UL-Monroe,Warhawks,8-1,0-9,1.0,49,14,70,20,21,28,7,14,14,0,0,6,8.0,35,50,0.7908381372466999,13.36299283992355
2743,2743,2020,13,NCAAF_20201128_NTEXAS@TXSA,North Texas,Mean Green,UTSA,Roadrunners,3-4,7-4,0.0,7,28,17,49,0,7,3,7,7,21,7,14,-4.0,-21,-32,0.679272293848546,7.688649062851823
2744,2744,2020,13,NCAAF_20201128_SALA@ARKST,South Alabama,Jaguars,Arkansas St.,Red Wolves,4-6,3-7,1.0,14,17,38,31,7,7,14,10,7,10,7,7,1.0,-3,7,0.20745083538952913,-13.461486821292965
2745,2745,2020,13,NCAAF_20201128_AUBURN@BAMA,Auburn,Tigers,Alabama,Crimson Tide,5-3,8-0,1.0,3,21,13,42,0,3,3,7,7,14,14,7,-3.0,-18,-29,0.20338061768539262,-13.697735726359838
2746,2746,2020,13,NCAAF_20201128_NWEST@MICHST,Northwestern,Wildcats,Michigan St.,Spartans,5-1,2-3,0.0,6,17,20,29,0,6,7,7,10,7,0,12,3.0,-11,-9,0.5234761381484154,0.9721741032889213
2747,2747,2020,13,NCAAF_20201128_PITT@CLEM,Pittsburgh,Panthers,Clemson,Tigers,5-5,8-1,1.0,10,38,17,52,0,10,7,0,31,7,7,7,-3.0,-28,-35,0.05077158404258142,-27.035607088825827
2748,2748,2020,13,NCAAF_20201128_TROY@APLST,Troy,Trojans,App. St.,Mountaineers,4-5,7-2,1.0,10,34,10,47,0,10,0,0,21,13,13,0,-3.0,-24,-37,0.29753958202388975,-8.775498538521106
2749,2749,2020,13,NCAAF_20201128_LVILLE@BC,Louisville,Cardinals,Boston College,Eagles,3-7,6-4,1.0,10,13,27,34,3,7,3,14,7,6,7,14,-3.0,-3,-7,0.39263398937487615,-4.498628033789146
2750,2750,2020,13,NCAAF_20201128_MISSST@MISS,Miss. State,Bulldogs,Ole Miss,Rebels,2-6,4-4,1.0,14,21,24,31,0,14,0,10,14,7,0,10,-2.0,-7,-7,0.6766462241792129,7.567722176709367
2751,2751,2020,13,NCAAF_20201128_RUT@PURDUE,Rutgers,Scarlet Knights,Purdue,Boilermakers,2-4,2-3,0.0,13,23,37,30,13,0,21,3,7,16,7,0,0.0,-10,7,0.11891066338555578,-19.490551814858918
2752,2752,2020,13,NCAAF_20201128_SDGST@COLO,San Diego St.,Aztecs,Colorado,Buffaloes,3-3,3-0,1.0,10,14,10,20,0,10,0,0,7,7,3,3,0.0,-4,-10,0.530561877123621,1.2661116095227953
2753,2753,2020,13,NCAAF_20201128_DUKE@GATECH,Duke,Blue Devils,Georgia Tech,Yellow Jackets,2-7,3-5,0.0,26,28,33,56,7,19,7,0,14,14,14,14,-1.0,-2,-23,0.5284018198189959,1.1764677854698675
2754,2754,2020,13,NCAAF_20201128_KSTATE@BAYLOR,Kansas State,Wildcats,Baylor,Bears,4-5,2-5,1.0,17,6,31,32,14,3,0,14,6,0,9,17,2.0,11,-1,0.5881967011109972,3.6804719645049317
2755,2755,2020,13,NCAAF_20201128_LSU@TXAM,LSU,Tigers,Texas A&M,Aggies,3-4,6-1,0.0,0,13,7,20,0,0,0,7,10,3,7,0,-3.0,-13,-13,0.6998521041316531,8.651418195131441
2756,2756,2020,13,NCAAF_20201128_MEMP@NAVY,Memphis,Tigers,Navy,Midshipmen,6-2,3-5,0.0,7,7,10,7,7,0,0,3,7,0,0,0,3.0,0,3,0.6851086291906634,7.958899965106184
2757,2757,2020,13,NCAAF_20201128_UGA@SC,Georgia,Bulldogs,South Carolina,Gamecocks,6-2,2-7,0.0,28,10,45,16,21,7,10,7,0,10,0,6,4.0,18,29,0.8859029057535335,19.896291346324915
2758,2758,2020,13,NCAAF_20201128_UTAH@WASH,Utah,Utes,Washington,Huskies,0-2,3-0,1.0,21,0,21,24,7,14,0,0,0,0,17,7,-3.0,21,-3,0.4534015710387076,-1.9329870268364857
2759,2759,2020,13,NCAAF_20201128_ARIZ@UCLA,Arizona,Wildcats,UCLA,Bruins,0-3,2-2,1.0,7,20,10,27,7,0,3,0,3,17,0,7,-2.0,-13,-17,0.47580272057200723,-1.0020735446340723
2760,2760,2020,13,NCAAF_20201128_TCU@KANSAS,TCU,Horned Frogs,Kansas,Jayhawks,4-4,0-8,1.0,38,12,59,23,24,14,7,14,6,6,8,3,4.0,26,36,0.9169896920742491,22.86962347956012
2761,2761,2020,13,NCAAF_20201128_NEVADA@HAWAII,Nevada,Wolf Pack,Hawaii,Rainbow Warriors,5-1,3-3,1.0,7,10,21,24,0,7,0,14,0,10,7,7,2.0,-3,-3,0.5673784986404478,2.802001819252382
2762,2762,2020,13,NCAAF_20201127_IOWAST@TEXAS,Iowa St.,Cyclones,Texas,Longhorns,7-2,5-3,0.0,10,13,23,20,7,3,3,10,13,0,7,0,2.0,-3,3,0.5220662996849585,0.9137295112924448
2763,2763,2020,13,NCAAF_20201127_UMASS@LIB,UMass,Minutemen,Liberty,Flames,0-4,9-1,1.0,0,31,0,45,0,0,0,0,14,17,14,0,-9.0,-31,-45,0.1388981540210834,-17.919240538584063
2764,2764,2020,13,NCAAF_20201127_NEB@IOWA,Nebraska,Cornhuskers,Iowa,Hawkeyes,1-4,4-2,0.0,13,13,20,26,0,13,7,0,10,3,7,6,-3.0,0,-6,0.1530325275496911,-16.89935816093555
2765,2765,2020,13,NCAAF_20201127_ND@UNC,Notre Dame,Fighting Irish,North Carolina,Tar Heels,9-0,6-3,1.0,17,17,31,17,14,3,7,7,14,3,0,0,3.0,0,14,0.8631417164682366,18.072145107005326
2766,2766,2020,13,NCAAF_20201127_UCF@SFLA,UCF,Knights,South Florida,Bulls,6-3,1-8,0.0,31,14,58,46,14,17,14,13,7,7,14,18,5.0,17,12,0.9080535075790304,21.941028019290457
2767,2767,2020,13,NCAAF_20201127_CMICH@EMICH,C. Michigan,Chippewas,E. Michigan,Eagles,3-1,0-4,1.0,6,17,31,23,6,0,0,25,7,10,3,3,3.0,-11,8,0.4939778792687365,-0.2492484482539794
2768,2768,2020,13,NCAAF_20201127_WYO@UNLV,Wyoming,Cowboys,UNLV,Rebels,2-2,0-5,1.0,17,7,45,14,10,7,21,7,0,7,0,7,2.0,10,31,0.7827356626326132,12.902874319586715
2769,2769,2020,13,NCAAF_20201127_STNFRD@CAL,Stanford,Cardinal,California,Golden Bears,1-2,0-3,0.0,10,10,24,23,0,10,14,0,7,3,7,6,1.0,0,1,0.6390214833508312,5.875391553895497
2770,2770,2020,13,NCAAF_20201127_OREG@OREGST,Oregon,Ducks,Oregon State,Beavers,3-1,2-2,1.0,24,13,38,41,14,10,7,7,7,6,6,22,1.0,11,-3,0.9325131737871359,24.68038150662892
2771,2771,2020,13,NCAAF_20201126_NMEX@UTAHST,New Mexico,Lobos,Utah St.,Aggies,0-5,1-4,1.0,13,6,27,41,3,10,7,7,3,3,28,7,-1.0,7,-14,0.12696605050338872,-18.83672296317775
2772,2772,2020,14,NCAAF_20201206_WKY@CHARLO,W. Kentucky,Hilltoppers,Charlotte,49ers,5-6,2-4,0.0,17,0,37,19,3,14,10,10,0,0,7,12,3.0,17,18,0.6392149615360598,5.886600284889937
2773,2773,2020,14,NCAAF_20201206_WASHST@USC,Washington St.,Cougars,USC,Trojans,1-2,4-0,1.0,6,35,13,38,0,6,0,7,28,7,3,0,-3.0,-29,-25,0.49984996247754576,-0.00621246498428718
2774,2774,2020,14,NCAAF_20201205_ARK@MIZZOU,Arkansas,Razorbacks,Missouri,Tigers,3-6,5-3,0.0,27,20,48,50,6,21,6,15,10,10,3,27,-2.0,7,-2,0.17112232069294775,-15.688398755877301
2775,2775,2020,14,NCAAF_20201205_KANSAS@TXTECH,Kansas,Jayhawks,Texas Tech,Red Raiders,0-9,4-6,1.0,3,10,13,16,0,3,3,7,10,0,3,3,-4.0,-7,-3,0.14454920762448287,-17.511428838174538
2776,2776,2020,14,NCAAF_20201205_MEMP@TULANE,Memphis,Tigers,Tulane,Green Wave,6-3,6-5,0.0,14,21,21,35,7,7,7,0,14,7,7,7,0.0,-7,-14,0.6537741624175496,6.533617706331825
2777,2777,2020,14,NCAAF_20201205_NEB@PURDUE,Nebraska,Cornhuskers,Purdue,Boilermakers,2-4,2-4,0.0,27,13,37,27,17,10,7,3,3,10,7,7,0.0,14,10,0.3832562687150195,-4.905038352418842
2778,2778,2020,14,NCAAF_20201205_OHIOST@MICHST,Ohio State,Buckeyes,Michigan St.,Spartans,5-0,2-4,0.0,28,0,52,12,14,14,10,14,0,0,7,5,3.0,28,40,0.9342503840472394,24.913669191935014
2779,2779,2020,14,NCAAF_20201205_OKLAST@TCU,Oklahoma State,Cowboys,TCU,Horned Frogs,6-3,5-4,1.0,16,7,22,29,13,3,6,0,0,7,14,8,1.0,9,-7,0.5350220213148132,1.4519920515505191
2780,2780,2020,14,NCAAF_20201205_PSU@RUT,Penn State,Nittany Lions,Rutgers,Scarlet Knights,2-5,2-5,1.0,17,0,23,7,7,10,3,3,0,0,7,0,0.0,17,16,0.9793449842544295,33.70469848394089
2781,2781,2020,14,NCAAF_20201205_RICE@MRSHL,Rice,Owls,Marshall,Thundering Herd,2-2,7-1,0.0,10,0,20,0,7,3,10,0,0,0,0,0,-5.0,10,20,0.10643991296121302,-20.57702498998674
2782,2782,2020,14,NCAAF_20201205_TEXAS@KSTATE,Texas,Longhorns,Kansas State,Wildcats,6-3,4-6,0.0,31,17,69,31,17,14,35,3,7,10,14,0,2.0,14,38,0.6393502168318486,5.892568198823028
2783,2783,2020,14,NCAAF_20201205_TOLEDO@NILL,Toledo,Rockets,N. Illinois,Huskies,3-2,0-5,0.0,24,24,41,24,7,17,0,17,7,17,0,0,3.0,0,17,0.544157395539058,1.8321338921120969
2784,2784,2020,14,NCAAF_20201205_TXAM@AUBURN,Texas A&M,Aggies,Auburn,Tigers,7-1,5-4,0.0,14,10,31,20,7,7,0,17,0,10,10,0,2.0,4,11,0.3219469328472663,-7.6359270420904295
2785,2785,2020,14,NCAAF_20201205_WCAR@UNC,W. Carolina,Catamounts,North Carolina,Tar Heels,0-3,7-3,1.0,3,42,9,49,3,0,0,6,21,21,7,0,-7.0,-39,-40,0.0075880029343309285,-40.109744060468984
2786,2786,2020,14,NCAAF_20201205_BALLST@CMICH,Ball St.,Cardinals,C. Michigan,Chippewas,4-1,3-2,0.0,24,7,45,20,10,14,14,7,0,7,7,6,1.0,17,25,0.29774637334313747,-8.76963139400425
2787,2787,2020,14,NCAAF_20201205_BGREEN@AKRON,Bowling Green,Falcons,Akron,Zips,0-5,1-4,0.0,3,17,3,31,3,0,0,0,3,14,7,7,-1.0,-14,-28,0.4128575993524082,-3.637407360392899
2788,2788,2020,14,NCAAF_20201205_EMICH@WMICH,E. Michigan,Eagles,W. Michigan,Broncos,1-4,4-1,1.0,30,21,53,42,9,21,13,10,7,14,7,14,-3.0,9,11,0.41728329624542726,-3.4498901145741456
2789,2789,2020,14,NCAAF_20201205_TROY@SALA,Troy,Trojans,South Alabama,Jaguars,5-5,4-7,1.0,27,0,29,0,3,24,0,2,0,0,0,0,1.0,27,29,0.8051512979919595,14.208771347894753
2790,2790,2020,14,NCAAF_20201205_CUSE@ND,Syracuse,Orange,Notre Dame,Fighting Irish,1-10,10-0,0.0,7,24,21,45,0,7,7,7,3,21,14,7,-9.0,-17,-24,0.10495606866833507,-20.711179909843963
2791,2791,2020,14,NCAAF_20201205_LAMON@ARKST,UL-Monroe,Warhawks,Arkansas St.,Red Wolves,0-10,4-7,1.0,7,28,15,48,7,0,8,0,14,14,7,13,-4.0,-21,-33,0.23694767172669973,-11.829910278037573
2792,2792,2020,14,NCAAF_20201205_BC@UVA,Boston College,Eagles,Virginia,Cavaliers,6-5,5-4,1.0,17,20,32,43,7,10,0,15,6,14,10,13,1.0,-3,-11,0.5086602319247593,0.3586143763668588
2793,2793,2020,14,NCAAF_20201205_FLA@TENN,Florida,Gators,Tennessee,Volunteers,8-1,2-6,0.0,17,7,31,19,3,14,7,7,0,7,0,12,6.0,10,12,0.8180170534245139,14.996178609298227
2794,2794,2020,14,NCAAF_20201205_IND@WISC,Indiana,Hoosiers,Wisconsin,Badgers,6-1,2-2,0.0,7,3,14,6,0,7,7,0,0,3,3,0,4.0,4,8,0.19060636960349253,-14.464772411739887
2795,2795,2020,14,NCAAF_20201205_IOWA@ILL,Iowa,Hawkeyes,Illinois,Fighting Illini,5-2,2-4,1.0,13,14,35,21,0,13,8,14,7,7,0,7,3.0,-1,14,0.9339123362173857,24.870105270632166
2796,2796,2020,14,NCAAF_20201205_TULSA@NAVY,Tulsa,Golden Hurricane,Navy,Midshipmen,6-1,3-6,1.0,6,3,19,6,0,6,7,6,0,3,3,0,3.0,3,13,0.3809603295744779,-5.004478490882775
2797,2797,2020,14,NCAAF_20201205_WVU@IOWAST,West Virginia,Mountaineers,Iowa St.,Cyclones,5-4,8-2,1.0,0,21,6,42,0,0,0,6,7,14,14,7,-3.0,-21,-36,0.36796329162893204,-5.570950117095549
2798,2798,2020,14,NCAAF_20201205_GATECH@NCST,Georgia Tech,Yellow Jackets,NC State,Wolfpack,3-6,8-3,0.0,7,20,13,23,0,7,3,3,3,17,0,3,-5.0,-13,-10,0.40738244561317005,-3.8700434130637404
2799,2799,2020,14,NCAAF_20201205_STNFRD@WASH,Stanford,Cardinal,Washington,Huskies,2-2,3-1,1.0,24,3,31,26,14,10,7,0,0,3,13,10,-1.0,21,5,0.2873762253139346,-9.268046081932766
2800,2800,2020,14,NCAAF_20201205_BYU@CSTCAR,BYU,Cougars,C. Carolina,Chanticleers,9-1,10-0,0.0,14,13,17,22,0,14,3,0,6,7,3,6,-1.0,1,-5,0.8374251753175191,16.25318884576984
2801,2801,2020,14,NCAAF_20201205_FAU@GAS,FAU,Owls,Ga. Southern,Eagles,5-2,7-4,0.0,0,10,3,20,0,0,3,0,0,10,0,10,-2.0,-10,-17,0.766316046029174,12.005219332368142
2802,2802,2020,14,NCAAF_20201205_SJST@HAWAII,San Jose St.,Spartans,Hawaii,Rainbow Warriors,5-0,3-4,1.0,21,10,35,24,21,0,7,7,0,10,7,7,2.0,11,11,0.3725377179016395,-5.370861624702343
2803,2803,2020,14,NCAAF_20201205_COLO@ARIZ,Colorado,Buffaloes,Arizona,Wildcats,4-0,0-4,0.0,14,13,24,13,0,14,7,3,10,3,0,0,4.0,1,11,0.5051799724608539,0.21448835279761624
2804,2804,2020,14,NCAAF_20201205_COLOST@SDGST,Colorado St.,Rams,San Diego St.,Aztecs,1-3,4-3,1.0,17,23,17,29,0,17,0,0,7,16,0,6,-3.0,-6,-12,0.3149985443808583,-7.957537105498318
2805,2805,2020,14,NCAAF_20201205_OREG@CAL,Oregon,Ducks,California,Golden Bears,3-2,1-3,1.0,17,14,17,21,3,14,0,0,7,7,7,0,2.0,3,-4,0.7678255662604838,12.086760894646886
2806,2806,2020,14,NCAAF_20201205_CLEM@VATECH,Clemson,Tigers,Virginia Tech,Hokies,9-1,4-6,0.0,17,10,45,10,10,7,14,14,7,3,0,0,5.0,7,35,0.9361536919076179,25.16224374398132
2807,2807,2020,14,NCAAF_20201205_SC@UK,South Carolina,Gamecocks,Kentucky,Wildcats,2-8,4-6,1.0,3,27,18,41,3,0,7,8,10,17,7,7,-2.0,-24,-23,0.47184994067533925,-1.166552375658057
2808,2808,2020,14,NCAAF_20201205_BAMA@LSU,Alabama,Crimson Tide,LSU,Tigers,9-0,3-5,1.0,45,14,55,17,21,24,7,3,0,14,3,0,6.0,31,38,0.8085034260720446,14.410766850288724
2809,2809,2020,14,NCAAF_20201205_BAYLOR@OKLA,Baylor,Bears,Oklahoma,Sooners,2-6,7-2,0.0,0,10,14,27,0,0,7,7,3,7,7,10,-5.0,-10,-13,0.1123307719104556,-20.057349915962845
2810,2810,2020,14,NCAAF_20201205_MIAMI@DUKE,Miami (Fla.),Hurricanes,Duke,Blue Devils,8-1,2-8,1.0,21,0,48,0,14,7,21,6,0,0,0,0,6.0,21,48,0.7309234317949131,10.169006457988758
2811,2811,2020,14,NCAAF_20201205_FRESNO@NEVADA,Fresno St.,Bulldogs,Nevada,Wolf Pack,3-2,6-1,0.0,20,24,26,37,7,13,0,6,17,7,0,13,-3.0,-4,-11,0.77776324295117,12.631152850552894
2812,2812,2020,14,NCAAF_20201205_OREGST@UTAH,Oregon State,Beavers,Utah,Utes,2-3,1-2,0.0,10,16,24,30,0,10,0,14,6,10,7,7,1.0,-6,-6,0.07249117039739228,-24.075673446676774
2813,2813,2020,14,NCAAF_20201205_UCLA@ARIZST,UCLA,Bruins,Arizona St.,Sun Devils,3-2,0-2,0.0,17,3,25,18,0,17,0,8,0,3,9,6,3.0,14,7,0.4097906626470309,-3.7676278510471093
2814,2814,2020,14,NCAAF_20201205_WYO@NMEX,Wyoming,Cowboys,New Mexico,Lobos,2-3,1-5,0.0,13,10,16,17,3,10,0,3,0,10,0,7,1.0,3,-1,0.8337223935901064,16.006224295016636
2815,2815,2020,14,NCAAF_20201204_LALAF@APLST,Louisiana,Ragin' Cajuns,App. St.,Mountaineers,9-1,7-3,1.0,9,10,24,21,0,9,15,0,7,3,0,11,2.0,-1,3,0.3021584842531214,-8.559997855883239
2816,2816,2020,14,NCAAF_20201203_LATECH@NTEXAS,Louisiana Tech,Bulldogs,North Texas,Mean Green,5-3,3-5,0.0,28,17,42,31,7,21,14,0,14,3,7,7,2.0,11,11,0.5435860130431579,1.808331109906021
2817,2817,2020,14,NCAAF_20201203_AF@UTAHST,Air Force,Falcons,Utah St.,Aggies,3-2,1-5,0.0,21,7,35,7,7,14,7,7,7,0,0,0,2.0,14,28,0.4732532742461437,-1.1083078963345088
2818,2818,2020,15,NCAAF_20201212_BAMA@ARK,Alabama,Crimson Tide,Arkansas,Razorbacks,10-0,3-7,0.0,38,3,52,3,10,28,7,7,3,0,0,0,7.0,35,49,0.9913506892814453,39.43249358578578
2819,2819,2020,15,NCAAF_20201212_ILL@NWEST,Illinois,Fighting Illini,Northwestern,Wildcats,2-5,6-1,1.0,3,14,10,28,3,0,0,7,0,14,14,0,-4.0,-11,-18,0.2238713523117848,-12.576786114581864
2820,2820,2020,15,NCAAF_20201212_MICHST@PSU,Michigan St.,Spartans,Penn State,Nittany Lions,2-5,3-5,1.0,21,10,24,39,0,21,3,0,3,7,15,14,-1.0,11,-15,0.16222124934929316,-16.323829111983514
2821,2821,2020,15,NCAAF_20201212_MINN@NEB,Minnesota,Golden Gophers,Nebraska,Cornhuskers,3-3,2-5,0.0,17,14,24,17,10,7,0,7,0,14,0,3,1.0,3,7,0.6148700804079141,4.837909945762249
2822,2822,2020,15,NCAAF_20201212_NILL@EMICH,N. Illinois,Huskies,E. Michigan,Eagles,0-6,2-4,0.0,10,20,33,41,10,0,14,9,10,10,14,7,-2.0,-10,-8,0.5258553646232567,1.0744044507043782
2823,2823,2020,15,NCAAF_20201212_UGA@MIZZOU,Georgia,Bulldogs,Missouri,Tigers,7-2,5-4,0.0,21,14,49,14,14,7,21,7,0,14,0,0,2.0,7,35,0.8185822745471361,15.074832993505424
2824,2824,2020,15,NCAAF_20201212_UTAH@COLO,Utah,Utes,Colorado,Buffaloes,2-2,4-1,1.0,10,14,38,21,7,3,14,14,0,14,7,0,-2.0,-4,17,0.8052415321671889,14.255108946698442
2825,2825,2020,15,NCAAF_20201212_WAKE@LVILLE,Wake Forest,Demon Deacons,Louisville,Cardinals,4-4,4-7,1.0,10,21,21,45,7,3,3,8,0,21,7,17,0.0,-11,-24,0.6327239944035593,5.617210162012952
2826,2826,2020,15,NCAAF_20201212_WMICH@BALLST,W. Michigan,Broncos,Ball St.,Cardinals,4-2,5-1,1.0,20,13,27,30,3,17,7,0,6,7,0,17,-1.0,7,-3,0.7408643977413611,10.70197192790863
2827,2827,2020,15,NCAAF_20201212_UAB@RICE,UAB,Blazers,Rice,Owls,5-3,2-3,1.0,7,13,21,16,0,7,14,0,3,10,0,3,3.0,-6,5,0.7954036083941678,13.672330935354807
2828,2828,2020,15,NCAAF_20201212_AKRON@BUFF,Akron,Zips,Buffalo,Bulls,1-5,5-0,1.0,0,35,7,56,0,0,0,7,14,21,14,7,-4.0,-35,-49,0.10336222532631856,-20.91687307808479
2829,2829,2020,15,NCAAF_20201212_CMICH@TOLEDO,C. Michigan,Chippewas,Toledo,Rockets,3-3,4-2,1.0,10,17,23,24,7,3,13,0,10,7,0,7,-1.0,-7,-1,0.3870665514700806,-4.754048967535596
2830,2830,2020,15,NCAAF_20201212_CSTCAR@TROY,C. Carolina,Chanticleers,Troy,Trojans,11-0,5-6,1.0,21,16,42,38,14,7,7,14,3,13,7,15,6.0,5,4,0.3573447794194303,-6.056024941663281
2831,2831,2020,15,NCAAF_20201212_NAVY@ARMY,Navy,Midshipmen,Army,Black Knights,3-7,8-2,0.0,0,3,0,15,0,0,0,0,0,3,0,12,-5.0,-3,-15,0.49945983845640884,-0.022430376158013132
2832,2832,2020,15,NCAAF_20201212_OKLAST@BAYLOR,Oklahoma State,Cowboys,Baylor,Bears,7-3,2-7,1.0,28,0,42,3,14,14,7,7,0,0,0,3,5.0,28,39,0.6895695016402553,8.194145772084426
2833,2833,2020,15,NCAAF_20201212_UNC@MIAMI,North Carolina,Tar Heels,Miami (Fla.),Hurricanes,8-3,8-2,0.0,34,10,62,26,21,13,7,21,3,7,8,8,0.0,24,36,0.29380570057840305,-8.983859701866663
2834,2834,2020,15,NCAAF_20201212_WISC@IOWA,Wisconsin,Badgers,Iowa,Hawkeyes,2-3,6-2,0.0,0,6,7,28,0,0,7,0,3,3,15,7,-4.0,-6,-21,0.5589228739377509,2.455754460481785
2835,2835,2020,15,NCAAF_20201212_HOU@MEMP,Houston,Cougars,Memphis,Tigers,3-4,7-3,1.0,6,17,27,30,3,3,0,21,3,14,10,3,-4.0,-11,-3,0.3721680518536953,-5.402512675010257
2836,2836,2020,15,NCAAF_20201212_DUKE@FSU,Duke,Blue Devils,Florida State,Seminoles,2-9,3-6,0.0,21,28,35,56,7,14,0,14,28,0,14,14,-1.0,-7,-21,0.47560589963226274,-1.0136043672666801
2837,2837,2020,15,NCAAF_20201212_TENN@VANDY,Tennessee,Volunteers,Vanderbilt,Commodores,3-6,0-9,0.0,28,10,42,17,7,21,7,7,7,3,0,7,3.0,18,25,0.6487454487094779,6.327221177162869
2838,2838,2020,15,NCAAF_20201212_APLST@GAS,App. St.,Mountaineers,Ga. Southern,Eagles,8-3,7-5,0.0,7,17,34,26,0,7,10,17,7,10,0,9,1.0,-10,8,0.7885174685082768,13.274291438976434
2839,2839,2020,15,NCAAF_20201212_BOISE@WYO,Boise St.,Broncos,Wyoming,Cowboys,5-1,2-4,1.0,10,3,17,9,7,3,7,0,3,0,3,3,3.0,7,8,0.7511761745668953,11.235122900251383
2840,2840,2020,15,NCAAF_20201212_LATECH@TCU,Louisiana Tech,Bulldogs,TCU,Horned Frogs,5-4,6-4,1.0,0,31,10,52,0,0,3,7,10,21,14,7,-1.0,-31,-42,0.09304386405566523,-21.904514393090153
2841,2841,2020,15,NCAAF_20201212_LSU@FLA,LSU,Tigers,Florida,Gators,4-5,8-2,0.0,24,17,37,34,7,17,3,10,7,10,14,3,-4.0,7,3,0.5920100397200956,3.85526232734162
2842,2842,2020,15,NCAAF_20201212_AUBURN@MISSST,Auburn,Tigers,Miss. State,Bulldogs,6-4,2-7,1.0,6,3,24,10,3,3,3,15,0,3,0,7,4.0,3,14,0.6865653013780271,8.053456341107335
2843,2843,2020,15,NCAAF_20201212_USC@UCLA,USC,Trojans,UCLA,Bruins,5-0,3-3,1.0,10,21,43,38,0,10,13,20,7,14,14,3,2.0,-11,5,0.7131934776535056,9.322435025883806
2844,2844,2020,15,NCAAF_20201212_UVA@VATECH,Virginia,Cavaliers,Virginia Tech,Hokies,5-5,5-6,0.0,7,27,15,33,7,0,8,0,3,24,3,3,0.0,-20,-18,0.4619169597815215,-1.583819097802916
2845,2845,2020,15,NCAAF_20201212_SDGST@BYU,San Diego St.,Aztecs,BYU,Cougars,4-4,10-1,0.0,14,17,14,28,14,0,0,0,7,10,3,8,-6.0,-3,-14,0.4782463828745671,-0.9037735569241931
2846,2846,2020,15,NCAAF_20201212_STNFRD@OREGST,Stanford,Cardinal,Oregon State,Beavers,3-2,2-4,0.0,9,14,27,24,6,3,7,11,7,7,7,3,1.0,-5,3,0.8462537460136978,16.905765201683835
2847,2847,2020,15,NCAAF_20201212_FRESNO@NMEX,Fresno St.,Bulldogs,New Mexico,Lobos,3-3,2-5,0.0,24,21,39,49,7,17,7,8,7,14,7,21,1.0,3,-10,0.8942336437146097,20.697176788057277
2848,2848,2020,15,NCAAF_20201212_UNLV@HAWAII,UNLV,Rebels,Hawaii,Rainbow Warriors,0-6,4-4,1.0,7,21,21,38,0,7,14,0,7,14,14,3,-4.0,-14,-17,0.4026639183038877,-4.0828691966474935
2849,2849,2020,15,NCAAF_20201211_UTEP@NTEXAS,UTEP,Miners,North Texas,Mean Green,3-5,4-5,1.0,21,17,43,45,7,14,0,22,7,10,14,14,-1.0,4,-2,0.13943307641438407,-17.939037150469062
2850,2850,2020,15,NCAAF_20201211_ARIZST@ARIZ,Arizona St.,Sun Devils,Arizona,Wildcats,1-2,0-5,0.0,42,7,70,7,21,21,21,7,0,7,0,0,1.0,35,63,0.6317176753579502,5.572969829064391
2851,2851,2020,15,NCAAF_20201211_NEVADA@SJST,Nevada,Wolf Pack,San Jose St.,Spartans,6-2,6-0,1.0,20,7,20,30,10,10,0,0,7,0,20,3,0.0,13,-10,0.6847433542526489,7.96841563665248
2852,2852,2020,15,NCAAF_20201210_FAU@USM,FAU,Owls,So. Miss,Golden Eagles,5-3,3-7,1.0,17,24,31,45,7,10,14,0,10,14,14,7,2.0,-7,-14,0.7542589023726924,11.396769938349166
2853,2853,2020,15,NCAAF_20201210_PITT@GATECH,Pittsburgh,Panthers,Georgia Tech,Yellow Jackets,6-5,3-7,1.0,16,7,34,20,3,13,7,11,7,0,6,7,3.0,9,14,0.591443737717294,3.831105073055028
2854,2854,2021,1,NCAAF_20210906_LVILLE@MISS,Louisville,Cardinals,Ole Miss,Rebels,0-1,1-0,0.0,0,26,24,43,0,0,10,14,9,17,3,14,-1.0,-26,-19,0.4146811605701868,-3.579002390342339
2855,2855,2021,1,NCAAF_20210904_ARMY@GAST,Army,Black Knights,Georgia St.,Panthers,1-0,0-1,0.0,27,7,43,10,14,13,6,10,0,7,3,0,1.0,20,33,0.8199129677503181,15.195409929358902
2856,2856,2021,1,NCAAF_20210904_COLG@BC,Colgate,Raiders,Boston College,Eagles,0-1,1-0,0.0,0,27,0,51,0,0,0,0,7,20,3,21,-1.0,-27,-51,0.030007249351967413,-31.23143831511959
2857,2857,2021,1,NCAAF_20210904_FORD@NEB,Fordham,,Nebraska,,0-1,1-1,,7,24,7,52,0,7,0,0,7,17,14,14,-1.0,-17,-45,0.00031897977585437776,-56.709860800973615
2858,2858,2021,1,NCAAF_20210904_HOLY@UCONN,Holy Cross,Crusaders,UConn,Huskies,1-0,0-2,1.0,24,21,38,28,7,17,7,7,14,7,7,0,1.0,3,10,0.21208848965841987,-13.271760977687677
2859,2859,2021,1,NCAAF_20210904_LAMON@UK,UL-Monroe,Warhawks,Kentucky,Wildcats,0-1,1-0,0.0,7,28,10,45,7,0,0,3,14,14,3,14,-1.0,-21,-35,0.04714161363882541,-27.78622219425631
2860,2860,2021,1,NCAAF_20210904_PSU@WISC,Penn State,Nittany Lions,Wisconsin,Badgers,1-0,0-1,1.0,0,0,16,10,0,0,7,9,0,0,7,3,1.0,0,6,0.5510367485256606,2.1302874068936717
2861,2861,2021,1,NCAAF_20210904_STNFRD@KSTATE,Stanford,Cardinal,Kansas State,Wildcats,0-1,1-0,1.0,0,14,7,24,0,0,0,7,7,7,0,10,-1.0,-14,-17,0.5121454131827555,0.5056439051779762
2862,2862,2021,1,NCAAF_20210904_TEMPLE@RUT,Temple,Owls,Rutgers,Scarlet Knights,0-1,1-0,0.0,7,26,14,61,0,7,7,0,12,14,14,21,-1.0,-19,-47,0.6128232933718625,4.760807643746034
2863,2863,2021,1,NCAAF_20210904_TULANE@OKLA,Tulane,Green Wave,Oklahoma,Sooners,0-1,1-0,0.0,14,37,35,40,14,0,8,13,14,23,3,0,-1.0,-23,-5,0.06836124286322365,-24.712109367090648
2864,2864,2021,1,NCAAF_20210904_WMICH@MICH,W. Michigan,Broncos,Michigan,Wolverines,0-1,1-0,0.0,7,27,14,47,7,0,0,7,10,17,6,14,-1.0,-20,-33,0.040269287056626024,-29.02083737820533
2865,2865,2021,1,NCAAF_20210904_FRESNO@OREG,Fresno St.,Bulldogs,Oregon,Ducks,1-1,1-0,1.0,13,21,24,31,0,13,8,3,14,7,0,10,0.0,-8,-7,0.23541428610542936,-11.975397854260905
2866,2866,2021,1,NCAAF_20210904_LAF@AF,Lafayette,Leopards,Air Force,Falcons,0-1,1-0,1.0,7,28,14,35,0,7,7,0,14,14,0,7,-1.0,-21,-21,0.1232981537331923,-19.241107906828802
2867,2867,2021,1,NCAAF_20210904_RICE@ARK,Rice,Owls,Arkansas,Razorbacks,0-1,1-0,0.0,10,7,17,38,0,10,7,0,7,0,10,21,-1.0,3,-21,0.15667138435434635,-16.743113409616285
2868,2868,2021,1,NCAAF_20210904_BAMA@MIAMI,Alabama,Crimson Tide,Miami (Fla.),Hurricanes,1-0,0-1,1.0,27,3,44,13,10,17,14,3,0,3,10,0,1.0,24,31,0.9271350339274737,24.1586705136433
2869,2869,2021,1,NCAAF_20210904_IND@IOWA,Indiana,Hoosiers,Iowa,Hawkeyes,0-1,1-0,0.0,3,31,6,34,3,0,3,0,14,17,0,3,-1.0,-28,-28,0.24781277194039275,-11.315412735347536
2870,2870,2021,1,NCAAF_20210904_MIAOH@CINCY,Miami-OH,RedHawks,Cincinnati,Bearcats,0-1,1-0,0.0,0,35,14,49,0,0,0,14,21,14,0,14,-1.0,-35,-35,0.194797699576149,-14.28733690371132
2871,2871,2021,1,NCAAF_20210904_MRSHL@NAVY,Marshall,Thundering Herd,Navy,Midshipmen,1-0,0-1,1.0,21,0,49,7,14,7,7,21,0,0,0,7,1.0,21,42,0.46110186696443234,-1.6217504143095312
2872,2872,2021,1,NCAAF_20210904_WVU@MD,West Virginia,Mountaineers,Maryland,Terrapins,0-1,1-0,0.0,21,20,24,30,14,7,0,3,17,3,0,10,-1.0,1,-6,0.720582271859179,9.707637409760537
2873,2873,2021,1,NCAAF_20210904_CMICH@MIZZOU,C. Michigan,Chippewas,Missouri,Tigers,0-1,1-0,0.0,14,17,24,34,7,7,0,10,7,10,7,10,-1.0,-3,-10,0.1200605364005286,-19.507273897796267
2874,2874,2021,1,NCAAF_20210904_LATECH@MISSST,Louisiana Tech,Bulldogs,Miss. State,Bulldogs,0-1,1-0,1.0,21,14,34,35,7,14,10,3,14,0,0,21,-1.0,7,-1,0.09865620068633207,-21.4097407617204
2875,2875,2021,1,NCAAF_20210904_MTST@WYO,Montana St.,Bobcats,Wyoming,Cowboys,0-1,1-0,1.0,7,3,16,19,7,0,0,9,0,3,0,16,-1.0,4,-3,0.08823536103811092,-22.44689857994598
2876,2876,2021,1,NCAAF_20210904_UMASS@PITT,UMass,Minutemen,Pittsburgh,Panthers,0-1,1-0,1.0,0,23,7,51,0,0,0,7,13,10,14,14,-1.0,-23,-44,0.0279076758144986,-31.75931405055485
2877,2877,2021,1,NCAAF_20210904_LALAF@TEXAS,Louisiana,Ragin' Cajuns,Texas,Longhorns,0-1,1-0,1.0,6,14,18,38,3,3,6,6,7,7,14,10,-1.0,-8,-20,0.10797711234398266,-20.548058631694175
2878,2878,2021,1,NCAAF_20210904_NOIOWA@IOWAST,Northern Iowa,Panthers,Iowa St.,Cyclones,0-1,1-0,1.0,10,13,10,16,7,3,0,0,3,10,0,3,-1.0,-3,-6,0.1331873591952698,-18.45718049456582
2879,2879,2021,1,NCAAF_20210904_SJST@USC,San Jose St.,Spartans,USC,Trojans,1-1,1-0,1.0,0,13,7,30,0,0,7,0,10,3,0,17,0.0,-13,-23,0.04937147737539804,-27.416807087913753
2880,2880,2021,1,NCAAF_20210904_CAMP@LIB,Campbell,Fighting Camels,Liberty,Flames,0-1,1-0,1.0,7,20,7,48,0,7,0,0,14,6,14,14,-1.0,-13,-41,0.053683981566982064,-26.738575127765557
2881,2881,2021,1,NCAAF_20210904_GRDWB@GAS,Gardner-Webb,Runnin' Bulldogs,Ga. Southern,Eagles,0-1,1-0,1.0,6,20,25,30,6,0,6,13,3,17,0,10,-1.0,-14,-5,0.01481736624478791,-36.117893014711285
2882,2882,2021,1,NCAAF_20210904_ABIL@SMU,Abil Christian,Wildcats,SMU,Mustangs,0-1,1-0,1.0,3,35,9,56,0,3,6,0,7,28,14,7,-1.0,-32,-47,0.018921105007093764,-34.48417809964451
2883,2883,2021,1,NCAAF_20210904_AKRON@AUBURN,Akron,Zips,Auburn,Tigers,0-1,1-0,1.0,0,37,10,60,0,0,0,10,13,24,16,7,-1.0,-37,-50,0.004759491634976132,-43.057565860768136
2884,2884,2021,1,NCAAF_20210904_BAYLOR@TXSTSM,Baylor,Bears,Texas St.,Bobcats,1-0,0-1,0.0,14,10,29,20,7,7,10,5,3,7,3,7,1.0,4,9,0.9526220622303564,27.74641651360014
2885,2885,2021,1,NCAAF_20210904_CAR@ARKST,Cent. Ark.,,Arkansas St.,,0-1,1-0,,7,6,21,40,7,0,7,7,3,3,14,20,-1.0,1,-19,0.19080373133835193,-14.529574206796156
2886,2886,2021,1,NCAAF_20210904_CUSE@OHIO,Syracuse,Orange,Ohio,Bobcats,1-0,0-1,0.0,12,6,29,9,9,3,10,7,0,6,0,3,1.0,6,20,0.512195161760146,0.507715706922454
2887,2887,2021,1,NCAAF_20210904_EIL@SC,E. Illinois,Panthers,South Carolina,Gamecocks,0-2,1-0,0.0,0,29,0,46,0,0,0,0,15,14,3,14,-1.0,-29,-46,0.0042607984334392945,-43.686004256632145
2888,2888,2021,1,NCAAF_20210904_MONNJ@MTSU,Monmouth,Hawks,Middle Tenn.,Blue Raiders,0-1,1-0,1.0,7,21,15,50,0,7,8,0,0,21,7,22,-1.0,-14,-35,0.030587694192174997,-31.09092491991089
2889,2889,2021,1,NCAAF_20210904_MOST@OKLAST,Missouri St.,Bears,Oklahoma State,Cowboys,0-1,1-0,1.0,3,20,16,23,0,3,6,7,6,14,0,3,-1.0,-17,-7,0.0031095857336344013,-45.435044722437624
2890,2890,2021,1,NCAAF_20210904_NICHST@MEMP,Nicholls St.,,Memphis,,0-1,1-0,,7,29,17,42,7,0,7,3,10,19,6,7,-1.0,-22,-25,0.03882597425909484,-29.301583416407766
2891,2891,2021,1,NCAAF_20210904_NRFST@TOLEDO,Norfolk St.,Spartans,Toledo,Rockets,0-1,1-0,1.0,7,28,10,49,7,0,0,3,14,14,14,7,-1.0,-21,-39,0.01947917341140648,-34.28601084874583
2892,2892,2021,1,NCAAF_20210904_OREGST@PURDUE,Oregon State,Beavers,Purdue,Boilermakers,0-1,1-0,1.0,7,13,21,30,7,0,0,14,7,6,3,14,-1.0,-6,-9,0.15167131391931532,-17.092827550538345
2893,2893,2021,1,NCAAF_20210904_SO@TROY,Southern U.,,Troy,,0-1,1-0,,3,34,3,55,0,3,0,0,14,20,14,7,-1.0,-31,-52,0.011090505855513633,-37.98304767283639
2894,2894,2021,1,NCAAF_20210904_TXTECH@HOU,Texas Tech,Red Raiders,Houston,Cougars,1-0,0-1,0.0,7,21,38,21,0,7,17,14,14,7,0,0,1.0,-14,17,0.6301097045493413,5.515714089445851
2895,2895,2021,1,NCAAF_20210904_FAU@FLA,FAU,Owls,Florida,Gators,0-1,1-0,0.0,0,14,14,35,0,0,0,14,14,0,7,14,-1.0,-14,-21,0.16294162170875692,-16.31478588243749
2896,2896,2021,1,NCAAF_20210904_NILL@GATECH,N. Illinois,Huskies,Georgia Tech,Yellow Jackets,1-0,0-1,1.0,14,7,22,21,7,7,0,8,0,7,0,14,1.0,7,1,0.3123219537325689,-8.125168404584997
2897,2897,2021,1,NCAAF_20210904_NWST@NTEXAS,Northwestern St.,Demons,North Texas,Mean Green,0-1,1-0,1.0,14,24,14,44,0,14,0,0,7,17,17,3,-1.0,-10,-30,0.08484702173444791,-22.80369943858716
2898,2898,2021,1,NCAAF_20210904_TXSA@ILL,UTSA,,Illinois,,1-0,1-1,,20,14,37,30,7,13,3,14,0,14,3,13,0.0,6,7,0.20151126544374898,-13.886856673695661
2899,2899,2021,1,NCAAF_20210904_UGA@CLEM,Georgia,Bulldogs,Clemson,Tigers,1-0,0-1,1.0,7,0,10,3,0,7,3,0,0,0,0,3,1.0,7,7,0.35490882994869577,-6.179257163664602
2900,2900,2021,1,NCAAF_20210904_WMMARY@UVA,William & Mary,Tribe,Virginia,Cavaliers,0-1,1-0,1.0,0,17,0,43,0,0,0,0,3,14,12,14,-1.0,-17,-43,0.027334289320462335,-31.909210285395716
2901,2901,2021,1,NCAAF_20210904_DUQ@TCU,Duquesne,Dukes,TCU,Horned Frogs,0-1,1-0,0.0,0,35,3,45,0,0,3,0,21,14,3,7,-1.0,-35,-42,0.003083574973850256,-45.48092788708004
2902,2902,2021,1,NCAAF_20210904_ETNST@VANDY,ETSU,Buccaneers,Vanderbilt,Commodores,1-0,0-1,0.0,10,3,23,3,0,10,3,10,3,0,0,0,1.0,7,20,0.011691623001645723,-37.64860215046474
2903,2903,2021,1,NCAAF_20210904_KENTST@TXAM,Kent St.,Golden Flashes,Texas A&M,Aggies,0-1,1-0,0.0,3,10,10,41,3,0,0,7,10,0,17,14,-1.0,-7,-31,0.028590544836088472,-31.5841073001244
2904,2904,2021,1,NCAAF_20210904_MT@WASH,Montana,Grizzlies,Washington,Huskies,1-0,0-1,0.0,3,7,13,7,3,0,0,10,7,0,0,0,1.0,-4,6,0.003144919036720095,-45.37326691722035
2905,2905,2021,1,NCAAF_20210904_USM@SALA,So. Miss,,South Alabama,,0-1,1-0,,7,14,7,31,7,0,0,0,0,14,10,7,-1.0,-7,-24,0.73593274675272,10.476250385635694
2906,2906,2021,1,NCAAF_20210904_LSU@UCLA,LSU,Tigers,UCLA,Bruins,0-1,2-0,0.0,10,14,27,38,0,10,10,7,0,14,10,14,-2.0,-4,-11,0.8466472685792392,16.974385939287345
2907,2907,2021,1,NCAAF_20210904_BTHN@UTEP,Bethune-Cook.,Wildcats,UTEP,Miners,0-1,2-0,1.0,0,10,28,38,0,0,14,14,10,0,7,21,-2.0,-10,-10,0.39793536897361026,-4.295988710802476
2908,2908,2021,1,NCAAF_20210904_BYU@ARIZ,BYU,Cougars,Arizona,Wildcats,1-0,0-1,1.0,14,3,24,16,0,14,7,3,0,3,10,3,1.0,11,8,0.5893902670232395,3.7526606748839413
2909,2909,2021,1,NCAAF_20210904_NEVADA@CAL,Nevada,Wolf Pack,California,Golden Bears,1-0,0-1,0.0,13,14,22,17,0,13,9,0,14,0,0,3,1.0,-1,5,0.23445196964931092,-12.027409140499117
2910,2910,2021,1,NCAAF_20210904_NMEXST@SDGST,New Mexico St.,Aggies,San Diego St.,Aztecs,0-2,1-0,1.0,10,0,10,28,3,7,0,0,0,0,21,7,-1.0,10,-18,0.09327992362765414,-21.934139540584624
2911,2911,2021,1,NCAAF_20210904_UTAHST@WASHST,Utah St.,Aggies,Washington St.,Cougars,1-0,0-1,0.0,5,6,26,23,3,2,6,15,0,6,14,3,1.0,-1,3,0.26540708547453784,-10.408286777189232
2912,2912,2021,1,NCAAF_20210904_PORTST@HAWAII,Portland St.,,Hawaii,,0-1,1-1,,7,35,35,49,0,7,21,7,28,7,7,7,-1.0,-28,-14,0.32935267131320545,-7.335068235915628
2913,2913,2021,1,NCAAF_20210903_UNC@VATECH,North Carolina,Tar Heels,Virginia Tech,Hokies,0-1,1-0,0.0,0,14,10,17,0,0,7,3,7,7,0,3,-1.0,-14,-7,0.4320245262816592,-2.843384010638033
2914,2914,2021,1,NCAAF_20210903_DUKE@CHARLO,Duke,Blue Devils,Charlotte,49ers,0-1,1-0,1.0,14,10,28,31,0,14,0,14,7,3,7,14,-1.0,4,-3,0.8653675321539624,18.346033091220647
2915,2915,2021,1,NCAAF_20210903_ODU@WAKE,Old Dominion,Monarchs,Wake Forest,Demon Deacons,0-1,1-0,1.0,3,28,10,42,3,0,0,7,14,14,7,7,-1.0,-25,-32,0.056504984641673306,-26.31795220824165
2916,2916,2021,1,NCAAF_20210903_STFRPA@EMICH,St. Fran.-Pa.,Red Flash,E. Michigan,Eagles,0-1,1-0,0.0,7,28,15,35,0,7,0,8,14,14,7,0,-1.0,-21,-20,,
2917,2917,2021,1,NCAAF_20210903_SD@KANSAS,South Dakota,Coyotes,Kansas,Jayhawks,0-1,1-0,0.0,0,7,14,17,0,0,7,7,0,7,3,7,-1.0,-7,-3,0.19026482157355584,-14.562496360597152
2918,2918,2021,1,NCAAF_20210903_MICHST@NWEST,Michigan St.,Spartans,Northwestern,Wildcats,1-0,0-1,1.0,21,7,38,21,14,7,7,10,0,7,0,14,1.0,14,17,0.4875958237943391,-0.5164202936666697
2919,2919,2021,1,NCAAF_20210903_NCO@COLO,N. Colorado,Bears,Colorado,Buffaloes,0-1,1-0,1.0,0,14,7,35,0,0,7,0,0,14,7,14,-1.0,-14,-28,0.04238829749570361,-28.623108018157268
2920,2920,2021,1,NCAAF_20210903_SDST@COLOST,S. Dakota St.,Jackrabbits,Colorado St.,Rams,1-0,0-1,0.0,21,10,42,23,7,14,14,7,0,10,0,13,1.0,11,19,0.7239564426290047,9.874754594704882
2921,2921,2021,1,NCAAF_20210902_CIT@CSTCAR,The Citadel,Bulldogs,C. Carolina,Chanticleers,0-1,1-0,1.0,0,31,14,52,0,0,7,7,7,24,14,7,-1.0,-31,-38,0.4416451539796926,-2.43781033774178
2922,2922,2021,1,NCAAF_20210902_WAG@BUFF,Wagner,Seahawks,Buffalo,Bulls,0-1,1-0,0.0,0,38,7,69,0,0,0,7,14,24,21,10,-1.0,-38,-62,0.010511100906940407,-38.32068347379527
2923,2923,2021,1,NCAAF_20210902_WIL@BALLST,W. Illinois,Leathernecks,Ball St.,Cardinals,0-1,1-0,1.0,7,7,21,31,0,7,7,7,7,0,14,10,-1.0,0,-10,0.6809444066247231,7.810675070795696
2924,2924,2021,1,NCAAF_20210902_DAVIS@TULSA,UC-Davis,Aggies,Tulsa,Golden Hurricane,1-0,0-1,1.0,10,10,19,17,7,3,3,6,3,7,7,0,1.0,0,2,0.3043892902399602,-8.49944898512831
2925,2925,2021,1,NCAAF_20210902_ECU@APLST,East Carolina,Pirates,App. St.,Mountaineers,0-1,1-0,1.0,6,20,19,33,6,0,3,10,14,6,7,6,-1.0,-14,-14,0.13720664978227526,-18.150055622541913
2926,2926,2021,1,NCAAF_20210902_SFLA@NCST,South Florida,Bulls,NC State,Wolfpack,0-1,1-0,1.0,0,24,0,45,0,0,0,0,10,14,14,7,-1.0,-24,-45,0.2456612485677998,-11.428637824564134
2927,2927,2021,1,NCAAF_20210902_WBRST@UTAH,Weber St.,Wildcats,Utah,Utes,0-1,1-0,1.0,7,19,17,40,7,0,3,7,13,6,7,14,-1.0,-12,-23,0.06615503130260914,-24.993534397519966
2928,2928,2021,1,NCAAF_20210902_BGREEN@TENN,Bowling Green,Falcons,Tennessee,Volunteers,0-1,1-0,1.0,6,14,6,38,0,6,0,0,14,0,14,10,-1.0,-8,-32,0.04214991311110805,-28.66703670149718
2929,2929,2021,1,NCAAF_20210902_HOUBP@NMEX,Houston Christian,Huskies,New Mexico,Lobos,0-1,1-0,1.0,10,21,17,27,0,10,0,7,14,7,3,3,-1.0,-11,-10,0.24252905611063325,-11.594428194714169
2930,2930,2021,1,NCAAF_20210902_LIUPOST@FIU,LIU,,FIU,,0-1,1-0,,10,28,10,48,0,10,0,0,21,7,10,10,-1.0,-18,-38,,
2931,2931,2021,1,NCAAF_20210902_OHIOST@MINN,Ohio State,Buckeyes,Minnesota,Golden Gophers,1-0,0-1,0.0,10,14,45,31,7,3,21,14,0,14,7,10,1.0,-4,14,0.9273569731175583,24.185319094470742
2932,2932,2021,1,NCAAF_20210902_TNMART@WKY,UT Martin,Skyhawks,W. Kentucky,Hilltoppers,0-1,1-0,1.0,14,28,21,59,7,7,0,7,7,21,17,14,-1.0,-14,-38,0.15243259606259973,-17.039094295575865
2933,2933,2021,1,NCAAF_20210902_BOISE@UCF,Boise St.,Broncos,UCF,Knights,0-1,1-0,1.0,24,14,31,36,14,10,0,7,0,14,14,8,-1.0,10,-5,0.36051316646713316,-5.929936499315545
2934,2934,2021,1,NCAAF_20210902_SUT@ARIZST,So. Utah,Thunderbirds,Arizona St.,Sun Devils,0-2,1-0,1.0,7,28,14,41,7,0,7,0,13,15,6,7,-1.0,-21,-27,0.0031205044718914943,-45.41588689489322
2935,2935,2021,1,NCAAF_20210901_UAB@JAXST,UAB,Blazers,Jacksonville St.,Gamecocks,1-0,0-1,0.0,10,0,31,0,0,10,14,7,0,0,0,0,1.0,10,31,0.6501805998767756,6.406882807165175
2936,2936,2021,1,NCAAF_20210828_NEB@ILL,Nebraska,Cornhuskers,Illinois,Fighting Illini,1-1,1-1,1.0,9,16,22,30,0,9,7,6,2,14,14,0,0.0,-7,-8,0.6975945366383893,8.59372160574685
2937,2937,2021,1,NCAAF_20210828_UCONN@FRESNO,UConn,,Fresno St.,,0-2,1-1,,0,31,0,45,0,0,0,0,7,24,7,7,-1.0,-31,-45,0.0484702264443837,-27.564474819698034
2938,2938,2021,1,NCAAF_20210828_HAWAII@UCLA,Hawaii,,UCLA,,1-1,2-0,,3,31,10,44,3,0,7,0,24,7,13,0,-1.0,-28,-34,0.202089572072073,-13.852737421338475
2939,2939,2021,1,NCAAF_20210828_UTEP@NMEXST,UTEP,,New Mexico St.,,2-0,0-2,,20,3,30,3,17,3,10,0,0,3,0,0,2.0,17,27,0.3096641480536596,-8.25010094533286
2940,2940,2021,1,NCAAF_20210828_SUT@SJST,So. Utah,,San Jose St.,,0-2,1-1,,14,38,14,45,0,14,0,0,21,17,7,0,-1.0,-24,-31,0.08721387470040654,-22.553369418521925
2941,2941,2021,2,NCAAF_20210911_ILL@UVA,Illinois,Fighting Illini,Virginia,Cavaliers,1-2,2-0,0.0,7,21,14,42,0,7,7,0,14,7,14,7,-1.0,-14,-28,0.31439901727294983,-8.042867683008126
2942,2942,2021,2,NCAAF_20210911_VMI@KENTST,VMI,,Kent St.,,1-1,1-1,,0,39,10,60,0,0,3,7,22,17,14,7,0.0,-39,-50,0.0105945415491977,-38.34265253068952
2943,2943,2021,2,NCAAF_20210911_WKY@ARMY,W. Kentucky,Hilltoppers,Army,Black Knights,1-1,2-0,1.0,14,21,35,38,0,14,0,21,0,21,7,10,-1.0,-7,-3,0.2571298796074364,-10.851268739209218
2944,2944,2021,2,NCAAF_20210911_ALST@AUBURN,Alabama St.,Hornets,Auburn,Tigers,1-1,2-0,1.0,0,20,0,62,0,0,0,0,6,14,35,7,-1.0,-20,-62,0.0005018596754334803,-54.7286143270876
2945,2945,2021,2,NCAAF_20210911_INST@NWEST,Indiana St.,,Northwestern,,1-1,1-1,,0,14,6,24,0,0,0,6,14,0,3,7,0.0,-14,-18,0.02108695543424266,-33.80398272688876
2946,2946,2021,2,NCAAF_20210911_KENSAW@GATECH,Kennesaw St.,,Georgia Tech,,1-1,1-1,,3,24,17,45,0,3,0,14,14,10,7,14,0.0,-21,-28,,
2947,2947,2021,2,NCAAF_20210911_MIAOH@MINN,Miami-OH,RedHawks,Minnesota,Golden Gophers,0-2,1-1,1.0,3,21,26,31,0,3,10,13,7,14,0,10,-1.0,-18,-5,0.12012734834998773,-19.538203524507708
2948,2948,2021,2,NCAAF_20210911_NRFST@WAKE,Norfolk St.,,Wake Forest,,0-2,2-0,,9,24,16,41,3,6,0,7,7,17,17,0,-2.0,-15,-25,0.0030583423850654157,-45.61091686650798
2949,2949,2021,2,NCAAF_20210911_OREG@OHIOST,Oregon,Ducks,Ohio State,Buckeyes,2-0,1-1,0.0,14,7,35,28,0,14,14,7,0,7,7,14,1.0,7,7,0.12160444880485566,-19.415971923349844
2950,2950,2021,2,NCAAF_20210911_PITT@TENN,Pittsburgh,Panthers,Tennessee,Volunteers,2-0,1-1,1.0,27,20,41,34,0,27,7,7,10,10,7,7,1.0,7,7,0.5766309338886613,3.2157205845589942
2951,2951,2021,2,NCAAF_20210911_SC@ECU,South Carolina,Gamecocks,East Carolina,Pirates,2-0,0-2,0.0,7,14,20,17,0,7,7,6,7,7,0,3,2.0,-7,3,0.8929205577618331,20.6672236736415
2952,2952,2021,2,NCAAF_20210911_TULSA@OKLAST,Tulsa,Golden Hurricane,Oklahoma State,Cowboys,0-2,2-0,0.0,7,7,23,28,0,7,7,9,0,7,0,21,-2.0,0,-5,0.11721008987094539,-19.782759254675284
2953,2953,2021,2,NCAAF_20210911_YST@MICHST,Youngstown St.,Penguins,Michigan St.,Spartans,1-1,2-0,0.0,7,35,14,42,0,7,7,0,14,21,7,0,-1.0,-28,-28,0.01617415124655186,-35.6054869923712
2954,2954,2021,2,NCAAF_20210911_FLA@SFLA,Florida,Gators,South Florida,Bulls,2-0,0-2,1.0,35,3,42,20,14,21,0,7,3,0,10,7,2.0,32,22,0.9219693807758715,23.599296308002295
2955,2955,2021,2,NCAAF_20210911_MRGNST@TULANE,Morgan St.,,Tulane,,0-2,1-1,,7,52,20,69,0,7,7,6,17,35,7,10,-1.0,-45,-49,0.00021654328477827,-58.54812662343306
2956,2956,2021,2,NCAAF_20210911_WYO@NILL,Wyoming,,N. Illinois,,2-0,1-1,,28,10,50,43,14,14,14,8,3,7,12,21,1.0,18,7,0.6231157907249919,5.218742474028204
2957,2957,2021,2,NCAAF_20210911_DUQ@OHIO,Duquesne,,Ohio,,1-1,0-2,,11,13,28,26,8,3,7,10,13,0,0,13,1.0,-2,2,0.03665563597785959,-29.7958202711593
2958,2958,2021,2,NCAAF_20210911_MTSU@VATECH,Middle Tenn.,Blue Raiders,Virginia Tech,Hokies,1-1,2-0,0.0,7,14,14,35,0,7,0,7,7,7,14,7,-1.0,-7,-21,0.15960020841679,-16.572609177118238
2959,2959,2021,2,NCAAF_20210911_RUT@CUSE,Rutgers,,Syracuse,,2-0,1-1,,0,0,17,7,0,0,14,3,0,0,7,0,1.0,0,10,0.3389866087084228,-6.908378215663333
2960,2960,2021,2,NCAAF_20210911_TOLEDO@ND,Toledo,Rockets,Notre Dame,Fighting Irish,1-1,2-0,0.0,16,14,29,32,6,10,0,13,7,7,0,18,-1.0,2,-3,0.06340432606392143,-25.402208420590796
2961,2961,2021,2,NCAAF_20210911_PURDUE@UCONN,Purdue,Boilermakers,UConn,Huskies,2-0,0-3,0.0,35,0,49,0,7,28,14,0,0,0,0,0,2.0,35,49,0.9843436315182378,35.82170091973603
2962,2962,2021,2,NCAAF_20210911_ROB@CMICH,Robert Morris,,C. Michigan,,0-1,1-1,,0,28,0,45,0,0,0,0,7,21,14,3,-1.0,-28,-45,0.12171637466863827,-19.406752596984006
2963,2963,2021,2,NCAAF_20210911_AF@NAVY,Air Force,Falcons,Navy,Midshipmen,2-0,0-2,1.0,7,3,23,3,0,7,7,9,0,3,0,0,2.0,4,20,0.5783550434834321,3.2890098166801636
2964,2964,2021,2,NCAAF_20210911_BALLST@PSU,Ball St.,Cardinals,Penn State,Nittany Lions,1-1,2-0,1.0,6,24,13,44,0,6,0,7,14,10,10,10,-1.0,-18,-31,0.0066165525584338525,-41.21819179814929
2965,2965,2021,2,NCAAF_20210911_BC@UMASS,Boston College,,UMass,,2-0,0-2,,14,0,45,28,14,0,21,10,0,0,21,7,2.0,14,17,0.9745503317549754,32.4817628210335
2966,2966,2021,2,NCAAF_20210911_BUFF@NEB,Buffalo,Bulls,Nebraska,Cornhuskers,1-1,2-1,1.0,0,14,3,28,0,0,3,0,0,14,0,14,-1.0,-14,-25,0.37522489024421524,-5.291482148517389
2967,2967,2021,2,NCAAF_20210911_CAL@TCU,California,Golden Bears,TCU,Horned Frogs,0-2,2-0,1.0,19,14,32,34,6,13,0,13,0,14,7,13,-2.0,5,-2,0.279273002758211,-9.732954167535127
2968,2968,2021,2,NCAAF_20210911_GAS@FAU,Ga. Southern,,FAU,,1-1,1-1,,6,10,6,38,6,0,0,0,0,10,21,7,0.0,-4,-32,0.27247742524715035,-10.07127406206564
2969,2969,2021,2,NCAAF_20210911_MURYST@CINCY,Murray St.,Racers,Cincinnati,Bearcats,1-1,2-0,1.0,7,7,7,42,0,7,0,0,0,7,14,21,-1.0,0,-35,0.005948562755156983,-41.846215099153596
2970,2970,2021,2,NCAAF_20210911_TEMPLE@AKRON,Temple,,Akron,,1-1,0-2,,24,17,45,24,7,17,14,7,14,3,0,7,1.0,7,21,0.8643896958300235,18.30546048930978
2971,2971,2021,2,NCAAF_20210911_TXAM@COLO,Texas A&M,Aggies,Colorado,Buffaloes,2-0,1-1,1.0,3,7,10,7,0,3,0,7,7,0,0,0,1.0,-4,3,0.7665109713095493,12.10216428200556
2972,2972,2021,2,NCAAF_20210911_UAB@UGA,UAB,Blazers,Georgia,Bulldogs,1-1,2-0,0.0,0,35,7,56,0,0,0,7,21,14,14,7,-1.0,-35,-49,0.021890389296349122,-33.54416649194991
2973,2973,2021,2,NCAAF_20210911_MERCER@BAMA,Mercer,Bears,Alabama,Crimson Tide,1-1,2-0,0.0,0,31,14,48,0,0,7,7,14,17,14,3,-1.0,-31,-34,0.00010292540581802179,-61.75367726167815
2974,2974,2021,2,NCAAF_20210911_SALA@BGREEN,South Alabama,,Bowling Green,,2-0,0-2,,6,8,22,19,0,6,6,10,8,0,11,0,2.0,-2,3,0.661313408729433,6.922018928132729
2975,2975,2021,2,NCAAF_20210911_IOWA@IOWAST,Iowa,Hawkeyes,Iowa St.,Cyclones,2-0,1-1,1.0,14,10,27,17,0,14,10,3,3,7,0,7,1.0,4,10,0.6429111927857296,6.093488840524287
2976,2976,2021,2,NCAAF_20210911_ILST@WMICH,Illinois St.,,W. Michigan,,1-1,1-1,,0,14,0,28,0,0,0,0,7,7,14,0,0.0,-14,-28,0.5080984492460165,0.33776026177201857
2977,2977,2021,2,NCAAF_20210911_LIUPOST@WVU,LIU,,West Virginia,,0-2,1-1,,0,38,0,66,0,0,0,0,21,17,21,7,-1.0,-38,-66,0.000270439844820225,-57.559760445169104
2978,2978,2021,2,NCAAF_20210911_SCST@CLEM,SC State,Bulldogs,Clemson,Tigers,0-2,1-1,0.0,3,35,3,49,0,3,0,0,28,7,14,0,-1.0,-32,-46,2.812242445604518e-05,-67.01626409460528
2979,2979,2021,2,NCAAF_20210911_GRDWB@CHARLO,Gardner-Webb,,Charlotte,,0-2,2-0,,10,28,10,38,3,7,0,0,14,14,7,3,-2.0,-18,-28,0.0907715457143008,-22.22795603708505
2980,2980,2021,2,NCAAF_20210911_LAMAR@TXSA,Lamar,,UTSA,,1-1,2-0,,0,34,0,54,0,0,0,0,13,21,10,10,-1.0,-34,-54,0.00672679220788075,-41.11999040695332
2981,2981,2021,2,NCAAF_20210911_PORTST@WASHST,Portland St.,Vikings,Washington St.,Cougars,0-2,1-1,0.0,10,30,24,44,0,10,0,14,7,23,7,7,-1.0,-20,-20,0.03589583919318862,-29.95468993861141
2982,2982,2021,2,NCAAF_20210911_BTHN@UCF,Bethune-Cook.,,UCF,,0-2,2-0,,7,35,14,63,7,0,7,0,14,21,21,7,-2.0,-28,-49,0.0017567751394289566,-48.5617989258692
2983,2983,2021,2,NCAAF_20210911_HOU@RICE,Houston,Cougars,Rice,Owls,1-1,0-2,0.0,17,7,44,7,17,0,14,13,0,7,0,0,1.0,10,37,0.9005943228755569,21.378223186317882
2984,2984,2021,2,NCAAF_20210911_NCCEN@MRSHL,NC Central,,Marshall,,1-1,2-0,,7,30,10,44,0,7,0,3,6,24,7,7,-1.0,-23,-34,0.0026432531239650725,-46.402476866997176
2985,2985,2021,2,NCAAF_20210911_APLST@MIAMI,App. St.,Mountaineers,Miami (Fla.),Hurricanes,1-1,1-1,1.0,14,12,23,25,7,7,3,6,9,3,7,6,0.0,2,-2,0.3304755002060782,-7.29719735584149
2986,2986,2021,2,NCAAF_20210911_EKY@LVILLE,E. Kentucky,,Louisville,,1-1,1-1,,3,20,3,30,0,3,0,0,7,13,7,3,0.0,-17,-27,0.03821237663049826,-29.478546252449405
2987,2987,2021,2,NCAAF_20210911_EMICH@WISC,E. Michigan,Eagles,Wisconsin,Badgers,1-1,1-1,0.0,0,24,7,34,0,0,0,7,7,17,3,7,0.0,-24,-27,0.031860110865088,-30.848046273555155
2988,2988,2021,2,NCAAF_20210911_GRAM@USM,Grambling,,So. Miss,,1-1,1-1,,0,10,0,37,0,0,0,0,7,3,10,17,0.0,-10,-37,0.14696854240107204,-17.461406972231316
2989,2989,2021,2,NCAAF_20210911_HAMP@ODU,Hampton,,Old Dominion,,1-1,1-1,,0,34,7,47,0,0,7,0,10,24,7,6,0.0,-34,-40,0.03396329761487027,-30.37156754181001
2990,2990,2021,2,NCAAF_20210911_LIB@TROY,Liberty,Flames,Troy,Trojans,2-0,1-1,0.0,14,7,21,13,7,7,0,7,7,0,0,6,1.0,7,8,0.4818677670237208,-0.7564456949885425
2991,2991,2021,2,NCAAF_20210911_MEMP@ARKST,Memphis,,Arkansas St.,,2-0,1-1,,34,23,55,50,20,14,7,14,10,13,7,20,1.0,11,5,0.7900415606626677,13.419197483155358
2992,2992,2021,2,NCAAF_20210911_NCST@MISSST,NC State,Wolfpack,Miss. State,Bulldogs,1-1,2-0,1.0,3,14,10,24,0,3,0,7,7,7,7,3,-1.0,-11,-14,0.3726733172319129,-5.403533832128915
2993,2993,2021,2,NCAAF_20210911_NICHST@LALAF,Nicholls St.,,Louisiana,,0-2,1-1,,10,17,24,27,7,3,0,14,10,7,7,3,-1.0,-7,-3,0.14887995241325225,-17.323737937570513
2994,2994,2021,2,NCAAF_20210911_NMEXST@NMEX,New Mexico St.,,New Mexico,,0-3,2-0,,20,24,25,34,3,17,2,3,14,10,3,7,-2.0,-4,-9,0.3850019425171105,-4.864289956050243
2995,2995,2021,2,NCAAF_20210911_NTEXAS@SMU,North Texas,,SMU,,1-1,2-0,,6,7,12,35,3,3,6,0,0,7,14,14,-1.0,-1,-23,0.23289502933808282,-12.134461575323257
2996,2996,2021,2,NCAAF_20210911_SELOU@LATECH,SE Louisiana,,Louisiana Tech,,1-1,1-1,,21,24,42,45,7,14,14,7,14,10,14,7,0.0,-3,-3,0.5094511404348789,0.3941864607984371
2997,2997,2021,2,NCAAF_20210911_SFA@TXTECH,S.F. Austin,,Texas Tech,,1-1,2-0,,13,7,22,28,7,6,0,9,7,0,14,7,-1.0,6,-6,0.004104507570429572,-43.978618123465594
2998,2998,2021,2,NCAAF_20210911_SIL@KSTATE,S. Illinois,,Kansas State,,1-1,2-0,,23,21,23,31,0,23,0,0,14,7,3,7,-1.0,2,-8,0.08063962677450276,-23.305450121996046
2999,2999,2021,2,NCAAF_20210911_TEXAS@ARK,Texas,Longhorns,Arkansas,Razorbacks,1-1,2-0,0.0,0,16,21,40,0,0,7,14,3,13,17,7,-1.0,-16,-19,0.8850380908420399,19.97418315320101
3000,3000,2021,2,NCAAF_20210911_TXSO@BAYLOR,Texas Southern,Tigers,Baylor,Bears,0-2,2-0,0.0,0,42,7,66,0,0,0,7,21,21,10,14,-2.0,-42,-59,0.00012816670267512542,-60.82400744387178
3001,3001,2021,2,NCAAF_20210911_WCAR@OKLA,W. Carolina,Catamounts,Oklahoma,Sooners,0-2,2-0,1.0,0,45,0,76,0,0,0,0,17,28,17,14,-2.0,-45,-76,0.00011068958644311344,-61.44680041170977
3002,3002,2021,2,NCAAF_20210911_AP@MISS,Austin Peay,Governors,Ole Miss,Rebels,1-1,2-0,1.0,7,37,17,54,0,7,3,7,14,23,14,3,-1.0,-30,-37,0.023580160476774803,-33.022980597586866
3003,3003,2021,2,NCAAF_20210911_GAST@UNC,Georgia St.,Panthers,North Carolina,Tar Heels,0-2,1-1,1.0,10,24,17,59,3,7,0,7,14,10,21,14,-1.0,-14,-42,0.11510584524291634,-19.961848280066306
3004,3004,2021,2,NCAAF_20210911_HOW@MD,Howard,,Maryland,,0-2,2-0,,0,38,0,62,0,0,0,0,14,24,14,10,-2.0,-38,-62,0.003935682611096891,-44.214676384098766
3005,3005,2021,2,NCAAF_20210911_IDAHO@IND,Idaho,,Indiana,,1-1,1-1,,7,35,14,56,0,7,7,0,21,14,7,14,0.0,-28,-42,0.041879119111198904,-28.770890428118037
3006,3006,2021,2,NCAAF_20210911_MIZZOU@UK,Missouri,Tigers,Kentucky,Wildcats,1-1,2-0,0.0,14,21,28,35,7,7,7,7,14,7,7,7,-1.0,-7,-7,0.567741024618359,2.8387805111017315
3007,3007,2021,2,NCAAF_20210911_JAXST@FSU,Jacksonville St.,,Florida State,,1-1,0-2,,7,14,20,17,0,7,0,13,0,14,3,0,1.0,-7,3,0.09188450908021661,-22.11516126983429
3008,3008,2021,2,NCAAF_20210911_MCN@LSU,McNeese St.,Cowboys,LSU,Tigers,0-2,1-1,1.0,0,17,7,34,0,0,0,7,7,10,7,10,-1.0,-17,-27,0.0032369235955912457,-45.29985074308047
3009,3009,2021,2,NCAAF_20210911_WASH@MICH,Washington,Huskies,Michigan,Wolverines,0-2,2-0,1.0,0,10,10,31,0,0,3,7,3,7,7,14,-2.0,-10,-21,0.3559217587730754,-6.145565544126839
3010,3010,2021,2,NCAAF_20210911_CPOLY@FRESNO,Cal-Poly,,Fresno St.,,1-1,2-1,,10,35,10,63,0,10,0,0,7,28,21,7,-1.0,-25,-53,0.003937354472289489,-44.21229461887356
3011,3011,2021,2,NCAAF_20210911_SDGST@ARIZ,San Diego St.,Aztecs,Arizona,Wildcats,2-0,0-2,1.0,35,7,38,14,21,14,3,0,7,0,0,7,2.0,28,24,0.5591752132201541,2.476958098804289
3012,3012,2021,2,NCAAF_20210911_VANDY@COLOST,Vanderbilt,Commodores,Colorado St.,Rams,1-1,0-2,0.0,7,14,24,21,0,7,14,3,7,7,0,7,1.0,-7,3,0.508608889147163,0.35905227502644266
3013,3013,2021,2,NCAAF_20210911_UTAH@BYU,Utah,Utes,BYU,Cougars,1-1,2-0,0.0,7,16,17,26,0,7,0,10,3,13,7,3,-1.0,-9,-9,0.7757858941767423,12.61182458425128
3014,3014,2021,2,NCAAF_20210911_IDST@NEVADA,Idaho State,,Nevada,,0-2,2-0,,7,21,10,49,7,0,3,0,14,7,7,21,-2.0,-14,-39,0.2311161451239161,-12.231459069689208
3015,3015,2021,2,NCAAF_20210911_STNFRD@USC,Stanford,Cardinal,USC,Trojans,1-1,1-1,1.0,21,10,42,28,7,14,14,7,0,10,3,15,0.0,11,14,0.421475984005115,-3.296195988931686
3016,3016,2021,2,NCAAF_20210911_UNLV@ARIZST,UNLV,Rebels,Arizona St.,Sun Devils,0-2,2-0,0.0,10,14,10,37,3,7,0,0,0,14,7,16,-2.0,-4,-27,0.08816951687718699,-22.49572774190665
3017,3017,2021,2,NCAAF_20210911_HAWAII@OREGST,Hawaii,Rainbow Warriors,Oregon State,Beavers,1-2,1-1,0.0,7,24,27,45,0,7,13,7,21,3,7,14,0.0,-17,-18,0.40906610291993706,-3.8257491390090763
3018,3018,2021,2,NCAAF_20210910_KANSAS@CSTCAR,Kansas,Jayhawks,C. Carolina,Chanticleers,1-1,2-0,1.0,15,28,22,49,9,6,7,0,7,21,7,14,-1.0,-13,-27,0.5195477825346836,0.8155456030328878
3019,3019,2021,2,NCAAF_20210910_NCAT@DUKE,NC A&T,Aggies,Duke,Blue Devils,0-2,1-1,0.0,14,21,17,45,7,7,3,0,0,21,21,3,-1.0,-7,-28,0.08898140284071276,-22.411553665869633
3020,3020,2021,2,NCAAF_20210910_NDK@UTAHST,North Dakota,Fighting Hawks,Utah St.,Aggies,1-1,2-0,1.0,21,20,24,48,21,0,3,0,7,13,7,21,-1.0,1,-24,0.16903742451886505,-15.93828404468627
3021,3021,2021,2,NCAAF_20210910_UTEP@BOISE,UTEP,Miners,Boise St.,Broncos,2-1,1-1,1.0,13,41,13,54,3,10,0,0,10,31,10,3,1.0,-28,-41,0.012997577157236817,-37.03970487470201
3022,3022,2021,3,NCAAF_20210919_SJST@HAWAII,San Jose St.,,Hawaii,,2-1,1-3,,14,7,17,13,0,14,0,3,7,0,6,0,1.0,7,4,0.4065485442603858,-3.9204169922313667
3023,3023,2021,3,NCAAF_20210918_ALBANY@CUSE,Albany,Great Danes,Syracuse,Orange,0-3,2-1,0.0,10,45,24,62,10,0,0,14,21,24,10,7,-2.0,-35,-38,0.03601041871893096,-29.829981331008298
3024,3024,2021,3,NCAAF_20210918_BC@TEMPLE,Boston College,Eagles,Temple,Owls,3-0,1-2,1.0,21,0,28,3,14,7,0,7,0,0,0,3,2.0,21,25,0.7135525380575062,9.348563742414967
3025,3025,2021,3,NCAAF_20210918_CINCY@IND,Cincinnati,Bearcats,Indiana,Hoosiers,3-0,1-2,1.0,10,14,38,24,0,10,13,15,7,7,10,0,2.0,-4,14,0.38888904869445173,-4.679574077395159
3026,3026,2021,3,NCAAF_20210918_CSTCAR@BUFF,C. Carolina,Chanticleers,Buffalo,Bulls,3-0,1-2,0.0,14,14,28,25,7,7,7,7,14,0,3,8,2.0,0,3,0.2737479013439392,-9.974081115636181
3027,3027,2021,3,NCAAF_20210918_MICHST@MIAMI,Michigan St.,Spartans,Miami (Fla.),Hurricanes,3-0,1-2,0.0,10,7,38,17,0,10,7,21,0,7,7,3,2.0,3,21,0.4690471050900711,-1.287812825851006
3028,3028,2021,3,NCAAF_20210918_NEB@OKLA,Nebraska,Cornhuskers,Oklahoma,Sooners,2-2,3-0,0.0,3,7,16,23,3,0,6,7,7,0,9,7,-1.0,-4,-7,0.12147908035693744,-19.361027560260027
3029,3029,2021,3,NCAAF_20210918_NILL@MICH,N. Illinois,Huskies,Michigan,Wolverines,1-2,3-0,1.0,3,35,10,63,3,0,0,7,14,21,28,0,-2.0,-32,-53,0.0313038114522427,-30.874311824055212
3030,3030,2021,3,NCAAF_20210918_NMEX@TXAM,New Mexico,Lobos,Texas A&M,Aggies,2-1,3-0,1.0,0,24,0,34,0,0,0,0,14,10,10,0,-1.0,-24,-34,0.040716600746021014,-28.892191882908605
3031,3031,2021,3,NCAAF_20210918_SEMOST@MIZZOU,SE Missouri St.,Redhawks,Missouri,Tigers,0-3,2-1,0.0,0,38,28,59,0,0,7,21,21,17,14,7,-2.0,-38,-31,0.0023169531734800186,-46.949646630870234
3032,3032,2021,3,NCAAF_20210918_TNCHAT@UK,Chattanooga,Mocs,Kentucky,Wildcats,1-2,3-0,0.0,10,14,23,28,7,3,3,10,7,7,0,14,-2.0,-4,-5,0.0179934372803765,-34.77276438162971
3033,3033,2021,3,NCAAF_20210918_TNTECH@TENN,Tenn. Tech,Golden Eagles,Tennessee,Volunteers,0-3,2-1,0.0,0,28,0,56,0,0,0,0,14,14,21,7,-2.0,-28,-56,0.0032684091165890994,-45.09457324577784
3034,3034,2021,3,NCAAF_20210918_UCONN@ARMY,UConn,Huskies,Army,Black Knights,0-4,3-0,1.0,0,42,21,52,0,0,14,7,14,28,7,3,-3.0,-42,-31,0.058482399841324306,-25.99392653503685
3035,3035,2021,3,NCAAF_20210918_VATECH@WVU,Virginia Tech,Hokies,West Virginia,Mountaineers,2-1,2-1,1.0,7,24,21,27,7,0,7,7,14,10,3,0,0.0,-17,-6,0.46650955985576104,-1.3936283083310173
3036,3036,2021,3,NCAAF_20210918_WMICH@PITT,W. Michigan,Broncos,Pittsburgh,Panthers,2-1,2-1,1.0,27,27,44,41,14,13,7,10,7,20,7,7,0.0,0,3,0.2593940123487747,-10.698660370480525
3037,3037,2021,3,NCAAF_20210918_MINN@COLO,Minnesota,Golden Gophers,Colorado,Buffaloes,2-1,1-2,0.0,13,0,30,0,0,13,7,10,0,0,0,0,1.0,13,30,0.7154666893025519,9.44197648152658
3038,3038,2021,3,NCAAF_20210918_NEVADA@KSTATE,Nevada,Wolf Pack,Kansas State,Wildcats,2-1,3-0,0.0,7,17,17,38,7,0,10,0,7,10,0,21,-1.0,-10,-21,0.18896167559158084,-14.620433705781124
3039,3039,2021,3,NCAAF_20210918_PURDUE@ND,Purdue,Boilermakers,Notre Dame,Fighting Irish,2-1,3-0,0.0,3,10,13,27,3,0,10,0,0,10,7,10,-1.0,-7,-14,0.26360670179299484,-10.483941625676493
3040,3040,2021,3,NCAAF_20210918_BAMA@FLA,Alabama,Crimson Tide,Florida,Gators,3-0,2-1,1.0,21,9,31,29,21,0,7,3,3,6,14,6,1.0,12,2,0.8765659293482969,19.20126743700979
3041,3041,2021,3,NCAAF_20210918_BAYLOR@KANSAS,Baylor,Bears,Kansas,Jayhawks,3-0,1-2,1.0,14,7,45,7,7,7,14,17,0,7,0,0,2.0,7,38,0.827115781128777,15.633563648231757
3042,3042,2021,3,NCAAF_20210918_BRY@AKRON,Bryant,,Akron,,1-2,1-2,,7,14,14,35,0,7,7,0,7,7,0,21,0.0,-7,-21,,
3043,3043,2021,3,NCAAF_20210918_DE@RUT,Delaware,,Rutgers,,2-1,3-0,,10,35,13,45,0,10,3,0,7,28,3,7,-1.0,-25,-32,0.42756915543011964,-3.027232500091486
3044,3044,2021,3,NCAAF_20210918_ELON@APLST,Elon,,App. St.,,1-2,2-1,,3,13,10,44,3,0,7,0,7,6,14,17,-1.0,-10,-34,0.006911093268704094,-40.82131307202462
3045,3045,2021,3,NCAAF_20210918_EMICH@UMASS,E. Michigan,,UMass,,2-1,0-3,,21,7,42,28,14,7,7,14,0,7,7,14,2.0,14,14,0.8761377207699608,19.166511809508847
3046,3046,2021,3,NCAAF_20210918_FSU@WAKE,Florida State,Seminoles,Wake Forest,Demon Deacons,0-3,3-0,0.0,14,27,14,35,7,7,0,0,14,13,8,0,-3.0,-13,-21,0.40045118203206953,-4.181525955458255
3047,3047,2021,3,NCAAF_20210918_GATECH@CLEM,Georgia Tech,Yellow Jackets,Clemson,Tigers,1-2,2-1,0.0,3,7,8,14,0,3,0,5,7,0,0,7,-1.0,-4,-6,0.030266495945519223,-31.121766041695082
3048,3048,2021,3,NCAAF_20210918_IDAHO@OREGST,Idaho,,Oregon State,,1-2,2-1,,0,28,0,42,0,0,0,0,14,14,14,0,-1.0,-28,-42,0.22838811582412288,-12.339420451033106
3049,3049,2021,3,NCAAF_20210918_KENTST@IOWA,Kent St.,Golden Flashes,Iowa,Hawkeyes,1-2,3-0,0.0,7,16,7,30,7,0,0,0,9,7,7,7,-2.0,-9,-23,0.007151852275092185,-40.617242695418554
3050,3050,2021,3,NCAAF_20210918_LIUPOST@MIAOH,LIU,,Miami-OH,,0-3,1-2,,7,21,7,42,0,7,0,0,7,14,14,7,-1.0,-14,-35,0.003584623113248142,-44.58577527056855
3051,3051,2021,3,NCAAF_20210918_SMU@LATECH,SMU,Mustangs,Louisiana Tech,Bulldogs,3-0,1-2,0.0,16,14,39,37,7,9,17,6,7,7,14,9,2.0,2,2,0.7358718972394614,10.457488638579889
3052,3052,2021,3,NCAAF_20210918_TULSA@OHIOST,Tulsa,Golden Hurricane,Ohio State,Buckeyes,0-3,2-1,0.0,6,13,20,41,3,3,7,7,3,10,14,14,-2.0,-7,-21,0.008425195159533216,-39.62917391105782
3053,3053,2021,3,NCAAF_20210918_USC@WASHST,USC,Trojans,Washington St.,Cougars,2-1,1-2,1.0,7,14,45,14,0,7,28,10,7,7,0,0,1.0,-7,31,0.5220397186022665,0.9165205012511706
3054,3054,2021,3,NCAAF_20210918_BALLST@WYO,Ball St.,,Wyoming,,1-2,3-0,,0,31,12,45,0,0,6,6,10,21,0,14,-2.0,-31,-33,0.2084751987571658,-13.459630707627639
3055,3055,2021,3,NCAAF_20210918_COLOST@TOLEDO,Colorado St.,,Toledo,,1-2,1-2,,3,3,22,6,3,0,10,9,0,3,3,0,0.0,0,16,0.42819081699318773,-3.0009634690966323
3056,3056,2021,3,NCAAF_20210918_GAS@ARK,Ga. Southern,Eagles,Arkansas,Razorbacks,1-2,3-0,1.0,10,24,10,45,0,10,0,0,14,10,14,7,-2.0,-14,-35,0.3315137398819681,-7.225196375032851
3057,3057,2021,3,NCAAF_20210918_MISSST@MEMP,Miss. State,Bulldogs,Memphis,Tigers,2-1,3-0,1.0,17,7,29,31,3,14,0,12,7,0,7,17,-1.0,10,-2,0.6289798212172427,5.457859897041885
3058,3058,2021,3,NCAAF_20210918_NWEST@DUKE,Northwestern,Wildcats,Duke,Blue Devils,1-2,2-1,1.0,7,30,23,30,0,7,13,3,21,9,0,0,-1.0,-23,-7,0.7167017234173896,9.502406787909763
3059,3059,2021,3,NCAAF_20210918_SACST@CAL,Sacramento St.,,California,,1-2,1-2,,6,21,30,42,6,0,14,10,14,7,14,7,0.0,-15,-12,0.10779529894248663,-20.533569964364347
3060,3060,2021,3,NCAAF_20210918_ARKST@WASH,Arkansas St.,,Washington,,1-2,1-2,,0,28,3,52,0,0,3,0,14,14,7,17,0.0,-28,-49,0.07349387270988728,-24.047455760671028
3061,3061,2021,3,NCAAF_20210918_MURYST@BGREEN,Murray St.,,Bowling Green,,1-2,1-2,,10,10,10,27,0,10,0,0,7,3,10,7,0.0,0,-17,0.3301124312067243,-7.289294408225487
3062,3062,2021,3,NCAAF_20210918_ECU@MRSHL,East Carolina,,Marshall,,1-2,2-1,,21,24,42,38,7,14,0,21,10,14,14,0,-1.0,-3,4,0.21475619501492416,-13.099860676906246
3063,3063,2021,3,NCAAF_20210918_FORD@FAU,Fordham,,FAU,,0-3,2-1,,7,14,14,45,0,7,0,7,7,7,14,17,-2.0,-7,-31,0.002165033166646735,-47.308128840206564
3064,3064,2021,3,NCAAF_20210918_MTSU@TXSA,Middle Tenn.,,UTSA,,1-2,3-0,,0,10,13,27,0,0,0,13,7,3,7,10,-2.0,-10,-14,0.6524750160927559,6.500152425371994
3065,3065,2021,3,NCAAF_20210918_ODU@LIB,Old Dominion,,Liberty,,1-2,3-0,,17,28,17,45,3,14,0,0,14,14,14,3,-2.0,-11,-28,0.2092486563489271,-13.414987580053548
3066,3066,2021,3,NCAAF_20210918_CHARLO@GAST,Charlotte,,Georgia St.,,2-1,1-2,,7,7,9,20,0,7,2,0,0,7,6,7,1.0,0,-11,0.48057772171695345,-0.8075824707400443
3067,3067,2021,3,NCAAF_20210918_FAMU@SFLA,Florida A&M,,South Florida,,1-2,1-2,,3,24,17,38,3,0,7,7,10,14,7,7,0.0,-21,-21,0.004753416198952531,-43.00042142959717
3068,3068,2021,3,NCAAF_20210918_FIU@TXTECH,FIU,,Texas Tech,,1-2,3-0,,14,35,21,54,7,7,7,0,7,28,9,10,-2.0,-21,-33,0.17311092961204355,-15.6188732457789
3069,3069,2021,3,NCAAF_20210918_GRAM@HOU,Grambling,,Houston,,1-2,2-1,,0,21,0,45,0,0,0,0,7,14,21,3,-1.0,-21,-45,0.020163063768925737,-33.998687448794385
3070,3070,2021,3,NCAAF_20210918_SC@UGA,South Carolina,Gamecocks,Georgia,Bulldogs,2-1,3-0,0.0,6,26,13,40,6,0,0,7,14,12,14,0,-1.0,-20,-27,0.09301699811415509,-21.927490407047344
3071,3071,2021,3,NCAAF_20210918_TROY@USM,Troy,,So. Miss,,2-1,1-2,,0,3,21,9,0,0,14,7,3,0,0,6,1.0,-3,12,0.6013627758277824,4.259403161078922
3072,3072,2021,3,NCAAF_20210918_UIW@TXSTSM,Incarnate Word,,Texas St.,,2-1,1-2,,14,17,42,34,14,0,14,14,7,10,7,10,1.0,-3,8,0.055211390070768473,-26.469056746116962
3073,3073,2021,3,NCAAF_20210918_AUBURN@PSU,Auburn,Tigers,Penn State,Nittany Lions,2-1,3-0,0.0,10,14,20,28,3,7,7,3,7,7,7,7,-1.0,-4,-8,0.38292088718827455,-4.938290428661844
3074,3074,2021,3,NCAAF_20210918_CMICH@LSU,C. Michigan,Chippewas,LSU,Tigers,1-2,2-1,0.0,7,35,21,49,7,0,7,7,21,14,7,7,-1.0,-28,-28,0.049480270143464566,-27.358129441569417
3075,3075,2021,3,NCAAF_20210918_FUR@NCST,Furman,,NC State,,2-1,2-1,,0,38,7,45,0,0,7,0,10,28,7,0,0.0,-38,-38,0.09084048004244272,-22.1462712670816
3076,3076,2021,3,NCAAF_20210918_STONYBRK@OREG,Stony Brook,Seawolves,Oregon,Ducks,1-2,3-0,1.0,7,17,7,48,7,0,0,0,10,7,14,17,-2.0,-10,-41,0.0006358002892896675,-53.43094533815622
3077,3077,2021,3,NCAAF_20210918_UAB@NTEXAS,UAB,,North Texas,,2-1,1-2,,30,0,40,6,17,13,3,7,0,0,0,6,1.0,30,34,0.5951241532438445,3.9919479201645345
3078,3078,2021,3,NCAAF_20210918_UTAHST@AF,Utah St.,,Air Force,,3-0,2-1,,13,24,49,45,7,6,21,15,10,14,14,7,1.0,-11,4,0.4966410205774746,-0.1396135333861821
3079,3079,2021,3,NCAAF_20210918_UVA@UNC,Virginia,Cavaliers,North Carolina,Tar Heels,2-1,2-1,1.0,28,24,39,59,7,21,3,8,21,3,21,14,0.0,4,-20,0.516874157771154,0.7015630495823189
3080,3080,2021,3,NCAAF_20210918_ALCORN@SALA,Alcorn St.,,South Alabama,,1-2,3-0,,14,7,21,28,0,14,0,7,7,0,21,0,-2.0,7,-7,0.3005806486672491,-8.667693839268622
3081,3081,2021,3,NCAAF_20210918_JACKST@LAMON,Jackson St.,,UL-Monroe,,2-1,1-1,,7,3,7,12,0,7,0,0,3,0,3,6,1.0,4,-5,0.05567360544511768,-26.400593951014798
3082,3082,2021,3,NCAAF_20210918_RICE@TEXAS,Rice,Owls,Texas,Longhorns,0-3,2-1,0.0,0,44,0,58,0,0,0,0,16,28,14,0,-2.0,-44,-58,0.016527120883706448,-35.3423094979579
3083,3083,2021,3,NCAAF_20210918_SCST@NMEXST,SC State,,New Mexico St.,,0-3,1-3,,13,36,35,43,0,13,7,15,15,21,7,0,-1.0,-23,-8,0.34232821525560153,-6.7340537285589335
3084,3084,2021,3,NCAAF_20210918_STNFRD@VANDY,Stanford,Cardinal,Vanderbilt,Commodores,2-1,1-2,1.0,27,14,41,23,14,13,7,7,7,7,3,6,1.0,13,18,0.8166036035595294,14.964802399504833
3085,3085,2021,3,NCAAF_20210918_TULANE@MISS,Tulane,Green Wave,Ole Miss,Rebels,1-2,3-0,0.0,21,40,21,61,7,14,0,0,19,21,21,0,-2.0,-19,-40,0.4009326018222561,-4.160873093012469
3086,3086,2021,3,NCAAF_20210918_OKLAST@BOISE,Oklahoma State,Cowboys,Boise St.,Broncos,3-0,1-2,0.0,21,20,21,20,7,14,0,0,10,10,0,0,2.0,1,1,0.576657023428901,3.2060196603709983
3087,3087,2021,3,NCAAF_20210918_NAZ@ARIZ,N. Arizona,Lumberjacks,Arizona,Wildcats,1-2,0-3,0.0,7,13,21,19,0,7,7,7,10,3,0,6,1.0,-6,2,0.03077331675285777,-30.999999999999204
3088,3088,2021,3,NCAAF_20210918_ARIZST@BYU,Arizona St.,Sun Devils,BYU,Cougars,2-1,3-0,0.0,7,21,17,27,7,0,10,0,7,14,0,6,-1.0,-14,-10,0.5835672947210258,3.499171464016399
3089,3089,2021,3,NCAAF_20210918_IOWAST@UNLV,Iowa St.,Cyclones,UNLV,Rebels,2-1,0-3,1.0,24,0,48,3,7,17,14,10,0,0,3,0,2.0,24,45,0.9683824890351724,30.80081476209466
3090,3090,2021,3,NCAAF_20210918_FRESNO@UCLA,Fresno St.,Bulldogs,UCLA,Bruins,3-1,2-1,1.0,23,10,40,37,6,17,3,14,7,3,7,20,1.0,13,3,0.5061966788971759,0.25756775975514756
3091,3091,2021,3,NCAAF_20210917_UCF@LVILLE,UCF,Knights,Louisville,Cardinals,2-1,2-1,0.0,14,21,35,42,7,7,7,14,7,14,7,14,0.0,-7,-7,0.7996191146457673,13.932837945167648
3092,3092,2021,3,NCAAF_20210917_MD@ILL,Maryland,Terrapins,Illinois,Fighting Illini,3-0,1-3,0.0,3,3,20,17,0,3,7,10,0,3,7,7,2.0,0,3,0.60450596707937,4.394571136581931
3093,3093,2021,3,NCAAF_20210916_OHIO@LALAF,Ohio,Bobcats,Louisiana,Ragin' Cajuns,0-3,2-1,1.0,7,21,14,49,0,7,7,0,7,14,7,21,-2.0,-14,-35,0.5858360706045849,3.595653370590867
3094,3094,2021,4,NCAAF_20210925_BGREEN@MINN,Bowling Green,Falcons,Minnesota,Golden Gophers,2-2,2-2,1.0,7,3,14,10,0,7,7,0,3,0,7,0,0.0,4,4,0.010796391280714746,-38.10999171998242
3095,3095,2021,4,NCAAF_20210925_BOISE@UTAHST,Boise St.,Broncos,Utah St.,Aggies,2-2,3-1,0.0,10,0,27,3,10,0,7,10,0,0,0,3,-1.0,10,24,0.6976329479239131,8.585980557870926
3096,3096,2021,4,NCAAF_20210925_FIU@CMICH,FIU,Panthers,C. Michigan,Chippewas,1-3,2-2,0.0,14,10,27,31,0,14,13,0,0,10,0,21,-1.0,4,-4,0.4490508592586476,-2.124243086878778
3097,3097,2021,4,NCAAF_20210925_LSU@MISSST,LSU,Tigers,Miss. State,Bulldogs,3-1,2-2,0.0,7,3,28,25,7,0,14,7,0,3,7,15,1.0,4,3,0.6758944845404009,7.568215478633988
3098,3098,2021,4,NCAAF_20210925_MIAOH@ARMY,Miami-OH,RedHawks,Army,Black Knights,1-3,4-0,1.0,3,17,10,23,0,3,0,7,7,10,0,6,-3.0,-14,-13,0.30149221122968184,-8.62759748524661
3099,3099,2021,4,NCAAF_20210925_ND@WISC,Notre Dame,Fighting Irish,Wisconsin,Badgers,4-0,1-2,1.0,10,3,41,13,0,10,0,31,3,0,7,3,3.0,7,28,0.43601493468613883,-2.671991689384413
3100,3100,2021,4,NCAAF_20210925_NH@PITT,New Hamp.,Wildcats,Pittsburgh,Panthers,3-1,3-1,1.0,7,49,7,77,0,7,0,0,28,21,21,7,0.0,-42,-70,0.08228666486770497,-23.054768039797523
3101,3101,2021,4,NCAAF_20210925_NOVA@PSU,Villanova,Wildcats,Penn State,Nittany Lions,3-1,4-0,1.0,3,17,17,38,3,0,0,14,7,10,14,7,-1.0,-14,-21,0.02168387633269031,-33.5100805773634
3102,3102,2021,4,NCAAF_20210925_OHIO@NWEST,Ohio,Bobcats,Northwestern,Wildcats,0-4,2-2,1.0,0,17,6,35,0,0,0,6,14,3,0,18,-2.0,-17,-29,0.24640133480573057,-11.3769510301139
3103,3103,2021,4,NCAAF_20210925_RICH@VATECH,Richmond,Spiders,Virginia Tech,Hokies,2-2,3-1,0.0,7,14,10,21,0,7,3,0,7,7,7,0,-1.0,-7,-11,0.02169792234605228,-33.5055879980207
3104,3104,2021,4,NCAAF_20210925_SMU@TCU,SMU,Mustangs,TCU,Horned Frogs,4-0,2-1,1.0,21,21,42,34,14,7,14,7,14,7,6,7,2.0,0,8,0.2374115728094086,-11.854609391139661
3105,3105,2021,4,NCAAF_20210925_TXTECH@TEXAS,Texas Tech,Red Raiders,Texas,Longhorns,3-1,3-1,0.0,14,42,35,70,0,14,14,7,14,28,21,7,0.0,-28,-35,0.2957980567279106,-8.899820438355164
3106,3106,2021,4,NCAAF_20210925_UGA@VANDY,Georgia,Bulldogs,Vanderbilt,Commodores,4-0,1-3,0.0,38,0,62,0,35,3,17,7,0,0,0,0,3.0,38,62,0.9769535386447299,33.08527453997044
3107,3107,2021,4,NCAAF_20210925_WAG@TEMPLE,Wagner,Seahawks,Temple,Owls,0-4,2-2,1.0,7,17,7,41,7,0,0,0,0,17,17,7,-2.0,-10,-34,0.009020077673666305,-39.22697394766817
3108,3108,2021,4,NCAAF_20210925_CCTST@MIAMI,CCSU,Blue Devils,Miami (Fla.),Hurricanes,1-3,2-2,0.0,0,49,0,69,0,0,0,0,21,28,13,7,-1.0,-49,-69,0.010820649449737818,-38.09588310899073
3109,3109,2021,4,NCAAF_20210925_UMASS@CSTCAR,UMass,Minutemen,C. Carolina,Chanticleers,0-4,4-0,1.0,0,36,3,53,0,0,0,3,13,23,14,3,-4.0,-36,-50,0.17030682225332794,-15.807507258712576
3110,3110,2021,4,NCAAF_20210925_SJST@WMICH,San Jose St.,Spartans,W. Michigan,Broncos,2-2,3-1,0.0,3,20,3,23,3,0,0,0,13,7,0,3,-1.0,-17,-20,0.2976706012571164,-8.81003769969766
3111,3111,2021,4,NCAAF_20210925_TOLEDO@BALLST,Toledo,Rockets,Ball St.,Cardinals,2-2,1-3,0.0,14,9,22,12,7,7,0,8,6,3,0,3,1.0,5,10,0.7577674720744219,11.597258363622245
3112,3112,2021,4,NCAAF_20210925_TXSTSM@EMICH,Texas St.,Bobcats,E. Michigan,Eagles,1-3,3-1,1.0,14,28,21,59,7,7,7,0,14,14,10,21,-2.0,-14,-38,0.18749618350621955,-14.716143226366853
3113,3113,2021,4,NCAAF_20210925_ME@NILL,Maine,Black Bears,N. Illinois,Huskies,1-3,2-2,0.0,14,21,14,41,7,7,0,0,7,14,3,17,-1.0,-7,-27,0.20124526605800297,-13.887092741305196
3114,3114,2021,4,NCAAF_20210925_WASHST@UTAH,Washington St.,Cougars,Utah,Utes,1-3,2-2,1.0,6,7,13,24,0,6,7,0,0,7,3,14,-1.0,-1,-11,0.3783137819242569,-5.140799455986212
3115,3115,2021,4,NCAAF_20210925_COLOST@IOWA,Colorado St.,Rams,Iowa,Hawkeyes,1-3,4-0,1.0,14,7,14,24,0,14,0,0,0,7,14,3,-3.0,7,-10,0.04598269799450594,-27.95262251770737
3116,3116,2021,4,NCAAF_20210925_ILL@PURDUE,Illinois,,Purdue,,1-4,3-1,,3,6,9,13,0,3,3,3,6,0,0,7,-2.0,-3,-4,0.20843857261297982,-13.466911670048603
3117,3117,2021,4,NCAAF_20210925_IOWAST@BAYLOR,Iowa St.,Cyclones,Baylor,Bears,2-2,4-0,1.0,13,21,29,31,7,6,10,6,7,14,7,3,-2.0,-8,-2,0.7527766569733028,11.333747757783613
3118,3118,2021,4,NCAAF_20210925_KENTST@MD,Kent St.,,Maryland,,1-3,4-0,,9,24,16,37,6,3,0,7,7,17,13,0,-3.0,-15,-21,0.12505177591370553,-19.077721393483785
3119,3119,2021,4,NCAAF_20210925_LVILLE@FSU,Louisville,Cardinals,Florida State,Seminoles,3-1,0-4,1.0,31,13,31,23,17,14,0,0,0,13,7,3,3.0,18,8,0.5132549474848631,0.5512385294605338
3120,3120,2021,4,NCAAF_20210925_RUT@MICH,Rutgers,Scarlet Knights,Michigan,Wolverines,3-1,4-0,0.0,3,20,13,20,3,0,7,3,7,13,0,0,-1.0,-17,-7,0.0366397269067954,-29.710379168721488
3121,3121,2021,4,NCAAF_20210925_TWST@SDGST,Towson,,San Diego St.,,1-3,4-0,,14,21,21,48,7,7,0,7,7,14,24,3,-3.0,-7,-27,0.02282573904097085,-33.15262499318351
3122,3122,2021,4,NCAAF_20210925_TXAM@ARK,Texas A&M,Aggies,Arkansas,Razorbacks,3-1,4-0,1.0,3,17,10,20,0,3,7,0,10,7,0,3,-1.0,-14,-10,0.8314620787575003,15.923714551659828
3123,3123,2021,4,NCAAF_20210925_TXSA@MEMP,UTSA,,Memphis,,4-0,3-1,,7,21,31,28,0,7,7,17,21,0,7,0,1.0,-14,3,0.09481867120280052,-21.757578061534332
3124,3124,2021,4,NCAAF_20210925_WYO@UCONN,Wyoming,Cowboys,UConn,Huskies,4-0,0-5,0.0,3,13,24,22,0,3,7,14,10,3,0,9,4.0,-10,2,0.9380942299047632,25.52830258439485
3125,3125,2021,4,NCAAF_20210925_GAST@AUBURN,Georgia St.,Panthers,Auburn,Tigers,1-3,3-1,1.0,24,12,24,34,3,21,0,0,6,6,7,15,-2.0,12,-10,0.012381170281610454,-37.24135658536204
3126,3126,2021,4,NCAAF_20210925_KANSAS@DUKE,Kansas,,Duke,,1-3,3-1,,24,21,33,52,3,21,3,6,7,14,21,10,-2.0,3,-19,0.24728160048079284,-11.330688769804851
3127,3127,2021,4,NCAAF_20210925_ARKST@TULSA,Arkansas St.,Red Wolves,Tulsa,Golden Hurricane,1-3,1-3,1.0,14,24,34,41,14,0,17,3,7,17,14,3,0.0,-10,-7,0.43589794080628486,-2.6769199025380885
3128,3128,2021,4,NCAAF_20210925_BUFF@ODU,Buffalo,,Old Dominion,,2-2,1-3,,35,7,35,34,7,28,0,0,7,0,14,13,1.0,28,1,0.8774091502025252,19.277348173143082
3129,3129,2021,4,NCAAF_20210925_CHARSO@ECU,Charleston So.,,East Carolina,,1-2,2-2,,14,24,28,31,14,0,0,14,0,24,7,0,-1.0,-10,-3,0.0895934026883205,-22.28192805029869
3130,3130,2021,4,NCAAF_20210925_UCLA@STNFRD,UCLA,Bruins,Stanford,Cardinal,3-1,2-2,0.0,21,7,35,24,14,7,0,14,0,7,7,10,1.0,14,11,0.37604818067569634,-5.239728776421998
3131,3131,2021,4,NCAAF_20210925_UL@GAS,Louisiana,,Ga. Southern,,3-1,1-3,,14,13,28,20,0,14,14,0,7,6,0,7,2.0,1,8,0.668191122984837,7.214476861532489
3132,3132,2021,4,NCAAF_20210925_TXSO@RICE,Texas Southern,,Rice,,0-3,1-3,,6,20,34,48,0,6,7,21,14,6,14,14,-1.0,-14,-14,0.020763668312239525,-33.80991112341201
3133,3133,2021,4,NCAAF_20210925_KSTATE@OKLAST,Kansas State,Wildcats,Oklahoma State,Cowboys,3-1,4-0,1.0,13,31,20,31,10,3,7,0,21,10,0,0,-1.0,-18,-11,0.3753679109097706,-5.269469565802069
3134,3134,2021,4,NCAAF_20210925_NAVY@HOU,Navy,Midshipmen,Houston,Cougars,0-3,3-1,1.0,17,7,20,28,7,10,0,3,7,0,7,14,-3.0,10,-8,0.41000696484600363,-3.774198592849416
3135,3135,2021,4,NCAAF_20210925_NTEXAS@LATECH,North Texas,,Louisiana Tech,,1-3,2-2,,7,24,17,24,0,7,0,10,14,10,0,0,-1.0,-17,-7,0.42568667216868517,-3.108017573355937
3136,3136,2021,4,NCAAF_20210925_TENN@FLA,Tennessee,Volunteers,Florida,Gators,2-2,3-1,1.0,14,17,14,38,7,7,0,0,10,7,14,7,-1.0,-3,-24,0.19948482009291935,-13.991286376099993
3137,3137,2021,4,NCAAF_20210925_UK@SC,Kentucky,Wildcats,South Carolina,Gamecocks,4-0,2-2,1.0,10,0,16,10,7,3,3,3,0,0,7,3,2.0,10,6,0.5543962198013537,2.268834265544797
3138,3138,2021,4,NCAAF_20210925_AKRON@OHIOST,Akron,Zips,Ohio State,Buckeyes,1-3,3-1,1.0,7,38,7,59,7,0,0,0,14,24,14,7,-2.0,-31,-52,0.000286391654499063,-57.13183623526936
3139,3139,2021,4,NCAAF_20210925_UNC@GATECH,North Carolina,Tar Heels,Georgia Tech,Yellow Jackets,2-2,2-2,1.0,7,13,22,45,7,0,7,8,0,13,14,18,0.0,-6,-23,0.5978097506222464,4.1085260991833366
3140,3140,2021,4,NCAAF_20210925_USM@BAMA,So. Miss,Golden Eagles,Alabama,Crimson Tide,1-3,4-0,1.0,7,42,14,63,0,7,0,7,21,21,7,14,-3.0,-35,-49,0.002791680828114318,-45.97001377610093
3141,3141,2021,4,NCAAF_20210925_WVU@OKLA,West Virginia,Mountaineers,Oklahoma,Sooners,2-2,4-0,1.0,10,7,13,16,7,3,3,0,7,0,3,6,-2.0,3,-3,0.16961453898909618,-15.852893883835918
3142,3142,2021,4,NCAAF_20210925_FAU@AF,FAU,Owls,Air Force,Falcons,2-2,3-1,1.0,7,24,7,31,0,7,0,0,14,10,7,0,-1.0,-17,-24,0.4599787235902868,-1.6668747435159048
3143,3143,2021,4,NCAAF_20210925_HAWAII@NMEXST,Hawaii,,New Mexico St.,,2-3,1-4,,17,13,41,21,10,7,7,17,3,10,0,8,1.0,4,20,0.7302975817994632,10.180220536074103
3144,3144,2021,4,NCAAF_20210925_IND@WKY,Indiana,Hoosiers,W. Kentucky,Hilltoppers,2-2,1-2,1.0,23,14,33,31,14,9,3,7,0,14,10,7,1.0,9,2,0.8993804926440575,21.19983987070293
3145,3145,2021,4,NCAAF_20210925_TROY@LAMON,Troy,,UL-Monroe,,2-2,2-1,,3,10,16,29,0,3,7,6,7,3,10,9,0.0,-7,-13,0.8149176538196482,14.865503662978654
3146,3146,2021,4,NCAAF_20210925_UAB@TULANE,UAB,,Tulane,,3-1,1-3,,21,14,28,21,7,14,7,0,0,14,0,7,2.0,7,7,0.33592720111107766,-7.026710735911934
3147,3147,2021,4,NCAAF_20210925_NMEX@UTEP,New Mexico,,UTEP,,2-2,3-1,,13,3,13,20,7,6,0,0,0,3,14,3,-1.0,10,-7,0.7646867880604095,11.967517351086826
3148,3148,2021,4,NCAAF_20210925_SFLA@BYU,South Florida,Bulls,BYU,Cougars,1-3,4-0,0.0,6,28,27,35,0,6,14,7,21,7,7,0,-3.0,-22,-8,0.24194413100219436,-11.612574636512477
3149,3149,2021,4,NCAAF_20210925_ARIZ@OREG,Arizona,Wildcats,Oregon,Ducks,0-4,4-0,0.0,10,24,19,41,7,3,9,0,17,7,0,17,-4.0,-14,-22,0.14971993678776818,-17.212201962783865
3150,3150,2021,4,NCAAF_20210925_COLO@ARIZST,Colorado,Buffaloes,Arizona St.,Sun Devils,1-3,3-1,0.0,3,14,13,35,0,3,7,3,7,7,7,14,-2.0,-11,-22,0.3542507078383582,-6.201713783297805
3151,3151,2021,4,NCAAF_20210925_OREGST@USC,Oregon State,Beavers,USC,Trojans,3-1,2-2,0.0,21,17,45,27,7,14,14,10,7,10,0,10,1.0,4,18,0.13554992858618753,-18.25554717592854
3152,3152,2021,4,NCAAF_20210924_MTSU@CHARLO,Middle Tenn.,Blue Raiders,Charlotte,49ers,1-3,3-1,1.0,17,14,39,42,7,10,7,15,14,0,14,14,-2.0,3,-3,0.6763050353250066,7.587163497059919
3153,3153,2021,4,NCAAF_20210924_WAKE@UVA,Wake Forest,Demon Deacons,Virginia,Cavaliers,4-0,2-2,1.0,20,3,37,17,10,10,14,3,0,3,14,0,2.0,17,20,0.5240786452234364,1.0017921187126149
3154,3154,2021,4,NCAAF_20210924_LIB@CUSE,Liberty,Flames,Syracuse,Orange,3-1,3-1,0.0,7,14,21,24,0,7,7,7,0,14,7,3,0.0,-7,-3,0.35012757146029705,-6.385948771866651
3155,3155,2021,4,NCAAF_20210924_UNLV@FRESNO,UNLV,Rebels,Fresno St.,Bulldogs,0-4,4-1,0.0,14,9,30,38,14,0,7,9,0,9,13,16,-4.0,5,-8,0.11412317009576356,-19.98658337071697
3156,3156,2021,4,NCAAF_20210923_MRSHL@APLST,Marshall,Thundering Herd,App. St.,Mountaineers,2-2,3-1,1.0,20,21,30,31,6,14,10,0,7,14,0,10,-1.0,-1,-1,0.3594934950033494,-5.968545758234768
3157,3157,2021,5,NCAAF_20211002_ARK@UGA,Arkansas,Razorbacks,Georgia,Bulldogs,4-1,5-0,0.0,0,24,0,37,0,0,0,0,21,3,3,10,-1.0,-24,-37,0.03639115651258795,-29.805920677267522
3158,3158,2021,5,NCAAF_20211002_CHARLO@ILL,Charlotte,49ers,Illinois,Fighting Illini,3-2,2-4,0.0,14,10,14,24,7,7,0,0,3,7,14,0,1.0,4,-10,0.20442118334119352,-13.720750572600423
3159,3159,2021,5,NCAAF_20211002_DUKE@UNC,Duke,Blue Devils,North Carolina,Tar Heels,3-2,3-2,0.0,0,24,7,38,0,0,7,0,7,17,0,14,0.0,-24,-31,0.3954558310231885,-4.404404365793312
3160,3160,2021,5,NCAAF_20211002_MEMP@TEMPLE,Memphis,Tigers,Temple,Owls,3-2,3-2,0.0,17,17,31,34,3,14,6,8,0,17,7,10,0.0,0,-3,0.738799804309475,10.626138443339755
3161,3161,2021,5,NCAAF_20211002_MICH@WISC,Michigan,Wolverines,Wisconsin,Badgers,5-0,1-3,1.0,13,10,38,17,7,6,7,18,0,10,0,7,4.0,3,21,0.5325441366404507,1.3566834402579389
3162,3162,2021,5,NCAAF_20211002_MINN@PURDUE,Minnesota,Golden Gophers,Purdue,Boilermakers,3-2,3-2,0.0,10,13,20,13,7,3,7,3,3,10,0,0,0.0,-3,7,0.5069325085705174,0.28869250348361675
3163,3163,2021,5,NCAAF_20211002_PITT@GATECH,Pittsburgh,Panthers,Georgia Tech,Yellow Jackets,4-1,2-3,1.0,42,14,52,21,21,21,7,3,7,7,7,0,2.0,28,31,0.5889537484905706,3.7353800202320144
3164,3164,2021,5,NCAAF_20211002_TENN@MIZZOU,Tennessee,Volunteers,Missouri,Tigers,3-2,2-3,0.0,45,10,62,24,28,17,10,7,3,7,7,7,1.0,35,38,0.3160898779499073,-7.951726194878461
3165,3165,2021,5,NCAAF_20211002_TEXAS@TCU,Texas,Longhorns,TCU,Horned Frogs,4-1,2-2,0.0,23,17,32,27,13,10,3,6,14,3,3,7,2.0,6,5,0.5683464799892368,2.86009622901247
3166,3166,2021,5,NCAAF_20211002_TOLEDO@UMASS,Toledo,Rockets,UMass,Minutemen,3-2,0-5,1.0,31,0,45,7,7,24,7,7,0,0,0,7,3.0,31,38,0.9195624834215248,23.292871408998053
3167,3167,2021,5,NCAAF_20211002_WMICH@BUFF,W. Michigan,Broncos,Buffalo,Bulls,4-1,2-3,1.0,7,7,24,17,7,0,0,17,7,0,3,7,2.0,0,7,0.42101228607878105,-3.3109328066153694
3168,3168,2021,5,NCAAF_20211002_LVILLE@WAKE,Louisville,Cardinals,Wake Forest,Demon Deacons,3-2,5-0,0.0,17,20,34,37,10,7,0,17,10,10,7,10,-2.0,-3,-3,0.39026527275982437,-4.6286847501304464
3169,3169,2021,5,NCAAF_20211002_APLST@GAST,App. St.,Mountaineers,Georgia St.,Panthers,4-1,1-4,0.0,14,6,45,16,7,7,17,14,0,6,3,7,3.0,8,29,0.8778705314291411,19.343642943638883
3170,3170,2021,5,NCAAF_20211002_USC@COLO,USC,Trojans,Colorado,Buffaloes,3-2,1-4,1.0,20,7,37,14,10,10,10,7,0,7,7,0,2.0,13,23,0.750788286566076,11.246161114153665
3171,3171,2021,5,NCAAF_20211002_CINCY@ND,Cincinnati,Bearcats,Notre Dame,Fighting Irish,4-0,4-1,0.0,17,0,24,13,0,17,0,7,0,0,7,6,0.0,17,11,0.18059252502226397,-15.168969325836883
3172,3172,2021,5,NCAAF_20211002_EMICH@NILL,E. Michigan,Eagles,N. Illinois,Huskies,3-2,3-2,1.0,3,17,20,27,0,3,14,3,10,7,7,3,0.0,-14,-7,0.5074484404810744,0.3101800189702999
3173,3173,2021,5,NCAAF_20211002_LAMON@CSTCAR,UL-Monroe,Warhawks,C. Carolina,Chanticleers,2-2,5-0,1.0,3,38,6,59,3,0,3,0,14,24,0,21,-3.0,-35,-53,0.2668697986470413,-10.338045337199901
3174,3174,2021,5,NCAAF_20211002_BGREEN@KENTST,Bowling Green,,Kent St.,,2-3,2-3,,6,13,20,27,3,3,14,0,10,3,7,7,0.0,-7,-7,0.3173901864609956,-7.8910605275698344
3175,3175,2021,5,NCAAF_20211002_CMICH@MIAOH,C. Michigan,,Miami-OH,,2-3,2-3,,7,14,17,28,0,7,3,7,14,0,0,14,0.0,-7,-11,0.5044566378455779,0.18558360628696846
3176,3176,2021,5,NCAAF_20211002_CUSE@FSU,Syracuse,Orange,Florida State,Seminoles,3-2,1-4,1.0,13,16,30,33,0,13,7,10,3,13,7,10,2.0,-3,-3,0.4816848017304507,-0.7629349339890723
3177,3177,2021,5,NCAAF_20211002_FIU@FAU,FIU,Panthers,FAU,Owls,1-4,3-2,0.0,21,34,21,58,7,14,0,0,7,27,10,14,-2.0,-13,-37,0.2606822604378617,-10.652615298774435
3178,3178,2021,5,NCAAF_20211002_MISS@BAMA,Ole Miss,Rebels,Alabama,Crimson Tide,3-1,5-0,1.0,0,28,21,42,0,0,7,14,7,21,7,7,-2.0,-28,-21,0.04084523450225419,-28.921596573400507
3179,3179,2021,5,NCAAF_20211002_NEVADA@BOISE,Nevada,Wolf Pack,Boise St.,Broncos,3-1,2-3,1.0,20,21,41,31,10,10,18,3,14,7,3,7,1.0,-1,10,0.14758575147442743,-17.390629145068942
3180,3180,2021,5,NCAAF_20211002_OHIO@AKRON,Ohio,,Akron,,1-4,1-4,,10,10,34,17,3,7,7,17,0,10,7,0,0.0,0,17,0.8885758608946919,20.2503796114122
3181,3181,2021,5,NCAAF_20211002_OHIOST@RUT,Ohio State,Buckeyes,Rutgers,Scarlet Knights,4-1,3-2,0.0,45,6,52,13,24,21,7,0,6,0,0,7,1.0,39,39,0.9897832474508601,38.51246074881726
3182,3182,2021,5,NCAAF_20211002_OKLA@KSTATE,Oklahoma,Sooners,Kansas State,Wildcats,5-0,3-2,0.0,13,10,37,31,3,10,14,10,7,3,7,14,2.0,3,6,0.8415256250194043,16.624857982591493
3183,3183,2021,5,NCAAF_20211002_TROY@SC,Troy,Trojans,South Carolina,Gamecocks,2-3,3-2,0.0,7,17,14,23,0,7,7,0,3,14,3,3,-1.0,-10,-9,0.23976731694609965,-11.745842916821289
3184,3184,2021,5,NCAAF_20211002_TULANE@ECU,Tulane,,East Carolina,,1-4,3-2,,7,31,29,52,0,7,16,6,17,14,0,21,-2.0,-24,-23,0.8136581373958223,14.809281662805347
3185,3185,2021,5,NCAAF_20211002_TXTECH@WVU,Texas Tech,Red Raiders,West Virginia,Mountaineers,4-1,2-3,1.0,17,0,23,20,14,3,0,6,0,0,17,3,2.0,17,3,0.4083928558256239,-3.84878725551755
3186,3186,2021,5,NCAAF_20211002_UCF@NAVY,UCF,Knights,Navy,Midshipmen,2-2,1-3,0.0,23,17,30,34,13,10,7,0,7,10,0,17,1.0,6,-4,0.852329656010693,17.384537428623617
3187,3187,2021,5,NCAAF_20211002_ARKST@GAS,Arkansas St.,,Ga. Southern,,1-4,2-3,,19,31,33,59,3,16,0,14,10,21,14,14,-1.0,-12,-26,0.5936393024838532,3.935763719890133
3188,3188,2021,5,NCAAF_20211002_SFLA@SMU,South Florida,Bulls,SMU,Mustangs,1-4,5-0,0.0,3,17,17,41,0,3,14,0,10,7,10,14,-4.0,-14,-24,0.2910989230504666,-9.13978290852765
3189,3189,2021,5,NCAAF_20211002_ARMY@BALLST,Army,Black Knights,Ball St.,Cardinals,4-1,2-3,1.0,14,21,16,28,0,14,0,2,21,0,0,7,2.0,-7,-12,0.827183376350896,15.66707417301177
3190,3190,2021,5,NCAAF_20211002_WASHST@CAL,Washington St.,Cougars,California,Golden Bears,2-3,1-4,1.0,14,6,21,6,14,0,7,0,6,0,0,0,1.0,8,15,0.6423917856807201,6.061201639913179
3191,3191,2021,5,NCAAF_20211002_FLA@UK,Florida,Gators,Kentucky,Wildcats,3-2,5-0,1.0,10,7,13,20,7,3,0,3,7,0,6,7,-2.0,3,-7,0.7074388233307124,9.069026191930107
3192,3192,2021,5,NCAAF_20211002_LATECH@NCST,Louisiana Tech,Bulldogs,NC State,Wolfpack,2-3,4-1,1.0,10,13,27,34,0,10,3,14,7,6,14,7,-2.0,-3,-7,0.19048823990690433,-14.554129764031359
3193,3193,2021,5,NCAAF_20211002_UNLV@TXSA,UNLV,,UTSA,,0-5,5-0,,10,17,17,24,7,3,0,7,7,10,7,0,-5.0,-7,-7,0.48845234213178645,-0.4809254944049144
3194,3194,2021,5,NCAAF_20211002_AF@NMEX,Air Force,Falcons,New Mexico,Lobos,4-1,2-3,0.0,24,0,38,10,7,17,7,7,0,0,7,3,2.0,24,28,0.8613954101879889,18.051239055692008
3195,3195,2021,5,NCAAF_20211002_USM@RICE,So. Miss,,Rice,,1-4,2-3,,7,10,19,24,7,0,7,5,7,3,14,0,-1.0,-3,-5,0.7502467852113175,11.217821823544682
3196,3196,2021,5,NCAAF_20211002_BAYLOR@OKLAST,Baylor,Bears,Oklahoma State,Cowboys,4-1,5-0,0.0,0,14,14,24,0,0,7,7,7,7,0,10,-1.0,-14,-10,0.30796077330163385,-8.333443793127344
3197,3197,2021,5,NCAAF_20211002_KANSAS@IOWAST,Kansas,Jayhawks,Iowa St.,Cyclones,1-4,3-2,1.0,0,38,7,59,0,0,7,0,28,10,14,7,-2.0,-38,-52,0.048433806925904044,-27.580510926141528
3198,3198,2021,5,NCAAF_20211002_LIB@UAB,Liberty,Flames,UAB,Blazers,4-1,3-2,0.0,3,3,36,12,0,3,21,12,3,0,0,9,1.0,0,24,0.5013961791110131,0.0581386917706368
3199,3199,2021,5,NCAAF_20211002_MISSST@TXAM,Miss. State,Bulldogs,Texas A&M,Aggies,3-2,3-2,0.0,17,13,26,22,10,7,7,2,7,6,6,3,0.0,4,4,0.4807935710484792,-0.8000879456722032
3200,3200,2021,5,NCAAF_20211002_MRSHL@MTSU,Marshall,,Middle Tenn.,,2-3,2-3,,14,28,28,34,0,14,0,14,7,21,6,0,0.0,-14,-6,0.6864463451221814,8.070359989510507
3201,3201,2021,5,NCAAF_20211002_BC@CLEM,Boston College,Eagles,Clemson,Tigers,4-1,3-2,0.0,6,13,13,19,3,3,7,0,7,6,3,3,1.0,-7,-6,0.06090191683203472,-25.703530985041766
3202,3202,2021,5,NCAAF_20211002_IND@PSU,Indiana,Hoosiers,Penn State,Nittany Lions,2-3,5-0,1.0,0,14,0,24,0,0,0,0,7,7,7,3,-3.0,-14,-24,0.17473601863112131,-15.54282452111454
3203,3203,2021,5,NCAAF_20211002_NWEST@NEB,Northwestern,Wildcats,Nebraska,Cornhuskers,2-3,3-3,0.0,7,35,7,56,7,0,0,0,21,14,14,7,-1.0,-28,-49,0.5838472741523327,3.51761130862576
3204,3204,2021,5,NCAAF_20211002_UCONN@VANDY,UConn,Huskies,Vanderbilt,Commodores,0-6,2-3,1.0,16,17,28,30,6,10,0,12,3,14,0,13,-2.0,-1,-2,0.12128569885121687,-19.41302096202537
3205,3205,2021,5,NCAAF_20211002_WKY@MICHST,W. Kentucky,Hilltoppers,Michigan St.,Spartans,1-3,5-0,1.0,16,42,31,48,10,6,0,15,21,21,3,3,-4.0,-26,-17,0.11014513876761178,-20.36280228974499
3206,3206,2021,5,NCAAF_20211002_UL@SALA,Louisiana,,South Alabama,,4-1,3-1,,20,6,20,18,14,6,0,0,0,6,6,6,1.0,14,2,0.8338681397195554,16.106823864203875
3207,3207,2021,5,NCAAF_20211002_AUBURN@LSU,Auburn,Tigers,LSU,Tigers,4-1,3-2,1.0,10,13,24,19,0,10,0,14,7,6,6,0,1.0,-3,5,0.5252561914491112,1.0524016121009936
3208,3208,2021,5,NCAAF_20211002_ODU@UTEP,Old Dominion,,UTEP,,1-4,4-1,,7,17,21,28,0,7,14,0,3,14,3,8,-3.0,-10,-7,0.6620386570369358,6.944553005196553
3209,3209,2021,5,NCAAF_20211002_WASH@OREGST,Washington,Huskies,Oregon State,Beavers,2-3,4-1,1.0,10,14,24,27,7,3,0,14,0,14,3,10,-2.0,-4,-3,0.9164198417981377,22.948184885676937
3210,3210,2021,5,NCAAF_20211002_ARIZST@UCLA,Arizona St.,Sun Devils,UCLA,Bruins,4-1,3-2,0.0,24,23,42,23,3,21,8,10,3,20,0,0,1.0,1,19,0.5773251606692371,3.2403430352552505
3211,3211,2021,5,NCAAF_20211002_NMEXST@SJST,New Mexico St.,Aggies,San Jose St.,Spartans,1-5,3-2,1.0,14,24,31,37,0,14,7,10,7,17,6,7,-2.0,-10,-6,0.3459778691711394,-6.581886281057791
3212,3212,2021,5,NCAAF_20211002_FRESNO@HAWAII,Fresno St.,Bulldogs,Hawaii,Rainbow Warriors,4-2,3-3,1.0,14,10,24,27,7,7,10,0,10,0,0,17,1.0,4,-3,0.8131994695739502,14.78088567527766
3213,3213,2021,5,NCAAF_20211001_HOU@TULSA,Houston,Cougars,Tulsa,Golden Hurricane,4-1,1-4,1.0,28,3,45,10,14,14,7,10,0,3,0,7,3.0,25,35,0.6415482890180009,6.023675393016333
3214,3214,2021,5,NCAAF_20211001_IOWA@MD,Iowa,Hawkeyes,Maryland,Terrapins,5-0,4-1,0.0,34,7,51,14,3,31,10,7,7,0,7,0,1.0,27,37,0.8921023380471447,20.562643987990782
3215,3215,2021,5,NCAAF_20211001_BYU@UTAHST,BYU,Cougars,Utah St.,Aggies,5-0,3-2,0.0,24,13,34,20,10,14,0,10,3,10,0,7,2.0,11,14,0.5654578188057899,2.738088980580301
3216,3216,2021,5,NCAAF_20210930_UVA@MIAMI,Virginia,Cavaliers,Miami (Fla.),Hurricanes,3-2,2-3,1.0,16,7,30,28,9,7,11,3,0,7,14,7,1.0,9,2,0.35011337039412593,-6.396026882399951
3217,3217,2021,6,NCAAF_20211009_AKRON@BGREEN,Akron,Zips,Bowling Green,Falcons,2-4,2-4,0.0,7,13,35,20,0,7,21,7,10,3,0,7,0.0,-6,15,0.5694424001185827,2.9137808258751647
3218,3218,2021,6,NCAAF_20211009_ARK@MISS,Arkansas,Razorbacks,Ole Miss,Rebels,4-2,4-1,1.0,14,21,51,52,7,7,17,20,0,21,10,21,0.0,-7,-1,0.30270170261924223,-8.60446987468822
3219,3219,2021,6,NCAAF_20211009_MD@OHIOST,Maryland,Terrapins,Ohio State,Buckeyes,4-2,5-1,1.0,10,35,17,66,3,7,7,0,14,21,21,10,-1.0,-25,-49,0.023658923906485718,-33.03323721423601
3220,3220,2021,6,NCAAF_20211009_MICHST@RUT,Michigan St.,Spartans,Rutgers,Scarlet Knights,6-0,3-3,1.0,21,13,31,13,7,14,7,3,7,6,0,0,3.0,8,18,0.8167264760082921,15.038335080256616
3221,3221,2021,6,NCAAF_20211009_NILL@TOLEDO,N. Illinois,Huskies,Toledo,Rockets,4-2,3-3,1.0,16,14,22,20,3,13,0,6,0,14,0,6,1.0,2,2,0.4121352577592289,-3.6982232181964036
3222,3222,2021,6,NCAAF_20211009_OKLA@TEXAS,Oklahoma,Sooners,Texas,Longhorns,6-0,4-2,0.0,20,38,55,48,7,13,10,25,28,10,3,7,2.0,-18,7,0.70399869666015,8.925741668176443
3223,3223,2021,6,NCAAF_20211009_SC@TENN,South Carolina,Gamecocks,Tennessee,Volunteers,3-3,4-2,1.0,7,38,20,45,0,7,7,6,28,10,0,7,-1.0,-31,-25,0.5459461887711828,1.9223572763733046
3224,3224,2021,6,NCAAF_20211009_VANDY@FLA,Vanderbilt,Commodores,Florida,Gators,2-4,4-2,1.0,0,21,0,42,0,0,0,0,14,7,21,0,-2.0,-21,-42,0.08163008646416192,-23.21951827107
3225,3225,2021,6,NCAAF_20211009_WVU@BAYLOR,West Virginia,Mountaineers,Baylor,Bears,2-4,5-1,0.0,10,28,20,45,7,3,3,7,21,7,14,3,-3.0,-18,-25,0.5957663572454914,4.037110256218739
3226,3226,2021,6,NCAAF_20211009_GATECH@DUKE,Georgia Tech,Yellow Jackets,Duke,Blue Devils,3-3,3-3,0.0,17,14,31,27,14,3,7,7,7,7,3,10,0.0,3,4,0.5364830178001949,1.5251710482376666
3227,3227,2021,6,NCAAF_20211009_UVA@LVILLE,Virginia,Cavaliers,Louisville,Cardinals,4-2,3-3,1.0,13,10,34,33,10,3,0,21,10,0,20,3,1.0,3,1,0.5707831623524016,2.9706333953719195
3228,3228,2021,6,NCAAF_20211009_BALLST@WMICH,Ball St.,Cardinals,W. Michigan,Broncos,3-3,4-2,1.0,17,17,45,20,7,10,7,21,14,3,3,0,-1.0,0,25,0.26881978985306687,-10.265595974817643
3229,3229,2021,6,NCAAF_20211009_BOISE@BYU,Boise St.,Broncos,BYU,Cougars,3-3,5-1,0.0,20,10,26,17,3,17,3,3,10,0,0,7,-2.0,10,9,0.6339566470302986,5.701680356543761
3230,3230,2021,6,NCAAF_20211009_CMICH@OHIO,C. Michigan,Chippewas,Ohio,Bobcats,3-3,1-5,0.0,13,10,30,27,7,6,7,10,3,7,9,8,2.0,3,3,0.36028315707113523,-5.95734264875
3231,3231,2021,6,NCAAF_20211009_FAU@UAB,FAU,Owls,UAB,Blazers,3-3,4-2,0.0,14,24,14,31,7,7,0,0,14,10,7,0,-1.0,-10,-17,0.6535868632428099,6.578896031524664
3232,3232,2021,6,NCAAF_20211009_FSU@UNC,Florida State,Seminoles,North Carolina,Tar Heels,2-4,3-3,0.0,21,10,35,25,0,21,14,0,10,0,7,8,-1.0,11,10,0.40052354002243995,-4.196800282650315
3233,3233,2021,6,NCAAF_20211009_MIAOH@EMICH,Miami-OH,RedHawks,E. Michigan,Eagles,2-4,4-2,0.0,6,10,12,13,6,0,3,3,0,10,3,0,-2.0,-4,-1,0.4716823013849969,-1.1831621025758068
3234,3234,2021,6,NCAAF_20211009_MTSU@LIB,Middle Tenn.,Blue Raiders,Liberty,Flames,2-4,5-1,1.0,7,24,13,41,0,7,6,0,14,10,10,7,-3.0,-17,-28,0.3956055687605967,-4.409078279014466
3235,3235,2021,6,NCAAF_20211009_SJST@COLOST,San Jose St.,Spartans,Colorado St.,Rams,3-3,2-3,0.0,7,16,14,32,0,7,0,7,10,6,10,6,1.0,-9,-18,0.2916416393782848,-9.136569906353316
3236,3236,2021,6,NCAAF_20211009_SMU@NAVY,SMU,Mustangs,Navy,Midshipmen,6-0,1-4,1.0,21,21,31,24,7,14,3,7,7,14,3,0,5.0,0,7,0.604620921587411,4.41887145792748
3237,3237,2021,6,NCAAF_20211009_UCONN@UMASS,UConn,Huskies,UMass,Minutemen,0-7,1-5,1.0,10,7,13,27,10,0,0,3,7,0,3,17,-1.0,3,-14,0.5478786082834897,2.0035916008209824
3238,3238,2021,6,NCAAF_20211009_UGA@AUBURN,Georgia,Bulldogs,Auburn,Tigers,6-0,4-2,0.0,17,3,34,10,3,14,7,10,3,0,7,0,2.0,14,24,0.6704491146383753,7.347186193673224
3239,3239,2021,6,NCAAF_20211009_WISC@ILL,Wisconsin,Badgers,Illinois,Fighting Illini,2-3,2-5,0.0,10,0,24,0,3,7,14,0,0,0,0,0,0.0,10,24,0.9368511732002717,25.462474867717788
3240,3240,2021,6,NCAAF_20211009_NTEXAS@MIZZOU,North Texas,Mean Green,Missouri,Tigers,1-4,3-3,0.0,7,31,35,48,0,7,7,21,14,17,0,17,-2.0,-24,-13,0.10495439505898552,-20.881662914286494
3241,3241,2021,6,NCAAF_20211009_OREGST@WASHST,Oregon State,Beavers,Washington St.,Cougars,4-2,3-3,0.0,10,3,24,31,0,10,7,7,0,3,14,14,1.0,7,-7,0.1880650368801965,-14.740038241684147
3242,3242,2021,6,NCAAF_20211009_PSU@IOWA,Penn State,Nittany Lions,Iowa,Hawkeyes,5-1,6-0,0.0,17,10,20,23,14,3,3,0,3,7,3,10,-1.0,7,-3,0.589263586623527,3.758101876009164
3243,3243,2021,6,NCAAF_20211009_ECU@UCF,East Carolina,Pirates,UCF,Knights,3-3,3-2,1.0,3,3,16,20,0,3,10,3,0,3,7,10,0.0,0,-4,0.045026282649442084,-28.231356767775992
3244,3244,2021,6,NCAAF_20211009_BUFF@KENTST,Buffalo,Bulls,Kent St.,Golden Flashes,2-4,3-3,0.0,10,31,38,48,0,10,28,0,14,17,3,14,-1.0,-21,-10,0.8351334571885233,16.232320040612308
3245,3245,2021,6,NCAAF_20211009_GAS@TROY,Ga. Southern,Eagles,Troy,Trojans,2-4,3-3,0.0,3,17,24,27,0,3,15,6,10,7,7,3,-1.0,-14,-3,0.38889721194747806,-4.699802669542237
3246,3246,2021,6,NCAAF_20211009_TCU@TXTECH,TCU,Horned Frogs,Texas Tech,Red Raiders,3-2,4-2,1.0,35,10,52,31,14,21,10,7,7,3,14,7,-1.0,25,21,0.6611055183213266,6.919641098378634
3247,3247,2021,6,NCAAF_20211009_TXSA@WKY,UTSA,Roadrunners,W. Kentucky,Hilltoppers,6-0,1-4,1.0,28,24,52,46,14,14,14,10,10,14,13,9,5.0,4,6,0.3953825284862995,-4.4187222693058175
3248,3248,2021,6,NCAAF_20211009_UTEP@USM,UTEP,Miners,So. Miss,Golden Eagles,5-1,1-5,1.0,14,7,26,13,7,7,7,5,7,0,0,6,4.0,7,13,0.17057648024016525,-15.853230363556918
3249,3249,2021,6,NCAAF_20211009_WYO@AF,Wyoming,Cowboys,Air Force,Falcons,4-1,5-1,0.0,14,14,14,24,0,14,0,0,7,7,7,3,-1.0,0,-10,0.41374281789224077,-3.6294692525126493
3250,3250,2021,6,NCAAF_20211009_LSU@UK,LSU,Tigers,Kentucky,Wildcats,3-3,6-0,1.0,0,14,21,42,0,0,7,14,7,7,14,14,-3.0,-14,-21,0.7514497548819155,11.309376815261658
3251,3251,2021,6,NCAAF_20211009_MICH@NEB,Michigan,Wolverines,Nebraska,Cornhuskers,6-0,3-4,1.0,13,0,32,29,0,13,6,13,0,0,22,7,3.0,13,3,0.8539635685079041,17.54691780918779
3252,3252,2021,6,NCAAF_20211009_ND@VATECH,Notre Dame,Fighting Irish,Virginia Tech,Hokies,5-1,3-2,1.0,14,13,32,29,0,14,7,11,7,6,9,7,2.0,1,3,0.8003749056326518,14.039082300421342
3253,3253,2021,6,NCAAF_20211009_BAMA@TXAM,Alabama,Crimson Tide,Texas A&M,Aggies,5-1,4-2,0.0,10,24,38,41,7,3,14,14,17,7,7,10,1.0,-14,-3,0.910819628585513,22.41392863371982
3254,3254,2021,6,NCAAF_20211009_GAST@LAMON,Georgia St.,Panthers,UL-Monroe,Warhawks,2-4,2-3,0.0,28,7,55,21,7,21,14,13,7,0,7,7,0.0,21,34,0.6249338335266732,5.303868128388672
3255,3255,2021,6,NCAAF_20211009_UTAH@USC,Utah,Utes,USC,Trojans,3-2,3-3,0.0,21,10,42,26,7,14,14,7,3,7,0,16,0.0,11,16,0.583625957631138,3.517066815938847
3256,3256,2021,6,NCAAF_20211009_MEMP@TULSA,Memphis,Tigers,Tulsa,Golden Hurricane,3-3,2-4,1.0,13,14,29,35,0,13,0,16,7,7,7,14,1.0,-1,-6,0.7485217472413117,11.155925256413525
3257,3257,2021,6,NCAAF_20211009_NMEX@SDGST,New Mexico,Lobos,San Diego St.,Aztecs,2-4,5-0,1.0,0,17,7,31,0,0,7,0,7,10,7,7,-3.0,-17,-24,0.12912762320671156,-18.82830330996103
3258,3258,2021,6,NCAAF_20211009_NMEXST@NEVADA,New Mexico St.,Aggies,Nevada,Wolf Pack,1-6,4-1,1.0,7,31,28,55,7,0,0,21,3,28,21,3,-3.0,-24,-27,0.1886520693012086,-14.703817313718787
3259,3259,2021,6,NCAAF_20211009_UCLA@ARIZ,UCLA,Bruins,Arizona,Wildcats,4-2,0-5,0.0,14,13,34,16,7,7,10,10,3,10,3,0,4.0,1,18,0.6216919011078721,5.161680156994294
3260,3260,2021,6,NCAAF_20211008_CHARLO@FIU,Charlotte,49ers,FIU,Panthers,4-2,1-5,0.0,17,6,45,33,7,10,14,14,3,3,7,20,3.0,11,12,0.3704818141832882,-5.505597955309213
3261,3261,2021,6,NCAAF_20211008_TEMPLE@CINCY,Temple,Owls,Cincinnati,Bearcats,3-3,5-0,1.0,3,17,3,52,0,3,0,0,10,7,28,7,-2.0,-14,-49,0.24848400456191344,-11.312859443304774
3262,3262,2021,6,NCAAF_20211008_STNFRD@ARIZST,Stanford,Cardinal,Arizona St.,Sun Devils,3-3,5-1,1.0,7,21,10,28,7,0,3,0,14,7,7,0,-2.0,-14,-18,0.5246125632051131,1.0281435083398947
3263,3263,2021,6,NCAAF_20211007_CSTCAR@ARKST,C. Carolina,Chanticleers,Arkansas St.,Red Wolves,6-0,1-5,0.0,24,0,52,20,10,14,14,14,0,0,14,6,5.0,24,32,0.4789627267651261,-0.8786420484393602
3264,3264,2021,6,NCAAF_20211007_HOU@TULANE,Houston,Cougars,Tulane,Green Wave,5-1,1-5,0.0,17,15,40,22,14,3,9,14,0,15,7,0,4.0,2,18,0.5592523328094056,2.4827485571902344
3265,3265,2021,7,NCAAF_20211016_AUBURN@ARK,Auburn,Tigers,Arkansas,Razorbacks,5-2,4-3,1.0,14,10,38,23,7,7,14,10,3,7,13,0,1.0,4,15,0.9090493370948292,22.25138493732186
3266,3266,2021,7,NCAAF_20211016_FLA@LSU,Florida,Gators,LSU,Tigers,4-3,4-3,0.0,13,21,42,49,6,7,22,7,0,21,14,14,0.0,-8,-7,0.45788334245310636,-1.7630050841321463
3267,3267,2021,7,NCAAF_20211016_MICHST@IND,Michigan St.,Spartans,Indiana,Hoosiers,7-0,2-4,1.0,7,9,20,15,7,0,10,3,3,6,0,6,5.0,-2,5,0.5078616274939709,0.3284967797499121
3268,3268,2021,7,NCAAF_20211016_NEB@MINN,Nebraska,Cornhuskers,Minnesota,Golden Gophers,3-5,4-2,1.0,9,21,23,30,3,6,7,7,7,14,0,9,-1.0,-12,-7,0.4241173903018012,-3.189900918178637
3269,3269,2021,7,NCAAF_20211016_OHIO@BUFF,Ohio,Bobcats,Buffalo,Bulls,1-6,3-4,0.0,21,10,26,27,21,0,5,0,0,10,0,17,-2.0,11,-1,0.48424585183963964,-0.6584129921160411
3270,3270,2021,7,NCAAF_20211016_OKLAST@TEXAS,Oklahoma State,Cowboys,Texas,Longhorns,6-0,4-3,0.0,13,17,32,24,3,10,3,16,10,7,7,0,2.0,-4,8,0.451831784856044,-2.017485492908463
3271,3271,2021,7,NCAAF_20211016_RUT@NWEST,Rutgers,Scarlet Knights,Northwestern,Wildcats,3-4,3-3,0.0,7,14,7,21,0,7,0,0,7,7,0,7,0.0,-7,-14,0.21905357787263613,-12.924768802536391
3272,3272,2021,7,NCAAF_20211016_TULSA@SFLA,Tulsa,Golden Hurricane,South Florida,Bulls,3-4,1-5,0.0,20,24,32,31,3,17,0,12,3,21,7,0,2.0,-4,1,0.5578752825244937,2.4266974535962618
3273,3273,2021,7,NCAAF_20211016_TXAM@MIZZOU,Texas A&M,Aggies,Missouri,Tigers,5-2,3-4,0.0,28,7,35,14,21,7,7,0,0,7,7,0,2.0,21,21,0.5893536041441848,3.7651582788080304
3274,3274,2021,7,NCAAF_20211016_UCF@CINCY,UCF,Knights,Cincinnati,Bearcats,3-3,6-0,1.0,7,35,21,56,0,7,7,7,14,21,7,14,-3.0,-28,-35,0.6400919464215951,5.979123475719234
3275,3275,2021,7,NCAAF_20211016_YALE@UCONN,Yale,Bulldogs,UConn,Huskies,2-3,1-7,0.0,0,14,15,21,0,0,9,6,0,14,7,0,1.0,-14,-6,,
3276,3276,2021,7,NCAAF_20211016_DUKE@UVA,Duke,Blue Devils,Virginia,Cavaliers,3-4,5-2,0.0,0,34,0,48,0,0,0,0,10,24,7,7,-2.0,-34,-48,0.3782732394393973,-5.167600997490922
3277,3277,2021,7,NCAAF_20211016_BALLST@EMICH,Ball St.,Cardinals,E. Michigan,Eagles,4-3,4-3,1.0,17,14,38,31,14,3,7,14,0,14,3,14,0.0,3,7,0.3375110062251844,-6.988594959974989
3278,3278,2021,7,NCAAF_20211016_AKRON@MIAOH,Akron,Zips,Miami-OH,RedHawks,2-5,3-4,1.0,7,21,21,34,0,7,0,14,14,7,13,0,-1.0,-14,-13,0.19342911230112092,-14.423872672648258
3279,3279,2021,7,NCAAF_20211016_TROY@TXSTSM,Troy,Trojans,Texas St.,Bobcats,4-3,2-4,0.0,17,14,31,28,10,7,7,7,7,7,14,0,2.0,3,3,0.8361511644950177,16.314645284388916
3280,3280,2021,7,NCAAF_20211016_ARIZ@COLO,Arizona,Wildcats,Colorado,Buffaloes,0-6,2-4,1.0,0,6,0,34,0,0,0,0,3,3,21,7,-2.0,-6,-34,0.4635108719984099,-1.5267253589618122
3281,3281,2021,7,NCAAF_20211016_BGREEN@NILL,Bowling Green,Falcons,N. Illinois,Huskies,2-5,5-2,1.0,13,21,26,34,7,6,3,10,0,21,10,3,-3.0,-8,-8,0.12585448019399315,-19.105753528875084
3282,3282,2021,7,NCAAF_20211016_BYU@BAYLOR,BYU,Cougars,Baylor,Bears,5-2,6-1,0.0,7,17,24,38,0,7,7,10,3,14,14,7,-1.0,-10,-14,0.4575424618113151,-1.7773283434208906
3283,3283,2021,7,NCAAF_20211016_FRESNO@WYO,Fresno St.,Bulldogs,Wyoming,Cowboys,5-2,4-2,1.0,7,0,17,0,7,0,7,3,0,0,0,0,1.0,7,17,0.6301858350269391,5.539754381265425
3284,3284,2021,7,NCAAF_20211016_KENTST@WMICH,Kent St.,Golden Flashes,W. Michigan,Broncos,3-4,5-2,0.0,17,23,31,64,7,10,6,8,17,6,27,14,-2.0,-6,-33,0.23434747552225565,-12.078176957735081
3285,3285,2021,7,NCAAF_20211016_MIAMI@UNC,Miami (Fla.),Hurricanes,North Carolina,Tar Heels,2-4,4-3,0.0,17,31,42,45,10,7,17,8,14,17,7,7,-2.0,-14,-3,0.6398020342018973,5.966207213258599
3286,3286,2021,7,NCAAF_20211016_PITT@VATECH,Pittsburgh,Panthers,Virginia Tech,Hokies,5-1,3-3,1.0,21,0,28,7,7,14,7,0,0,0,7,0,2.0,21,21,0.47619416892525546,-0.9952492856378967
3287,3287,2021,7,NCAAF_20211016_PURDUE@IOWA,Purdue,Boilermakers,Iowa,Hawkeyes,4-2,6-1,0.0,14,7,24,7,7,7,3,7,0,7,0,0,-2.0,7,17,0.22666092848172692,-12.499634285949696
3288,3288,2021,7,NCAAF_20211016_UAB@USM,UAB,Blazers,So. Miss,Golden Eagles,5-2,1-6,1.0,31,0,34,0,3,28,3,0,0,0,0,0,4.0,31,34,0.6290513783364571,5.489687905297274
3289,3289,2021,7,NCAAF_20211016_UK@UGA,Kentucky,Wildcats,Georgia,Bulldogs,6-1,7-0,1.0,7,14,13,30,0,7,0,6,0,14,10,6,-1.0,-7,-17,0.12060341940510089,-19.53525981783821
3290,3290,2021,7,NCAAF_20211016_WKY@ODU,W. Kentucky,Hilltoppers,Old Dominion,Monarchs,2-4,1-6,1.0,30,3,43,20,14,16,3,10,0,3,3,14,1.0,27,23,0.7236580212095619,9.896899901728034
3291,3291,2021,7,NCAAF_20211016_TXTECH@KANSAS,Texas Tech,Red Raiders,Kansas,Jayhawks,5-2,1-5,1.0,24,0,41,14,7,17,14,3,0,0,0,14,4.0,24,27,0.8540240527444796,17.566253334800194
3292,3292,2021,7,NCAAF_20211016_VANDY@SC,Vanderbilt,Commodores,South Carolina,Gamecocks,2-5,4-3,0.0,10,14,20,21,3,7,7,3,14,0,0,7,-2.0,-4,-1,0.23776826846657761,-11.893083408294387
3293,3293,2021,7,NCAAF_20211016_RICE@TXSA,Rice,Owls,UTSA,Roadrunners,2-4,7-0,0.0,0,31,0,45,0,0,0,0,17,14,14,0,-5.0,-31,-45,0.336121442879477,-7.052038492315319
3294,3294,2021,7,NCAAF_20211016_BAMA@MISSST,Alabama,Crimson Tide,Miss. State,Bulldogs,6-1,3-3,0.0,21,6,49,9,14,7,14,14,3,3,3,0,3.0,15,40,0.9107064510401668,22.421312239971826
3295,3295,2021,7,NCAAF_20211016_COLOST@NMEX,Colorado St.,Rams,New Mexico,Lobos,3-3,2-5,0.0,13,7,36,7,7,6,10,13,0,7,0,0,1.0,6,29,0.7499606933218085,11.240776565321653
3296,3296,2021,7,NCAAF_20211016_LIB@LAMON,Liberty,Flames,UL-Monroe,Warhawks,5-2,3-3,1.0,14,0,28,31,0,14,0,14,0,0,28,3,2.0,14,-3,0.8419611812911094,16.711175616763626
3297,3297,2021,7,NCAAF_20211016_UTAHST@UNLV,Utah St.,Aggies,UNLV,Rebels,4-2,0-6,0.0,14,17,28,24,7,7,7,7,17,0,7,0,4.0,-3,4,0.8372238368600922,16.38715643660305
3298,3298,2021,7,NCAAF_20211016_IOWAST@KSTATE,Iowa St.,Cyclones,Kansas State,Wildcats,4-2,3-3,1.0,20,7,33,20,10,10,7,6,7,0,0,13,1.0,13,13,0.6870904288129609,8.127967783739678
3299,3299,2021,7,NCAAF_20211016_MISS@TENN,Ole Miss,Rebels,Tennessee,Volunteers,5-1,4-3,1.0,24,12,31,26,10,14,7,0,9,3,7,7,1.0,12,5,0.5540483643093216,2.2652085783603297
3300,3300,2021,7,NCAAF_20211016_NCST@BC,NC State,Wolfpack,Boston College,Eagles,5-1,4-2,1.0,10,7,33,7,7,3,21,2,7,0,0,0,1.0,3,26,0.4996117887214572,-0.016220295443986288
3301,3301,2021,7,NCAAF_20211016_STNFRD@WASHST,Stanford,Cardinal,Washington St.,Cougars,3-4,4-3,1.0,16,20,31,34,13,3,0,15,0,20,7,7,-1.0,-4,-3,0.46525212604034716,-1.4536806769386885
3302,3302,2021,7,NCAAF_20211016_TCU@OKLA,TCU,Horned Frogs,Oklahoma,Sooners,3-3,7-0,0.0,14,24,31,52,7,7,10,7,14,10,21,7,-4.0,-10,-21,0.24328315512695886,-11.597726283964107
3303,3303,2021,7,NCAAF_20211016_ARMY@WISC,Army,Black Knights,Wisconsin,Badgers,4-2,3-3,0.0,0,13,14,20,0,0,0,14,0,13,0,7,1.0,-13,-6,0.09067611008887211,-22.27937890013027
3304,3304,2021,7,NCAAF_20211016_UCLA@WASH,UCLA,Bruins,Washington,Huskies,5-2,2-4,0.0,17,10,24,17,7,10,0,7,3,7,7,0,3.0,7,7,0.21827715043811335,-12.968631108078625
3305,3305,2021,7,NCAAF_20211016_AF@BOISE,Air Force,Falcons,Boise St.,Broncos,6-1,3-4,0.0,21,14,24,17,7,14,0,3,7,7,0,3,3.0,7,7,0.3193370075886083,-7.82682710614074
3306,3306,2021,7,NCAAF_20211016_LATECH@UTEP,Louisiana Tech,Bulldogs,UTEP,Miners,2-4,6-1,0.0,3,16,3,19,0,3,0,0,14,2,3,0,-4.0,-13,-16,0.8603724475162476,18.03539016497473
3307,3307,2021,7,NCAAF_20211016_ARIZST@UTAH,Arizona St.,Sun Devils,Utah,Utes,5-2,4-2,1.0,21,7,21,35,7,14,0,0,7,0,14,14,1.0,14,-14,0.33144675401496193,-7.2662300223792045
3308,3308,2021,7,NCAAF_20211016_HAWAII@NEVADA,Hawaii,Rainbow Warriors,Nevada,Wolf Pack,3-4,5-1,0.0,17,20,17,34,7,10,0,0,3,17,14,0,-2.0,-3,-17,0.4011785086541504,-4.172129037524428
3309,3309,2021,7,NCAAF_20211015_CLEM@CUSE,Clemson,Tigers,Syracuse,Orange,4-2,3-4,0.0,14,7,17,14,0,14,0,3,0,7,0,7,1.0,7,3,0.9672543501877019,30.701825972139545
3310,3310,2021,7,NCAAF_20211015_MRSHL@NTEXAS,Marshall,Thundering Herd,North Texas,Mean Green,4-3,1-5,1.0,42,7,49,21,14,28,0,7,0,7,0,14,3.0,35,28,0.7040814739843908,8.937330602451084
3311,3311,2021,7,NCAAF_20211015_CAL@OREG,California,Golden Bears,Oregon,Ducks,1-5,5-1,0.0,7,10,17,24,7,0,3,7,3,7,0,14,-4.0,-3,-7,0.2250017446366097,-12.59165697667811
3312,3312,2021,7,NCAAF_20211014_GAS@SALA,Ga. Southern,Eagles,South Alabama,Jaguars,2-5,4-2,0.0,8,31,14,41,0,8,3,3,10,21,7,3,-2.0,-23,-27,0.7038581281680294,8.92655802530794
3313,3313,2021,7,NCAAF_20211014_NAVY@MEMP,Navy,Midshipmen,Memphis,Tigers,1-5,4-3,0.0,10,28,17,35,7,3,7,0,14,14,7,0,-3.0,-18,-18,0.32270663078492323,-7.669973246168638
3314,3314,2021,7,NCAAF_20211012_APLST@UL,App. St.,Mountaineers,Louisiana,Ragin' Cajuns,4-2,5-1,0.0,6,20,13,41,3,3,7,0,20,0,7,14,-1.0,-14,-28,0.6889945700327307,8.217688634201636
3315,3315,2021,8,NCAAF_20211023_ARPB@ARK,Ark.-Pine Bluff,Golden Lions,Arkansas,Razorbacks,1-6,5-3,0.0,0,45,3,45,0,0,0,3,17,28,0,0,-4.0,-45,-42,0.0018191643583930217,-48.58751565737771
3316,3316,2021,8,NCAAF_20211023_CINCY@NAVY,Cincinnati,Bearcats,Navy,Midshipmen,7-0,1-6,1.0,13,10,27,20,7,6,14,0,7,3,0,10,6.0,3,7,0.7486464176162811,11.198738197075272
3317,3317,2021,8,NCAAF_20211023_EMICH@BGREEN,E. Michigan,Eagles,Bowling Green,Falcons,5-3,2-6,1.0,24,10,55,24,0,24,21,10,3,7,7,7,3.0,14,31,0.8659069579503447,18.50063459561204
3318,3318,2021,8,NCAAF_20211023_KSTATE@TXTECH,Kansas State,Wildcats,Texas Tech,Red Raiders,4-3,5-3,0.0,10,24,25,24,0,10,9,6,14,10,0,0,-1.0,-14,1,0.5609603246185861,2.5631796621877356
3319,3319,2021,8,NCAAF_20211023_NILL@CMICH,N. Illinois,Huskies,C. Michigan,Chippewas,6-2,4-4,0.0,18,28,39,38,7,11,11,10,14,14,7,3,2.0,-10,1,0.5333645362684865,1.399018280169571
3320,3320,2021,8,NCAAF_20211023_NWEST@MICH,Northwestern,Wildcats,Michigan,Wolverines,3-4,7-0,1.0,7,10,7,33,0,7,0,0,0,10,17,6,-4.0,-3,-26,0.16926694682205912,-15.991274450024093
3321,3321,2021,8,NCAAF_20211023_OKLA@KANSAS,Oklahoma,Sooners,Kansas,Jayhawks,8-0,1-6,0.0,0,10,35,23,0,0,14,21,7,3,7,6,7.0,-10,12,0.9865576047992002,36.97934008477955
3322,3322,2021,8,NCAAF_20211023_UMASS@FSU,UMass,Minutemen,Florida State,Seminoles,1-6,3-4,1.0,3,38,3,59,3,0,0,0,10,28,14,7,-2.0,-35,-56,0.044526471603734574,-28.411620322891395
3323,3323,2021,8,NCAAF_20211023_WAKE@ARMY,Wake Forest,Demon Deacons,Army,Black Knights,7-0,4-3,1.0,28,21,70,56,14,14,21,21,7,14,14,21,3.0,7,14,0.6498469132420043,6.4312764132730535
3324,3324,2021,8,NCAAF_20211023_CUSE@VATECH,Syracuse,Orange,Virginia Tech,Hokies,4-4,3-4,0.0,13,19,41,36,7,6,7,21,7,12,7,10,1.0,-6,5,0.3651554902515035,-5.75966738891691
3325,3325,2021,8,NCAAF_20211023_KENTST@OHIO,Kent St.,Golden Flashes,Ohio,Bobcats,4-4,1-7,0.0,17,7,34,27,10,7,14,3,0,7,10,10,3.0,10,7,0.18425894990959324,-15.025296603847437
3326,3326,2021,8,NCAAF_20211023_TXSTSM@GAST,Texas St.,Bobcats,Georgia St.,Panthers,2-5,3-4,1.0,13,14,16,28,6,7,3,0,7,7,7,7,-1.0,-1,-12,0.3347718683036299,-7.130818615428211
3327,3327,2021,8,NCAAF_20211023_WISC@PURDUE,Wisconsin,Badgers,Purdue,Boilermakers,4-3,4-3,1.0,13,13,30,13,7,6,7,10,0,13,0,0,0.0,0,17,0.7537138167378892,11.465857617013512
3328,3328,2021,8,NCAAF_20211023_BUFF@AKRON,Buffalo,Bulls,Akron,Zips,4-4,2-6,0.0,24,10,45,10,3,21,21,0,0,10,0,0,2.0,14,35,0.8886283324591555,20.37227484070729
3329,3329,2021,8,NCAAF_20211023_BYU@WASHST,BYU,Cougars,Washington St.,Cougars,6-2,4-4,1.0,7,7,21,19,7,0,7,7,7,0,6,6,2.0,0,2,0.3605146085983757,-5.966381999140367
3330,3330,2021,8,NCAAF_20211023_CLEM@PITT,Clemson,Tigers,Pittsburgh,Panthers,4-3,6-1,0.0,7,14,17,27,7,0,3,7,0,14,10,3,-2.0,-7,-10,0.9247266291259545,24.020392587824063
3331,3331,2021,8,NCAAF_20211023_COLO@CAL,Colorado,Buffaloes,California,Golden Bears,2-5,2-5,1.0,3,23,3,26,0,3,0,0,10,13,0,3,0.0,-20,-23,0.43025618768488594,-2.9360753996116955
3332,3332,2021,8,NCAAF_20211023_LSU@MISS,LSU,Tigers,Ole Miss,Rebels,4-4,6-1,0.0,7,17,17,31,7,0,0,10,0,17,14,0,-2.0,-10,-14,0.7711927533860492,12.410855662780705
3333,3333,2021,8,NCAAF_20211023_MD@MINN,Maryland,Terrapins,Minnesota,Golden Gophers,4-3,5-2,1.0,10,17,16,34,3,7,0,6,3,14,14,3,-1.0,-7,-18,0.2716737829879263,-10.154821271080095
3334,3334,2021,8,NCAAF_20211023_MIAOH@BALLST,Miami-OH,RedHawks,Ball St.,Cardinals,4-4,4-4,0.0,16,10,24,17,10,6,0,8,7,3,7,0,0.0,6,7,0.6299647403415763,5.543258308416739
3335,3335,2021,8,NCAAF_20211023_NMEX@WYO,New Mexico,Lobos,Wyoming,Cowboys,3-5,4-3,1.0,14,3,14,3,7,7,0,0,0,3,0,0,-1.0,11,11,0.18720435421691706,-14.84137574220506
3336,3336,2021,8,NCAAF_20211023_OKLAST@IOWAST,Oklahoma State,Cowboys,Iowa St.,Cyclones,6-1,5-2,0.0,14,7,21,24,7,7,0,7,0,7,10,7,1.0,7,-3,0.4371264787017334,-2.644287757445227
3337,3337,2021,8,NCAAF_20211023_OREG@UCLA,Oregon,Ducks,UCLA,Bruins,6-1,5-3,0.0,14,17,34,31,0,14,13,7,14,3,0,14,1.0,-3,3,0.7529690760483188,11.426417344041397
3338,3338,2021,8,NCAAF_20211023_RICE@UAB,Rice,Owls,UAB,Blazers,3-4,5-3,1.0,20,14,30,24,13,7,7,3,14,0,7,3,-2.0,6,6,0.15589824929412077,-16.900116299484807
3339,3339,2021,8,NCAAF_20211023_WMICH@TOLEDO,W. Michigan,Broncos,Toledo,Rockets,5-3,4-4,0.0,15,13,15,34,0,15,0,0,3,10,21,0,1.0,2,-19,0.46636876020525053,-1.4102279915733789
3340,3340,2021,8,NCAAF_20211023_BC@LVILLE,Boston College,Eagles,Louisville,Cardinals,4-3,4-3,1.0,7,21,14,28,7,0,0,7,7,14,0,7,0.0,-14,-14,0.5828788004313161,3.4965119212964737
3341,3341,2021,8,NCAAF_20211023_LIB@NTEXAS,Liberty,Flames,North Texas,Mean Green,6-2,1-6,0.0,14,20,35,26,0,14,14,7,7,13,6,0,5.0,-6,9,0.6479913223965064,6.347664544666486
3342,3342,2021,8,NCAAF_20211023_MISSST@VANDY,Miss. State,Bulldogs,Vanderbilt,Commodores,4-3,2-6,1.0,24,3,45,6,10,14,7,14,0,3,3,0,2.0,21,39,0.8690388079554188,18.744740435163635
3343,3343,2021,8,NCAAF_20211023_NEVADA@FRESNO,Nevada,Wolf Pack,Fresno St.,Bulldogs,5-2,6-2,1.0,10,14,32,34,3,7,6,16,7,7,14,6,-1.0,-4,-2,0.27769188103111764,-9.853286136647284
3344,3344,2021,8,NCAAF_20211023_SALA@LAMON,South Alabama,Jaguars,UL-Monroe,Warhawks,4-3,4-3,0.0,17,24,31,41,7,10,14,0,7,17,14,3,0.0,-7,-10,0.5484600411281593,2.0346377861184237
3345,3345,2021,8,NCAAF_20211023_SDGST@AF,San Diego St.,Aztecs,Air Force,Falcons,7-0,6-2,0.0,13,0,20,14,3,10,7,0,0,0,7,7,1.0,13,6,0.5035108301585436,0.1470437278873078
3346,3346,2021,8,NCAAF_20211023_TEMPLE@SFLA,Temple,Owls,South Florida,Bulls,3-4,2-5,0.0,7,17,14,34,0,7,7,0,0,17,10,7,1.0,-10,-20,0.5563660878564562,2.368654180598128
3347,3347,2021,8,NCAAF_20211023_TENN@BAMA,Tennessee,Volunteers,Alabama,Crimson Tide,4-4,7-1,1.0,14,21,24,52,14,0,3,7,7,14,3,28,-3.0,-7,-28,0.03126374432790502,-31.120456893847177
3348,3348,2021,8,NCAAF_20211023_TXSA@LATECH,UTSA,Roadrunners,Louisiana Tech,Bulldogs,8-0,2-5,0.0,21,10,45,16,7,14,7,17,10,0,0,6,6.0,11,29,0.3849531150176637,-4.887236800070468
3349,3349,2021,8,NCAAF_20211023_WKY@FIU,W. Kentucky,Hilltoppers,FIU,Panthers,3-4,1-6,0.0,17,12,34,19,0,17,7,10,6,6,0,7,2.0,5,15,0.5478321740126006,2.008148088289886
3350,3350,2021,8,NCAAF_20211023_GATECH@UVA,Georgia Tech,Yellow Jackets,Virginia,Cavaliers,3-4,6-2,1.0,16,24,40,48,13,3,8,16,7,17,17,7,-3.0,-8,-8,0.3960523523009055,-4.404039189130572
3351,3351,2021,8,NCAAF_20211023_NCST@MIAMI,NC State,Wolfpack,Miami (Fla.),Hurricanes,5-2,3-4,1.0,17,14,30,31,3,14,3,10,7,7,10,7,2.0,3,-1,0.40106482997639115,-4.187049923711697
3352,3352,2021,8,NCAAF_20211023_OHIOST@IND,Ohio State,Buckeyes,Indiana,Hoosiers,6-1,2-5,1.0,44,7,54,7,14,30,7,3,7,0,0,0,4.0,37,47,0.9264895385286973,24.22978324701785
3353,3353,2021,8,NCAAF_20211023_SC@TXAM,South Carolina,Gamecocks,Texas A&M,Aggies,4-4,6-2,1.0,0,31,14,44,0,0,0,14,14,17,10,3,-2.0,-31,-30,0.295755704293005,-8.966643941635766
3354,3354,2021,8,NCAAF_20211023_USC@ND,USC,Trojans,Notre Dame,Fighting Irish,3-4,6-1,0.0,3,17,16,31,0,3,0,13,7,10,7,7,-3.0,-14,-15,0.2888968960635713,-9.300200138918854
3355,3355,2021,8,NCAAF_20211023_UTAH@OREGST,Utah,Utes,Oregon State,Beavers,4-3,5-2,1.0,24,14,34,42,14,10,7,3,7,7,21,7,-1.0,10,-8,0.8866006871634753,20.19484374067781
3356,3356,2021,8,NCAAF_20211023_WVU@TCU,West Virginia,Mountaineers,TCU,Horned Frogs,3-4,3-4,1.0,20,17,29,17,10,10,3,6,7,10,0,0,0.0,3,12,0.403990007314618,-4.060747390550773
3357,3357,2021,8,NCAAF_20211023_NMEXST@HAWAII,New Mexico St.,,Hawaii,,1-7,4-4,,13,24,34,48,3,10,14,7,10,14,10,14,-3.0,-11,-14,0.25856692036669604,-10.82335370795488
3358,3358,2021,8,NCAAF_20211022_MTSU@UCONN,Middle Tenn.,Blue Raiders,UConn,Huskies,3-4,1-8,0.0,24,13,44,13,3,21,10,10,0,13,0,0,2.0,11,31,0.8216287599394019,15.398516920039356
3359,3359,2021,8,NCAAF_20211022_MEMP@UCF,Memphis,Tigers,UCF,Knights,4-4,4-3,0.0,7,14,7,24,0,7,0,0,14,0,7,3,0.0,-7,-17,0.32835071311194763,-7.426522018998867
3360,3360,2021,8,NCAAF_20211022_COLOST@UTAHST,Colorado St.,Rams,Utah St.,Aggies,3-4,5-2,1.0,14,20,24,26,0,14,0,10,0,20,3,3,-2.0,-6,-2,0.37190644506604476,-5.460522570533499
3361,3361,2021,8,NCAAF_20211022_WASH@ARIZ,Washington,Huskies,Arizona,Wildcats,3-4,0-7,1.0,0,13,21,16,0,0,7,14,3,10,3,0,3.0,-13,5,0.8703169803336273,18.845523183465502
3362,3362,2021,8,NCAAF_20211021_FAU@CHARLO,FAU,Owls,Charlotte,49ers,4-3,4-3,0.0,7,9,38,9,0,7,21,10,3,6,0,0,0.0,-2,29,0.8376819342622082,16.457601754564052
3363,3363,2021,8,NCAAF_20211021_TULANE@SMU,Tulane,Green Wave,SMU,Mustangs,1-6,7-0,0.0,7,31,26,55,7,0,12,7,17,14,7,17,-6.0,-24,-29,0.4269464036331253,-3.076959731751799
3364,3364,2021,8,NCAAF_20211021_UL@ARKST,Louisiana,Ragin' Cajuns,Arkansas St.,Red Wolves,6-1,1-6,1.0,14,10,28,27,0,14,14,0,0,10,17,0,5.0,4,1,0.6231553040799133,5.242809931301281
3365,3365,2021,8,NCAAF_20211021_SJST@UNLV,San Jose St.,Spartans,UNLV,Rebels,4-4,0-7,0.0,13,17,27,20,3,10,0,14,7,10,3,0,4.0,-4,7,0.5106373092153733,0.44556834866568806
3366,3366,2021,8,NCAAF_20211020_CSTCAR@APLST,C. Carolina,Chanticleers,App. St.,Mountaineers,6-1,5-2,0.0,20,14,27,30,14,6,7,0,0,14,13,3,1.0,6,-3,0.23963550799859246,-11.820955037053068
3367,3367,2021,9,NCAAF_20211030_BGREEN@BUFF,Bowling Green,Falcons,Buffalo,Bulls,3-6,4-5,1.0,28,10,56,44,14,14,0,28,0,10,13,21,-1.0,18,12,0.07427888022772322,-24.109270053338264
3368,3368,2021,9,NCAAF_20211030_CINCY@TULANE,Cincinnati,Bearcats,Tulane,Green Wave,8-0,1-7,0.0,14,12,31,12,7,7,7,10,0,12,0,0,7.0,2,19,0.7262385784947527,10.037869180081543
3369,3369,2021,9,NCAAF_20211030_IND@MD,Indiana,Hoosiers,Maryland,Terrapins,2-6,5-3,1.0,10,14,35,38,0,10,7,18,14,0,14,10,-3.0,-4,-3,0.7112099950540982,9.294333552844364
3370,3370,2021,9,NCAAF_20211030_IOWA@WISC,Iowa,Hawkeyes,Wisconsin,Badgers,6-2,5-3,1.0,0,20,7,27,0,0,7,0,7,13,0,7,1.0,-20,-20,0.4932350977585517,-0.2830058028508802
3371,3371,2021,9,NCAAF_20211030_MIAMI@PITT,Miami (Fla.),Hurricanes,Pittsburgh,Panthers,4-4,6-2,0.0,31,17,38,34,21,10,7,0,10,7,14,3,-2.0,14,4,0.5864668030264053,3.645910785130809
3372,3372,2021,9,NCAAF_20211030_MICH@MICHST,Michigan,Wolverines,Michigan St.,Spartans,7-1,8-0,0.0,23,14,33,37,10,13,7,3,0,14,8,15,-1.0,9,-4,0.7975138676709378,13.89793145103522
3373,3373,2021,9,NCAAF_20211030_RUT@ILL,Rutgers,Scarlet Knights,Illinois,Fighting Illini,4-4,3-6,1.0,10,14,20,14,7,3,0,10,0,14,0,0,1.0,-4,6,0.4581118081071732,-1.7555166741736912
3374,3374,2021,9,NCAAF_20211030_TEXAS@BAYLOR,Texas,Longhorns,Baylor,Bears,4-4,7-1,0.0,14,10,24,31,14,0,7,3,10,0,7,14,-3.0,4,-7,0.7100192411570371,9.236221553818154
3375,3375,2021,9,NCAAF_20211030_TXSTSM@UL,Texas St.,Bobcats,Louisiana,Ragin' Cajuns,2-6,7-1,1.0,0,17,0,45,0,0,0,0,0,17,18,10,-5.0,-17,-45,0.13026205917969214,-18.777368472257308
3376,3376,2021,9,NCAAF_20211030_UCF@TEMPLE,UCF,Knights,Temple,Owls,5-3,3-5,0.0,21,0,49,7,7,14,21,7,0,0,0,7,2.0,21,42,0.8713437221076493,18.904415369048365
3377,3377,2021,9,NCAAF_20211030_UMASS@LIB,UMass,Minutemen,Liberty,Flames,1-7,7-2,1.0,3,41,17,62,3,0,7,7,21,20,7,14,-6.0,-38,-45,0.08891947266574296,-22.487031158513673
3378,3378,2021,9,NCAAF_20211030_VATECH@GATECH,Virginia Tech,Hokies,Georgia Tech,Yellow Jackets,4-4,3-5,1.0,20,7,26,17,14,6,3,3,7,0,10,0,1.0,13,9,0.6244921141389055,5.295335847909428
3379,3379,2021,9,NCAAF_20211030_IOWAST@WVU,Iowa St.,Cyclones,West Virginia,Mountaineers,5-3,4-4,0.0,17,17,31,38,14,3,14,0,14,3,7,14,1.0,0,-7,0.6732058827063081,7.48961376720797
3380,3380,2021,9,NCAAF_20211030_HAWAII@UTAHST,Hawaii,Rainbow Warriors,Utah St.,Aggies,4-5,6-2,1.0,10,20,31,51,0,10,15,6,14,6,21,10,-2.0,-10,-20,0.25515278994952706,-10.987219196563615
3381,3381,2021,9,NCAAF_20211030_MIZZOU@VANDY,Missouri,Tigers,Vanderbilt,Commodores,4-4,2-7,1.0,17,14,37,28,10,7,7,13,7,7,7,7,2.0,3,9,0.8340731811081485,16.19451797749332
3382,3382,2021,9,NCAAF_20211030_WASHST@ARIZST,Washington St.,Cougars,Arizona St.,Sun Devils,5-4,5-3,0.0,28,7,34,21,14,14,0,6,0,7,0,14,0.0,21,13,0.5384519274881199,1.6110359082991863
3383,3383,2021,9,NCAAF_20211030_BC@CUSE,Boston College,Eagles,Syracuse,Orange,4-4,5-4,0.0,3,0,6,21,0,3,3,0,0,0,21,0,-1.0,3,-15,0.5984803163373953,4.162426444556786
3384,3384,2021,9,NCAAF_20211030_COLO@OREG,Colorado,Buffaloes,Oregon,Ducks,2-6,7-1,0.0,14,31,29,52,0,14,0,15,14,17,14,7,-5.0,-17,-23,0.17560238623495827,-15.558143560844997
3385,3385,2021,9,NCAAF_20211030_FIU@MRSHL,FIU,Panthers,Marshall,Thundering Herd,1-7,5-3,1.0,0,24,0,38,0,0,0,0,3,21,7,7,-4.0,-24,-38,0.26519469966544884,-10.470699138360828
3386,3386,2021,9,NCAAF_20211030_FSU@CLEM,Florida State,Seminoles,Clemson,Tigers,3-5,5-3,0.0,13,17,20,30,6,7,0,7,3,14,0,13,-2.0,-4,-10,0.04699316839721801,-27.949177484763595
3387,3387,2021,9,NCAAF_20211030_LAMON@APLST,UL-Monroe,Warhawks,App. St.,Mountaineers,4-4,6-2,0.0,7,49,28,59,0,7,14,7,21,28,3,7,-2.0,-42,-31,0.07420845225340167,-24.117637660958735
3388,3388,2021,9,NCAAF_20211030_LATECH@ODU,Louisiana Tech,Bulldogs,Old Dominion,Monarchs,2-6,2-6,0.0,10,10,20,23,0,10,3,7,0,10,7,6,0.0,0,-3,0.7487360511431641,11.190081288749184
3389,3389,2021,9,NCAAF_20211030_MINN@NWEST,Minnesota,Golden Gophers,Northwestern,Wildcats,6-2,3-5,1.0,20,7,41,14,13,7,0,21,0,7,0,7,3.0,13,27,0.566298631415136,2.7863231739916046
3390,3390,2021,9,NCAAF_20211030_PURDUE@NEB,Purdue,Boilermakers,Nebraska,Cornhuskers,5-3,3-6,1.0,14,17,28,23,0,14,7,7,7,10,0,6,2.0,-3,5,0.5733277663519198,3.0849574405661997
3391,3391,2021,9,NCAAF_20211030_TCU@KSTATE,TCU,Horned Frogs,Kansas State,Wildcats,3-5,5-3,1.0,5,21,12,31,0,5,0,7,7,14,0,10,-2.0,-16,-19,0.6020046969196993,4.314692886216335
3392,3392,2021,9,NCAAF_20211030_TXTECH@OKLA,Texas Tech,Red Raiders,Oklahoma,Sooners,5-4,9-0,1.0,7,28,21,52,7,0,7,7,14,14,10,14,-4.0,-21,-31,0.1330850538085433,-18.556617924540546
3393,3393,2021,9,NCAAF_20211030_UGA@FLA,Georgia,Bulldogs,Florida,Gators,8-0,4-4,1.0,24,0,34,7,0,24,3,7,0,0,0,7,4.0,24,27,0.7500825664079391,11.260708112907764
3394,3394,2021,9,NCAAF_20211030_USM@MTSU,So. Miss,Golden Eagles,Middle Tenn.,Blue Raiders,1-7,4-4,0.0,7,21,10,35,7,0,3,0,14,7,14,0,-3.0,-14,-25,0.4533328036656673,-1.9566754808349742
3395,3395,2021,9,NCAAF_20211030_CHARLO@WKY,Charlotte,49ers,W. Kentucky,Hilltoppers,4-4,4-4,1.0,13,28,13,45,3,10,0,0,14,14,7,10,0.0,-15,-32,0.3311022644420618,-7.290827082623537
3396,3396,2021,9,NCAAF_20211030_DUKE@WAKE,Duke,Blue Devils,Wake Forest,Demon Deacons,3-5,8-0,0.0,0,28,7,45,0,0,0,7,14,14,10,7,-5.0,-28,-38,0.3231183703813616,-7.660063322855308
3397,3397,2021,9,NCAAF_20211030_WYO@SJST,Wyoming,Cowboys,San Jose St.,Spartans,4-4,5-4,0.0,7,17,21,27,0,7,7,7,0,17,10,0,-1.0,-10,-6,0.7642370893689107,12.015857082521507
3398,3398,2021,9,NCAAF_20211030_ARKST@SALA,Arkansas St.,Red Wolves,South Alabama,Jaguars,1-7,5-3,0.0,7,28,13,31,0,7,3,3,14,14,0,3,-4.0,-21,-18,0.7401205742504539,10.742816620001122
3399,3399,2021,9,NCAAF_20211030_GAST@GAS,Georgia St.,Panthers,Ga. Southern,Eagles,4-4,2-6,0.0,0,7,21,14,0,0,7,14,0,7,0,7,2.0,-7,7,0.4193409680537349,-3.3974853787008215
3400,3400,2021,9,NCAAF_20211030_UTEP@FAU,UTEP,Miners,FAU,Owls,6-2,5-3,0.0,10,14,25,28,3,7,0,15,7,7,7,7,1.0,-4,-3,0.0651648938405961,-25.246742589144105
3401,3401,2021,9,NCAAF_20211030_ARIZ@USC,Arizona,Wildcats,USC,Trojans,0-8,4-4,0.0,14,35,34,41,7,7,7,13,14,21,3,3,-4.0,-21,-7,0.21332529925287336,-13.26646931908715
3402,3402,2021,9,NCAAF_20211030_BOISE@COLOST,Boise St.,Broncos,Colorado St.,Rams,4-4,3-5,0.0,7,16,28,19,0,7,14,7,13,3,3,0,1.0,-9,9,0.8063288923446638,14.426520322784086
3403,3403,2021,9,NCAAF_20211030_KANSAS@OKLAST,Kansas,Jayhawks,Oklahoma State,Cowboys,1-7,7-1,1.0,0,38,3,55,0,0,3,0,17,21,7,10,-6.0,-38,-52,0.06203837407647861,-25.665333566229606
3404,3404,2021,9,NCAAF_20211030_MISS@AUBURN,Ole Miss,Rebels,Auburn,Tigers,6-2,6-2,0.0,17,28,20,31,3,14,3,0,14,14,0,3,0.0,-11,-11,0.21388493638033923,-13.234383853914892
3405,3405,2021,9,NCAAF_20211030_OREGST@CAL,Oregon State,Beavers,California,Golden Bears,5-3,3-5,1.0,10,17,25,39,0,10,7,8,10,7,14,8,2.0,-7,-14,0.3117315161008457,-8.193299015250318
3406,3406,2021,9,NCAAF_20211030_SMU@HOU,SMU,Mustangs,Houston,Cougars,7-1,7-1,0.0,20,23,37,44,7,13,14,3,17,6,7,14,0.0,-3,-7,0.5144754646180594,0.6056766668320961
3407,3407,2021,9,NCAAF_20211030_UK@MISSST,Kentucky,Wildcats,Miss. State,Bulldogs,6-2,5-3,1.0,10,14,17,31,7,3,0,7,0,14,17,0,1.0,-4,-14,0.4132758928329727,-3.6569351854348042
3408,3408,2021,9,NCAAF_20211030_LVILLE@NCST,Louisville,Cardinals,NC State,Wolfpack,4-4,6-2,0.0,7,7,13,28,7,0,3,3,7,0,0,21,-2.0,0,-15,0.40041113275494533,-4.210282054278537
3409,3409,2021,9,NCAAF_20211030_PSU@OHIOST,Penn State,Nittany Lions,Ohio State,Buckeyes,5-3,7-1,0.0,10,17,24,33,7,3,14,0,3,14,10,6,-2.0,-7,-9,0.2992576492665804,-8.787225804627042
3410,3410,2021,9,NCAAF_20211030_UNC@ND,North Carolina,Tar Heels,Notre Dame,Fighting Irish,4-4,7-1,0.0,13,17,34,44,0,13,14,7,7,10,14,13,-3.0,-4,-10,0.17414502106126628,-15.65253894298337
3411,3411,2021,9,NCAAF_20211030_UCLA@UTAH,UCLA,Bruins,Utah,Utes,5-4,5-3,0.0,10,28,24,44,3,7,7,7,7,21,0,16,0.0,-18,-20,0.26861149580288546,-10.297238045168001
3412,3412,2021,9,NCAAF_20211030_UVA@BYU,Virginia,Cavaliers,BYU,Cougars,6-3,7-2,1.0,42,38,49,66,7,35,7,0,21,17,7,21,-1.0,4,-17,0.543700646074293,1.83177525578094
3413,3413,2021,9,NCAAF_20211030_FRESNO@SDGST,Fresno St.,Bulldogs,San Diego St.,Aztecs,7-2,7-1,1.0,20,7,30,20,7,13,3,7,0,7,6,7,0.0,13,10,0.5294230027313178,1.231953411978452
3414,3414,2021,9,NCAAF_20211030_WASH@STNFRD,Washington,Huskies,Stanford,Cardinal,4-4,3-5,0.0,9,3,20,13,0,9,3,8,3,0,0,10,1.0,6,7,0.6835524842839328,7.971468755911815
3415,3415,2021,9,NCAAF_20211029_NAVY@TULSA,Navy,Midshipmen,Tulsa,Golden Hurricane,2-6,3-5,1.0,3,3,20,17,0,3,7,10,0,3,7,7,-1.0,0,3,0.563954590868477,2.686938875947817
3416,3416,2021,9,NCAAF_20211029_UNLV@NEVADA,UNLV,Rebels,Nevada,Wolf Pack,0-8,6-2,0.0,0,20,20,51,0,0,7,13,10,10,21,10,-6.0,-20,-31,0.2812816393637354,-9.663410193810591
3417,3417,2021,9,NCAAF_20211028_SFLA@ECU,South Florida,Bulls,East Carolina,Pirates,2-6,4-4,1.0,14,6,14,29,0,14,0,0,0,6,13,10,-2.0,8,-15,0.6476835804419746,6.326262065374635
3418,3418,2021,9,NCAAF_20211028_TROY@CSTCAR,Troy,Trojans,C. Carolina,Chanticleers,4-4,7-1,1.0,14,21,28,35,7,7,7,7,7,14,7,7,-3.0,-7,-7,0.5395207026721756,1.655960059994868
3419,3419,2021,10,NCAAF_20211106_ILL@MINN,Illinois,Fighting Illini,Minnesota,Golden Gophers,4-6,6-3,0.0,14,0,14,6,7,7,0,0,0,0,0,6,-2.0,14,8,0.19405192125065973,-14.398981241686897
3420,3420,2021,10,NCAAF_20211106_KSTATE@KANSAS,Kansas State,Wildcats,Kansas,Jayhawks,6-3,1-8,0.0,21,3,35,10,14,7,7,7,3,0,7,0,5.0,18,25,0.8952103358019511,20.93331738450229
3421,3421,2021,10,NCAAF_20211106_LATECH@UAB,Louisiana Tech,Bulldogs,UAB,Blazers,2-7,6-3,0.0,21,24,38,52,7,14,0,17,7,17,7,21,-4.0,-3,-14,0.4060206280281725,-3.967255616676084
3422,3422,2021,10,NCAAF_20211106_LIB@MISS,Liberty,Flames,Ole Miss,Rebels,7-3,7-2,0.0,0,24,14,27,0,0,14,0,10,14,3,0,0.0,-24,-13,0.24539719345333033,-11.495777347317585
3423,3423,2021,10,NCAAF_20211106_MIZZOU@UGA,Missouri,Tigers,Georgia,Bulldogs,4-5,9-0,1.0,3,26,6,43,3,0,0,3,7,19,14,3,-5.0,-23,-37,0.12130615191829186,-19.494509202943618
3424,3424,2021,10,NCAAF_20211106_OHIOST@NEB,Ohio State,Buckeyes,Nebraska,Cornhuskers,8-1,3-7,1.0,17,10,26,17,0,17,6,3,0,10,7,0,5.0,7,9,0.9500984214468096,27.458040405532415
3425,3425,2021,10,NCAAF_20211106_PITT@DUKE,Pittsburgh,Panthers,Duke,Blue Devils,7-2,3-6,0.0,30,19,54,29,7,23,14,10,12,7,3,7,4.0,11,25,0.6993639555322935,8.718391743473944
3426,3426,2021,10,NCAAF_20211106_SMU@MEMP,SMU,Mustangs,Memphis,Tigers,7-2,5-4,0.0,10,7,25,28,0,10,0,15,0,7,14,7,2.0,3,-3,0.42803654924982326,-3.0259939346432247
3427,3427,2021,10,NCAAF_20211106_WAKE@UNC,Wake Forest,Demon Deacons,North Carolina,Tar Heels,8-1,5-4,0.0,31,24,55,58,10,21,17,7,14,10,10,24,3.0,7,-3,0.5482879159078682,2.024338831443856
3428,3428,2021,10,NCAAF_20211106_GATECH@MIAMI,Georgia Tech,Yellow Jackets,Miami (Fla.),Hurricanes,3-6,5-4,1.0,21,17,30,33,7,14,7,2,14,3,7,9,-2.0,4,-3,0.28019490949306136,-9.71424568870691
3429,3429,2021,10,NCAAF_20211106_APLST@ARKST,App. St.,Mountaineers,Arkansas St.,Red Wolves,7-2,1-8,0.0,24,14,48,14,14,10,14,10,0,14,0,0,6.0,10,34,0.7737392597950914,12.533032593975463
3430,3430,2021,10,NCAAF_20211106_CAL@ARIZ,California,Golden Bears,Arizona,Wildcats,3-6,1-8,1.0,0,0,3,10,0,0,3,0,0,0,3,7,2.0,0,-7,0.6433025898823058,6.12790199022038
3431,3431,2021,10,NCAAF_20211106_LAMON@TXSTSM,UL-Monroe,Warhawks,Texas St.,Bobcats,4-5,3-6,0.0,16,20,19,27,6,10,3,0,10,10,0,7,1.0,-4,-8,0.5442550481229955,1.8545416753840982
3432,3432,2021,10,NCAAF_20211106_NTEXAS@USM,North Texas,Mean Green,So. Miss,Golden Eagles,3-6,1-8,1.0,7,14,38,14,0,7,21,10,14,0,0,0,2.0,-7,24,0.5156471667410257,0.6545264980734373
3433,3433,2021,10,NCAAF_20211106_TEMPLE@ECU,Temple,Owls,East Carolina,Pirates,3-6,5-4,1.0,0,21,3,45,0,0,0,3,7,14,14,10,-2.0,-21,-42,0.6592588083776354,6.847642274076179
3434,3434,2021,10,NCAAF_20211106_AUBURN@TXAM,Auburn,Tigers,Texas A&M,Aggies,6-3,7-2,1.0,3,3,3,20,3,0,0,0,3,0,3,14,-1.0,0,-17,0.642992475346028,6.114030240073362
3435,3435,2021,10,NCAAF_20211106_BAYLOR@TCU,Baylor,Bears,TCU,Horned Frogs,7-2,4-5,0.0,14,16,28,30,7,7,7,7,7,9,7,7,3.0,-2,-2,0.36812026645166684,-5.6196426032878435
3436,3436,2021,10,NCAAF_20211106_COLOST@WYO,Colorado St.,Rams,Wyoming,Cowboys,3-6,5-4,1.0,10,17,17,31,7,3,0,7,7,10,7,7,-2.0,-7,-14,0.4606743382404178,-1.6472569058572617
3437,3437,2021,10,NCAAF_20211106_IDST@BYU,Idaho State,Bengals,BYU,Cougars,1-8,8-2,1.0,7,42,14,59,0,7,7,0,21,21,7,10,-7.0,-35,-45,0.0541753277015955,-26.78806206661477
3438,3438,2021,10,NCAAF_20211106_MICHST@PURDUE,Michigan St.,Spartans,Purdue,Boilermakers,8-1,6-3,1.0,14,21,29,40,7,7,7,8,7,14,10,9,2.0,-7,-11,0.5110477194376954,0.4620705448692206
3439,3439,2021,10,NCAAF_20211106_MTSU@WKY,Middle Tenn.,Blue Raiders,W. Kentucky,Hilltoppers,4-5,5-4,1.0,14,31,21,48,7,7,0,7,21,10,17,0,-1.0,-17,-27,0.49983712486805665,-0.006811377042026834
3440,3440,2021,10,NCAAF_20211106_NAVY@ND,Navy,Midshipmen,Notre Dame,Fighting Irish,2-7,8-1,0.0,3,17,6,34,3,0,3,0,0,17,0,17,-6.0,-14,-28,0.08102351286824616,-23.327365327037683
3441,3441,2021,10,NCAAF_20211106_OKLAST@WVU,Oklahoma State,Cowboys,West Virginia,Mountaineers,8-1,4-5,0.0,10,3,24,3,0,10,7,7,3,0,0,0,4.0,7,21,0.6192942370689332,5.0656084950579725
3442,3442,2021,10,NCAAF_20211106_PSU@MD,Penn State,Nittany Lions,Maryland,Terrapins,6-3,5-4,1.0,7,6,31,14,7,0,7,17,0,6,0,8,1.0,1,17,0.9351426728628109,25.27948397280636
3443,3443,2021,10,NCAAF_20211106_RI@UMASS,Rhode Island,Rams,UMass,Minutemen,6-3,1-8,0.0,21,16,35,22,7,14,14,0,6,10,0,6,5.0,5,13,0.6318810246314351,5.619699747437494
3444,3444,2021,10,NCAAF_20211106_SALA@TROY,South Alabama,Jaguars,Troy,Trojans,5-4,5-4,1.0,14,31,24,31,7,7,7,3,10,21,0,0,0.0,-17,-7,0.23447789643286654,-12.08192613792312
3445,3445,2021,10,NCAAF_20211106_TULSA@CINCY,Tulsa,Golden Hurricane,Cincinnati,Bearcats,3-6,9-0,1.0,12,14,20,28,0,12,0,8,14,0,14,0,-6.0,-2,-8,0.20196853679179305,-13.924320634560104
3446,3446,2021,10,NCAAF_20211106_WISC@RUT,Wisconsin,Badgers,Rutgers,Scarlet Knights,6-3,4-5,1.0,31,3,52,3,7,24,21,0,3,0,0,0,2.0,28,49,0.9476411805255094,27.067506201114156
3447,3447,2021,10,NCAAF_20211106_MISSST@ARK,Miss. State,Bulldogs,Arkansas,Razorbacks,5-4,6-3,0.0,7,13,28,31,0,7,7,14,10,3,3,15,-1.0,-6,-3,0.8063100982105083,14.420965233633524
3448,3448,2021,10,NCAAF_20211106_NCST@FSU,NC State,Wolfpack,Florida State,Seminoles,7-2,3-6,0.0,14,0,28,14,7,7,7,7,0,0,14,0,4.0,14,14,0.6102737264698062,4.671955307325334
3449,3449,2021,10,NCAAF_20211106_TULANE@UCF,Tulane,Green Wave,UCF,Knights,1-8,6-3,0.0,0,7,10,14,0,0,10,0,7,0,0,7,-5.0,-7,-4,0.18084328549354178,-15.218061754197038
3450,3450,2021,10,NCAAF_20211106_UTAHST@NMEXST,Utah St.,Aggies,New Mexico St.,Aggies,7-2,1-8,1.0,7,13,35,13,0,7,21,7,10,3,0,0,6.0,-6,22,0.9073055614320048,22.094844530270052
3451,3451,2021,10,NCAAF_20211106_CSTCAR@GAS,C. Carolina,Chanticleers,Ga. Southern,Eagles,8-1,2-7,1.0,21,0,28,8,0,21,7,0,0,0,0,8,6.0,21,20,0.5874848226062123,3.6884093575133647
3452,3452,2021,10,NCAAF_20211106_MRSHL@FAU,Marshall,Thundering Herd,FAU,Owls,6-3,5-4,0.0,21,13,28,13,7,14,7,0,10,3,0,0,1.0,8,15,0.48466676510582307,-0.6413880806273937
3453,3453,2021,10,NCAAF_20211106_BOISE@FRESNO,Boise St.,Broncos,Fresno St.,Bulldogs,5-4,7-3,1.0,16,7,40,14,10,6,7,17,0,7,0,7,-2.0,9,26,0.6302747942809749,5.548657699673754
3454,3454,2021,10,NCAAF_20211106_IOWA@NWEST,Iowa,Hawkeyes,Northwestern,Wildcats,7-2,3-6,0.0,14,3,17,12,7,7,3,0,0,3,3,6,4.0,11,5,0.7987729693152452,13.96829830884667
3455,3455,2021,10,NCAAF_20211106_LSU@BAMA,LSU,Tigers,Alabama,Crimson Tide,4-5,8-1,0.0,7,14,14,20,7,0,7,0,0,14,6,0,-4.0,-7,-6,0.1587743959082295,-16.675403662831854
3456,3456,2021,10,NCAAF_20211106_ODU@FIU,Old Dominion,Monarchs,FIU,Panthers,3-6,1-8,0.0,24,10,47,24,24,0,6,17,10,0,7,7,2.0,14,23,0.3321141166482513,-7.2420727800571285
3457,3457,2021,10,NCAAF_20211106_TENN@UK,Tennessee,Volunteers,Kentucky,Wildcats,5-4,6-3,1.0,24,21,45,42,14,10,14,7,7,14,14,7,-1.0,3,3,0.3894097479756269,-4.685723198866526
3458,3458,2021,10,NCAAF_20211106_UNLV@NMEX,UNLV,Rebels,New Mexico,Lobos,1-8,3-6,0.0,21,17,31,17,7,14,3,7,7,10,0,0,-2.0,4,14,0.5148987265742644,0.6232040503265353
3459,3459,2021,10,NCAAF_20211106_CLEM@LVILLE,Clemson,Tigers,Louisville,Cardinals,6-3,4-5,0.0,17,17,30,24,7,10,0,13,14,3,7,0,2.0,0,6,0.9487711887176589,27.245247799273784
3460,3460,2021,10,NCAAF_20211106_FLA@SC,Florida,Gators,South Carolina,Gamecocks,4-5,5-4,1.0,10,30,17,40,7,3,0,7,10,20,10,0,-1.0,-20,-23,0.7710542688581713,12.384637580326398
3461,3461,2021,10,NCAAF_20211106_HOU@SFLA,Houston,Cougars,South Florida,Bulls,8-1,2-7,1.0,26,28,54,42,9,17,21,7,14,14,7,7,6.0,-2,12,0.7203354358249832,9.74053369349599
3462,3462,2021,10,NCAAF_20211106_IND@MICH,Indiana,Hoosiers,Michigan,Wolverines,2-7,8-1,1.0,7,17,7,29,0,7,0,0,3,14,6,6,-6.0,-10,-22,0.188623418606787,-14.731306986081336
3463,3463,2021,10,NCAAF_20211106_OREG@WASH,Oregon,Ducks,Washington,Huskies,8-1,4-5,1.0,10,9,26,16,3,7,7,9,9,0,0,7,4.0,1,10,0.4925185969210527,-0.31288780775264513
3464,3464,2021,10,NCAAF_20211106_TEXAS@IOWAST,Texas,Longhorns,Iowa St.,Cyclones,4-5,6-3,1.0,7,3,7,30,0,7,0,0,3,0,21,6,-2.0,4,-23,0.47323991570153634,-1.119937211230308
3465,3465,2021,10,NCAAF_20211106_SJST@NEVADA,San Jose St.,Spartans,Nevada,Wolf Pack,5-5,7-2,0.0,7,7,24,27,7,0,7,10,7,0,10,10,-2.0,0,-3,0.2925194046181603,-9.109912953584171
3466,3466,2021,10,NCAAF_20211106_TXSA@UTEP,UTSA,Roadrunners,UTEP,Miners,9-0,6-3,1.0,30,9,44,23,16,14,7,7,6,3,7,7,3.0,21,21,0.7658066520778808,12.097398692703905
3467,3467,2021,10,NCAAF_20211106_USC@ARIZST,USC,Trojans,Arizona St.,Sun Devils,4-5,6-3,1.0,10,14,16,31,0,10,6,0,7,7,3,14,-2.0,-4,-15,0.5796931103474854,3.3552161292232086
3468,3468,2021,10,NCAAF_20211106_SDGST@HAWAII,San Diego St.,Aztecs,Hawaii,Rainbow Warriors,8-1,4-6,1.0,14,7,17,10,7,7,0,3,7,0,0,3,4.0,7,7,0.7840890868528132,13.114622800668599
3469,3469,2021,10,NCAAF_20211105_VATECH@BC,Virginia Tech,Hokies,Boston College,Eagles,4-5,5-4,1.0,0,10,3,17,0,0,3,0,7,3,7,0,-1.0,-10,-14,0.5392859157031324,1.6455866272850699
3470,3470,2021,10,NCAAF_20211105_UTAH@STNFRD,Utah,Utes,Stanford,Cardinal,6-3,3-6,1.0,38,0,52,7,14,24,0,14,0,0,7,0,3.0,38,45,0.6583454489853503,6.80611040950464
3471,3471,2021,10,NCAAF_20211104_GAST@UL,Georgia St.,Panthers,Louisiana,Ragin' Cajuns,4-5,8-1,0.0,3,0,17,21,3,0,7,7,0,0,7,14,-4.0,3,-4,0.23974026781337,-11.797624136080003
3472,3472,2021,10,NCAAF_20211103_CMICH@WMICH,C. Michigan,Chippewas,W. Michigan,Broncos,5-4,5-4,1.0,21,14,42,30,0,21,7,14,7,7,10,6,0.0,7,12,0.4166372844378331,-3.511962870619186
3473,3473,2021,10,NCAAF_20211103_NILL@KENTST,N. Illinois,Huskies,Kent St.,Golden Flashes,6-3,5-4,1.0,21,31,47,52,7,14,6,20,0,31,14,7,1.0,-10,-5,0.7284226211450394,10.144461723848622
3474,3474,2021,10,NCAAF_20211102_BALLST@AKRON,Ball St.,Cardinals,Akron,Zips,5-4,2-7,1.0,21,10,31,25,7,14,7,3,3,7,0,15,3.0,11,6,0.7106942468316564,9.266314396113785
3475,3475,2021,10,NCAAF_20211102_EMICH@TOLEDO,E. Michigan,Eagles,Toledo,Rockets,6-3,4-5,0.0,24,28,52,49,14,10,21,7,14,14,8,13,2.0,-4,3,0.4026721136338465,-4.111454760103811
3476,3476,2021,10,NCAAF_20211102_MIAOH@OHIO,Miami-OH,RedHawks,Ohio,Bobcats,4-5,2-7,0.0,0,14,33,35,0,0,13,20,7,7,14,7,2.0,-14,-2,0.3863795457970223,-4.817690821580413
3477,3477,2021,11,NCAAF_20211113_BUCK@ARMY,Bucknell,Bison,Army,Black Knights,1-9,6-3,1.0,0,42,10,63,0,0,10,0,21,21,7,14,-5.0,-42,-53,0.0010710039166433871,-51.19344828112628
3478,3478,2021,11,NCAAF_20211113_CUSE@LVILLE,Syracuse,Orange,Louisville,Cardinals,5-5,5-5,1.0,3,35,3,41,3,0,0,0,14,21,3,3,0.0,-32,-38,0.46905430712049456,-1.2948826192583738
3479,3479,2021,11,NCAAF_20211113_HOU@TEMPLE,Houston,Cougars,Temple,Owls,9-1,3-7,0.0,10,0,37,8,7,3,14,13,0,0,0,8,6.0,10,29,0.7138336472097562,9.415855458601186
3480,3480,2021,11,NCAAF_20211113_ME@UMASS,Maine,Black Bears,UMass,Minutemen,5-5,1-9,0.0,14,10,35,10,0,14,7,14,10,0,0,0,4.0,4,25,0.6120145999049209,4.745682909357811
3481,3481,2021,11,NCAAF_20211113_MICH@PSU,Michigan,Wolverines,Penn State,Nittany Lions,9-1,6-4,0.0,7,6,21,17,0,7,7,7,3,3,0,11,3.0,1,4,0.4647070631897787,-1.477234474411489
3482,3482,2021,11,NCAAF_20211113_MISSST@AUBURN,Miss. State,Bulldogs,Auburn,Tigers,6-4,6-4,0.0,10,28,43,34,3,7,13,20,14,14,0,6,0.0,-18,9,0.3253865834788676,-7.549242082552041
3483,3483,2021,11,NCAAF_20211113_NMEXST@BAMA,New Mexico St.,Aggies,Alabama,Crimson Tide,1-9,9-1,1.0,3,49,3,59,3,0,0,0,14,35,0,10,-8.0,-46,-56,0.000407010031339472,-55.832525627538416
3484,3484,2021,11,NCAAF_20211113_NWEST@WISC,Northwestern,Wildcats,Wisconsin,Badgers,3-7,7-3,0.0,0,21,7,35,0,0,0,7,0,21,14,0,-4.0,-21,-28,0.18027495035524144,-15.24758934030126
3485,3485,2021,11,NCAAF_20211113_OKLA@BAYLOR,Oklahoma,Sooners,Baylor,Bears,9-1,8-2,1.0,7,7,14,27,0,7,0,7,0,7,3,17,1.0,0,-13,0.858492829738589,17.903395184068074
3486,3486,2021,11,NCAAF_20211113_RUT@IND,Rutgers,Scarlet Knights,Indiana,Hoosiers,5-5,2-8,0.0,17,3,38,3,14,3,14,7,0,3,0,0,3.0,14,35,0.19657439910632868,-14.240383734569036
3487,3487,2021,11,NCAAF_20211113_SAMF@FLA,Samford,Bulldogs,Florida,Gators,4-6,5-5,1.0,42,35,52,70,21,21,0,10,14,21,21,14,-1.0,7,-18,0.0410862216950203,-28.987330632808153
3488,3488,2021,11,NCAAF_20211113_UCF@SMU,UCF,Knights,SMU,Mustangs,6-4,8-2,0.0,14,38,28,55,14,0,7,7,21,17,7,10,-2.0,-24,-27,0.7443452989820384,10.953106245088406
3489,3489,2021,11,NCAAF_20211113_UCONN@CLEM,UConn,Huskies,Clemson,Tigers,1-9,7-3,0.0,7,30,7,44,7,0,0,0,10,20,7,7,-6.0,-23,-37,0.0004223668381705403,-55.66112581925984
3490,3490,2021,11,NCAAF_20211113_WVU@KSTATE,West Virginia,Mountaineers,Kansas State,Wildcats,4-6,7-3,1.0,3,17,17,34,0,3,7,7,14,3,7,10,-3.0,-14,-17,0.5077581788646078,0.3243255245694172
3491,3491,2021,11,NCAAF_20211113_GAST@CSTCAR,Georgia St.,Panthers,C. Carolina,Chanticleers,5-5,8-2,0.0,28,23,42,40,14,14,0,14,14,9,3,14,-3.0,5,2,0.34079587254343835,-6.842221054018751
3492,3492,2021,11,NCAAF_20211113_UTAH@ARIZ,Utah,Utes,Arizona,Wildcats,7-3,1-9,1.0,21,17,38,29,7,14,10,7,14,3,3,9,6.0,4,9,0.8516761830892663,17.40438387231984
3493,3493,2021,11,NCAAF_20211113_WKY@RICE,W. Kentucky,Hilltoppers,Rice,Owls,6-4,3-7,1.0,28,0,42,21,7,21,0,14,0,0,7,14,3.0,28,21,0.7768317553377769,12.699743294473024
3494,3494,2021,11,NCAAF_20211113_SALA@APLST,South Alabama,Jaguars,App. St.,Mountaineers,5-5,8-2,0.0,7,14,7,31,0,7,0,0,14,0,3,14,-3.0,-7,-24,0.08758022561790124,-22.610076697920363
3495,3495,2021,11,NCAAF_20211113_GAS@TXSTSM,Ga. Southern,Eagles,Texas St.,Bobcats,3-7,3-7,0.0,17,17,38,30,3,14,14,7,0,17,7,6,0.0,0,8,0.7341158805419099,10.42794537238035
3496,3496,2021,11,NCAAF_20211113_BC@GATECH,Boston College,Eagles,Georgia Tech,Yellow Jackets,6-4,3-7,1.0,28,21,41,30,7,21,0,13,14,7,3,6,3.0,7,11,0.5952126569165692,4.018607308875289
3497,3497,2021,11,NCAAF_20211113_CHARLO@LATECH,Charlotte,49ers,Louisiana Tech,Bulldogs,5-5,3-7,1.0,7,14,32,42,0,7,10,15,7,7,14,14,2.0,-7,-10,0.3178574834903739,-7.899616054362809
3498,3498,2021,11,NCAAF_20211113_DUKE@VATECH,Duke,Blue Devils,Virginia Tech,Hokies,3-7,5-5,0.0,3,17,17,48,0,3,7,7,7,10,10,21,-2.0,-14,-31,0.3105238265029522,-8.244279561925282
3499,3499,2021,11,NCAAF_20211113_FAU@ODU,FAU,Owls,Old Dominion,Monarchs,5-5,4-6,1.0,3,11,16,30,3,0,7,6,2,9,6,13,1.0,-8,-14,0.8660772882326506,18.478157670607857
3500,3500,2021,11,NCAAF_20211113_FIU@MTSU,FIU,Panthers,Middle Tenn.,Blue Raiders,1-9,5-5,0.0,3,34,10,50,3,0,0,7,7,27,9,7,-4.0,-31,-40,0.41441615193571657,-3.6054423827757773
3501,3501,2021,11,NCAAF_20211113_IOWAST@TXTECH,Iowa St.,Cyclones,Texas Tech,Red Raiders,6-4,6-4,0.0,14,31,38,41,7,7,7,17,14,17,0,10,0.0,-17,-3,0.7482490438518623,11.156387755045898
3502,3502,2021,11,NCAAF_20211113_MIAMI@FSU,Miami (Fla.),Hurricanes,Florida State,Seminoles,5-5,4-6,1.0,7,20,28,31,0,7,7,14,14,6,0,11,1.0,-13,-3,0.6937079326701413,8.444766281977536
3503,3503,2021,11,NCAAF_20211113_MINN@IOWA,Minnesota,Golden Gophers,Iowa,Hawkeyes,6-4,8-2,1.0,13,10,22,27,3,10,3,6,3,7,7,10,-2.0,3,-5,0.26429534099266705,-10.508822257085853
3504,3504,2021,11,NCAAF_20211113_PURDUE@OHIOST,Purdue,Boilermakers,Ohio State,Buckeyes,6-4,9-1,1.0,17,45,31,59,7,10,14,0,21,24,7,7,-3.0,-28,-28,0.07812332537174294,-23.644037470288367
3505,3505,2021,11,NCAAF_20211113_UAB@MRSHL,UAB,Blazers,Marshall,Thundering Herd,7-3,6-4,1.0,14,7,21,14,14,0,7,0,0,7,7,0,1.0,7,7,0.394125660701667,-4.4789996295045285
3506,3506,2021,11,NCAAF_20211113_UGA@TENN,Georgia,Bulldogs,Tennessee,Volunteers,10-0,5-5,0.0,24,10,41,17,7,17,3,14,10,0,0,7,5.0,14,24,0.9301152241805645,24.625299621692193
3507,3507,2021,11,NCAAF_20211113_UL@TROY,Louisiana,Ragin' Cajuns,Troy,Trojans,9-1,5-5,0.0,14,13,35,21,14,0,14,7,10,3,0,8,4.0,1,14,0.5855719994384423,3.6049353798557604
3508,3508,2021,11,NCAAF_20211113_USM@TXSA,So. Miss,Golden Eagles,UTSA,Roadrunners,1-9,10-0,1.0,10,10,17,27,0,10,7,0,0,10,7,10,-9.0,0,-10,0.5013187880066948,0.05512768364553722
3509,3509,2021,11,NCAAF_20211113_HAWAII@UNLV,Hawaii,Rainbow Warriors,UNLV,Rebels,4-7,2-8,1.0,10,10,13,27,10,0,0,3,7,3,10,7,2.0,0,-14,0.6178988137173255,5.002388582714389
3510,3510,2021,11,NCAAF_20211113_MD@MICHST,Maryland,Terrapins,Michigan St.,Spartans,5-5,9-1,0.0,14,27,21,40,7,7,7,0,13,14,7,6,-4.0,-13,-19,0.27552902670053603,-9.942099083965559
3511,3511,2021,11,NCAAF_20211113_SC@MIZZOU,South Carolina,Gamecocks,Missouri,Tigers,5-5,5-5,1.0,14,17,28,31,7,7,0,14,0,17,7,7,0.0,-3,-3,0.41169921940210863,-3.7217890032787864
3512,3512,2021,11,NCAAF_20211113_UTEP@NTEXAS,UTEP,Miners,North Texas,Mean Green,6-4,4-6,1.0,7,3,17,20,0,7,0,10,0,3,14,3,2.0,4,-3,0.20060481365881833,-13.999273956424418
3513,3513,2021,11,NCAAF_20211113_ARKST@LAMON,Arkansas St.,Red Wolves,UL-Monroe,Warhawks,2-8,4-6,1.0,10,7,27,24,7,3,7,10,0,7,17,0,-2.0,3,3,0.7581165869735484,11.677812121039665
3514,3514,2021,11,NCAAF_20211113_STNFRD@OREGST,Stanford,Cardinal,Oregon State,Beavers,3-7,6-4,1.0,0,14,14,35,0,0,7,7,7,7,14,7,-3.0,-14,-21,0.758619438759188,11.704687801729506
3515,3515,2021,11,NCAAF_20211113_AF@COLOST,Air Force,Falcons,Colorado St.,Rams,7-3,3-7,0.0,21,14,35,21,21,0,14,0,7,7,7,0,4.0,7,14,0.6667911164830305,7.188717597014488
3516,3516,2021,11,NCAAF_20211113_ARIZST@WASH,Arizona St.,Sun Devils,Washington,Huskies,7-3,4-6,0.0,7,17,35,30,0,7,7,21,14,3,7,6,3.0,-10,5,0.31806382029763625,-7.889968063152651
3517,3517,2021,11,NCAAF_20211113_NMEX@FRESNO,New Mexico,Lobos,Fresno St.,Bulldogs,3-7,8-3,1.0,0,24,7,34,0,0,7,0,7,17,10,0,-5.0,-24,-27,0.11220040715962876,-20.26038842422986
3518,3518,2021,11,NCAAF_20211113_TXAM@MISS,Texas A&M,Aggies,Ole Miss,Rebels,7-3,8-2,0.0,0,15,19,29,0,0,10,9,10,5,0,14,-1.0,-15,-10,0.6730761092705028,7.478114850938823
3519,3519,2021,11,NCAAF_20211113_UK@VANDY,Kentucky,Wildcats,Vanderbilt,Commodores,7-3,2-8,0.0,31,3,34,17,7,24,0,3,3,0,8,6,5.0,28,17,0.8223423966236993,15.414536358036685
3520,3520,2021,11,NCAAF_20211113_NCST@WAKE,NC State,Wolfpack,Wake Forest,Demon Deacons,7-3,9-1,0.0,20,24,42,45,6,14,7,15,7,17,7,14,-2.0,-4,-3,0.5004464679872951,0.018663125648117784
3521,3521,2021,11,NCAAF_20211113_ND@UVA,Notre Dame,Fighting Irish,Virginia,Cavaliers,9-1,6-4,1.0,21,0,28,3,7,14,7,0,0,0,0,3,3.0,21,25,0.8218891068648504,15.385512993842212
3522,3522,2021,11,NCAAF_20211113_TCU@OKLAST,TCU,Horned Frogs,Oklahoma State,Cowboys,4-6,9-1,0.0,3,28,17,63,3,0,0,14,7,21,14,21,-5.0,-25,-46,0.4358557924549755,-2.6929957678778464
3523,3523,2021,11,NCAAF_20211113_COLO@UCLA,Colorado,Buffaloes,UCLA,Bruins,3-7,6-4,1.0,20,10,20,44,7,13,0,0,0,10,20,14,-3.0,10,-24,0.3976703659987989,-4.32557052803304
3524,3524,2021,11,NCAAF_20211113_NEVADA@SDGST,Nevada,Wolf Pack,San Diego St.,Aztecs,7-3,9-1,0.0,7,10,21,23,0,7,7,7,7,3,7,6,-2.0,-3,-2,0.3205771385055657,-7.772659718286263
3525,3525,2021,11,NCAAF_20211113_UTAHST@SJST,Utah St.,Aggies,San Jose St.,Spartans,8-2,5-6,0.0,24,14,48,17,0,24,7,17,7,7,3,0,3.0,10,31,0.8150174799845791,14.95109995513144
3526,3526,2021,11,NCAAF_20211113_WASHST@OREG,Washington St.,Cougars,Oregon,Ducks,5-5,9-1,1.0,14,14,24,38,0,14,0,10,14,0,10,14,-4.0,0,-14,0.35362702785036726,-6.262788893770448
3527,3527,2021,11,NCAAF_20211112_CINCY@SFLA,Cincinnati,Bearcats,South Florida,Bulls,10-0,2-8,0.0,24,7,45,28,7,17,7,14,7,0,14,7,8.0,17,17,0.8356221761213652,16.286626638164307
3528,3528,2021,11,NCAAF_20211112_WYO@BOISE,Wyoming,Cowboys,Boise St.,Broncos,5-5,6-4,1.0,7,10,13,23,0,7,0,6,7,3,3,10,-1.0,-3,-10,0.22087373582516,-12.828299830700871
3529,3529,2021,11,NCAAF_20211110_BALLST@NILL,Ball St.,Cardinals,N. Illinois,Huskies,5-5,7-3,1.0,17,17,29,30,10,7,9,3,0,17,3,10,-2.0,0,-1,0.3519130416292443,-6.3397381569512845
3530,3530,2021,11,NCAAF_20211110_TOLEDO@BGREEN,Toledo,Rockets,Bowling Green,Falcons,5-5,3-7,0.0,35,10,49,17,14,21,7,7,7,3,0,7,2.0,25,32,0.9086587706886096,22.222076088143922
3531,3531,2021,11,NCAAF_20211110_KENTST@CMICH,Kent St.,Golden Flashes,C. Michigan,Chippewas,5-5,6-4,0.0,17,26,30,54,14,3,13,0,0,26,14,14,-1.0,-9,-24,0.30122002700483763,-8.686684683027124
3532,3532,2021,11,NCAAF_20211109_AKRON@WMICH,Akron,Zips,W. Michigan,Broncos,2-8,6-4,1.0,14,24,40,45,7,7,10,16,7,17,7,14,-4.0,-10,-5,0.14657065885073028,-17.531224808943534
3533,3533,2021,11,NCAAF_20211109_BUFF@MIAOH,Buffalo,Bulls,Miami-OH,RedHawks,4-6,5-5,1.0,10,24,18,45,7,3,0,8,10,14,14,7,-1.0,-14,-27,0.627218620292123,5.411442002512445
3534,3534,2021,11,NCAAF_20211109_OHIO@EMICH,Ohio,Bobcats,E. Michigan,Eagles,3-7,6-4,1.0,20,13,34,26,14,6,7,7,7,6,7,6,-3.0,7,8,0.5854173266193216,3.5983172325121586
3535,3535,2021,12,NCAAF_20211120_CHARSO@UGA,Charleston So.,Buccaneers,Georgia,Bulldogs,4-6,11-0,0.0,0,49,7,56,0,0,7,0,28,21,7,0,-7.0,-49,-49,0.00014444577109484769,-60.51181692348291
3536,3536,2021,12,NCAAF_20211120_FAU@WKY,FAU,Owls,W. Kentucky,Hilltoppers,5-6,7-4,1.0,10,31,17,52,3,7,7,0,14,17,7,14,-2.0,-21,-35,0.6659998718935336,7.159370130564639
3537,3537,2021,12,NCAAF_20211120_FSU@BC,Florida State,Seminoles,Boston College,Eagles,5-6,6-5,0.0,19,3,26,23,7,12,7,0,0,3,7,13,-1.0,16,3,0.4302136181981441,-2.935070222208765
3538,3538,2021,12,NCAAF_20211120_IOWAST@OKLA,Iowa St.,Cyclones,Oklahoma,Sooners,6-5,10-1,1.0,7,14,21,28,7,0,0,14,7,7,7,7,-4.0,-7,-7,0.32597800376659636,-7.529151660081936
3539,3539,2021,12,NCAAF_20211120_KENTST@AKRON,Kent St.,Golden Flashes,Akron,Zips,6-5,2-9,0.0,29,0,38,0,7,22,3,6,0,0,0,0,4.0,29,38,0.6269675768219741,5.4056152227960865
3540,3540,2021,12,NCAAF_20211120_MICHST@OHIOST,Michigan St.,Spartans,Ohio State,Buckeyes,9-2,10-1,0.0,0,49,7,56,0,0,0,7,21,28,0,7,-1.0,-49,-49,0.07811627568355617,-23.667756264625154
3541,3541,2021,12,NCAAF_20211120_NMEXST@UK,New Mexico St.,Aggies,Kentucky,Wildcats,1-10,8-3,1.0,16,35,16,56,7,9,0,0,21,14,14,7,-7.0,-19,-40,0.039125180237546076,-29.394537037583632
3542,3542,2021,12,NCAAF_20211120_PRARIE@TXAM,Prairie View,Panthers,Texas A&M,Aggies,7-3,8-3,1.0,0,38,3,52,0,0,3,0,21,17,7,7,-1.0,-38,-49,0.003751827411984543,-44.62980696615966
3543,3543,2021,12,NCAAF_20211120_PURDUE@NWEST,Purdue,Boilermakers,Northwestern,Wildcats,7-4,3-8,1.0,13,7,32,14,0,13,13,6,0,7,7,0,4.0,6,18,0.5751649186787562,3.1639087150294927
3544,3544,2021,12,NCAAF_20211120_RUT@PSU,Rutgers,Scarlet Knights,Penn State,Nittany Lions,5-6,7-4,0.0,0,7,0,28,0,0,0,0,0,7,14,7,-2.0,-7,-28,0.03750263547769639,-29.72008920146743
3545,3545,2021,12,NCAAF_20211120_SFLA@TULANE,South Florida,Bulls,Tulane,Green Wave,2-9,2-9,1.0,7,35,14,45,7,0,0,7,28,7,7,3,0.0,-28,-31,0.35416654912324796,-6.244640444329093
3546,3546,2021,12,NCAAF_20211120_TEXAS@WVU,Texas,Longhorns,West Virginia,Mountaineers,4-7,5-6,0.0,10,21,23,31,0,10,7,6,7,14,7,3,-1.0,-11,-8,0.6385524252636239,5.91907470823503
3547,3547,2021,12,NCAAF_20211120_TNST@MISSST,Tennessee St.,Tigers,Miss. State,Bulldogs,5-6,7-4,1.0,0,35,10,55,0,0,0,10,21,14,14,6,-2.0,-35,-45,0.0462692203941365,-28.079615940576446
3548,3548,2021,12,NCAAF_20211120_UMASS@ARMY,UMass,Minutemen,Army,Black Knights,1-10,7-3,1.0,10,19,17,33,3,7,0,7,8,11,0,14,-6.0,-9,-16,0.04270485083618325,-28.713407024977755
3549,3549,2021,12,NCAAF_20211120_WAKE@CLEM,Wake Forest,Demon Deacons,Clemson,Tigers,9-2,8-3,1.0,10,17,27,48,0,10,3,14,10,7,21,10,1.0,-7,-21,0.09723083044393555,-21.65856440096661
3550,3550,2021,12,NCAAF_20211120_WOFF@UNC,Wofford,Terriers,North Carolina,Tar Heels,1-10,6-5,0.0,7,20,14,34,0,7,0,7,10,10,14,0,-5.0,-13,-20,0.14019252355972034,-18.018935883336894
3551,3551,2021,12,NCAAF_20211120_TXSTSM@CSTCAR,Texas St.,Bobcats,C. Carolina,Chanticleers,3-8,9-2,0.0,14,14,21,35,0,14,7,0,7,7,14,7,-6.0,0,-14,0.1933877413925874,-14.44713200656588
3552,3552,2021,12,NCAAF_20211120_ARKST@GAST,Arkansas St.,Red Wolves,Georgia St.,Panthers,2-9,6-5,0.0,13,14,20,28,3,10,0,7,7,7,0,14,-4.0,-1,-8,0.618069242577823,5.014696050288535
3553,3553,2021,12,NCAAF_20211120_ILL@IOWA,Illinois,Fighting Illini,Iowa,Hawkeyes,4-7,9-2,1.0,13,17,23,33,10,3,3,7,7,10,3,13,-5.0,-4,-10,0.07645029392486258,-23.85978510957102
3554,3554,2021,12,NCAAF_20211120_GATECH@ND,Georgia Tech,Yellow Jackets,Notre Dame,Fighting Irish,3-8,10-1,0.0,0,45,0,55,0,0,0,0,24,21,10,0,-7.0,-45,-55,0.11476187573261776,-20.057636323798647
3555,3555,2021,12,NCAAF_20211120_WASH@COLO,Washington,Huskies,Colorado,Buffaloes,4-7,4-7,0.0,10,10,17,20,0,10,0,7,10,0,0,10,0.0,0,-3,0.8331604579183371,16.137261415800822
3556,3556,2021,12,NCAAF_20211120_APLST@TROY,App. St.,Mountaineers,Troy,Trojans,9-2,5-6,0.0,10,7,45,7,3,7,21,14,7,0,0,0,4.0,3,38,0.741871805437539,10.83563240311355
3557,3557,2021,12,NCAAF_20211120_ARK@BAMA,Arkansas,Razorbacks,Alabama,Crimson Tide,7-4,10-1,1.0,14,24,35,42,0,14,7,14,3,21,10,8,-3.0,-10,-7,0.014585178092943796,-36.40956770825255
3558,3558,2021,12,NCAAF_20211120_ECU@NAVY,East Carolina,Pirates,Navy,Midshipmen,7-4,2-8,1.0,24,21,38,35,14,10,0,14,7,14,0,14,5.0,3,3,0.28030490677958975,-9.714040055125679
3559,3559,2021,12,NCAAF_20211120_MICH@MD,Michigan,Wolverines,Maryland,Terrapins,10-1,5-6,1.0,24,3,59,18,14,10,28,7,0,3,15,0,5.0,21,41,0.9245009510643294,23.970861399067985
3560,3560,2021,12,NCAAF_20211120_MINN@IND,Minnesota,Golden Gophers,Indiana,Hoosiers,7-4,2-9,1.0,21,7,35,14,0,21,7,7,7,0,0,7,5.0,14,21,0.5658786739851038,2.7691582571865183
3561,3561,2021,12,NCAAF_20211120_MRSHL@CHARLO,Marshall,Thundering Herd,Charlotte,49ers,7-4,5-6,0.0,21,14,49,28,7,14,21,7,7,7,0,14,2.0,7,21,0.8397351229673604,16.58195226940518
3562,3562,2021,12,NCAAF_20211120_NEB@WISC,Nebraska,Cornhuskers,Wisconsin,Badgers,3-8,8-3,1.0,14,14,28,35,7,7,7,7,14,0,14,7,-5.0,0,-7,0.17521645106716122,-15.586739375563297
3563,3563,2021,12,NCAAF_20211120_ODU@MTSU,Old Dominion,Monarchs,Middle Tenn.,Blue Raiders,5-6,5-6,0.0,10,10,24,17,7,3,0,14,7,3,0,7,0.0,0,7,0.2853373220071994,-9.465690978834573
3564,3564,2021,12,NCAAF_20211120_SMU@CINCY,SMU,Mustangs,Cincinnati,Bearcats,8-3,11-0,1.0,0,27,14,48,0,0,0,14,14,13,14,7,-3.0,-27,-34,0.3689708298374874,-5.585025231275495
3565,3565,2021,12,NCAAF_20211120_UAB@TXSA,UAB,Blazers,UTSA,Roadrunners,7-4,11-0,1.0,24,17,31,34,14,10,0,7,7,10,10,7,-4.0,7,-3,0.6702702607962425,7.3557656726359255
3566,3566,2021,12,NCAAF_20211120_UVA@PITT,Virginia,Cavaliers,Pittsburgh,Panthers,6-5,9-2,1.0,21,24,38,48,7,14,10,7,0,24,10,14,-3.0,-3,-10,0.45089360115959776,-2.0599366853670062
3567,3567,2021,12,NCAAF_20211120_BYU@GAS,BYU,Cougars,Ga. Southern,Eagles,9-2,3-8,0.0,20,17,34,17,7,13,7,7,3,14,0,0,6.0,3,17,0.8459861124211832,17.015948051749433
3568,3568,2021,12,NCAAF_20211120_CUSE@NCST,Syracuse,Orange,NC State,Wolfpack,5-6,8-3,0.0,7,28,17,41,0,7,3,7,0,28,10,3,-3.0,-21,-24,0.35251461831399744,-6.318832626997278
3569,3569,2021,12,NCAAF_20211120_KANSAS@TCU,Kansas,Jayhawks,TCU,Horned Frogs,2-9,5-6,1.0,14,7,28,31,7,7,0,14,7,0,14,10,-3.0,7,-3,0.0787523448648485,-23.595259679109745
3570,3570,2021,12,NCAAF_20211120_RICE@UTEP,Rice,Owls,UTEP,Miners,3-8,7-4,0.0,21,14,28,38,0,21,0,7,7,7,10,14,-4.0,7,-10,0.576295565355655,3.2120881798846312
3571,3571,2021,12,NCAAF_20211120_TEMPLE@TULSA,Temple,Owls,Tulsa,Golden Hurricane,3-8,5-6,1.0,0,27,10,44,0,0,10,0,10,17,7,10,-2.0,-27,-34,0.43542637507185233,-2.7138106725434454
3572,3572,2021,12,NCAAF_20211120_UCLA@USC,UCLA,Bruins,USC,Trojans,7-4,4-6,0.0,28,17,62,33,7,21,14,20,10,7,9,7,3.0,11,29,0.3589764903108399,-6.029309042815157
3573,3573,2021,12,NCAAF_20211120_UCONN@UCF,UConn,Huskies,UCF,Knights,1-10,7-4,1.0,14,35,17,49,0,14,0,3,21,14,0,14,-6.0,-21,-32,0.010698874768851452,-38.40792820201773
3574,3574,2021,12,NCAAF_20211120_UL@LIB,Louisiana,Ragin' Cajuns,Liberty,Flames,10-1,7-4,0.0,21,7,42,14,7,14,7,14,0,7,7,0,3.0,14,28,0.5413876508850315,1.7348689637516372
3575,3575,2021,12,NCAAF_20211120_BAYLOR@KSTATE,Baylor,Bears,Kansas State,Wildcats,9-2,7-4,1.0,17,7,20,10,7,10,0,3,0,7,3,0,2.0,10,10,0.45517578878653464,-1.8795078539019414
3576,3576,2021,12,NCAAF_20211120_AUBURN@SC,Auburn,Tigers,South Carolina,Gamecocks,6-5,6-5,1.0,14,14,17,21,14,0,3,0,0,14,7,0,0.0,0,-4,0.812532106170053,14.81079791955915
3577,3577,2021,12,NCAAF_20211120_CAL@STNFRD,California,Golden Bears,Stanford,Cardinal,4-6,3-8,0.0,14,3,41,11,0,14,13,14,0,3,0,8,1.0,11,30,0.4284420501311397,-3.010381424393472
3578,3578,2021,12,NCAAF_20211120_NTEXAS@FIU,North Texas,Mean Green,FIU,Panthers,5-6,1-10,1.0,35,0,49,7,7,28,14,0,0,0,7,0,4.0,35,42,0.5702524478031576,2.9548773199530842
3579,3579,2021,12,NCAAF_20211120_OREG@UTAH,Oregon,Ducks,Utah,Utes,9-2,8-3,0.0,0,28,7,38,0,0,7,0,7,21,7,3,1.0,-28,-31,0.5163532943605904,0.684449733680367
3580,3580,2021,12,NCAAF_20211120_SALA@TENN,South Alabama,Jaguars,Tennessee,Volunteers,5-6,6-5,1.0,7,35,14,60,0,7,0,7,14,21,14,11,-1.0,-28,-46,0.08927552301728792,-22.455418827340964
3581,3581,2021,12,NCAAF_20211120_VANDY@MISS,Vanderbilt,Commodores,Ole Miss,Rebels,2-9,9-2,0.0,9,24,17,31,3,6,0,8,10,14,0,7,-7.0,-15,-14,0.1935484183469215,-14.43735708047052
3582,3582,2021,12,NCAAF_20211120_VATECH@MIAMI,Virginia Tech,Hokies,Miami (Fla.),Hurricanes,5-6,6-5,1.0,13,28,26,38,3,10,13,0,14,14,3,7,-1.0,-15,-12,0.41494822977868173,-3.5861499240626245
3583,3583,2021,12,NCAAF_20211120_OKLAST@TXTECH,Oklahoma State,Cowboys,Texas Tech,Red Raiders,10-1,6-5,0.0,13,0,23,0,3,10,3,7,0,0,0,0,4.0,13,23,0.7207322593517607,9.765490586779777
3584,3584,2021,12,NCAAF_20211120_WYO@UTAHST,Wyoming,Cowboys,Utah St.,Aggies,6-5,8-3,1.0,24,17,44,17,14,10,17,3,14,3,0,0,-2.0,7,27,0.40939325966069495,-3.8243812493919904
3585,3585,2021,12,NCAAF_20211120_LAMON@LSU,UL-Monroe,Warhawks,LSU,Tigers,4-7,5-6,1.0,7,17,14,27,0,7,0,7,7,10,7,3,-1.0,-10,-13,0.009298085126240974,-39.286577548521905
3586,3586,2021,12,NCAAF_20211120_NMEX@BOISE,New Mexico,Lobos,Boise St.,Broncos,3-8,7-4,1.0,0,24,0,37,0,0,0,0,10,14,6,7,-4.0,-24,-37,0.054907271805561875,-26.6919658726855
3587,3587,2021,12,NCAAF_20211120_ARIZST@OREGST,Arizona St.,Sun Devils,Oregon State,Beavers,7-4,7-4,1.0,0,17,10,24,0,0,3,7,3,14,0,7,0.0,-17,-14,0.764409885593783,12.028040521047956
3588,3588,2021,12,NCAAF_20211120_COLOST@HAWAII,Colorado St.,Rams,Hawaii,Rainbow Warriors,3-8,5-7,0.0,10,29,45,50,7,3,7,28,9,20,7,14,-2.0,-19,-5,0.6332206515357062,5.682095361200254
3589,3589,2021,12,NCAAF_20211119_USM@LATECH,So. Miss,Golden Eagles,Louisiana Tech,Bulldogs,2-9,3-8,1.0,21,9,35,19,7,14,0,14,3,6,0,10,-1.0,12,16,0.42369327617890384,-3.212563800564112
3590,3590,2021,12,NCAAF_20211119_ARIZ@WASHST,Arizona,Wildcats,Washington St.,Cougars,1-10,6-5,0.0,7,21,18,44,0,7,3,8,7,14,16,7,-5.0,-14,-26,0.2531270681145106,-11.09528281704388
3591,3591,2021,12,NCAAF_20211119_MEMP@HOU,Memphis,Tigers,Houston,Cougars,5-6,10-1,1.0,3,21,13,31,0,3,7,3,0,21,0,10,-5.0,-18,-18,0.5655484624999327,2.7551510199768927
3592,3592,2021,12,NCAAF_20211119_SDGST@UNLV,San Diego St.,Aztecs,UNLV,Rebels,10-1,2-9,0.0,21,10,28,20,7,14,0,7,3,7,10,0,8.0,11,8,0.8511368436403346,17.38239321285812
3593,3593,2021,12,NCAAF_20211118_LVILLE@DUKE,Louisville,Cardinals,Duke,Blue Devils,6-5,3-8,1.0,35,9,62,22,14,21,13,14,3,6,7,6,3.0,26,40,0.634843907244599,5.754120227197291
3594,3594,2021,12,NCAAF_20211117_CMICH@BALLST,C. Michigan,Chippewas,Ball St.,Cardinals,7-4,5-6,0.0,28,17,37,17,7,21,6,3,7,10,0,0,2.0,11,20,0.6334785711947573,5.69353231598393
3595,3595,2021,12,NCAAF_20211116_TOLEDO@OHIO,Toledo,Rockets,Ohio,Bobcats,6-5,3-8,1.0,14,6,35,23,0,14,14,7,0,6,3,14,3.0,8,12,0.5057070835098121,0.2388051377948841
3596,3596,2021,12,NCAAF_20211116_WMICH@EMICH,W. Michigan,Broncos,E. Michigan,Eagles,6-5,7-4,0.0,7,6,21,22,0,7,14,0,0,6,10,6,-1.0,1,-1,0.5320059931515707,1.3406413677637374
3597,3597,2021,12,NCAAF_20211116_BGREEN@MIAOH,Bowling Green,Falcons,Miami-OH,RedHawks,3-8,6-5,1.0,7,20,7,34,7,0,0,0,6,14,14,0,-3.0,-13,-27,0.1390732986545704,-18.103024837834823
3598,3598,2021,13,NCAAF_20211127_AKRON@TOLEDO,Akron,Zips,Toledo,Rockets,2-10,7-5,1.0,7,21,14,49,0,7,0,7,7,14,14,14,-5.0,-14,-35,0.10905995080585673,-20.62763602468948
3599,3599,2021,13,NCAAF_20211127_ARMY@LIB,Army,Black Knights,Liberty,Flames,8-3,7-5,0.0,24,3,31,16,10,14,7,0,0,3,13,0,1.0,21,15,0.6193289485099892,5.087116303087498
3600,3600,2021,13,NCAAF_20211127_FSU@FLA,Florida State,Seminoles,Florida,Gators,5-7,6-6,0.0,7,7,21,24,0,7,0,14,7,0,10,7,-1.0,0,-3,0.21560906513125955,-13.183622128516049
3601,3601,2021,13,NCAAF_20211127_HOU@UCONN,Houston,Cougars,UConn,Huskies,11-1,1-11,0.0,21,10,45,17,7,14,17,7,0,10,0,7,10.0,11,28,0.9567696101275823,28.714715137540054
3602,3602,2021,13,NCAAF_20211127_MD@RUT,Maryland,Terrapins,Rutgers,Scarlet Knights,6-6,5-7,1.0,20,2,40,16,13,7,6,14,2,0,14,0,1.0,18,24,0.5984521409542722,4.176346851156154
3603,3603,2021,13,NCAAF_20211127_NAVY@TEMPLE,Navy,Midshipmen,Temple,Owls,3-8,3-9,1.0,17,7,38,14,7,10,7,14,0,7,7,0,0.0,10,24,0.6314217639085786,5.62146391638089
3604,3604,2021,13,NCAAF_20211127_OHIOST@MICH,Ohio State,Buckeyes,Michigan,Wolverines,10-2,11-1,0.0,13,14,27,42,3,10,0,14,7,7,14,14,-1.0,-1,-15,0.7294746039111389,10.237664045556244
3605,3605,2021,13,NCAAF_20211127_TXTECH@BAYLOR,Texas Tech,Red Raiders,Baylor,Bears,6-6,10-2,0.0,10,17,24,27,3,7,0,14,10,7,0,10,-4.0,-7,-3,0.4565729214928337,-1.8268837026776623
3606,3606,2021,13,NCAAF_20211127_UGA@GATECH,Georgia,Bulldogs,Georgia Tech,Yellow Jackets,12-0,3-9,0.0,24,0,45,0,10,14,14,7,0,0,0,0,9.0,24,45,0.9539872200824304,28.21957254888224
3607,3607,2021,13,NCAAF_20211127_WAKE@BC,Wake Forest,Demon Deacons,Boston College,Eagles,10-2,6-6,1.0,24,10,41,10,14,10,10,7,7,3,0,0,4.0,14,31,0.5507145546758512,2.1349969844143857
3608,3608,2021,13,NCAAF_20211127_MIAMI@DUKE,Miami (Fla.),Hurricanes,Duke,Blue Devils,7-5,3-9,0.0,30,10,47,10,10,20,17,0,10,0,0,0,4.0,20,37,0.7889629582270328,13.446910430941784
3609,3609,2021,13,NCAAF_20211127_LATECH@RICE,Louisiana Tech,Bulldogs,Rice,Owls,3-9,4-8,1.0,10,14,31,35,10,0,14,7,7,7,7,14,-1.0,-4,-4,0.7632431928768193,12.005551656062494
3610,3610,2021,13,NCAAF_20211127_CHARLO@ODU,Charlotte,49ers,Old Dominion,Monarchs,5-7,6-6,1.0,14,28,34,56,0,14,14,6,14,14,7,21,-1.0,-14,-22,0.5158215476424162,0.6644353388699074
3611,3611,2021,13,NCAAF_20211127_TROY@GAST,Troy,Trojans,Georgia St.,Panthers,5-7,7-5,1.0,3,17,10,37,0,3,0,7,7,10,13,7,-2.0,-14,-27,0.6605909875753777,6.935545094340114
3612,3612,2021,13,NCAAF_20211127_TXSA@NTEXAS,UTSA,Roadrunners,North Texas,Mean Green,11-1,6-6,0.0,13,31,23,45,3,10,0,10,17,14,14,0,5.0,-18,-22,0.46056287321235967,-1.6584573855993767
3613,3613,2021,13,NCAAF_20211127_TXSTSM@ARKST,Texas St.,Bobcats,Arkansas St.,Red Wolves,4-8,2-10,1.0,17,10,24,22,14,3,7,0,7,3,3,9,2.0,7,2,0.2247357255803505,-12.66753226582324
3614,3614,2021,13,NCAAF_20211127_GAS@APLST,Ga. Southern,Eagles,App. St.,Mountaineers,3-9,10-2,1.0,0,7,3,27,0,0,3,0,7,0,10,10,-7.0,-7,-24,0.15983510582594984,-16.667953955232463
3615,3615,2021,13,NCAAF_20211127_FIU@USM,FIU,Panthers,So. Miss,Golden Eagles,1-11,3-9,1.0,14,21,17,37,7,7,3,0,21,0,3,13,-2.0,-7,-20,0.43802113988186253,-2.6127137488834364
3616,3616,2021,13,NCAAF_20211127_HAWAII@WYO,Hawaii,Rainbow Warriors,Wyoming,Cowboys,6-7,6-6,1.0,31,7,38,14,14,17,0,7,0,7,7,0,0.0,24,24,0.3071355033866743,-8.441481274192938
3617,3617,2021,13,NCAAF_20211127_UMASS@NMEXST,UMass,Minutemen,New Mexico St.,Aggies,1-11,2-10,0.0,13,27,27,44,0,13,14,0,7,20,7,10,-1.0,-14,-17,0.3346620463951676,-7.153275186325061
3618,3618,2021,13,NCAAF_20211127_IND@PURDUE,Indiana,Hoosiers,Purdue,Boilermakers,2-10,8-4,0.0,7,17,7,44,7,0,0,0,7,10,14,13,-6.0,-10,-37,0.42816735060096156,-3.0323476588655467
3619,3619,2021,13,NCAAF_20211127_NWEST@ILL,Northwestern,Wildcats,Illinois,Fighting Illini,3-9,5-7,0.0,7,37,14,47,0,7,0,7,14,23,3,7,-2.0,-30,-33,0.7133369714068637,9.432603920000076
3620,3620,2021,13,NCAAF_20211127_OREGST@OREG,Oregon State,Beavers,Oregon,Ducks,7-5,10-2,0.0,3,24,29,38,3,0,6,20,14,10,0,14,-3.0,-21,-9,0.12913792545997738,-18.934818552521563
3621,3621,2021,13,NCAAF_20211127_PSU@MICHST,Penn State,Nittany Lions,Michigan St.,Spartans,7-5,10-2,0.0,14,17,27,30,7,7,6,7,14,3,6,7,-3.0,-3,-3,0.8178665598523398,15.196161745813413
3622,3622,2021,13,NCAAF_20211127_WKY@MRSHL,W. Kentucky,Hilltoppers,Marshall,Thundering Herd,8-4,7-5,1.0,6,14,53,21,0,6,23,24,7,7,0,7,1.0,-8,32,0.33788151123967725,-7.005477744582947
3623,3623,2021,13,NCAAF_20211127_VANDY@TENN,Vanderbilt,Commodores,Tennessee,Volunteers,2-10,7-5,1.0,7,24,21,45,0,7,6,8,7,17,14,7,-5.0,-17,-24,0.24766674533483246,-11.42060455697117
3624,3624,2021,13,NCAAF_20211127_VATECH@UVA,Virginia Tech,Hokies,Virginia,Cavaliers,6-6,6-6,1.0,17,21,29,24,7,10,7,5,14,7,3,0,0.0,-4,5,0.5357679829136183,1.5037214878256577
3625,3625,2021,13,NCAAF_20211127_ARIZ@ARIZST,Arizona,Wildcats,Arizona St.,Sun Devils,1-11,8-4,1.0,9,14,15,38,3,6,6,0,7,7,17,7,-7.0,-5,-23,0.28478116132258224,-9.525335137501315
3626,3626,2021,13,NCAAF_20211127_LAMON@UL,UL-Monroe,Warhawks,Louisiana,Ragin' Cajuns,4-8,11-1,0.0,10,14,16,21,3,7,0,6,14,0,7,0,-7.0,-4,-5,0.14161846057517646,-17.97341088486519
3627,3627,2021,13,NCAAF_20211127_TULSA@SMU,Tulsa,Golden Hurricane,SMU,Mustangs,6-6,8-4,0.0,14,17,34,31,0,14,14,6,10,7,0,14,-2.0,-3,3,0.33954438949522303,-6.929353055280558
3628,3628,2021,13,NCAAF_20211127_WISC@MINN,Wisconsin,Badgers,Minnesota,Golden Gophers,8-4,8-4,0.0,10,6,13,23,0,10,3,0,3,3,14,3,0.0,4,-10,0.7565752213713337,11.646350724345837
3629,3629,2021,13,NCAAF_20211127_MTSU@FAU,Middle Tenn.,Blue Raiders,FAU,Owls,6-6,5-7,0.0,3,14,27,17,0,3,7,17,7,7,3,0,1.0,-11,10,0.32937154713865147,-7.397370242766215
3630,3630,2021,13,NCAAF_20211127_TXAM@LSU,Texas A&M,Aggies,LSU,Tigers,8-4,6-6,0.0,7,17,24,27,0,7,3,14,3,14,3,7,2.0,-10,-3,0.4116559232803416,-3.739935535997404
3631,3631,2021,13,NCAAF_20211127_WVU@KANSAS,West Virginia,Mountaineers,Kansas,Jayhawks,6-6,2-10,0.0,21,13,34,28,7,14,10,3,6,7,8,7,4.0,8,6,0.8937893294548205,20.88544533580813
3632,3632,2021,13,NCAAF_20211127_CLEM@SC,Clemson,Tigers,South Carolina,Gamecocks,9-3,6-6,1.0,17,0,30,0,10,7,3,10,0,0,0,0,3.0,17,30,0.9227571697634886,23.848915637850553
3633,3633,2021,13,NCAAF_20211127_OKLA@OKLAST,Oklahoma,Sooners,Oklahoma State,Cowboys,10-2,11-1,0.0,24,24,33,37,7,17,9,0,14,10,0,13,-1.0,0,-4,0.6880569347488776,8.2130839963408
3634,3634,2021,13,NCAAF_20211127_PITT@CUSE,Pittsburgh,Panthers,Syracuse,Orange,10-2,5-7,0.0,14,7,31,14,0,14,14,3,7,0,7,0,5.0,7,17,0.6556095223737898,6.708311872889453
3635,3635,2021,13,NCAAF_20211127_TULANE@MEMP,Tulane,Green Wave,Memphis,Tigers,2-10,6-6,0.0,14,14,28,33,7,7,7,7,7,7,6,13,-4.0,0,-5,0.3578215952646908,-6.101609792800957
3636,3636,2021,13,NCAAF_20211127_UK@LVILLE,Kentucky,Wildcats,Louisville,Cardinals,9-3,6-6,1.0,24,7,52,21,14,10,14,14,7,0,0,14,3.0,17,31,0.6083816780916939,4.607827488172859
3637,3637,2021,13,NCAAF_20211127_ND@STNFRD,Notre Dame,Fighting Irish,Stanford,Cardinal,11-1,3-9,0.0,24,0,45,14,7,17,7,14,0,0,7,7,8.0,24,31,0.8160058149063127,15.078634817084264
3638,3638,2021,13,NCAAF_20211127_NEVADA@COLOST,Nevada,Wolf Pack,Colorado St.,Rams,8-4,3-9,1.0,31,0,52,10,14,17,7,14,0,0,7,3,5.0,31,42,0.5001954354006739,0.008205274574436316
3639,3639,2021,13,NCAAF_20211127_BYU@USC,BYU,Cougars,USC,Trojans,10-2,4-7,0.0,21,13,35,31,7,14,7,7,3,10,10,8,6.0,8,4,0.37304104257729465,-5.4236272647418104
3640,3640,2021,13,NCAAF_20211127_CAL@UCLA,California,Golden Bears,UCLA,Bruins,4-7,8-4,1.0,14,17,14,42,0,14,0,0,3,14,10,15,-4.0,-3,-28,0.4817246502912177,-0.7675515342801873
3641,3641,2021,13,NCAAF_20211126_BOISE@SDGST,Boise St.,Broncos,San Diego St.,Aztecs,7-5,11-1,1.0,16,13,16,27,7,9,0,0,3,10,14,0,-4.0,3,-11,0.6861604562318944,8.123406958275666
3642,3642,2021,13,NCAAF_20211126_EMICH@CMICH,E. Michigan,Eagles,C. Michigan,Chippewas,7-5,8-4,1.0,3,10,10,31,0,3,7,0,7,3,7,14,-1.0,-7,-21,0.520226219237051,0.8495535540354808
3643,3643,2021,13,NCAAF_20211126_KSTATE@TEXAS,Kansas State,Wildcats,Texas,Longhorns,7-5,5-7,0.0,17,16,17,22,7,10,0,0,7,9,3,3,2.0,1,-5,0.36993933759807174,-5.561044263518625
3644,3644,2021,13,NCAAF_20211126_OHIO@BGREEN,Ohio,Bobcats,Bowling Green,Falcons,3-9,4-8,0.0,10,10,10,21,0,10,0,0,3,7,3,8,-1.0,0,-11,0.9083784637529004,22.290734629686085
3645,3645,2021,13,NCAAF_20211126_UTAHST@NMEX,Utah St.,Aggies,New Mexico,Lobos,9-3,3-9,0.0,28,0,35,10,7,21,7,0,0,0,3,7,6.0,28,25,0.8503484205660653,17.384713460656542
3646,3646,2021,13,NCAAF_20211126_IOWA@NEB,Iowa,Hawkeyes,Nebraska,Cornhuskers,10-2,3-9,0.0,6,14,28,21,0,6,3,19,7,7,7,0,7.0,-8,7,0.7860478718231954,13.278660529149306
3647,3647,2021,13,NCAAF_20211126_UTEP@UAB,UTEP,Miners,UAB,Blazers,7-5,8-4,0.0,17,14,25,42,7,10,8,0,7,7,14,14,-1.0,3,-17,0.12376439376934423,-19.368577374544657
3648,3648,2021,13,NCAAF_20211126_MIZZOU@ARK,Missouri,Tigers,Arkansas,Razorbacks,6-6,8-4,1.0,6,10,17,34,0,6,3,8,3,7,14,10,-2.0,-4,-17,0.7205095659103401,9.787626568970893
3649,3649,2021,13,NCAAF_20211126_SFLA@UCF,South Florida,Bulls,UCF,Knights,2-10,8-4,0.0,7,14,13,17,7,0,6,0,7,7,0,3,-6.0,-7,-4,0.11116332942757823,-20.440408206866834
3650,3650,2021,13,NCAAF_20211126_UNLV@AF,UNLV,Rebels,Air Force,Falcons,2-10,9-3,0.0,0,24,14,48,0,0,7,7,14,10,17,7,-7.0,-24,-34,0.15162474671148407,-17.243366167972397
3651,3651,2021,13,NCAAF_20211126_CINCY@ECU,Cincinnati,Bearcats,East Carolina,Pirates,12-0,7-5,0.0,21,3,35,13,0,21,0,14,3,0,3,7,5.0,18,22,0.8965604080354053,21.141016084366242
3652,3652,2021,13,NCAAF_20211126_COLO@UTAH,Colorado,Buffaloes,Utah,Utes,4-8,9-3,0.0,6,14,13,28,3,3,7,0,0,14,14,0,-5.0,-8,-15,0.16787785421114076,-16.12275040438459
3653,3653,2021,13,NCAAF_20211126_TCU@IOWAST,TCU,Horned Frogs,Iowa St.,Cyclones,5-7,7-5,0.0,7,17,14,48,0,7,0,7,3,14,10,21,-2.0,-10,-34,0.37233299323583235,-5.454963994610694
3654,3654,2021,13,NCAAF_20211126_UNC@NCST,North Carolina,Tar Heels,NC State,Wolfpack,6-6,9-3,1.0,10,14,30,34,0,10,14,6,14,0,7,13,-3.0,-4,-4,0.44762048490142237,-2.2054889653818464
3655,3655,2021,13,NCAAF_20211126_WASHST@WASH,Washington St.,Cougars,Washington,Huskies,7-5,4-8,1.0,13,7,40,13,10,3,10,17,0,7,0,6,3.0,6,27,0.37252785106720543,-5.446338109310943
3656,3656,2021,13,NCAAF_20211125_FRESNO@SJST,Fresno St.,Bulldogs,San Jose St.,Spartans,9-3,5-7,0.0,23,9,40,9,7,16,10,7,3,6,0,0,4.0,14,31,0.8628562574417307,18.3111790829538
3657,3657,2021,13,NCAAF_20211125_MISS@MISSST,Ole Miss,Rebels,Miss. State,Bulldogs,10-2,7-5,1.0,10,6,31,21,3,7,7,14,6,0,0,15,3.0,4,10,0.37381459665994554,-5.3894131193162025
3658,3658,2021,13,NCAAF_20211123_BUFF@BALLST,Buffalo,Bulls,Ball St.,Cardinals,4-8,6-6,0.0,3,17,3,20,0,3,0,0,14,3,3,0,-2.0,-14,-17,0.7345656447137543,10.496538220579964
3659,3659,2021,13,NCAAF_20211123_WMICH@NILL,W. Michigan,Broncos,N. Illinois,Huskies,7-5,8-4,0.0,28,7,42,21,7,21,7,7,0,7,0,14,-1.0,21,21,0.5421889248002537,1.7745990161884606
3660,3660,2021,14,NCAAF_20211204_BAYLOR@OKLAST,Baylor,Bears,Oklahoma State,Cowboys,11-2,11-2,1.0,21,6,21,16,7,14,0,0,3,3,7,3,0.0,15,5,0.30342652767094236,-8.646915346283777
3661,3661,2021,14,NCAAF_20211204_KENTST@NILL,Kent St.,Golden Flashes,N. Illinois,Huskies,7-6,9-4,0.0,0,17,23,41,0,0,10,13,10,7,7,17,-2.0,-17,-18,0.29494355956539375,-9.05742243456649
3662,3662,2021,14,NCAAF_20211204_UTAHST@SDGST,Utah St.,Aggies,San Diego St.,Aztecs,10-3,11-2,0.0,14,3,46,13,0,14,15,17,0,3,3,7,-1.0,11,33,0.4550128701541525,-1.8989693342745113
3663,3663,2021,14,NCAAF_20211204_APLST@UL,App. St.,Mountaineers,Louisiana,Ragin' Cajuns,10-3,12-1,0.0,7,17,16,24,0,7,3,6,7,10,0,7,-2.0,-10,-8,0.6671595502217398,7.260785552751258
3664,3664,2021,14,NCAAF_20211204_HOU@CINCY,Houston,Cougars,Cincinnati,Bearcats,11-2,13-0,1.0,13,14,20,35,10,3,0,7,14,0,21,0,-2.0,-1,-15,0.35623576530555157,-6.192975576547894
3665,3665,2021,14,NCAAF_20211204_UGA@BAMA,Georgia,Bulldogs,Alabama,Crimson Tide,12-1,12-1,1.0,17,24,24,41,3,14,0,7,0,24,7,10,0.0,-7,-17,0.3669582316651764,-5.7120685879952475
3666,3666,2021,14,NCAAF_20211204_MICH@IOWA,Michigan,Wolverines,Iowa,Hawkeyes,12-1,10-3,1.0,14,3,42,3,14,0,7,21,3,0,0,0,2.0,11,39,0.5920314281122927,3.9115605674121525
3667,3667,2021,14,NCAAF_20211204_PITT@WAKE,Pittsburgh,Panthers,Wake Forest,Demon Deacons,11-2,10-3,1.0,24,21,45,21,14,10,7,14,21,0,0,0,1.0,3,24,0.4892399066703321,-0.4532886091261048
3668,3668,2021,14,NCAAF_20211204_USC@CAL,USC,Trojans,California,Golden Bears,4-8,5-7,1.0,7,17,14,24,0,7,0,7,3,14,0,7,-1.0,-10,-10,0.6394761113964547,6.000064572605538
3669,3669,2021,14,NCAAF_20211203_WKY@TXSA,W. Kentucky,Hilltoppers,UTSA,Roadrunners,8-5,12-1,1.0,13,28,41,49,10,3,13,15,14,14,14,7,-4.0,-15,-8,0.6194607632650866,5.109547114195038
3670,3670,2021,14,NCAAF_20211203_OREG@UTAH,Oregon,Ducks,Utah,Utes,10-3,10-3,0.0,0,23,10,38,0,0,3,7,14,9,8,7,0.0,-23,-28,0.4872651322988504,-0.5365056696685429
3671,3671,2021,15,NCAAF_20211211_ARMY@NAVY,Army,Black Knights,Navy,Midshipmen,8-4,4-8,1.0,13,7,13,17,10,3,0,0,7,0,7,3,4.0,6,-4,0.5574055972416883,2.428489916589058
3672,3672,2022,1,NCAAF_20220905_CLEM@GATECH,Clemson,Tigers,Georgia Tech,Yellow Jackets,1-0,0-1,0.0,14,3,41,10,0,14,10,17,0,3,7,0,1.0,11,31,0.9586252264406279,29.17546958484286
3673,3673,2022,1,NCAAF_20220904_FSU@LSU,Florida State,Seminoles,LSU,Tigers,2-0,1-1,0.0,7,3,24,23,0,7,10,7,3,0,7,13,1.0,4,1,0.17926079397529637,-15.440498367032433
3674,3674,2022,1,NCAAF_20220903_BUFF@MD,Buffalo,Bulls,Maryland,Terrapins,0-1,1-0,1.0,7,17,10,31,0,7,0,3,7,10,7,7,-1.0,-10,-21,0.4167881056565442,-3.533395960707594
3675,3675,2022,1,NCAAF_20220903_CCTST@UCONN,CCSU,,UConn,,0-1,1-1,,3,7,3,28,0,3,0,0,0,7,7,14,-1.0,-4,-25,0.24017660045509004,-11.867852453978571
3676,3676,2022,1,NCAAF_20220903_COLOST@MICH,Colorado St.,Rams,Michigan,Wolverines,0-1,1-0,0.0,0,23,7,51,0,0,0,7,10,13,14,14,-1.0,-23,-44,0.03335360928143616,-30.83508667994039
3677,3677,2022,1,NCAAF_20220903_DE@NAVY,Delaware,Fightin' Blue Hens,Navy,Midshipmen,1-0,0-1,0.0,7,0,14,7,7,0,7,0,0,0,7,0,1.0,7,7,0.18017576500713817,-15.38180323630661
3678,3678,2022,1,NCAAF_20220903_NCST@ECU,NC State,Wolfpack,East Carolina,Pirates,1-0,0-1,0.0,21,7,21,20,14,7,0,0,7,0,7,6,1.0,14,1,0.8759696317867642,19.424058425802173
3679,3679,2022,1,NCAAF_20220903_RUT@BC,Rutgers,Scarlet Knights,Boston College,Eagles,1-0,0-1,1.0,6,14,22,21,0,6,9,7,7,7,7,0,1.0,-8,1,0.2795353285622859,-9.824466440547496
3680,3680,2022,1,NCAAF_20220903_SAMST@TXAM,Sam Houston,Bearkats,Texas A&M,Aggies,0-1,1-0,1.0,0,17,0,31,0,0,0,0,7,10,7,7,-1.0,-17,-31,0.010116129837413168,-39.04768515301362
3681,3681,2022,1,NCAAF_20220903_SDST@IOWA,S. Dakota St.,Jackrabbits,Iowa,Hawkeyes,0-1,1-0,0.0,3,3,3,7,0,3,0,0,3,0,2,2,-1.0,0,-4,0.25500479346137017,-11.078968482952803
3682,3682,2022,1,NCAAF_20220903_UNC@APLST,North Carolina,Tar Heels,App. St.,Mountaineers,2-0,0-1,0.0,28,21,63,61,7,21,13,22,14,7,0,40,2.0,7,2,0.5212528242489521,0.8962783207356324
3683,3683,2022,1,NCAAF_20220903_RICH@UVA,Richmond,Spiders,Virginia,Cavaliers,0-1,1-0,1.0,10,28,17,34,7,3,7,0,14,14,0,6,-1.0,-18,-17,0.10806766911470489,-20.799591031408056
3684,3684,2022,1,NCAAF_20220903_NOIOWA@AF,Northern Iowa,Panthers,Air Force,Falcons,0-1,1-0,1.0,3,27,17,48,3,0,0,14,14,13,14,7,-1.0,-24,-31,0.4812503265053971,-0.7906319301027906
3685,3685,2022,1,NCAAF_20220903_SEMOST@IOWAST,SE Missouri St.,Redhawks,Iowa St.,Cyclones,0-1,1-0,1.0,10,21,10,42,0,10,0,0,7,14,7,14,-1.0,-11,-32,0.0015180097619214017,-49.84467619475595
3686,3686,2022,1,NCAAF_20220903_BGREEN@UCLA,Bowling Green,Falcons,UCLA,Bruins,0-1,1-0,0.0,17,24,17,45,10,7,0,0,7,17,7,14,-1.0,-7,-28,0.03320384137432064,-30.869060574170476
3687,3687,2022,1,NCAAF_20220903_ARIZ@SDGST,Arizona,Wildcats,San Diego St.,Aztecs,1-0,0-1,0.0,24,10,38,20,10,14,7,7,0,10,10,0,1.0,14,18,0.4056649246242411,-4.014234876925798
3688,3688,2022,1,NCAAF_20220903_BTHN@MIAMI,Bethune-Cook.,Wildcats,Miami (Fla.),Hurricanes,0-1,1-0,1.0,10,42,13,70,3,7,3,0,14,28,14,14,-1.0,-32,-57,0.003576407307685714,-45.2299003272758
3689,3689,2022,1,NCAAF_20220903_CINCY@ARK,Cincinnati,Bearcats,Arkansas,Razorbacks,0-1,1-0,0.0,0,14,24,31,0,0,17,7,7,7,10,7,-1.0,-14,-7,0.7245551012973624,10.0297071908318
3690,3690,2022,1,NCAAF_20220903_NDK@NEB,North Dakota,,Nebraska,,0-1,1-1,,7,7,17,38,0,7,10,0,7,0,17,14,-1.0,0,-21,0.06641530790515249,-25.275465003508145
3691,3691,2022,1,NCAAF_20220903_NRFST@MRSHL,Norfolk St.,,Marshall,,0-1,1-0,,0,38,3,55,0,0,3,0,10,28,17,0,-1.0,-38,-52,0.030199000938703646,-31.578962539451027
3692,3692,2022,1,NCAAF_20220903_OREG@UGA,Oregon,Ducks,Georgia,Bulldogs,0-1,1-0,1.0,3,28,3,49,0,3,0,0,7,21,14,7,-1.0,-25,-46,0.2140832020071648,-13.324121881655742
3693,3693,2022,1,NCAAF_20220903_UTEP@OKLA,UTEP,Miners,Oklahoma,Sooners,0-1,1-0,0.0,10,28,13,45,0,10,0,3,21,7,14,3,-1.0,-18,-32,0.001873625374154586,-48.745274022276874
3694,3694,2022,1,NCAAF_20220903_DAVIS@CAL,UC-Davis,Aggies,California,Golden Bears,0-1,1-0,0.0,7,17,13,34,7,0,6,0,0,17,10,7,-1.0,-10,-21,0.17839762813486115,-15.496043163421064
3695,3695,2022,1,NCAAF_20220903_TROY@MISS,Troy,Trojans,Ole Miss,Rebels,0-1,1-0,1.0,3,21,10,28,0,3,0,7,7,14,7,0,-1.0,-18,-18,0.17729085061955785,-15.567512742283157
3696,3696,2022,1,NCAAF_20220903_NICHST@SALA,Nicholls St.,,South Alabama,,0-1,1-0,,0,27,7,48,0,0,0,7,10,17,14,7,-1.0,-27,-41,0.4919567943911416,-0.3390621093907953
3697,3697,2022,1,NCAAF_20220903_TXSTSM@NEVADA,Texas St.,,Nevada,,0-1,2-0,,7,14,14,38,0,7,0,7,14,0,24,0,-2.0,-7,-24,0.14304158524912092,-17.938858231831432
3698,3698,2022,1,NCAAF_20220903_FAU@OHIO,FAU,,Ohio,,1-1,1-0,,17,13,38,41,10,7,0,21,3,10,14,14,0.0,4,-3,0.5312905044899026,1.3203201342761304
3699,3699,2022,1,NCAAF_20220903_MRGNST@GAS,Morgan St.,,Ga. Southern,,0-1,1-0,,7,17,7,59,0,7,0,0,0,17,14,28,-1.0,-10,-52,0.005175783879591833,-43.114645105960335
3700,3700,2022,1,NCAAF_20220903_MTSU@JMAD,Middle Tenn.,Blue Raiders,James Madison,Dukes,0-1,1-0,0.0,0,21,7,44,0,0,7,0,0,21,16,7,-1.0,-21,-37,0.19305724429711524,-14.574448690033535
3701,3701,2022,1,NCAAF_20220903_RICE@USC,Rice,Owls,USC,Trojans,0-1,1-0,0.0,14,31,14,66,7,7,0,0,7,24,28,7,-1.0,-17,-52,0.031117528363071023,-31.35598546740505
3702,3702,2022,1,NCAAF_20220903_BYU@SFLA,BYU,Cougars,South Florida,Bulls,1-0,0-1,1.0,38,7,50,21,28,10,9,3,0,7,14,0,1.0,31,29,0.7779949208167247,12.871860772452862
3703,3703,2022,1,NCAAF_20220903_ALBANY@BAYLOR,Albany,Great Danes,Baylor,Bears,0-1,1-0,1.0,7,35,10,69,7,0,3,0,21,14,14,20,-1.0,-28,-59,0.009755829228761503,-39.27631775584433
3704,3704,2022,1,NCAAF_20220903_ARMY@CSTCAR,Army,Black Knights,C. Carolina,Chanticleers,0-1,1-0,1.0,14,14,28,38,7,7,7,7,7,7,10,14,-1.0,0,-10,0.6793706416192846,7.835385626122331
3705,3705,2022,1,NCAAF_20220903_ELON@VANDY,Elon,,Vanderbilt,,0-1,2-0,,10,28,31,42,7,3,14,7,21,7,7,7,-2.0,-18,-11,0.05916617437856797,-26.263911630723726
3706,3706,2022,1,NCAAF_20220903_GRAM@ARKST,Grambling,Tigers,Arkansas St.,Red Wolves,0-1,1-0,0.0,0,30,3,58,0,0,3,0,16,14,21,7,-1.0,-30,-55,0.06061485753580231,-26.059104279066446
3707,3707,2022,1,NCAAF_20220903_ILST@WISC,Illinois St.,Redbirds,Wisconsin,Badgers,0-1,1-0,1.0,0,17,0,38,0,0,0,0,7,10,14,7,-1.0,-17,-38,0.014179797712656539,-36.86599217372071
3708,3708,2022,1,NCAAF_20220903_MERCER@AUBURN,Mercer,Bears,Auburn,Tigers,1-0,1-0,0.0,7,28,16,42,0,7,0,9,14,14,14,0,0.0,-21,-26,0.008207715845447217,-40.35150624669683
3709,3709,2022,1,NCAAF_20220903_MIAOH@UK,Miami-OH,RedHawks,Kentucky,Wildcats,0-1,1-0,1.0,10,13,13,37,7,3,3,0,7,6,17,7,-1.0,-3,-24,0.16520988372221268,-16.36678934068584
3710,3710,2022,1,NCAAF_20220903_SD@KSTATE,South Dakota,Coyotes,Kansas State,Wildcats,0-1,1-0,0.0,0,27,0,34,0,0,0,0,20,7,7,0,-1.0,-27,-34,0.03583868407781299,-30.288898324676893
3711,3711,2022,1,NCAAF_20220903_SELOU@UL,SE Louisiana,Lions,Louisiana,Ragin' Cajuns,0-1,1-0,1.0,0,17,7,24,0,0,7,0,10,7,0,7,-1.0,-17,-17,0.35346207296276466,-6.32276892871522
3712,3712,2022,1,NCAAF_20220903_UMASS@TULANE,UMass,Minutemen,Tulane,Green Wave,0-1,1-0,1.0,10,21,10,42,0,10,0,0,7,14,21,0,-1.0,-11,-32,0.04870088086469582,-27.874422973164428
3713,3713,2022,1,NCAAF_20220903_UTAH@FLA,Utah,Utes,Florida,Gators,0-1,1-0,0.0,13,14,26,29,7,6,6,7,7,7,0,15,-1.0,-1,-3,0.5242528884431,1.0229441115771465
3714,3714,2022,1,NCAAF_20220903_GAST@SC,Georgia St.,Panthers,South Carolina,Gamecocks,0-1,1-0,1.0,7,12,14,35,0,7,7,0,0,12,16,7,-1.0,-5,-21,0.13285720849982496,-18.716319658203417
3715,3715,2022,1,NCAAF_20220903_MEMP@MISSST,Memphis,Tigers,Miss. State,Bulldogs,0-1,1-0,0.0,3,28,23,49,0,3,7,13,14,14,7,14,-1.0,-25,-26,0.32692683658429267,-7.540687128826221
3716,3716,2022,1,NCAAF_20220903_ND@OHIOST,Notre Dame,Fighting Irish,Ohio State,Buckeyes,0-1,1-0,1.0,10,7,10,21,3,7,0,0,7,0,7,7,-1.0,3,-11,0.23737348234450484,-12.019909160332759
3717,3717,2022,1,NCAAF_20220903_SMU@NTEXAS,SMU,Mustangs,North Texas,Mean Green,1-0,1-1,1.0,31,10,48,10,14,17,7,10,0,10,0,0,0.0,21,38,0.7764811466378051,12.786498586996458
3718,3718,2022,1,NCAAF_20220903_UTAHST@BAMA,Utah St.,Aggies,Alabama,Crimson Tide,1-1,1-0,1.0,0,41,0,55,0,0,0,0,17,24,14,0,0.0,-41,-55,0.0246472327719226,-33.06147080006241
3719,3719,2022,1,NCAAF_20220903_COLG@STNFRD,Colgate,Raiders,Stanford,Cardinal,0-1,1-0,0.0,7,28,10,41,0,7,3,0,7,21,0,13,-1.0,-21,-31,0.013207194330500549,-37.33329520474285
3720,3720,2022,1,NCAAF_20220903_LAMON@TEXAS,UL-Monroe,Warhawks,Texas,Longhorns,0-1,1-0,1.0,3,24,10,52,3,0,0,7,14,10,21,7,-1.0,-21,-42,0.019123676829550074,-34.8466585045561
3721,3721,2022,1,NCAAF_20220903_LVILLE@CUSE,Louisville,Cardinals,Syracuse,Orange,0-1,1-0,0.0,7,17,7,31,7,0,0,0,10,7,0,14,-1.0,-10,-24,0.5776670141326377,3.294797977561018
3722,3722,2022,1,NCAAF_20220903_ME@NMEX,Maine,Black Bears,New Mexico,Lobos,0-1,1-0,0.0,0,21,0,41,0,0,0,0,0,21,13,7,-1.0,-21,-41,0.4067882482584515,-3.965532550968817
3723,3723,2022,1,NCAAF_20220903_MURYST@TXTECH,Murray St.,Racers,Texas Tech,Red Raiders,0-1,1-0,1.0,10,42,10,63,3,7,0,0,14,28,14,7,-1.0,-32,-53,0.009264220360405973,-39.60047779635363
3724,3724,2022,1,NCAAF_20220903_IDAHO@WASHST,Idaho,Vandals,Washington St.,Cougars,0-1,1-0,0.0,10,10,17,24,10,0,0,7,0,10,7,7,-1.0,0,-7,0.030998730566342836,-31.384514896059954
3725,3725,2022,1,NCAAF_20220903_BOISE@OREGST,Boise St.,Broncos,Oregon State,Beavers,0-1,1-0,1.0,0,24,17,34,0,0,10,7,14,10,3,7,-1.0,-24,-17,0.7819483454571323,13.096378244529205
3726,3726,2022,1,NCAAF_20220903_KENTST@WASH,Kent St.,Golden Flashes,Washington,Huskies,0-1,1-0,1.0,13,31,20,45,7,6,0,7,21,10,7,7,-1.0,-18,-25,0.029380692522186003,-31.782397077862925
3727,3727,2022,1,NCAAF_20220903_WKY@HAWAII,W. Kentucky,,Hawaii,,2-0,0-2,,21,10,49,17,0,21,7,21,3,7,0,7,2.0,11,32,0.5454231623012139,1.9188438998238553
3728,3728,2022,1,NCAAF_20220902_EKY@EMICH,E. Kentucky,Colonels,E. Michigan,Eagles,0-1,1-0,1.0,10,14,34,42,0,10,7,17,0,14,14,14,-1.0,-4,-8,0.11789548749210699,-19.936964026081455
3729,3729,2022,1,NCAAF_20220902_VATECH@ODU,Virginia Tech,Hokies,Old Dominion,Monarchs,0-1,1-0,1.0,7,10,17,20,7,0,10,0,0,10,0,10,-1.0,-3,-3,0.9287970662810381,24.66768541761894
3730,3730,2022,1,NCAAF_20220902_WMICH@MICHST,W. Michigan,Broncos,Michigan St.,Spartans,0-1,1-0,0.0,3,21,13,35,3,0,10,0,7,14,0,14,-1.0,-18,-22,0.18611262087636127,-15.00541119927442
3731,3731,2022,1,NCAAF_20220902_WMMARY@CHARLO,William & Mary,,Charlotte,,1-0,0-2,,17,17,41,24,10,7,3,21,3,14,7,0,1.0,0,17,0.2680872528778486,-10.402707669496635
3732,3732,2022,1,NCAAF_20220902_TEMPLE@DUKE,Temple,Owls,Duke,Blue Devils,0-1,1-0,0.0,0,24,0,30,0,0,0,0,10,14,3,3,-1.0,-24,-30,0.37912357687624276,-5.1757813614368615
3733,3733,2022,1,NCAAF_20220902_ILL@IND,Illinois,,Indiana,,1-1,1-0,,10,16,20,23,7,3,7,3,3,13,0,7,0.0,-6,-3,0.29792859843535013,-8.918823782426728
3734,3734,2022,1,NCAAF_20220902_TNTECH@KANSAS,Tenn. Tech,Golden Eagles,Kansas,Jayhawks,0-1,1-0,1.0,3,35,10,56,0,3,0,7,21,14,7,14,-1.0,-32,-46,0.024924372887983437,-32.9811515514678
3735,3735,2022,1,NCAAF_20220902_TCU@COLO,TCU,Horned Frogs,Colorado,Buffaloes,1-0,0-1,0.0,7,6,38,13,0,7,10,21,3,3,0,7,1.0,1,25,0.7386410848798928,10.748339694647143
3736,3736,2022,1,NCAAF_20220901_BALLST@TENN,Ball St.,Cardinals,Tennessee,Volunteers,0-1,1-0,1.0,0,38,10,59,0,0,7,3,17,21,14,7,-1.0,-38,-49,0.1441943199933836,-17.85325744154602
3737,3737,2022,1,NCAAF_20220901_CMICH@OKLAST,C. Michigan,Chippewas,Oklahoma State,Cowboys,0-1,1-0,1.0,15,44,44,58,7,8,7,22,16,28,7,7,-1.0,-29,-14,0.0830134665605109,-23.291995029590964
3738,3738,2022,1,NCAAF_20220901_LIUPOST@TOLEDO,LIU,Sharks,Toledo,Rockets,0-1,1-0,0.0,0,20,0,37,0,0,0,0,3,17,0,17,-1.0,-20,-37,0.0019088734935364116,-48.64691118754223
3739,3739,2022,1,NCAAF_20220901_SCST@UCF,SC State,Bulldogs,UCF,Knights,0-1,1-0,0.0,3,28,10,56,0,3,7,0,21,7,14,14,-1.0,-25,-46,0.006507645321564337,-41.76079640895887
3740,3740,2022,1,NCAAF_20220901_WVU@PITT,West Virginia,Mountaineers,Pittsburgh,Panthers,0-1,1-0,1.0,10,10,31,38,0,10,7,14,3,7,14,14,-1.0,0,-7,0.5297801663919932,1.2564688334547895
3741,3741,2022,1,NCAAF_20220901_VMI@WAKE,VMI,Keydets,Wake Forest,Demon Deacons,0-1,1-0,1.0,3,23,10,44,0,3,7,0,17,6,14,7,-1.0,-20,-34,5.292114962274219e-05,-65.19335788028428
3742,3742,2022,1,NCAAF_20220901_ALAM@UAB,Alabama A&M,Bulldogs,UAB,Blazers,0-1,1-0,0.0,0,38,0,59,0,0,0,0,28,10,21,0,-1.0,-38,-59,0.004665087089522513,-43.717583077911115
3743,3743,2022,1,NCAAF_20220901_EIL@NILL,E. Illinois,Panthers,N. Illinois,Huskies,0-1,1-0,0.0,6,21,27,34,3,3,7,14,7,14,7,6,-1.0,-15,-7,0.024489114319593108,-33.10763590643592
3744,3744,2022,1,NCAAF_20220901_LATECH@MIZZOU,Louisiana Tech,Bulldogs,Missouri,Tigers,0-1,1-0,1.0,10,24,24,52,3,7,0,14,0,24,14,14,-1.0,-14,-28,0.13636925071873263,-18.443757905576092
3745,3745,2022,1,NCAAF_20220901_PSU@PURDUE,Penn State,Nittany Lions,Purdue,Boilermakers,1-0,0-1,1.0,21,10,35,31,0,21,0,14,3,7,14,7,1.0,11,4,0.7900690771848111,13.565061440599322
3746,3746,2022,1,NCAAF_20220901_NMEXST@MINN,New Mexico St.,Aggies,Minnesota,Golden Gophers,0-2,1-0,1.0,0,24,0,38,0,0,0,0,7,17,14,0,-1.0,-24,-38,0.027345032400610036,-32.30968974334229
3747,3747,2022,1,NCAAF_20220901_NAZ@ARIZST,N. Arizona,Lumberjacks,Arizona St.,Sun Devils,0-1,1-0,1.0,3,24,3,40,0,3,0,0,3,21,13,3,-1.0,-21,-37,0.037111079200861874,-30.02117565921924
3748,3748,2022,1,NCAAF_20220901_CPOLY@FRESNO,Cal-Poly,Mustangs,Fresno St.,Bulldogs,0-1,1-0,1.0,7,21,7,35,0,7,0,0,21,0,7,7,-1.0,-14,-28,0.003102688477368165,-46.02165191466952
3749,3749,2022,1,NCAAF_20220901_PORTST@SJST,Portland St.,Vikings,San Jose St.,Spartans,0-1,1-0,0.0,7,14,17,21,7,0,3,7,7,7,0,7,-1.0,-7,-4,0.45611163783961084,-1.8537403078065608
3750,3750,2022,1,NCAAF_20220827_AP@WKY,Austin Peay,Governors,W. Kentucky,Hilltoppers,2-1,2-0,0.0,17,21,27,38,10,7,3,7,7,14,0,17,0.0,-4,-11,0.12870649756958652,-19.04492398058943
3751,3751,2022,1,NCAAF_20220827_NEB@NWEST,Nebraska,Cornhuskers,Northwestern,Wildcats,0-1,1-0,1.0,14,17,28,31,7,7,14,0,3,14,7,7,-1.0,-3,-3,0.5363552645310797,1.5345830934905393
3752,3752,2022,1,NCAAF_20220827_IDST@UNLV,Idaho State,Bengals,UNLV,Rebels,0-1,1-0,0.0,7,45,21,52,7,0,7,7,10,35,0,7,-1.0,-38,-31,0.2917780473164423,-9.218664620755192
3753,3753,2022,1,NCAAF_20220827_UCONN@UTAHST,UConn,,Utah St.,,0-1,1-0,,14,24,20,31,14,0,0,6,0,24,0,7,-1.0,-10,-11,0.052119639486729374,-27.32045221230902
3754,3754,2022,1,NCAAF_20220827_WYO@ILL,Wyoming,Cowboys,Illinois,Fighting Illini,0-1,1-0,0.0,3,17,6,38,3,0,3,0,7,10,7,14,-1.0,-14,-32,0.4908643179119735,-0.3851231316501753
3755,3755,2022,1,NCAAF_20220827_DUQ@FSU,Duquesne,,Florida State,,0-1,1-0,,0,26,7,47,0,0,7,0,20,6,14,7,-1.0,-26,-40,0.0774675537425834,-23.9180750238923
3756,3756,2022,1,NCAAF_20220827_CHARLO@FAU,Charlotte,49ers,FAU,Owls,0-2,1-1,1.0,7,26,13,43,7,0,6,0,10,16,7,10,-1.0,-19,-30,0.17630308647881232,-15.631535387757708
3757,3757,2022,1,NCAAF_20220827_FAMU@UNC,Florida A&M,,North Carolina,,0-1,1-0,,14,28,24,56,7,7,10,0,14,14,7,21,-1.0,-14,-32,0.0013090928748791253,-50.60594580765053
3758,3758,2022,1,NCAAF_20220827_NTEXAS@UTEP,North Texas,,UTEP,,1-1,0-2,,14,13,31,13,0,14,14,3,0,13,0,0,1.0,1,18,0.8015073192608986,14.243709841380905
3759,3759,2022,1,NCAAF_20220827_NEVADA@NMEXST,Nevada,Wolf Pack,New Mexico St.,Aggies,1-0,0-2,0.0,17,2,23,12,0,17,0,6,0,2,7,3,1.0,15,11,0.8427579566156898,16.91481376158606
3760,3760,2022,1,NCAAF_20220827_VANDY@HAWAII,Vanderbilt,Commodores,Hawaii,Rainbow Warriors,1-0,0-1,0.0,21,10,63,10,14,7,35,7,7,3,0,0,1.0,11,53,0.5581472750962562,2.4597814057022447
3761,3761,2022,2,NCAAF_20220910_ARKST@OHIOST,Arkansas St.,Red Wolves,Ohio State,Buckeyes,1-1,2-0,1.0,9,24,12,45,3,6,3,0,14,10,21,0,-1.0,-15,-33,0.005166440981684728,-43.134856858963246
3762,3762,2022,2,NCAAF_20220910_BAMA@TEXAS,Alabama,Crimson Tide,Texas,Longhorns,2-0,1-1,1.0,10,10,20,19,10,0,0,10,3,7,3,6,1.0,0,1,0.8898850681314111,20.62002470670808
3763,3763,2022,2,NCAAF_20220910_DUKE@NWEST,Duke,Blue Devils,Northwestern,Wildcats,2-0,1-1,0.0,21,10,31,23,14,7,0,10,0,10,6,7,1.0,11,8,0.2932586938740682,-9.148268271222378
3764,3764,2022,2,NCAAF_20220910_MIZZOU@KSTATE,Missouri,Tigers,Kansas State,Wildcats,1-1,2-0,1.0,3,20,12,40,3,0,3,6,7,13,6,14,-1.0,-17,-28,0.5005080687628547,0.021421043123609707
3765,3765,2022,2,NCAAF_20220910_OHIO@PSU,Ohio,Bobcats,Penn State,Nittany Lions,1-1,2-0,1.0,7,26,10,46,0,7,0,3,14,12,14,6,-1.0,-19,-36,0.042928884943753465,-28.89126049867923
3766,3766,2022,2,NCAAF_20220910_SC@ARK,South Carolina,Gamecocks,Arkansas,Razorbacks,1-1,2-0,1.0,9,21,30,44,3,6,7,14,7,14,0,23,-1.0,-12,-14,0.6324140553249002,5.689457183072761
3767,3767,2022,2,NCAAF_20220910_UNC@GAST,North Carolina,Tar Heels,Georgia St.,Panthers,3-0,0-2,1.0,21,10,35,28,7,14,7,7,3,7,18,0,3.0,11,7,0.865980295140872,18.629734038323818
3768,3768,2022,2,NCAAF_20220910_USM@MIAMI,So. Miss,Golden Eagles,Miami (Fla.),Hurricanes,0-2,2-0,0.0,7,10,7,30,0,7,0,0,3,7,14,6,-2.0,-3,-23,0.08383540613917595,-23.20711395075034
3769,3769,2022,2,NCAAF_20220910_WAKE@VANDY,Wake Forest,Demon Deacons,Vanderbilt,Commodores,2-0,2-1,0.0,21,10,45,25,14,7,14,10,3,7,8,7,0.0,11,20,0.7792588767703157,12.946291883637684
3770,3770,2022,2,NCAAF_20220910_WIL@MINN,W. Illinois,,Minnesota,,0-2,2-0,,3,31,10,62,3,0,0,7,14,17,21,10,-2.0,-28,-52,0.09329295495086609,-22.21506211841637
3771,3771,2022,2,NCAAF_20220910_CHARSO@NCST,Charleston So.,Buccaneers,NC State,Wolfpack,0-2,2-0,0.0,0,38,3,55,0,0,3,0,10,28,10,7,-2.0,-38,-52,0.015326778022331733,-36.35729737213097
3772,3772,2022,2,NCAAF_20220910_SALA@CMICH,South Alabama,,C. Michigan,,2-0,0-2,,31,10,38,24,20,11,0,7,7,3,0,14,2.0,21,14,0.26259864033478864,-10.686712675351714
3773,3773,2022,2,NCAAF_20220910_SUT@UTAH,So. Utah,Thunderbirds,Utah,Utes,1-1,1-1,0.0,7,45,7,73,7,0,0,0,7,38,14,14,0.0,-38,-66,0.0010459869778759456,-51.75294011389417
3774,3774,2022,2,NCAAF_20220910_LAF@TEMPLE,Lafayette,,Temple,,1-1,1-1,,7,21,14,30,7,0,7,0,7,14,0,9,0.0,-14,-16,0.2938995111972178,-9.116959338305321
3775,3775,2022,2,NCAAF_20220910_WMICH@BALLST,W. Michigan,Broncos,Ball St.,Cardinals,1-1,0-2,0.0,14,16,37,30,7,7,7,16,10,6,7,7,1.0,-2,7,0.6972939067724546,8.689813178244492
3776,3776,2022,2,NCAAF_20220910_MRSHL@ND,Marshall,Thundering Herd,Notre Dame,Fighting Irish,2-0,0-2,0.0,9,7,26,21,0,9,3,14,0,7,0,14,2.0,2,5,0.08378247252039184,-23.21289656223348
3777,3777,2022,2,NCAAF_20220910_APLST@TXAM,App. St.,Mountaineers,Texas A&M,Aggies,1-1,1-1,1.0,7,7,17,14,0,7,7,3,0,7,7,0,0.0,0,3,0.27815912232163165,-9.89557168067762
3778,3778,2022,2,NCAAF_20220910_COLO@AF,Colorado,Buffaloes,Air Force,Falcons,0-2,2-0,1.0,10,20,10,41,0,10,0,0,13,7,7,14,-2.0,-10,-31,0.42033118556254656,-3.3816149429225106
3779,3779,2022,2,NCAAF_20220910_FUR@CLEM,Furman,Paladins,Clemson,Tigers,1-1,2-0,0.0,9,28,12,35,3,6,3,0,14,14,7,0,-1.0,-19,-23,0.0020611931101502945,-48.25078265705258
3780,3780,2022,2,NCAAF_20220910_KENSAW@CINCY,Kennesaw St.,Owls,Cincinnati,Bearcats,0-2,1-1,0.0,3,21,10,63,0,3,0,7,7,14,21,21,-1.0,-18,-53,0.013759272404826883,-37.072844521790955
3781,3781,2022,2,NCAAF_20220910_MD@CHARLO,Maryland,Terrapins,Charlotte,49ers,2-0,0-3,1.0,35,14,56,21,21,14,14,7,7,7,0,7,2.0,21,35,0.8731380787143153,19.197617470377452
3782,3782,2022,2,NCAAF_20220910_MEMP@NAVY,Memphis,Tigers,Navy,Midshipmen,1-1,0-2,1.0,13,7,37,13,10,3,10,14,7,0,0,6,1.0,6,24,0.6683588339267714,7.323226135129005
3783,3783,2022,2,NCAAF_20220910_WASHST@WISC,Washington St.,Cougars,Wisconsin,Badgers,2-0,1-1,0.0,7,14,17,14,0,7,10,0,0,14,0,0,1.0,-7,3,0.22682903190908288,-12.603798346559643
3784,3784,2022,2,NCAAF_20220910_AKRON@MICHST,Akron,Zips,Michigan St.,Spartans,1-1,2-0,1.0,0,24,0,52,0,0,0,0,14,10,28,0,-1.0,-24,-52,0.020985318343615944,-34.20886776702184
3785,3785,2022,2,NCAAF_20220910_INST@PURDUE,Indiana St.,Sycamores,Purdue,Boilermakers,1-1,1-1,1.0,0,35,0,56,0,0,0,0,21,14,14,7,0.0,-35,-56,0.031185804705705422,-31.346654632385935
3786,3786,2022,2,NCAAF_20220910_IOWAST@IOWA,Iowa St.,Cyclones,Iowa,Hawkeyes,2-0,1-1,1.0,3,7,10,7,0,3,0,7,7,0,0,0,1.0,-4,3,0.428659378309985,-3.0240539453278075
3787,3787,2022,2,NCAAF_20220910_MTSU@COLOST,Middle Tenn.,Blue Raiders,Colorado St.,Rams,1-1,0-2,0.0,27,0,34,19,10,17,7,0,0,0,19,0,1.0,27,15,0.4272421103277624,-3.0848018004193136
3788,3788,2022,2,NCAAF_20220910_NCO@WYO,N. Colorado,,Wyoming,,0-2,2-1,,0,9,10,33,0,0,3,7,3,6,7,17,-2.0,-9,-23,0.07149406921386436,-24.63727448432536
3789,3789,2022,2,NCAAF_20220910_NRFST@JMAD,Norfolk St.,,James Madison,,0-2,2-0,,0,35,7,63,0,0,7,0,21,14,21,7,-2.0,-35,-56,0.0016055131251857535,-49.565059579850754
3790,3790,2022,2,NCAAF_20220910_PORTST@WASH,Portland St.,Vikings,Washington,Huskies,0-2,2-0,1.0,3,31,6,52,0,3,3,0,14,17,14,7,-2.0,-28,-46,0.030751669029760786,-31.45118644965686
3791,3791,2022,2,NCAAF_20220910_SAMF@UGA,Samford,Bulldogs,Georgia,Bulldogs,1-1,2-0,1.0,0,30,0,33,0,0,0,0,13,17,0,3,-1.0,-30,-33,0.009573684967918106,-39.40355027588225
3792,3792,2022,2,NCAAF_20220910_UNLV@CAL,UNLV,Rebels,California,Golden Bears,1-1,2-0,1.0,7,17,14,20,0,7,7,0,14,3,3,0,-1.0,-10,-6,0.12804415726346063,-19.102317362632505
3793,3793,2022,2,NCAAF_20220910_UVA@ILL,Virginia,Cavaliers,Illinois,Fighting Illini,1-1,2-1,0.0,3,21,3,24,3,0,0,0,14,7,3,0,-1.0,-18,-21,0.6488434393375786,6.428632504453674
3794,3794,2022,2,NCAAF_20220910_WAG@RUT,Wagner,Seahawks,Rutgers,Scarlet Knights,0-2,2-0,1.0,7,38,7,66,0,7,0,0,28,10,14,14,-2.0,-31,-59,0.008852625234818778,-39.89260977763439
3795,3795,2022,2,NCAAF_20220910_ALST@UCLA,Alabama St.,Hornets,UCLA,Bruins,2-1,2-0,1.0,7,31,7,45,0,7,0,0,14,17,7,7,0.0,-24,-38,0.008073661189776593,-40.46185656034692
3796,3796,2022,2,NCAAF_20220910_UIW@NEVADA,Incarnate Word,,Nevada,,2-0,2-1,,24,17,55,41,9,15,14,17,17,0,14,10,0.0,7,14,0.01649512075739512,-35.863809781648115
3797,3797,2022,2,NCAAF_20220910_GRDWB@CSTCAR,Gardner-Webb,Runnin' Bulldogs,C. Carolina,Chanticleers,1-1,2-0,0.0,10,17,27,31,0,10,10,7,3,14,7,7,-1.0,-7,-4,0.023348480354575263,-33.45578657205101
3798,3798,2022,2,NCAAF_20220910_HOLY@BUFF,Holy Cross,,Buffalo,,2-0,0-2,,14,21,37,31,0,14,14,9,7,14,7,3,2.0,-7,6,0.04008344906833694,-29.430406157426887
3799,3799,2022,2,NCAAF_20220910_ODU@ECU,Old Dominion,Monarchs,East Carolina,Pirates,1-1,1-1,0.0,7,16,21,39,7,0,7,7,9,7,6,17,0.0,-9,-18,0.356497909821906,-6.187024454688242
3800,3800,2022,2,NCAAF_20220910_ROB@MIAOH,Robert Morris,,Miami-OH,,0-2,1-1,,7,24,14,31,7,0,0,7,10,14,0,7,-1.0,-17,-17,0.019229823748982522,-34.81625497130591
3801,3801,2022,2,NCAAF_20220910_SELOU@FAU,SE Louisiana,,FAU,,0-2,2-1,,3,28,9,42,0,3,0,6,7,21,7,7,-2.0,-25,-33,0.3166169485379534,-8.026207292238439
3802,3802,2022,2,NCAAF_20220910_UAB@LIB,UAB,Blazers,Liberty,Flames,1-1,2-0,0.0,7,7,14,21,7,0,0,7,0,7,7,7,-1.0,0,-7,0.5142539607430621,0.6010989870790695
3803,3803,2022,2,NCAAF_20220910_ALAM@TROY,Alabama A&M,,Troy,,0-2,1-1,,3,7,17,38,3,0,0,14,0,7,21,10,-1.0,-4,-21,0.004359096492006498,-44.11758158771357
3804,3804,2022,2,NCAAF_20220910_ALCORN@TULANE,Alcorn St.,,Tulane,,0-2,2-0,,0,31,0,52,0,0,0,0,17,14,14,7,-2.0,-31,-52,0.045011964281170824,-28.514603082556278
3805,3805,2022,2,NCAAF_20220910_CAR@MISS,Cent. Ark.,Bears,Ole Miss,Rebels,0-2,2-0,0.0,0,31,3,59,0,0,0,3,28,3,21,7,-2.0,-31,-56,0.035018841637764586,-30.47238282188232
3806,3806,2022,2,NCAAF_20220910_CUSE@UCONN,Syracuse,Orange,UConn,Huskies,2-0,1-2,1.0,27,7,48,14,17,10,14,7,0,7,7,0,1.0,20,34,0.9391448191321996,26.031333947626365
3807,3807,2022,2,NCAAF_20220910_EMICH@UL,E. Michigan,Eagles,Louisiana,Ragin' Cajuns,1-1,2-0,1.0,14,0,21,49,7,7,7,0,0,0,21,28,-1.0,14,-28,0.3702278912717144,-5.571648829742458
3808,3808,2022,2,NCAAF_20220910_FIU@TXSTSM,FIU,,Texas St.,,1-1,1-1,,6,20,12,41,3,3,0,6,10,10,0,21,0.0,-14,-29,0.6549129818921131,6.704801912913183
3809,3809,2022,2,NCAAF_20220910_HOW@SFLA,Howard,Bison,South Florida,Bulls,0-3,1-1,0.0,7,14,20,42,7,0,7,6,0,14,14,14,-1.0,-7,-22,0.01096379963191707,-38.54522733405764
3810,3810,2022,2,NCAAF_20220910_KENTST@OKLA,Kent St.,Golden Flashes,Oklahoma,Sooners,0-2,2-0,1.0,3,7,3,33,0,3,0,0,0,7,24,2,-2.0,-4,-30,0.0076668401280493015,-40.7786132620389
3811,3811,2022,2,NCAAF_20220910_LAMAR@SMU,Lamar,Cardinals,SMU,Mustangs,0-2,2-0,1.0,10,24,16,45,0,10,3,3,14,10,14,7,-2.0,-14,-29,0.00010962035834127803,-62.16277170383785
3812,3812,2022,2,NCAAF_20220910_NILL@TULSA,N. Illinois,Huskies,Tulsa,Golden Hurricane,1-1,1-1,0.0,7,24,35,38,0,7,14,14,7,17,0,14,0.0,-17,-3,0.4094391582204314,-3.851594999612587
3813,3813,2022,2,NCAAF_20220910_SFA@LATECH,S.F. Austin,,Louisiana Tech,,1-2,1-1,,7,38,17,52,7,0,3,7,21,17,14,0,0.0,-31,-35,0.12166352625021792,-19.62417485934583
3814,3814,2022,2,NCAAF_20220910_UK@FLA,Kentucky,Wildcats,Florida,Gators,2-0,1-1,0.0,13,16,26,16,0,13,10,3,3,13,0,0,1.0,-3,10,0.3501408230165428,-6.474726852358572
3815,3815,2022,2,NCAAF_20220910_UMASS@TOLEDO,UMass,,Toledo,,0-2,2-0,,7,28,10,55,0,7,0,3,14,14,17,10,-2.0,-21,-45,0.05888786664125689,-26.309602640956996
3816,3816,2022,2,NCAAF_20220910_WBRST@UTAHST,Weber St.,,Utah St.,,2-0,1-2,,13,7,35,7,13,0,15,7,7,0,0,0,1.0,6,28,0.3139723730917947,-8.15137532661953
3817,3817,2022,2,NCAAF_20220910_WCAR@GATECH,W. Carolina,Catamounts,Georgia Tech,Yellow Jackets,1-1,1-1,0.0,14,28,17,35,14,0,0,3,14,14,7,0,0.0,-14,-18,0.013040912031705876,-37.4245322725784
3818,3818,2022,2,NCAAF_20220910_ARIZST@OKLAST,Arizona St.,Sun Devils,Oklahoma State,Cowboys,1-1,2-0,0.0,3,17,17,34,3,0,7,7,0,17,3,14,-1.0,-14,-17,0.3152465847324406,-8.0910108302524
3819,3819,2022,2,NCAAF_20220910_GAS@NEB,Ga. Southern,Eagles,Nebraska,Cornhuskers,2-0,1-2,0.0,28,28,45,42,14,14,7,10,7,21,7,7,1.0,0,3,0.12507022025368375,-19.34323266232576
3820,3820,2022,2,NCAAF_20220910_MCN@RICE,McNeese St.,,Rice,,0-2,1-1,,0,31,10,52,0,0,10,0,10,21,14,7,-1.0,-31,-42,0.5710980397921452,3.0136602177791474
3821,3821,2022,2,NCAAF_20220910_SJST@AUBURN,San Jose St.,Spartans,Auburn,Tigers,1-1,2-0,1.0,10,7,16,24,0,10,0,6,0,7,10,7,-1.0,3,-8,0.01987627243264456,-34.587317186497614
3822,3822,2022,2,NCAAF_20220910_SO@LSU,Southern U.,Jaguars,LSU,Tigers,1-1,1-1,0.0,0,51,17,65,0,0,7,10,37,14,7,7,0.0,-51,-48,4.7752930184774556e-05,-65.6274890720926
3823,3823,2022,2,NCAAF_20220910_TXSO@NTEXAS,Texas Southern,Tigers,North Texas,Mean Green,0-2,2-1,1.0,17,45,27,59,3,14,7,3,10,35,7,7,-2.0,-28,-32,0.009325670183415902,-39.568014824249644
3824,3824,2022,2,NCAAF_20220910_USC@STNFRD,USC,Trojans,Stanford,Cardinal,2-0,1-1,0.0,35,14,41,28,21,14,6,0,7,7,0,14,1.0,21,13,0.5998975520547184,4.256858568848884
3825,3825,2022,2,NCAAF_20220910_BC@VATECH,Boston College,Eagles,Virginia Tech,Hokies,0-2,1-1,1.0,3,17,10,27,0,3,7,0,10,7,7,3,-1.0,-14,-17,0.4558821653150088,-1.8638900628111514
3826,3826,2022,2,NCAAF_20220910_HAWAII@MICH,Hawaii,Rainbow Warriors,Michigan,Wolverines,0-3,2-0,1.0,0,42,10,56,0,0,3,7,21,21,0,14,-2.0,-42,-46,0.013383982370189784,-37.25454253950954
3827,3827,2022,2,NCAAF_20220910_IDAHO@IND,Idaho,Vandals,Indiana,Hoosiers,0-2,2-0,0.0,10,0,22,35,0,10,0,12,0,0,23,12,-2.0,10,-13,0.05864740860716067,-26.344112112080495
3828,3828,2022,2,NCAAF_20220910_IDST@SDGST,Idaho State,Bengals,San Diego St.,Aztecs,0-2,1-1,1.0,7,21,7,38,7,0,0,0,14,7,3,14,-1.0,-14,-31,0.04696814095312707,-28.173459047998904
3829,3829,2022,2,NCAAF_20220910_NICHST@LAMON,Nicholls St.,,UL-Monroe,,0-2,1-1,,7,21,7,35,7,0,0,0,0,21,7,7,-1.0,-14,-28,0.3828588636973622,-5.01206302899368
3830,3830,2022,2,NCAAF_20220910_TRLST@TCU,Tarleton St.,,TCU,,1-1,2-0,,7,38,17,59,0,7,10,0,21,17,14,7,-1.0,-31,-42,,
3831,3831,2022,2,NCAAF_20220910_EWASH@OREG,E. Washington,Eagles,Oregon,Ducks,1-1,1-1,1.0,7,42,14,70,0,7,7,0,14,28,21,7,0.0,-35,-56,0.006159861231673114,-42.098163613947406
3832,3832,2022,2,NCAAF_20220910_NMEXST@UTEP,New Mexico St.,Aggies,UTEP,Miners,0-3,1-2,0.0,0,17,13,20,0,0,6,7,3,14,3,0,-1.0,-17,-7,0.5780611281914161,3.3124767426994026
3833,3833,2022,2,NCAAF_20220910_OREGST@FRESNO,Oregon State,Beavers,Fresno St.,Bulldogs,2-0,1-1,1.0,14,13,35,32,7,7,7,14,7,6,10,9,1.0,1,3,0.3531616586876134,-6.33778195998849
3834,3834,2022,2,NCAAF_20220910_MISSST@ARIZ,Miss. State,Bulldogs,Arizona,Wildcats,2-0,1-1,0.0,18,10,39,17,15,3,7,14,7,3,7,0,1.0,8,22,0.8198316801165063,15.385728156666346
3835,3835,2022,2,NCAAF_20220909_LVILLE@UCF,Louisville,Cardinals,UCF,Knights,1-1,1-1,1.0,7,14,20,14,7,0,10,3,7,7,0,0,0.0,-7,6,0.30232995795910544,-8.707940840541028
3836,3836,2022,2,NCAAF_20220909_BOISE@NMEX,Boise St.,Broncos,New Mexico,Lobos,1-1,1-1,0.0,10,0,31,14,0,10,7,14,0,0,0,14,0.0,10,17,0.9367204059086239,25.697923093018915
3837,3837,2022,3,NCAAF_20220917_WOFF@VATECH,Wofford,Terriers,Virginia Tech,Hokies,0-3,2-1,0.0,0,20,7,27,0,0,0,7,3,17,0,7,-2.0,-20,-20,0.11659206732461269,-20.092634956306938
3838,3838,2022,3,NCAAF_20220917_ABIL@MIZZOU,Abil Christian,Wildcats,Missouri,Tigers,2-1,2-1,1.0,3,17,17,34,3,0,7,7,14,3,14,3,0.0,-14,-17,0.005923147384604088,-42.41492860057349
3839,3839,2022,3,NCAAF_20220917_CINCY@MIAOH,Cincinnati,Bearcats,Miami-OH,RedHawks,2-1,1-2,0.0,24,17,38,17,7,17,7,7,10,7,0,0,1.0,7,21,0.8476852051692184,17.3010166551843
3840,3840,2022,3,NCAAF_20220917_LIUPOST@KENTST,LIU,,Kent St.,,0-3,1-2,,10,35,10,63,7,3,0,0,7,28,14,14,-1.0,-25,-53,0.030875936446618013,-31.483489978301463
3841,3841,2022,3,NCAAF_20220917_NOVA@ARMY,Villanova,Wildcats,Army,Black Knights,2-2,1-2,1.0,7,21,10,49,7,0,3,0,14,7,7,21,1.0,-14,-39,0.41235611550274,-3.7328437570462256
3842,3842,2022,3,NCAAF_20220917_OKLA@NEB,Oklahoma,Sooners,Nebraska,Cornhuskers,3-1,1-3,1.0,35,7,49,14,14,21,14,0,7,0,0,7,2.0,28,35,0.8427729848988273,16.953229868046947
3843,3843,2022,3,NCAAF_20220917_PURDUE@CUSE,Purdue,Boilermakers,Syracuse,Orange,1-2,3-0,0.0,9,3,29,32,6,3,0,20,3,0,7,22,-2.0,6,-3,0.7420174792418437,10.947629541891388
3844,3844,2022,3,NCAAF_20220917_SIL@NWEST,S. Illinois,Salukis,Northwestern,Wildcats,1-2,1-2,1.0,14,14,31,24,0,14,3,14,7,7,0,10,0.0,0,7,0.14763756132646066,-17.639155607336193
3845,3845,2022,3,NCAAF_20220917_TXSTSM@BAYLOR,Texas St.,Bobcats,Baylor,Bears,1-2,2-1,0.0,7,21,7,42,0,7,0,0,7,14,7,14,-1.0,-14,-35,0.0393965640570032,-29.62385911682486
3846,3846,2022,3,NCAAF_20220917_UCONN@MICH,UConn,Huskies,Michigan,Wolverines,1-3,3-0,0.0,0,38,0,59,0,0,0,0,17,21,7,14,-2.0,-38,-59,0.0012044333660898854,-51.142828526048675
3847,3847,2022,3,NCAAF_20220917_UGA@SC,Georgia,Bulldogs,South Carolina,Gamecocks,3-0,1-2,0.0,24,0,48,7,14,10,21,3,0,0,0,7,2.0,24,41,0.922513986553956,23.968763603009393
3848,3848,2022,3,NCAAF_20220917_YST@UK,Youngstown St.,Penguins,Kentucky,Wildcats,2-1,4-0,0.0,0,21,0,31,0,0,0,0,0,21,7,3,-2.0,-21,-31,0.03188028345072258,-31.24378701575131
3849,3849,2022,3,NCAAF_20220917_BUCK@CMICH,Bucknell,Bison,C. Michigan,Chippewas,0-3,1-3,1.0,0,7,0,41,0,0,0,0,0,7,13,21,-1.0,-7,-41,0.0036505263985542324,-45.21430726588653
3850,3850,2022,3,NCAAF_20220917_BUFF@CSTCAR,Buffalo,Bulls,C. Carolina,Chanticleers,0-3,3-0,0.0,16,14,26,38,6,10,3,7,7,7,3,21,-3.0,2,-12,0.5580383512951932,2.46056390132037
3851,3851,2022,3,NCAAF_20220917_TWST@WVU,Towson,Tigers,West Virginia,Mountaineers,2-1,1-2,0.0,7,45,7,65,7,0,0,0,21,24,6,14,1.0,-38,-58,0.010609697206021451,-38.83133946042631
3852,3852,2022,3,NCAAF_20220917_MURYST@BALLST,Murray St.,Racers,Ball St.,Cardinals,0-3,1-2,1.0,0,14,0,31,0,0,0,0,7,7,10,7,-1.0,-14,-31,0.1047292383328835,-21.1520296747683
3853,3853,2022,3,NCAAF_20220917_ODU@UVA,Old Dominion,Monarchs,Virginia,Cavaliers,1-2,2-1,0.0,7,10,14,16,0,7,0,7,7,3,0,6,-1.0,-3,-2,0.09279992931539605,-22.309064488473837
3854,3854,2022,3,NCAAF_20220917_OHIO@IOWAST,Ohio,Bobcats,Iowa St.,Cyclones,1-2,3-0,0.0,3,30,10,43,0,3,7,0,14,16,7,6,-2.0,-27,-33,0.09803532776465895,-21.788615575065023
3855,3855,2022,3,NCAAF_20220917_RUT@TEMPLE,Rutgers,Scarlet Knights,Temple,Owls,3-0,1-2,1.0,10,7,16,14,3,7,3,3,7,0,0,7,2.0,3,2,0.6159288019382614,4.96849319710293
3856,3856,2022,3,NCAAF_20220917_SALA@UCLA,South Alabama,Jaguars,UCLA,Bruins,2-1,3-0,1.0,17,13,31,32,10,7,14,0,6,7,10,9,-1.0,4,-1,0.09134236334641277,-22.457806432629354
3857,3857,2022,3,NCAAF_20220917_CAL@ND,California,Golden Bears,Notre Dame,Fighting Irish,2-1,1-2,0.0,10,7,17,24,0,10,7,0,0,7,7,10,1.0,3,-7,0.15092233172347091,-17.40095215495444
3858,3858,2022,3,NCAAF_20220917_NTEXAS@UNLV,North Texas,Mean Green,UNLV,Rebels,2-2,2-1,0.0,20,23,27,58,10,10,7,0,9,14,14,21,0.0,-3,-31,0.6096220943638339,4.690893649842906
3859,3859,2022,3,NCAAF_20220917_TULANE@KSTATE,Tulane,Green Wave,Kansas State,Wildcats,3-0,2-1,1.0,7,10,17,10,7,0,3,7,0,10,0,0,1.0,-3,7,0.2623274065320137,-10.721943038241989
3860,3860,2022,3,NCAAF_20220917_BYU@OREG,BYU,Cougars,Oregon,Ducks,2-1,2-1,1.0,7,24,20,41,0,7,0,13,10,14,14,3,0.0,-17,-21,0.28228148449219614,-9.708892874139337
3861,3861,2022,3,NCAAF_20220917_COLO@MINN,Colorado,Buffaloes,Minnesota,Golden Gophers,0-3,3-0,0.0,0,35,7,49,0,0,0,7,14,21,7,7,-3.0,-35,-42,0.21552077495431843,-13.270590151559645
3862,3862,2022,3,NCAAF_20220917_GAS@UAB,Ga. Southern,Eagles,UAB,Blazers,3-1,2-1,1.0,7,21,21,35,0,7,7,7,7,14,0,14,1.0,-14,-14,0.35216372816871677,-6.395640421243684
3863,3863,2022,3,NCAAF_20220917_MISS@GATECH,Ole Miss,Rebels,Georgia Tech,Yellow Jackets,3-0,1-2,1.0,21,0,42,0,14,7,21,0,0,0,0,0,2.0,21,42,0.7045186695538606,9.05774752318132
3864,3864,2022,3,NCAAF_20220917_NMEXST@WISC,New Mexico St.,Aggies,Wisconsin,Badgers,0-4,2-1,0.0,0,35,7,66,0,0,0,7,7,28,21,10,-2.0,-35,-59,0.005110560302183154,-43.284015769606185
3865,3865,2022,3,NCAAF_20220917_PSU@AUBURN,Penn State,Nittany Lions,Auburn,Tigers,3-0,2-1,1.0,14,6,41,12,7,7,17,10,3,3,0,6,1.0,8,29,0.63557116025879,5.842174409409267
3866,3866,2022,3,NCAAF_20220917_STONYBRK@UMASS,Stony Brook,,UMass,,0-2,1-2,,3,17,3,20,0,3,0,0,7,10,3,0,-1.0,-14,-17,0.37558443550528,-5.344205614243037
3867,3867,2022,3,NCAAF_20220917_TROY@APLST,Troy,Trojans,App. St.,Mountaineers,1-2,2-1,1.0,21,14,28,32,7,14,0,7,7,7,10,8,-1.0,7,-4,0.22280063833188413,-12.855291240530278
3868,3868,2022,3,NCAAF_20220917_VANDY@NILL,Vanderbilt,Commodores,N. Illinois,Huskies,3-1,1-2,1.0,14,21,38,28,7,7,21,3,7,14,7,0,2.0,-7,10,0.548366934854911,2.048309608197883
3869,3869,2022,3,NCAAF_20220917_KANSAS@HOU,Kansas,Jayhawks,Houston,Cougars,3-0,1-2,1.0,28,14,48,30,14,14,14,6,14,0,13,3,2.0,14,18,0.20966188926064444,-13.610766875960508
3870,3870,2022,3,NCAAF_20220917_LAMON@BAMA,UL-Monroe,Warhawks,Alabama,Crimson Tide,1-2,3-0,0.0,7,35,7,63,0,7,0,0,28,7,14,14,-2.0,-28,-56,0.0006511333189112012,-54.19194894105601
3871,3871,2022,3,NCAAF_20220917_TNMART@BOISE,UT Martin,Skyhawks,Boise St.,Broncos,1-2,2-1,1.0,7,20,7,30,7,0,0,0,7,13,0,10,-1.0,-13,-23,0.009463389613410644,-39.554556718317485
3872,3872,2022,3,NCAAF_20220917_COLOST@WASHST,Colorado St.,Rams,Washington St.,Cougars,0-3,3-0,1.0,0,28,7,38,0,0,0,7,21,7,3,7,-3.0,-28,-31,0.15639283822795225,-17.01177926893581
3873,3873,2022,3,NCAAF_20220917_LIB@WAKE,Liberty,Flames,Wake Forest,Demon Deacons,2-1,3-0,1.0,8,20,36,37,0,8,15,13,3,17,0,17,-1.0,-12,-1,0.22993860499178798,-12.455531146553426
3874,3874,2022,3,NCAAF_20220917_CAMP@ECU,Campbell,,East Carolina,,1-2,2-2,,10,21,10,49,10,0,0,0,7,14,21,7,-1.0,-11,-39,0.08526643395984479,-23.09755455150571
3875,3875,2022,3,NCAAF_20220917_MISSST@LSU,Miss. State,Bulldogs,LSU,Tigers,2-1,2-1,0.0,13,7,16,31,6,7,3,0,0,7,3,21,0.0,6,-15,0.4013083700157901,-4.2127236083046
3876,3876,2022,3,NCAAF_20220917_NCAT@DUKE,NC A&T,Aggies,Duke,Blue Devils,0-3,3-0,0.0,6,28,20,49,0,6,0,14,21,7,14,7,-3.0,-22,-29,0.07729165523492432,-23.991358025000523
3877,3877,2022,3,NCAAF_20220917_AKRON@TENN,Akron,Zips,Tennessee,Volunteers,1-2,3-0,0.0,0,35,6,63,0,0,3,3,14,21,14,14,-2.0,-35,-57,0.03823698716359303,-29.85626532480876
3878,3878,2022,3,NCAAF_20220917_ARKST@MEMP,Arkansas St.,Red Wolves,Memphis,Tigers,1-2,2-1,0.0,17,21,32,44,7,10,0,15,7,14,0,23,-1.0,-4,-12,0.20706874488220517,-13.76310944262957
3879,3879,2022,3,NCAAF_20220917_ARPB@OKLAST,Ark.-Pine Bluff,Golden Lions,Oklahoma State,Cowboys,2-2,3-0,0.0,7,49,7,63,0,7,0,0,28,21,7,7,-1.0,-42,-56,3.9313136709240304e-05,-66.54670157012129
3880,3880,2022,3,NCAAF_20220917_CHARLO@GAST,Charlotte,49ers,Georgia St.,Panthers,1-3,0-3,0.0,21,20,42,41,7,14,7,14,14,6,7,14,1.0,1,1,0.3600864463665393,-6.037375575056103
3881,3881,2022,3,NCAAF_20220917_JAXST@TULSA,Jacksonville St.,,Tulsa,,3-1,2-1,,3,40,17,54,0,3,7,7,12,28,7,7,1.0,-37,-37,0.24880524391336345,-11.43092887789146
3882,3882,2022,3,NCAAF_20220917_MOST@ARK,Missouri St.,Bears,Arkansas,Razorbacks,2-1,3-0,1.0,17,14,27,38,7,10,7,3,0,14,3,21,-1.0,3,-11,0.09337535735625735,-22.250818855593252
3883,3883,2022,3,NCAAF_20220917_NWST@USM,Northwestern St.,,So. Miss,,0-3,1-2,,0,41,10,64,0,0,10,0,13,28,16,7,-1.0,-41,-54,0.06605231937949185,-25.37884618245016
3884,3884,2022,3,NCAAF_20220917_TNST@MTSU,Tennessee St.,,Middle Tenn.,,0-3,3-1,,0,42,6,49,0,0,6,0,21,21,7,0,-3.0,-42,-43,0.2788924795638268,-9.878396706734065
3885,3885,2022,3,NCAAF_20220917_TOLEDO@OHIOST,Toledo,Rockets,Ohio State,Buckeyes,2-1,3-0,0.0,14,42,21,77,7,7,7,0,28,14,14,21,-1.0,-28,-56,0.01473781473724689,-36.691090384401946
3886,3886,2022,3,NCAAF_20220917_TXTECH@NCST,Texas Tech,Red Raiders,NC State,Wolfpack,2-1,3-0,1.0,7,20,14,27,0,7,0,7,6,14,0,7,-1.0,-13,-13,0.4677747537738537,-1.3628506776962013
3887,3887,2022,3,NCAAF_20220917_ME@BC,Maine,Black Bears,Boston College,Eagles,0-3,1-3,0.0,10,28,17,38,10,0,7,0,14,14,3,7,-1.0,-18,-21,0.038243361663012454,-29.85497212278449
3888,3888,2022,3,NCAAF_20220917_MICHST@WASH,Michigan St.,Spartans,Washington,Huskies,2-1,3-0,0.0,8,29,28,39,0,8,6,14,9,20,7,3,-1.0,-21,-11,0.41199966526638343,-3.748277616454857
3889,3889,2022,3,NCAAF_20220917_NEVADA@IOWA,Nevada,Wolf Pack,Iowa,Hawkeyes,2-2,2-1,0.0,0,17,0,27,0,0,0,0,14,3,3,7,0.0,-17,-27,0.06571702082592235,-25.422949252909802
3890,3890,2022,3,NCAAF_20220917_PITT@WMICH,Pittsburgh,Panthers,W. Michigan,Broncos,2-1,1-2,1.0,13,6,34,13,10,3,7,14,3,3,7,0,1.0,7,21,0.7935901906378591,13.80200007476003
3891,3891,2022,3,NCAAF_20220917_SFLA@FLA,South Florida,Bulls,Florida,Gators,1-2,2-1,1.0,13,24,28,31,7,6,8,7,3,21,0,7,-1.0,-11,-3,0.07560729897797824,-24.188998783363104
3892,3892,2022,3,NCAAF_20220917_SMU@MD,SMU,Mustangs,Maryland,Terrapins,2-1,3-0,1.0,20,17,27,34,6,14,7,0,3,14,3,14,-1.0,3,-7,0.536837106067336,1.5584144719239248
3893,3893,2022,3,NCAAF_20220917_UCF@FAU,UCF,Knights,FAU,Owls,2-1,2-2,0.0,16,14,40,14,7,9,14,10,14,0,0,0,0.0,2,26,0.7964094998083229,13.969234365192165
3894,3894,2022,3,NCAAF_20220917_UL@RICE,Louisiana,Ragin' Cajuns,Rice,Owls,2-1,2-1,1.0,14,13,21,33,7,7,0,7,3,10,6,14,0.0,1,-12,0.8779632203097544,19.632005138289742
3895,3895,2022,3,NCAAF_20220917_LATECH@CLEM,Louisiana Tech,Bulldogs,Clemson,Tigers,1-2,3-0,0.0,6,13,20,48,0,6,0,14,10,3,21,14,-2.0,-7,-28,0.011023292145737718,-38.58707308401165
3896,3896,2022,3,NCAAF_20220917_MTST@OREGST,Montana St.,Bobcats,Oregon State,Beavers,2-1,3-0,0.0,14,34,28,68,7,7,7,7,7,27,20,14,-1.0,-20,-40,0.16965840740616955,-16.103747494890854
3897,3897,2022,3,NCAAF_20220917_TXSA@TEXAS,UTSA,Roadrunners,Texas,Longhorns,1-2,2-1,0.0,17,17,20,41,3,14,3,0,0,17,14,10,-1.0,0,-21,0.052169573618703224,-27.372908888401753
3898,3898,2022,3,NCAAF_20220917_UTEP@NMEX,UTEP,Miners,New Mexico,Lobos,1-3,2-1,0.0,3,20,10,27,3,0,0,7,10,10,0,7,-1.0,-17,-17,0.3305926245264339,-7.3864881334556
3899,3899,2022,3,NCAAF_20220917_MIAMI@TXAM,Miami (Fla.),Hurricanes,Texas A&M,Aggies,2-1,2-1,0.0,3,10,9,17,3,0,3,3,10,0,7,0,0.0,-7,-8,0.4222030733411526,-3.3076706053600446
3900,3900,2022,3,NCAAF_20220917_SDGST@UTAH,San Diego St.,Aztecs,Utah,Utes,1-2,2-1,0.0,0,21,7,35,0,0,0,7,0,21,14,0,-1.0,-21,-28,0.18281434421429377,-15.247183879134582
3901,3901,2022,3,NCAAF_20220917_FRESNO@USC,Fresno St.,Bulldogs,USC,Trojans,1-2,4-0,0.0,10,21,17,45,0,10,7,0,14,7,14,10,-3.0,-11,-28,0.3512806679743894,-6.435748967703148
3902,3902,2022,3,NCAAF_20220917_EMICH@ARIZST,E. Michigan,Eagles,Arizona St.,Sun Devils,2-1,1-2,1.0,24,14,30,21,10,14,3,3,0,14,0,7,1.0,10,9,0.1718216948147282,-15.960070858010226
3903,3903,2022,3,NCAAF_20220917_NDST@ARIZ,N. Dakota St.,Bison,Arizona,Wildcats,2-1,2-1,0.0,14,17,28,31,7,7,14,0,7,10,7,7,0.0,-3,-3,,
3904,3904,2022,3,NCAAF_20220917_DUQ@HAWAII,Duquesne,,Hawaii,,1-3,1-3,,6,14,14,24,3,3,0,8,7,7,0,10,0.0,-8,-10,0.20696839454288773,-13.769027425192348
3905,3905,2022,3,NCAAF_20220916_FSU@LVILLE,Florida State,Seminoles,Louisville,Cardinals,3-0,1-2,0.0,14,21,35,31,14,0,7,14,14,7,0,10,2.0,-7,4,0.49272545564102077,-0.307332710097171
3906,3906,2022,3,NCAAF_20220916_AF@WYO,Air Force,Falcons,Wyoming,Cowboys,2-1,3-1,0.0,0,10,14,17,0,0,7,7,3,7,0,7,-1.0,-10,-3,0.6586443146683199,6.889120543953936
3907,3907,2022,4,NCAAF_20220924_BAYLOR@IOWAST,Baylor,Bears,Iowa St.,Cyclones,3-1,3-1,1.0,17,14,31,24,7,10,7,7,7,7,0,10,0.0,3,7,0.3035234227879191,-8.662582347833904
3908,3908,2022,4,NCAAF_20220924_BGREEN@MISSST,Bowling Green,Falcons,Miss. State,Bulldogs,1-3,3-1,0.0,7,31,14,45,0,7,0,7,17,14,7,7,-2.0,-24,-31,0.010664235304348124,-38.77610031181257
3909,3909,2022,4,NCAAF_20220924_BUFF@EMICH,Buffalo,Bulls,E. Michigan,Eagles,1-3,2-2,1.0,30,24,50,31,13,17,10,10,14,10,7,0,-1.0,6,19,0.5579487113666763,2.4553080351611243
3910,3910,2022,4,NCAAF_20220924_CMICH@PSU,C. Michigan,Chippewas,Penn State,Nittany Lions,1-3,4-0,1.0,14,21,14,33,0,14,0,0,14,7,6,6,-3.0,-7,-19,0.023731501645883668,-33.386572169256624
3911,3911,2022,4,NCAAF_20220924_DUKE@KANSAS,Duke,Blue Devils,Kansas,Jayhawks,3-1,4-0,0.0,13,21,27,35,7,6,0,14,7,14,7,7,-1.0,-8,-8,0.663757740774857,7.120497940483119
3912,3912,2022,4,NCAAF_20220924_KENTST@UGA,Kent St.,Golden Flashes,Georgia,Bulldogs,1-3,4-0,0.0,13,26,22,39,3,10,3,6,12,14,6,7,-3.0,-13,-17,0.003234615867451107,-45.865255703474304
3913,3913,2022,4,NCAAF_20220924_MD@MICH,Maryland,Terrapins,Michigan,Wolverines,3-1,4-0,0.0,13,17,27,34,10,3,0,14,10,7,0,17,-1.0,-4,-7,0.06967792620748536,-24.898193162712914
3914,3914,2022,4,NCAAF_20220924_RI@PITT,Rhode Island,Rams,Pittsburgh,Panthers,2-2,3-1,1.0,14,24,24,45,7,7,3,7,14,10,7,14,-1.0,-10,-21,0.04083506161269457,-29.326099877279603
3915,3915,2022,4,NCAAF_20220924_SFLA@LVILLE,South Florida,Bulls,Louisville,Cardinals,1-3,2-2,0.0,0,28,3,41,0,0,0,3,14,14,3,10,-1.0,-28,-38,0.2545531042550133,-11.120688574545284
3916,3916,2022,4,NCAAF_20220924_TCU@SMU,TCU,Horned Frogs,SMU,Mustangs,3-0,2-2,1.0,28,14,42,34,14,14,0,14,0,14,7,13,1.0,14,8,0.7069303794415476,9.17034801760019
3917,3917,2022,4,NCAAF_20220924_FORD@OHIO,Fordham,Rams,Ohio,Bobcats,3-1,2-2,0.0,21,31,52,59,0,21,28,3,14,17,7,21,1.0,-10,-7,0.012142080897905694,-37.94208030709865
3918,3918,2022,4,NCAAF_20220924_UCLA@COLO,UCLA,Bruins,Colorado,Buffaloes,4-0,0-4,0.0,21,10,45,17,14,7,17,7,0,10,0,7,4.0,11,28,0.6484564969188512,6.420072049392047
3919,3919,2022,4,NCAAF_20220924_UMASS@TEMPLE,UMass,Minutemen,Temple,Owls,1-3,2-2,1.0,0,7,0,28,0,0,0,0,0,7,14,7,-1.0,-7,-28,0.11769361668023515,-19.986606683382888
3920,3920,2022,4,NCAAF_20220924_FIU@WKY,FIU,Panthers,W. Kentucky,Hilltoppers,1-2,3-1,1.0,0,42,0,73,0,0,0,0,14,28,17,14,-2.0,-42,-73,0.30049732317738487,-8.808739016318441
3921,3921,2022,4,NCAAF_20220924_FLA@TENN,Florida,Gators,Tennessee,Volunteers,3-2,4-0,1.0,14,17,33,38,0,14,7,12,3,14,14,7,-1.0,-3,-5,0.7151349390103234,9.574760090945801
3922,3922,2022,4,NCAAF_20220924_IND@CINCY,Indiana,Hoosiers,Cincinnati,Bearcats,3-1,3-1,1.0,10,38,24,45,3,7,7,7,10,28,0,7,0.0,-28,-21,0.44721681695506343,-2.23508958396701
3923,3923,2022,4,NCAAF_20220924_JMAD@APLST,James Madison,,App. St.,,3-0,2-2,,10,28,32,28,3,7,7,15,0,28,0,0,1.0,-18,4,0.7167775841285435,9.656387788881375
3924,3924,2022,4,NCAAF_20220924_MINN@MICHST,Minnesota,Golden Gophers,Michigan St.,Spartans,4-0,2-2,1.0,17,0,34,7,14,3,7,10,0,0,0,7,2.0,17,27,0.5466070538499671,1.9722842021790257
3925,3925,2022,4,NCAAF_20220924_MTSU@MIAMI,Middle Tenn.,Blue Raiders,Miami (Fla.),Hurricanes,3-2,2-2,1.0,24,10,45,31,17,7,7,14,3,7,7,14,1.0,14,14,0.12739870039157664,-19.181119792680875
3926,3926,2022,4,NCAAF_20220924_ND@UNC,Notre Dame,Fighting Irish,North Carolina,Tar Heels,2-2,4-1,0.0,24,14,45,32,0,24,14,7,7,7,6,12,-2.0,10,13,0.8305275743506241,16.10678346011605
3927,3927,2022,4,NCAAF_20220924_NTEXAS@MEMP,North Texas,Mean Green,Memphis,Tigers,2-3,3-1,0.0,13,20,34,44,10,3,7,14,6,14,7,17,-1.0,-7,-10,0.17214116293412074,-15.9296835047262
3928,3928,2022,4,NCAAF_20220924_TOLEDO@SDGST,Toledo,Rockets,San Diego St.,Aztecs,2-2,2-2,0.0,0,7,14,17,0,0,0,14,0,7,3,7,0.0,-7,-3,0.4050679513950126,-4.046700574727083
3929,3929,2022,4,NCAAF_20220924_TXSO@TXSA,Texas Southern,Tigers,UTSA,Roadrunners,1-3,2-2,1.0,17,21,24,52,7,10,7,0,14,7,14,17,-1.0,-4,-28,0.01401052851207929,-37.00537038266771
3930,3930,2022,4,NCAAF_20220924_GATECH@UCF,Georgia Tech,Yellow Jackets,UCF,Knights,1-3,3-1,0.0,7,13,10,27,0,7,3,0,3,10,3,11,-2.0,-6,-17,0.20829062896349027,-13.683225766308396
3931,3931,2022,4,NCAAF_20220924_OREG@WASHST,Oregon,Ducks,Washington St.,Cougars,3-1,3-1,0.0,9,17,44,41,3,6,6,29,10,7,10,14,0.0,-8,3,0.6001503203359021,4.273845656699677
3932,3932,2022,4,NCAAF_20220924_SACST@COLOST,Sacramento St.,,Colorado St.,,4-0,0-4,,24,10,41,10,7,17,7,10,0,10,0,0,4.0,14,31,0.31593626054934965,-8.069676940154295
3933,3933,2022,4,NCAAF_20220924_TULSA@MISS,Tulsa,Golden Hurricane,Ole Miss,Rebels,2-2,4-0,0.0,17,35,27,35,14,3,3,7,7,28,0,0,-2.0,-18,-8,0.22521509475872414,-12.71187473953023
3934,3934,2022,4,NCAAF_20220924_ARIZ@CAL,Arizona,Wildcats,California,Golden Bears,2-2,3-1,0.0,24,21,31,49,14,10,0,7,7,14,14,14,-1.0,3,-18,0.354093573268083,-6.304444636321932
3935,3935,2022,4,NCAAF_20220924_AKRON@LIB,Akron,Zips,Liberty,Flames,1-3,3-1,1.0,3,14,12,21,0,3,3,6,7,7,0,7,-2.0,-11,-9,0.12006548204591105,-19.78556190064728
3936,3936,2022,4,NCAAF_20220924_ARKST@ODU,Arkansas St.,Red Wolves,Old Dominion,Monarchs,1-3,2-2,1.0,12,0,26,29,0,12,7,7,0,0,21,8,-1.0,12,-3,0.6949498107361352,8.589089021548034
3937,3937,2022,4,NCAAF_20220924_BALLST@GAS,Ball St.,Cardinals,Ga. Southern,Eagles,1-3,3-1,0.0,10,13,23,34,3,7,10,3,3,10,7,14,-2.0,-3,-11,0.42862976487942306,-3.0295634107753813
3938,3938,2022,4,NCAAF_20220924_RICE@HOU,Rice,Owls,Houston,Cougars,2-2,2-2,1.0,14,10,27,34,0,14,10,3,7,3,14,10,0.0,4,-7,0.0893090084439696,-22.65509513646475
3939,3939,2022,4,NCAAF_20220924_ARK@TXAM,Arkansas,Razorbacks,Texas A&M,Aggies,3-1,3-1,1.0,14,13,21,23,14,0,0,7,0,13,10,0,0.0,1,-2,0.20052254018417848,-14.144565874371665
3940,3940,2022,4,NCAAF_20220924_HOUBP@TXSTSM,Houston Christian,Huskies,Texas St.,Bobcats,1-2,2-2,0.0,0,24,0,34,0,0,0,0,7,17,3,7,-1.0,-24,-34,0.3724368633895381,-5.481029016355478
3941,3941,2022,4,NCAAF_20220924_IOWA@RUT,Iowa,Hawkeyes,Rutgers,Scarlet Knights,3-1,3-1,0.0,17,3,27,10,7,10,7,3,3,0,0,7,0.0,14,17,0.9241267420431378,24.1435235377337
3942,3942,2022,4,NCAAF_20220924_LATECH@SALA,Louisiana Tech,Bulldogs,South Alabama,Jaguars,1-3,4-1,0.0,7,17,14,38,0,7,0,7,14,3,14,7,-3.0,-10,-24,0.6657438610617225,7.212297485436466
3943,3943,2022,4,NCAAF_20220924_MRSHL@TROY,Marshall,Thundering Herd,Troy,Trojans,2-2,2-2,0.0,0,10,7,16,0,0,7,0,10,0,0,6,0.0,-10,-9,0.6556318315312276,6.747072830309207
3944,3944,2022,4,NCAAF_20220924_NILL@UK,N. Illinois,Huskies,Kentucky,Wildcats,1-3,4-0,1.0,14,14,23,31,7,7,0,9,7,7,10,7,-3.0,0,-8,0.1360769426640165,-18.49628749009139
3945,3945,2022,4,NCAAF_20220924_UNLV@UTAHST,UNLV,Rebels,Utah St.,Aggies,3-1,1-3,1.0,27,16,34,24,14,13,7,0,7,9,0,8,2.0,11,10,0.20580387746413176,-13.82978129931962
3946,3946,2022,4,NCAAF_20220924_USM@TULANE,So. Miss,Golden Eagles,Tulane,Green Wave,2-2,4-1,1.0,10,17,27,24,0,10,7,10,7,10,0,7,-2.0,-7,3,0.2576413073608621,-10.959060166221889
3947,3947,2022,4,NCAAF_20220924_CHARLO@SC,Charlotte,49ers,South Carolina,Gamecocks,1-4,2-2,0.0,14,20,20,56,7,7,0,6,3,17,22,14,-1.0,-6,-36,0.08260255975366781,-23.375230995928177
3948,3948,2022,4,NCAAF_20220924_FAU@PURDUE,FAU,Owls,Purdue,Boilermakers,2-3,2-2,0.0,13,14,26,28,0,13,7,6,7,7,7,7,0.0,-1,-2,0.20618158805570164,-13.807453829753968
3949,3949,2022,4,NCAAF_20220924_MIAOH@NWEST,Miami-OH,RedHawks,Northwestern,Wildcats,2-2,1-3,1.0,7,7,17,14,0,7,0,10,7,0,0,7,1.0,0,3,0.20525828979818406,-13.862075398826164
3950,3950,2022,4,NCAAF_20220924_NMEX@LSU,New Mexico,Lobos,LSU,Tigers,2-2,3-1,1.0,0,17,0,38,0,0,0,0,10,7,14,7,-1.0,-17,-38,0.021475618303978483,-34.09465881705637
3951,3951,2022,4,NCAAF_20220924_UCONN@NCST,UConn,Huskies,NC State,Wolfpack,1-4,4-0,0.0,3,31,10,41,0,3,0,7,17,14,7,3,-3.0,-28,-31,0.024585908418745972,-33.13313817499284
3952,3952,2022,4,NCAAF_20220924_VANDY@BAMA,Vanderbilt,Commodores,Alabama,Crimson Tide,3-2,5-0,0.0,3,31,3,55,3,0,0,0,14,17,10,14,-2.0,-28,-52,0.006982260421085296,-41.40465219744124
3953,3953,2022,4,NCAAF_20220924_WISC@OHIOST,Wisconsin,Badgers,Ohio State,Buckeyes,2-2,4-0,0.0,7,31,21,52,0,7,0,14,21,10,14,7,-2.0,-24,-31,0.24108843364123556,-11.837817536574448
3954,3954,2022,4,NCAAF_20220924_BC@FSU,Boston College,Eagles,Florida State,Seminoles,1-3,4-0,1.0,0,31,14,44,0,0,7,7,21,10,6,7,-3.0,-31,-30,0.527979040366847,1.1822671684237775
3955,3955,2022,4,NCAAF_20220924_HAWAII@NMEXST,Hawaii,Rainbow Warriors,New Mexico St.,Aggies,1-4,1-5,1.0,10,35,26,45,7,3,7,9,14,21,7,3,0.0,-25,-19,0.7110709145547075,9.373764345127256
3956,3956,2022,4,NCAAF_20220924_KSTATE@OKLA,Kansas State,Wildcats,Oklahoma,Sooners,3-1,3-1,1.0,24,17,41,34,14,10,3,14,7,10,3,14,0.0,7,7,0.19072872755167136,-14.74180510146698
3957,3957,2022,4,NCAAF_20220924_UL@LAMON,Louisiana,Ragin' Cajuns,UL-Monroe,Warhawks,2-2,2-2,0.0,17,7,17,21,14,3,0,0,7,0,0,14,0.0,10,-4,0.8474656555891418,17.275264638907174
3958,3958,2022,4,NCAAF_20220924_USC@OREGST,USC,Trojans,Oregon State,Beavers,4-0,3-1,1.0,3,7,17,14,0,3,0,14,0,7,0,7,1.0,-4,3,0.7717758157724575,12.54360315121994
3959,3959,2022,4,NCAAF_20220924_WYO@BYU,Wyoming,Cowboys,BYU,Cougars,3-2,3-1,0.0,10,14,24,38,3,7,0,14,7,7,14,10,0.0,-4,-14,0.31579058391346637,-8.076576170808039
3960,3960,2022,4,NCAAF_20220924_STNFRD@WASH,Stanford,Cardinal,Washington,Huskies,1-2,4-0,1.0,7,17,22,40,0,7,0,15,7,10,13,10,-3.0,-10,-18,0.29117950082250477,-9.263038203325777
3961,3961,2022,4,NCAAF_20220924_UTAH@ARIZST,Utah,Utes,Arizona St.,Sun Devils,3-1,1-3,1.0,24,6,34,13,14,10,7,3,0,6,0,7,2.0,18,21,0.7096709973687378,9.304837571783992
3962,3962,2022,4,NCAAF_20220924_WMICH@SJST,W. Michigan,Broncos,San Jose St.,Spartans,1-3,2-1,0.0,0,17,6,34,0,0,6,0,3,14,7,10,-1.0,-17,-28,0.6978039856213684,8.726613506625654
3963,3963,2022,4,NCAAF_20220923_UVA@CUSE,Virginia,Cavaliers,Syracuse,Orange,2-2,4-0,0.0,0,16,20,22,0,0,13,7,10,6,3,3,-2.0,-16,-2,0.5749844211406159,3.1847762878521735
3964,3964,2022,4,NCAAF_20220923_NEVADA@AF,Nevada,,Air Force,,2-3,4-1,,7,24,20,48,0,7,0,13,10,14,17,7,-2.0,-17,-28,0.30338846028940714,-8.669086901860283
3965,3965,2022,4,NCAAF_20220923_BOISE@UTEP,Boise St.,Broncos,UTEP,Miners,2-2,2-3,0.0,3,10,10,27,3,0,7,0,0,10,10,7,0.0,-7,-17,0.9725178099425604,32.32563388970311
3966,3966,2022,4,NCAAF_20220922_CSTCAR@GAST,C. Carolina,Chanticleers,Georgia St.,Panthers,4-0,0-4,1.0,27,17,41,24,21,6,7,7,7,10,0,7,4.0,10,17,0.6307725257990401,5.624098667099361
3967,3967,2022,4,NCAAF_20220922_WVU@VATECH,West Virginia,Mountaineers,Virginia Tech,Hokies,2-2,2-2,1.0,13,7,33,10,3,10,3,17,0,7,3,0,0.0,6,23,0.5825266843782387,3.5095714487069927
3968,3968,2022,4,NCAAF_20220922_TNCHAT@ILL,Chattanooga,Mocs,Illinois,Fighting Illini,3-1,3-1,1.0,0,24,0,31,0,0,0,0,10,14,7,0,0.0,-24,-31,0.13453212101968248,-18.615947786662673
3969,3969,2022,5,NCAAF_20221002_EWASH@FLA,E. Washington,Eagles,Florida,Gators,1-3,3-2,1.0,3,35,17,52,3,0,0,14,14,21,10,7,-2.0,-32,-35,0.00314896853821256,-46.15143793965967
3970,3970,2022,5,NCAAF_20221001_GAST@ARMY,Georgia St.,Panthers,Army,Black Knights,1-4,1-3,1.0,17,0,31,14,3,14,0,14,0,0,7,7,0.0,17,17,0.2149582625561437,-13.334880000149724
3971,3971,2022,5,NCAAF_20221001_ILL@WISC,Illinois,Fighting Illini,Wisconsin,Badgers,4-1,2-3,0.0,14,10,34,10,7,7,17,3,7,3,0,0,2.0,4,24,0.08864140886486993,-22.792619981523785
3972,3972,2022,5,NCAAF_20221001_LVILLE@BC,Louisville,Cardinals,Boston College,Eagles,2-3,2-3,1.0,23,21,33,34,7,16,10,0,7,14,7,6,0.0,2,-1,0.501962551508705,0.08310760638278225
3973,3973,2022,5,NCAAF_20221001_MICH@IOWA,Michigan,Wolverines,Iowa,Hawkeyes,5-0,3-2,1.0,13,0,27,14,7,6,7,7,0,0,0,14,2.0,13,13,0.6338643816187441,5.779476767325377
3974,3974,2022,5,NCAAF_20221001_NAVY@AF,Navy,Midshipmen,Air Force,Falcons,1-3,4-1,0.0,3,10,10,13,0,3,0,7,10,0,0,3,-3.0,-7,-3,0.36716111702078646,-5.733454784116475
3975,3975,2022,5,NCAAF_20221001_OKLA@TCU,Oklahoma,Sooners,TCU,Horned Frogs,3-2,4-0,1.0,17,41,24,55,10,7,0,7,27,14,14,0,-1.0,-24,-31,0.7742764766901459,12.72113181158079
3976,3976,2022,5,NCAAF_20221001_PURDUE@MINN,Purdue,Boilermakers,Minnesota,Golden Gophers,4-2,4-1,0.0,10,3,20,10,10,0,0,10,0,3,7,0,0.0,7,10,0.4589894603675305,-1.739724603442255
3977,3977,2022,5,NCAAF_20221001_TEMPLE@MEMP,Temple,Owls,Memphis,Tigers,2-3,4-2,0.0,3,0,3,24,0,3,0,0,0,0,7,17,-2.0,3,-21,0.19893367921353788,-14.28265174997614
3978,3978,2022,5,NCAAF_20221001_TXTECH@KSTATE,Texas Tech,Red Raiders,Kansas State,Wildcats,3-2,4-1,0.0,10,13,28,37,0,10,10,8,13,0,7,17,-1.0,-3,-9,0.4052750079695566,-4.0497294938734285
3979,3979,2022,5,NCAAF_20221001_UK@MISS,Kentucky,Wildcats,Ole Miss,Rebels,4-1,5-0,0.0,12,19,19,22,6,6,7,0,14,5,3,0,-1.0,-7,-3,0.5149485323800174,0.6331668666280166
3980,3980,2022,5,NCAAF_20221001_TXSTSM@JMAD,Texas St.,Bobcats,James Madison,Dukes,2-3,4-0,1.0,0,19,13,40,0,0,7,6,7,12,7,14,-2.0,-19,-27,0.02056845418968367,-34.499684104845755
3981,3981,2022,5,NCAAF_20221001_OREGST@UTAH,Oregon State,Beavers,Utah,Utes,3-2,4-1,1.0,13,21,16,42,7,6,3,0,14,7,14,7,-1.0,-8,-26,0.1312294889734087,-18.931189495323224
3982,3982,2022,5,NCAAF_20221001_UMASS@EMICH,UMass,Minutemen,E. Michigan,Eagles,1-4,3-2,0.0,10,0,13,20,7,3,3,0,0,0,14,6,-2.0,10,-7,0.10425193871467764,-21.247196986575545
3983,3983,2022,5,NCAAF_20221001_ECU@SFLA,East Carolina,Pirates,South Florida,Bulls,3-2,1-4,1.0,41,7,48,28,14,27,7,0,0,7,14,7,2.0,34,20,0.4445368047731454,-2.356292087043812
3984,3984,2022,5,NCAAF_20221001_BAMA@ARK,Alabama,Crimson Tide,Arkansas,Razorbacks,5-0,3-2,1.0,28,7,49,26,14,14,0,21,0,7,16,3,2.0,21,23,0.9805570403360259,34.8923746741018
3985,3985,2022,5,NCAAF_20221001_BGREEN@AKRON,Bowling Green,Falcons,Akron,Zips,2-3,1-4,1.0,24,14,31,28,10,14,0,7,7,7,7,7,1.0,10,3,0.4827485289469342,-0.7307679839893808
3986,3986,2022,5,NCAAF_20221001_CIT@APLST,The Citadel,Bulldogs,App. St.,Mountaineers,1-3,3-2,0.0,0,35,0,49,0,0,0,0,14,21,7,7,-2.0,-35,-49,0.05669089755492274,-26.74586771139684
3987,3987,2022,5,NCAAF_20221001_CMICH@TOLEDO,C. Michigan,Chippewas,Toledo,Rockets,1-4,3-2,1.0,3,31,17,38,3,0,8,6,3,28,0,7,-2.0,-28,-21,0.3937661437886295,-4.553164035988857
3988,3988,2022,5,NCAAF_20221001_FRESNO@UCONN,Fresno St.,Bulldogs,UConn,Huskies,1-3,2-4,0.0,7,6,14,19,0,7,7,0,3,3,6,7,-1.0,1,-5,0.9538831982556322,28.444664626141503
3989,3989,2022,5,NCAAF_20221001_GRDWB@MRSHL,Gardner-Webb,Runnin' Bulldogs,Marshall,Thundering Herd,2-4,3-2,0.0,7,14,7,28,7,0,0,0,7,7,7,7,-1.0,-7,-21,0.017746393852458686,-35.52249681194735
3990,3990,2022,5,NCAAF_20221001_IOWAST@KANSAS,Iowa St.,Cyclones,Kansas,Jayhawks,3-2,5-0,1.0,8,14,11,14,0,8,3,0,0,14,0,0,-2.0,-6,-3,0.9466448559426809,27.25240306370756
3991,3991,2022,5,NCAAF_20221001_MIAOH@BUFF,Miami-OH,RedHawks,Buffalo,Bulls,2-3,2-3,1.0,10,14,20,24,7,3,10,0,7,7,3,7,0.0,-4,-4,0.43109045811827107,-2.932744939669192
3992,3992,2022,5,NCAAF_20221001_MICHST@MD,Michigan St.,Spartans,Maryland,Terrapins,2-3,4-1,0.0,13,21,13,27,7,6,0,0,14,7,3,3,-2.0,-8,-14,0.698003381409588,8.762263922913007
3993,3993,2022,5,NCAAF_20221001_NWEST@PSU,Northwestern,Wildcats,Penn State,Nittany Lions,1-5,5-0,1.0,0,14,7,17,0,0,7,0,7,7,0,3,-4.0,-14,-10,0.121688006074671,-19.708167625100486
3994,3994,2022,5,NCAAF_20221001_OKLAST@BAYLOR,Oklahoma State,Cowboys,Baylor,Bears,5-0,3-2,0.0,16,3,36,25,7,9,17,3,3,0,22,0,2.0,13,11,0.6643299749476181,7.168212418041776
3995,3995,2022,5,NCAAF_20221001_RUT@OHIOST,Rutgers,Scarlet Knights,Ohio State,Buckeyes,3-2,5-0,1.0,7,28,10,49,7,0,3,0,14,14,14,7,-2.0,-21,-39,0.010989932171437733,-38.69895243733254
3996,3996,2022,5,NCAAF_20221001_VATECH@UNC,Virginia Tech,Hokies,North Carolina,Tar Heels,2-3,4-1,0.0,10,24,10,41,3,7,0,0,7,17,17,0,-2.0,-14,-31,0.5302268818924752,1.2812311014877196
3997,3997,2022,5,NCAAF_20221001_WAKE@FSU,Wake Forest,Demon Deacons,Florida State,Seminoles,4-1,4-1,0.0,21,7,31,21,7,14,7,3,7,0,6,8,0.0,14,10,0.5773824281902302,3.2977015539968306
3998,3998,2022,5,NCAAF_20221001_FAU@NTEXAS,FAU,Owls,North Texas,Mean Green,2-4,3-3,1.0,21,28,28,45,7,14,0,7,7,21,14,3,-1.0,-7,-17,0.6956884391242495,8.650312241689335
3999,3999,2022,5,NCAAF_20221001_TXAM@MISSST,Texas A&M,Aggies,Miss. State,Bulldogs,3-2,4-1,0.0,0,14,24,42,0,0,10,14,0,14,7,21,-1.0,-14,-18,0.5257922442901592,1.0929743642843732
4000,4000,2022,5,NCAAF_20221001_SALA@UL,South Alabama,Jaguars,Louisiana,Ragin' Cajuns,4-1,2-3,1.0,7,7,20,17,0,7,3,10,7,0,0,10,2.0,0,3,0.19919006298785347,-14.267136863213182
4001,4001,2022,5,NCAAF_20221001_WAG@CUSE,Wagner,Seahawks,Syracuse,Orange,0-5,5-0,0.0,0,49,0,59,0,0,0,0,21,28,7,3,-5.0,-49,-59,0.0021565150849188752,-48.220232315360136
4002,4002,2022,5,NCAAF_20221001_CAL@WASHST,California,Golden Bears,Washington St.,Cougars,3-2,4-2,1.0,3,7,9,28,0,3,0,6,0,7,7,14,-1.0,-4,-19,0.36665562529753737,-5.7561347329494765
4003,4003,2022,5,NCAAF_20221001_LIB@ODU,Liberty,Flames,Old Dominion,Monarchs,5-1,2-3,0.0,21,17,38,24,14,7,10,7,14,3,7,0,3.0,4,14,0.7537895102584808,11.596992285237548
4004,4004,2022,5,NCAAF_20221001_NH@WMICH,New Hamp.,Wildcats,W. Michigan,Broncos,3-2,2-3,0.0,7,28,7,44,0,7,0,0,21,7,3,13,1.0,-21,-37,0.06973643900633564,-24.964967133480968
4005,4005,2022,5,NCAAF_20221001_UTEP@CHARLO,UTEP,Miners,Charlotte,49ers,3-4,1-5,0.0,24,7,41,35,7,17,10,7,7,0,14,14,2.0,17,6,0.39584560621707854,-4.461914979447101
4006,4006,2022,5,NCAAF_20221001_CINCY@TULSA,Cincinnati,Bearcats,Tulsa,Golden Hurricane,4-1,2-3,1.0,24,14,31,21,14,10,7,0,7,7,7,0,2.0,10,10,0.7848096648224216,13.321464738156465
4007,4007,2022,5,NCAAF_20221001_GAS@CSTCAR,Ga. Southern,Eagles,C. Carolina,Chanticleers,3-2,5-0,1.0,7,7,30,34,0,7,10,13,7,0,7,20,-2.0,0,-4,0.40458486458682374,-4.079812993733867
4008,4008,2022,5,NCAAF_20221001_LAMON@ARKST,UL-Monroe,Warhawks,Arkansas St.,Red Wolves,2-3,2-3,0.0,14,24,28,45,7,7,7,7,10,14,14,7,0.0,-10,-17,0.275540633575339,-10.071096662138643
4009,4009,2022,5,NCAAF_20221001_LSU@AUBURN,LSU,Tigers,Auburn,Tigers,4-1,3-2,1.0,14,17,21,17,0,14,7,0,7,10,0,0,1.0,-3,4,0.47362665816531,-1.117634562577905
4010,4010,2022,5,NCAAF_20221001_TROY@WKY,Troy,Trojans,W. Kentucky,Hilltoppers,3-2,3-2,0.0,13,17,34,27,10,3,7,14,7,10,3,7,0.0,-4,7,0.48156139251592744,-0.7810894774802364
4011,4011,2022,5,NCAAF_20221001_IND@NEB,Indiana,Hoosiers,Nebraska,Cornhuskers,3-2,2-3,1.0,21,21,21,35,0,21,0,0,7,14,0,14,1.0,0,-14,0.49420599176506064,-0.24536484299210315
4012,4012,2022,5,NCAAF_20221001_NCST@CLEM,NC State,Wolfpack,Clemson,Tigers,4-1,5-0,0.0,10,13,20,30,3,7,3,7,3,10,7,10,-1.0,-3,-10,0.11187991947374398,-20.552878345098406
4013,4013,2022,5,NCAAF_20221001_SJST@WYO,San Jose St.,Spartans,Wyoming,Cowboys,3-1,3-3,1.0,19,10,33,16,2,17,7,7,3,7,6,0,0.0,9,17,0.27507396576651744,-10.094711091982617
4014,4014,2022,5,NCAAF_20221001_UAB@RICE,UAB,Blazers,Rice,Owls,3-2,3-2,0.0,17,7,24,28,7,10,7,0,7,0,14,7,0.0,10,-4,0.8206217941086115,15.504094627457789
4015,4015,2022,5,NCAAF_20221001_UGA@MIZZOU,Georgia,Bulldogs,Missouri,Tigers,5-0,2-3,1.0,6,16,26,22,0,6,6,14,3,13,3,3,3.0,-10,4,0.8890571978657178,20.636307139233395
4016,4016,2022,5,NCAAF_20221001_UVA@DUKE,Virginia,Cavaliers,Duke,Blue Devils,2-3,4-1,0.0,7,21,17,38,0,7,3,7,14,7,7,10,-2.0,-14,-21,0.6659586222481055,7.243748288949291
4017,4017,2022,5,NCAAF_20221001_WVU@TEXAS,West Virginia,Mountaineers,Texas,Longhorns,2-3,4-2,1.0,7,28,20,38,0,7,0,13,14,14,7,3,-2.0,-21,-18,0.37033519613066335,-5.591277089736195
4018,4018,2022,5,NCAAF_20221001_FIU@NMEXST,FIU,Panthers,New Mexico St.,Aggies,2-3,1-5,1.0,21,7,21,7,7,14,0,0,0,7,0,0,1.0,14,14,0.5928766238323848,3.969221657292792
4019,4019,2022,5,NCAAF_20221001_GATECH@PITT,Georgia Tech,Yellow Jackets,Pittsburgh,Panthers,2-3,3-2,1.0,6,7,26,21,3,3,3,17,0,7,0,14,-1.0,-1,5,0.28617001189987346,-9.538399380332066
4020,4020,2022,5,NCAAF_20221001_COLO@ARIZ,Colorado,Buffaloes,Arizona,Wildcats,0-5,3-3,0.0,13,26,20,43,7,6,7,0,13,13,10,7,-3.0,-13,-23,0.5096584871666345,0.40904350223513575
4021,4021,2022,5,NCAAF_20221001_ARIZST@USC,Arizona St.,Sun Devils,USC,Trojans,1-4,5-0,0.0,17,21,25,42,7,10,0,8,14,7,7,14,-4.0,-4,-17,0.43220801423215116,-2.884713593816059
4022,4022,2022,5,NCAAF_20221001_STNFRD@OREG,Stanford,Cardinal,Oregon,Ducks,1-3,4-1,1.0,3,31,27,45,0,3,14,10,10,21,7,7,-3.0,-28,-18,0.294662837057325,-9.119515056879663
4023,4023,2022,5,NCAAF_20220930_TXSA@MTSU,UTSA,Roadrunners,Middle Tenn.,Blue Raiders,3-2,3-2,0.0,31,20,45,30,10,21,7,7,0,20,0,10,0.0,11,15,0.42121792665691726,-3.358132939235702
4024,4024,2022,5,NCAAF_20220930_SDGST@BOISE,San Diego St.,Aztecs,Boise St.,Broncos,2-3,3-2,0.0,13,0,13,35,6,7,0,0,0,0,21,14,-1.0,13,-22,0.34704707617543473,-6.644428029252822
4025,4025,2022,5,NCAAF_20220930_WASH@UCLA,Washington,Huskies,UCLA,Bruins,4-1,5-0,1.0,10,26,32,40,7,3,6,16,9,17,14,0,-1.0,-16,-8,0.7178707914952073,9.739762202309294
4026,4026,2022,5,NCAAF_20220930_NMEX@UNLV,New Mexico,Lobos,UNLV,Rebels,2-3,4-1,1.0,17,9,20,31,14,3,0,3,0,9,8,14,-2.0,8,-11,0.43504189918569036,-2.7630198467923037
4027,4027,2022,5,NCAAF_20220929_SCST@SC,SC State,Bulldogs,South Carolina,Gamecocks,1-3,3-2,0.0,0,22,10,50,0,0,7,3,8,14,14,14,-2.0,-22,-40,0.017400995685668108,-35.657036021329986
4028,4028,2022,5,NCAAF_20220929_UTAHST@BYU,Utah St.,Aggies,BYU,Cougars,1-4,4-1,1.0,17,17,26,38,7,10,3,6,14,3,14,7,-3.0,0,-12,0.3731960601239521,-5.4634680926833425
4029,4029,2022,6,NCAAF_20221008_ARK@MISSST,Arkansas,Razorbacks,Miss. State,Bulldogs,3-3,5-1,0.0,10,21,17,40,0,10,7,0,14,7,13,6,-2.0,-11,-23,0.22566836053803618,-12.724426967657791
4030,4030,2022,6,NCAAF_20221008_BUFF@BGREEN,Buffalo,Bulls,Bowling Green,Falcons,3-3,2-4,1.0,31,0,38,7,17,14,7,0,0,0,7,0,1.0,31,31,0.8856726472614447,20.33762950379878
4031,4031,2022,6,NCAAF_20221008_EMICH@WMICH,E. Michigan,Eagles,W. Michigan,Broncos,4-2,2-4,1.0,35,7,45,23,14,21,7,3,0,7,9,7,2.0,28,22,0.45388102435347244,-1.9573793337594907
4032,4032,2022,6,NCAAF_20221008_LVILLE@UVA,Louisville,Cardinals,Virginia,Cavaliers,3-3,2-4,1.0,13,10,34,17,0,13,14,7,10,0,7,0,1.0,3,17,0.5020748033759774,0.087862480558897
4033,4033,2022,6,NCAAF_20221008_MICH@IND,Michigan,Wolverines,Indiana,Hoosiers,6-0,3-3,1.0,10,10,31,10,10,0,7,14,7,3,0,0,3.0,0,21,0.8711538861829113,19.121779723504233
4034,4034,2022,6,NCAAF_20221008_MIZZOU@FLA,Missouri,Tigers,Florida,Gators,2-4,4-3,1.0,10,10,17,24,0,10,0,7,10,0,7,7,-2.0,0,-7,0.3493610129692932,-6.538790144117229
4035,4035,2022,6,NCAAF_20221008_PURDUE@MD,Purdue,Boilermakers,Maryland,Terrapins,4-2,4-2,1.0,17,17,31,29,3,14,0,14,7,10,0,12,0.0,0,2,0.7194596214037041,9.819465510889813
4036,4036,2022,6,NCAAF_20221008_TCU@KANSAS,TCU,Horned Frogs,Kansas,Jayhawks,5-0,5-1,1.0,10,3,38,31,3,7,21,7,0,3,21,7,0.0,7,7,0.9003546105906091,21.684818806843623
4037,4037,2022,6,NCAAF_20221008_TENN@LSU,Tennessee,Volunteers,LSU,Tigers,5-0,4-2,1.0,23,7,40,13,13,10,14,3,0,7,0,6,1.0,16,27,0.2450453652989676,-11.659696705334909
4038,4038,2022,6,NCAAF_20221008_TEXAS@OKLA,Texas,Longhorns,Oklahoma,Sooners,4-2,3-3,1.0,28,0,49,0,7,21,14,7,0,0,0,0,1.0,28,49,0.32560263295855196,-7.6376197304684865
4039,4039,2022,6,NCAAF_20221008_AKRON@OHIO,Akron,Zips,Ohio,Bobcats,1-5,3-3,0.0,13,28,34,55,0,13,7,14,14,14,20,7,-2.0,-15,-21,0.12459508791795737,-19.467366041379137
4040,4040,2022,6,NCAAF_20221008_GAS@GAST,Ga. Southern,Eagles,Georgia St.,Panthers,4-3,2-4,1.0,17,27,33,41,7,10,13,3,13,14,7,7,2.0,-10,-8,0.5331320264923067,1.4046648554128751
4041,4041,2022,6,NCAAF_20221008_SFLA@CINCY,South Florida,Bulls,Cincinnati,Bearcats,1-6,5-1,1.0,17,14,24,28,10,7,0,7,7,7,7,7,-4.0,3,-4,0.13827389369903986,-18.382573226437216
4042,4042,2022,6,NCAAF_20221008_AUBURN@UGA,Auburn,Tigers,Georgia,Bulldogs,3-3,6-0,1.0,0,14,10,42,0,0,3,7,0,14,7,21,-3.0,-14,-32,0.2793312055771886,-9.880156962262845
4043,4043,2022,6,NCAAF_20221008_BALLST@CMICH,Ball St.,Cardinals,C. Michigan,Chippewas,3-3,1-5,1.0,7,10,17,16,0,7,7,3,10,0,6,0,2.0,-3,1,0.3571769789341439,-6.183486069244964
4044,4044,2022,6,NCAAF_20221008_ECU@TULANE,East Carolina,Pirates,Tulane,Green Wave,3-3,5-1,1.0,9,14,9,24,3,6,0,0,0,14,7,3,-2.0,-5,-15,0.28104068679598104,-9.794390840250799
4045,4045,2022,6,NCAAF_20221008_KENTST@MIAOH,Kent St.,Golden Flashes,Miami-OH,RedHawks,2-4,3-3,0.0,7,17,24,27,0,7,7,10,17,0,10,0,-1.0,-10,-3,0.3145920849288225,-8.157738010577077
4046,4046,2022,6,NCAAF_20221008_LIB@UMASS,Liberty,Flames,UMass,Minutemen,5-1,1-5,0.0,21,10,42,24,0,21,14,7,7,3,0,14,4.0,11,18,0.920946549687726,23.845443949515357
4047,4047,2022,6,NCAAF_20221008_MTSU@UAB,Middle Tenn.,Blue Raiders,UAB,Blazers,3-3,3-2,0.0,7,38,14,41,7,0,7,0,21,17,3,0,0.0,-31,-27,0.411696760702729,-3.7704625835572187
4048,4048,2022,6,NCAAF_20221008_TOLEDO@NILL,Toledo,Rockets,N. Illinois,Huskies,4-2,1-5,1.0,35,7,52,32,21,14,10,7,7,0,0,25,3.0,28,20,0.6241454548851795,5.345061385183499
4049,4049,2022,6,NCAAF_20221008_TULSA@NAVY,Tulsa,Golden Hurricane,Navy,Midshipmen,2-4,2-4,1.0,14,36,21,53,7,7,0,7,10,26,10,7,0.0,-22,-32,0.4776893989421185,-0.9452841907370839
4050,4050,2022,6,NCAAF_20221008_TXTECH@OKLAST,Texas Tech,Red Raiders,Oklahoma State,Cowboys,3-3,5-1,1.0,24,20,31,41,14,10,7,0,17,3,14,7,-2.0,4,-10,0.2700613313666237,-10.349780001979525
4051,4051,2022,6,NCAAF_20221008_UTAH@UCLA,Utah,Utes,UCLA,Bruins,5-2,6-0,1.0,10,14,32,42,0,10,8,14,7,7,14,14,-1.0,-4,-10,0.7524240141668398,11.524088543694006
4052,4052,2022,6,NCAAF_20221008_VATECH@PITT,Virginia Tech,Hokies,Pittsburgh,Panthers,2-5,4-2,1.0,16,17,29,45,6,10,7,6,7,10,14,14,-2.0,-1,-16,0.4534256144224421,-1.976795837947293
4053,4053,2022,6,NCAAF_20221008_WISC@NWEST,Wisconsin,Badgers,Northwestern,Wildcats,3-4,1-5,1.0,28,0,42,7,7,21,0,14,0,0,0,7,2.0,28,35,0.8280239258402172,15.988310171932653
4054,4054,2022,6,NCAAF_20221008_MISS@VANDY,Ole Miss,Rebels,Vanderbilt,Commodores,6-0,3-3,1.0,17,20,52,28,3,14,21,14,3,17,0,8,3.0,-3,24,0.8228293069598858,15.647321299240275
4055,4055,2022,6,NCAAF_20221008_OHIOST@MICHST,Ohio State,Buckeyes,Michigan St.,Spartans,6-0,3-4,0.0,35,13,49,20,14,21,14,0,7,6,0,7,3.0,22,29,0.9285376783228397,24.74960083093947
4056,4056,2022,6,NCAAF_20221008_UNC@MIAMI,North Carolina,Tar Heels,Miami (Fla.),Hurricanes,5-1,2-3,0.0,21,17,27,24,7,14,3,3,0,17,0,7,3.0,4,3,0.39192241578016895,-4.634250382908476
4057,4057,2022,6,NCAAF_20221008_WASH@ARIZST,Washington,Huskies,Arizona St.,Sun Devils,5-2,2-4,1.0,17,24,38,45,7,10,14,7,3,21,14,7,3.0,-7,-7,0.6738927218628668,7.613957551490103
4058,4058,2022,6,NCAAF_20221008_WKY@TXSA,W. Kentucky,Hilltoppers,UTSA,Roadrunners,3-3,4-2,0.0,14,17,28,31,7,7,0,14,7,10,7,7,-1.0,-3,-3,0.60998437873788,4.718151109781047
4059,4059,2022,6,NCAAF_20221008_AF@UTAHST,Air Force,Falcons,Utah St.,Aggies,4-2,2-4,1.0,14,13,27,34,7,7,3,10,10,3,7,14,2.0,1,-7,0.5983255180338087,4.20688475223983
4060,4060,2022,6,NCAAF_20221008_APLST@TXSTSM,App. St.,Mountaineers,Texas St.,Bobcats,3-3,3-4,0.0,3,24,24,36,0,3,7,14,7,17,9,3,0.0,-21,-12,0.93987703535597,26.249049141294563
4061,4061,2022,6,NCAAF_20221008_JMAD@ARKST,James Madison,Dukes,Arkansas St.,Red Wolves,5-0,2-4,1.0,14,3,42,20,0,14,7,21,0,3,10,7,3.0,11,22,0.8924127371171829,20.939570523377824
4062,4062,2022,6,NCAAF_20221008_UCONN@FIU,UConn,Huskies,FIU,Panthers,3-4,2-3,0.0,20,0,33,12,7,13,6,7,0,0,10,2,1.0,20,21,0.31648546458257953,-8.067759732484546
4063,4063,2022,6,NCAAF_20221008_USM@TROY,So. Miss,Golden Eagles,Troy,Trojans,2-3,4-2,1.0,7,10,10,27,0,7,3,0,3,7,7,10,-2.0,-3,-17,0.4006682355266201,-4.250852591370858
4064,4064,2022,6,NCAAF_20221008_UTEP@LATECH,UTEP,Miners,Louisiana Tech,Bulldogs,3-4,2-4,0.0,10,30,31,41,3,7,0,21,20,10,0,11,1.0,-20,-10,0.2224250821804712,-12.907563536234875
4065,4065,2022,6,NCAAF_20221008_WYO@NMEX,Wyoming,Cowboys,New Mexico,Lobos,4-3,2-5,0.0,7,14,27,14,0,7,10,10,14,0,0,0,2.0,-7,13,0.771322583218244,12.555843475924803
4066,4066,2022,6,NCAAF_20221008_ARMY@WAKE,Army,Black Knights,Wake Forest,Demon Deacons,2-4,5-1,1.0,0,21,10,45,0,0,0,10,14,7,17,7,-3.0,-21,-35,0.344863543122244,-6.744548009167374
4067,4067,2022,6,NCAAF_20221008_BYU@ND,BYU,Cougars,Notre Dame,Fighting Irish,4-2,3-2,1.0,6,18,20,28,6,0,7,7,3,15,7,3,1.0,-12,-8,0.16756565471660356,-16.2830190484417
4068,4068,2022,6,NCAAF_20221008_CLEM@BC,Clemson,Tigers,Boston College,Eagles,7-0,2-4,1.0,10,3,31,3,3,7,7,14,0,3,0,0,5.0,7,28,0.9258531118537006,24.42182447893174
4069,4069,2022,6,NCAAF_20221008_IOWA@ILL,Iowa,Hawkeyes,Illinois,Fighting Illini,3-3,6-1,0.0,6,6,6,9,3,3,0,0,3,3,0,3,-3.0,0,-3,0.8770196260834704,19.600790593311785
4070,4070,2022,6,NCAAF_20221008_KSTATE@IOWAST,Kansas State,Wildcats,Iowa St.,Cyclones,5-1,3-4,0.0,7,6,10,9,7,0,0,3,3,3,3,0,2.0,1,1,0.34806150481436027,-6.5981413266035815
4071,4071,2022,6,NCAAF_20221008_SC@UK,South Carolina,Gamecocks,Kentucky,Wildcats,4-2,5-2,0.0,7,7,24,14,7,0,10,7,0,7,0,7,-1.0,0,10,0.3925148979261984,-4.6082039738739695
4072,4072,2022,6,NCAAF_20221008_WASHST@USC,Washington St.,Cougars,USC,Trojans,4-2,6-0,1.0,14,17,14,30,0,14,0,0,10,7,7,6,-2.0,-3,-16,0.5025271797582747,0.10701966703732069
4073,4073,2022,6,NCAAF_20221008_CSTCAR@LAMON,C. Carolina,Chanticleers,UL-Monroe,Warhawks,6-0,2-4,1.0,28,14,28,21,14,14,0,0,7,7,7,0,4.0,14,7,0.7567351630707245,11.75556147427119
4074,4074,2022,6,NCAAF_20221008_TXAM@BAMA,Texas A&M,Aggies,Alabama,Crimson Tide,3-3,6-1,1.0,14,17,20,24,0,14,3,3,0,17,7,0,-3.0,-3,-4,0.10428003159251165,-21.24489641844866
4075,4075,2022,6,NCAAF_20221008_FSU@NCST,Florida State,Seminoles,NC State,Wolfpack,4-2,5-1,1.0,17,3,17,19,0,17,0,0,3,0,10,6,-1.0,14,-2,0.39105874693428877,-4.672238328638514
4076,4076,2022,6,NCAAF_20221008_OREG@ARIZ,Oregon,Ducks,Arizona,Wildcats,5-1,3-4,0.0,28,13,49,22,7,21,21,0,3,10,3,6,2.0,15,27,0.8378261143931284,16.65017725348025
4077,4077,2022,6,NCAAF_20221008_FRESNO@BOISE,Fresno St.,Bulldogs,Boise St.,Broncos,2-4,4-2,1.0,17,20,20,40,7,10,3,0,7,13,7,13,-2.0,-3,-20,0.38116418290600973,-5.109187127319956
4078,4078,2022,6,NCAAF_20221008_HAWAII@SDGST,Hawaii,Rainbow Warriors,San Diego St.,Aztecs,2-5,3-3,1.0,0,3,14,16,0,0,7,7,0,3,7,6,-1.0,-3,-2,0.22011303074447652,-13.039048018875974
4079,4079,2022,6,NCAAF_20221008_OREGST@STNFRD,Oregon State,Beavers,Stanford,Cardinal,4-2,1-4,1.0,7,17,28,27,0,7,3,18,7,10,7,3,3.0,-10,1,0.32918449523685767,-7.469991348643589
4080,4080,2022,6,NCAAF_20221007_NEB@RUT,Nebraska,Cornhuskers,Rutgers,Scarlet Knights,3-4,3-3,0.0,0,13,14,13,0,0,7,7,10,3,0,0,0.0,-13,1,0.750062972587854,11.398233850102542
4081,4081,2022,6,NCAAF_20221007_HOU@MEMP,Houston,Cougars,Memphis,Tigers,3-3,4-3,1.0,7,17,33,32,0,7,0,26,14,3,3,12,-1.0,-10,1,0.4254482617144768,-3.1756593270335998
4082,4082,2022,6,NCAAF_20221007_COLOST@NEVADA,Colorado St.,Rams,Nevada,Wolf Pack,1-4,2-4,1.0,14,7,17,14,14,0,0,3,0,7,0,7,-1.0,7,3,0.44851888494423753,-2.186166455191369
4083,4083,2022,6,NCAAF_20221007_UNLV@SJST,UNLV,Rebels,San Jose St.,Spartans,4-2,4-1,1.0,0,23,7,40,0,0,7,0,7,16,10,7,0.0,-23,-33,0.49491719812343515,-0.215248180008075
4084,4084,2022,6,NCAAF_20221005_SMU@UCF,SMU,Mustangs,UCF,Knights,2-3,4-1,1.0,13,10,19,41,7,6,0,6,3,7,14,17,-2.0,3,-22,0.28673585985745387,-9.510454826667
4085,4085,2022,7,NCAAF_20221015_AUBURN@MISS,Auburn,Tigers,Ole Miss,Rebels,3-4,7-1,0.0,17,28,34,48,0,17,14,3,14,14,10,10,-4.0,-11,-14,0.7056158869507699,9.134885611631944
4086,4086,2022,7,NCAAF_20221015_CMICH@AKRON,C. Michigan,Chippewas,Akron,Zips,2-5,1-6,0.0,14,7,28,21,7,7,7,7,7,0,7,7,1.0,7,7,0.8340566179820073,16.395500970948433
4087,4087,2022,7,NCAAF_20221015_COLG@ARMY,Colgate,Raiders,Army,Black Knights,1-5,2-4,1.0,17,28,17,42,10,7,0,0,14,14,14,0,-1.0,-11,-25,0.03637618754615546,-30.31964777669714
4088,4088,2022,7,NCAAF_20221015_IOWAST@TEXAS,Iowa St.,Cyclones,Texas,Longhorns,3-4,5-3,1.0,7,14,21,24,7,0,7,7,0,14,3,7,-2.0,-7,-3,0.49420232736013325,-0.24556609146225128
4089,4089,2022,7,NCAAF_20221015_KANSAS@OKLA,Kansas,Jayhawks,Oklahoma,Sooners,5-3,4-3,0.0,21,35,42,52,14,7,7,14,14,21,14,3,1.0,-14,-10,0.028826456661127153,-32.07603622324086
4090,4090,2022,7,NCAAF_20221015_MIAOH@BGREEN,Miami-OH,RedHawks,Bowling Green,Falcons,3-4,3-4,1.0,10,7,13,17,3,7,3,0,0,7,3,7,0.0,3,-4,0.8486693925333006,17.416464767518846
4091,4091,2022,7,NCAAF_20221015_MINN@ILL,Minnesota,Golden Gophers,Illinois,Fighting Illini,4-3,6-1,0.0,7,13,14,26,0,7,7,0,7,6,7,6,-2.0,-6,-12,0.7695072758753082,12.456889791860931
4092,4092,2022,7,NCAAF_20221015_ODU@CSTCAR,Old Dominion,Monarchs,C. Carolina,Chanticleers,3-4,6-1,1.0,14,7,49,21,7,7,21,14,0,7,7,7,-3.0,7,28,0.268552814415596,-10.428753496523086
4093,4093,2022,7,NCAAF_20221015_PSU@MICH,Penn State,Nittany Lions,Michigan,Wolverines,6-1,7-0,0.0,14,16,17,41,0,14,3,0,6,10,15,10,-1.0,-2,-24,0.4765614177235553,-0.9933009197229694
4094,4094,2022,7,NCAAF_20221015_MIAMI@VATECH,Miami (Fla.),Hurricanes,Virginia Tech,Hokies,3-4,2-5,0.0,17,0,20,14,10,7,3,0,0,0,0,14,1.0,17,6,0.6056705428107472,4.529281716723062
4095,4095,2022,7,NCAAF_20221015_BUFF@UMASS,Buffalo,Bulls,UMass,Minutemen,5-3,1-6,0.0,24,7,34,7,3,21,3,7,0,7,0,0,4.0,17,27,0.9228878105729255,24.074292308835766
4096,4096,2022,7,NCAAF_20221015_UCONN@BALLST,UConn,Huskies,Ball St.,Cardinals,3-5,4-4,0.0,21,10,21,25,7,14,0,0,7,3,3,12,-1.0,11,-4,0.27894964420510926,-9.901041552820516
4097,4097,2022,7,NCAAF_20221015_ARK@BYU,Arkansas,Razorbacks,BYU,Cougars,4-3,4-4,1.0,31,21,52,35,7,24,14,7,13,8,14,0,0.0,10,17,0.40170915540954166,-4.206095195701437
4098,4098,2022,7,NCAAF_20221015_BAMA@TENN,Alabama,Crimson Tide,Tennessee,Volunteers,6-1,6-0,1.0,20,28,49,52,7,13,15,14,21,7,6,18,0.0,-8,-3,0.9514131232246931,28.027256315136583
4099,4099,2022,7,NCAAF_20221015_CHARLO@UAB,Charlotte,49ers,UAB,Blazers,1-6,4-2,0.0,14,10,20,34,14,0,0,6,7,3,9,15,-3.0,4,-14,0.1929642123744304,-14.650113971237033
4100,4100,2022,7,NCAAF_20221015_GRDWB@LIB,Gardner-Webb,Runnin' Bulldogs,Liberty,Flames,2-5,6-1,1.0,10,14,20,21,0,10,7,3,7,7,0,7,-4.0,-4,-1,0.04259374416256445,-29.085628444200893
4101,4101,2022,7,NCAAF_20221015_KENTST@TOLEDO,Kent St.,Golden Flashes,Toledo,Rockets,2-5,5-2,1.0,31,28,31,52,21,10,0,0,7,21,10,14,-3.0,3,-21,0.21956778494706275,-13.072424077161713
4102,4102,2022,7,NCAAF_20221015_MD@IND,Maryland,Terrapins,Indiana,Hoosiers,5-2,3-4,0.0,14,17,38,33,7,7,10,14,3,14,3,13,2.0,-3,5,0.3940247720824386,-4.5426599655756945
4103,4103,2022,7,NCAAF_20221015_NCST@CUSE,NC State,Wolfpack,Syracuse,Orange,5-2,6-1,0.0,3,10,9,24,3,0,3,3,7,3,7,7,-1.0,-7,-15,0.6542940009959224,6.707086678399264
4104,4104,2022,7,NCAAF_20221015_NILL@EMICH,N. Illinois,Huskies,E. Michigan,Eagles,2-5,4-3,1.0,20,7,39,10,14,6,9,10,7,0,3,0,-2.0,13,29,0.4811402791362539,-0.7990915570421748
4105,4105,2022,7,NCAAF_20221015_OHIO@WMICH,Ohio,Bobcats,W. Michigan,Broncos,4-3,2-5,1.0,20,14,33,14,7,13,0,13,7,7,0,0,2.0,6,19,0.5373037050136458,1.5822887583653937
4106,4106,2022,7,NCAAF_20221015_TXSTSM@TROY,Texas St.,Bobcats,Troy,Trojans,3-4,5-2,0.0,7,10,14,17,0,7,7,0,0,10,0,7,-2.0,-3,-3,0.21416895754544485,-13.383079965303068
4107,4107,2022,7,NCAAF_20221015_VANDY@UGA,Vanderbilt,Commodores,Georgia,Bulldogs,3-5,7-0,0.0,0,28,0,55,0,0,0,0,14,14,6,21,-4.0,-28,-55,0.017832849272758855,-35.49582813264283
4108,4108,2022,7,NCAAF_20221015_WKY@MTSU,W. Kentucky,Hilltoppers,Middle Tenn.,Blue Raiders,5-3,3-4,0.0,14,10,35,17,0,14,14,7,7,3,0,7,2.0,4,18,0.555099722239043,2.3411899155978517
4109,4109,2022,7,NCAAF_20221015_JMAD@GAS,James Madison,Dukes,Ga. Southern,Eagles,5-1,4-3,0.0,17,14,38,45,7,10,7,14,0,14,17,14,1.0,3,-7,0.9209718379561891,23.852455346468787
4110,4110,2022,7,NCAAF_20221015_LATECH@NTEXAS,Louisiana Tech,Bulldogs,North Texas,Mean Green,2-4,4-3,1.0,17,27,27,47,3,14,10,0,14,13,7,13,-2.0,-10,-20,0.5008021672028226,0.03397540282594491
4111,4111,2022,7,NCAAF_20221015_TULANE@SFLA,Tulane,Green Wave,South Florida,Bulls,7-1,1-6,0.0,17,14,45,31,3,14,14,14,7,7,10,7,6.0,3,14,0.6807388407325194,7.937631338802021
4112,4112,2022,7,NCAAF_20221015_ARIZ@WASH,Arizona,Wildcats,Washington,Huskies,3-4,6-2,1.0,14,21,39,49,7,7,10,15,7,14,21,7,-3.0,-7,-10,0.16511211893558952,-16.451967557394255
4113,4113,2022,7,NCAAF_20221015_RICE@FAU,Rice,Owls,FAU,Owls,3-3,3-4,1.0,14,7,14,17,14,0,0,0,0,7,3,7,0.0,7,-3,0.15738497288897668,-16.985934150014373
4114,4114,2022,7,NCAAF_20221015_ARKST@USM,Arkansas St.,Red Wolves,So. Miss,Golden Eagles,2-5,3-3,1.0,10,7,19,20,7,3,9,0,0,7,0,13,-1.0,3,-1,0.5656356494100117,2.792625887628901
4115,4115,2022,7,NCAAF_20221015_LAMON@SALA,UL-Monroe,Warhawks,South Alabama,Jaguars,2-5,5-1,1.0,20,17,34,41,7,13,0,14,10,7,17,7,-3.0,3,-7,0.43704790087636536,-2.6774664982979175
4116,4116,2022,7,NCAAF_20221015_LSU@FLA,LSU,Tigers,Florida,Gators,6-2,4-3,0.0,28,21,45,35,7,21,14,3,14,7,0,14,2.0,7,10,0.5485707570627749,2.0622982194299766
4117,4117,2022,7,NCAAF_20221015_UTAHST@COLOST,Utah St.,Aggies,Colorado St.,Rams,3-4,1-5,1.0,7,10,17,13,7,0,10,0,3,7,0,3,2.0,-3,4,0.6635649616213899,7.1341190106450085
4118,4118,2022,7,NCAAF_20221015_CLEM@FSU,Clemson,Tigers,Florida State,Seminoles,8-0,4-3,0.0,24,14,34,28,7,17,10,0,7,7,0,14,4.0,10,6,0.9286749679288167,24.770885045317073
4119,4119,2022,7,NCAAF_20221015_MISSST@UK,Miss. State,Bulldogs,Kentucky,Wildcats,5-3,5-2,1.0,3,3,17,27,0,3,7,7,0,3,10,14,0.0,0,-10,0.5912159693804738,3.897697793689076
4120,4120,2022,7,NCAAF_20221015_NEB@PURDUE,Nebraska,Cornhuskers,Purdue,Boilermakers,3-4,5-3,0.0,13,27,37,43,0,13,17,7,10,17,7,9,-2.0,-14,-6,0.396187689051233,-4.447750745932353
4121,4121,2022,7,NCAAF_20221015_STNFRD@ND,Stanford,Cardinal,Notre Dame,Fighting Irish,2-4,3-3,0.0,10,0,16,14,7,3,3,3,0,0,7,7,-1.0,10,2,0.17671302382251586,-15.679809848258401
4122,4122,2022,7,NCAAF_20221015_NMEX@NMEXST,New Mexico,Lobos,New Mexico St.,Aggies,2-5,2-5,1.0,6,7,9,21,3,3,0,3,7,0,14,0,0.0,-1,-12,0.5909172573513565,3.8847060281339054
4123,4123,2022,7,NCAAF_20221015_UNC@DUKE,North Carolina,Tar Heels,Duke,Blue Devils,6-1,5-3,1.0,17,21,38,35,10,7,14,7,7,14,0,14,1.0,-4,3,0.690146551333444,8.38540082365921
4124,4124,2022,7,NCAAF_20221015_USC@UTAH,USC,Trojans,Utah,Utes,6-1,5-2,1.0,28,21,42,43,14,14,7,7,7,14,7,15,1.0,7,-1,0.36198560336926633,-5.9672817458263125
4125,4125,2022,7,NCAAF_20221015_WASHST@OREGST,Washington St.,Cougars,Oregon State,Beavers,4-3,6-2,0.0,3,10,10,24,0,3,7,0,7,3,7,7,-2.0,-7,-14,0.7674176701648281,12.341041706828719
4126,4126,2022,7,NCAAF_20221015_AF@UNLV,Air Force,Falcons,UNLV,Rebels,5-2,4-3,0.0,28,7,42,7,14,14,14,0,0,7,0,0,1.0,21,35,0.8465133229557824,17.261860017035815
4127,4127,2022,7,NCAAF_20221015_SJST@FRESNO,San Jose St.,Spartans,Fresno St.,Bulldogs,4-2,2-4,0.0,10,7,10,17,0,10,0,0,0,7,7,3,2.0,3,-7,0.18030857835994551,-15.447059769146335
4128,4128,2022,7,NCAAF_20221015_NEVADA@HAWAII,Nevada,,Hawaii,,2-5,2-5,,13,21,16,31,7,6,3,0,14,7,0,10,0.0,-8,-15,0.6449715130666056,6.281957735699052
4129,4129,2022,7,NCAAF_20221014_NAVY@SMU,Navy,Midshipmen,SMU,Mustangs,2-4,3-3,0.0,7,13,34,40,0,7,7,20,10,3,20,7,-1.0,-6,-6,0.3919482158296751,-4.63391467296492
4130,4130,2022,7,NCAAF_20221014_TXSA@FIU,UTSA,Roadrunners,FIU,Panthers,5-2,2-4,0.0,17,3,30,10,0,17,7,6,0,3,0,7,3.0,14,20,0.6515126497637387,6.5798172982601955
4131,4131,2022,7,NCAAF_20221013_BAYLOR@WVU,Baylor,Bears,West Virginia,Mountaineers,3-3,3-3,1.0,24,17,40,43,3,21,7,9,7,10,14,12,0.0,7,-3,0.4810225402053627,-0.804083943591877
4132,4132,2022,7,NCAAF_20221013_TEMPLE@UCF,Temple,Owls,UCF,Knights,2-4,5-1,1.0,13,35,13,70,10,3,0,0,14,21,21,14,-3.0,-22,-57,0.10125449221669824,-21.534137162788966
4133,4133,2022,7,NCAAF_20221012_UL@MRSHL,Louisiana,Ragin' Cajuns,Marshall,Thundering Herd,3-3,3-3,1.0,3,7,23,13,3,0,13,7,0,7,0,6,0.0,-4,10,0.47948805097146474,-0.8691562016385888
4134,4134,2022,8,NCAAF_20221022_AKRON@KENTST,Akron,Zips,Kent St.,Golden Flashes,1-7,3-5,0.0,17,21,27,33,7,10,7,3,0,21,9,3,-2.0,-4,-6,0.3084204289816802,-8.455467484497376
4135,4135,2022,8,NCAAF_20221022_CINCY@SMU,Cincinnati,Bearcats,SMU,Mustangs,6-1,3-4,0.0,20,14,29,27,10,10,9,0,0,14,0,13,3.0,6,2,0.6575650716425088,6.85834777554669
4136,4136,2022,8,NCAAF_20221022_CUSE@CLEM,Syracuse,Orange,Clemson,Tigers,6-1,8-0,1.0,21,10,21,27,7,14,0,0,7,3,0,17,-2.0,11,-6,0.059822326818939064,-26.30042887512809
4137,4137,2022,8,NCAAF_20221022_HOU@NAVY,Houston,Cougars,Navy,Midshipmen,4-3,2-5,1.0,21,7,38,20,14,7,10,7,0,7,7,6,2.0,14,18,0.6052833355763979,4.5130040257340625
4138,4138,2022,8,NCAAF_20221022_IND@RUT,Indiana,Hoosiers,Rutgers,Scarlet Knights,3-5,4-3,0.0,14,7,17,24,14,0,0,3,0,7,10,7,-1.0,7,-7,0.7288611165851668,10.298201796756075
4139,4139,2022,8,NCAAF_20221022_IOWA@OHIOST,Iowa,Hawkeyes,Ohio State,Buckeyes,3-4,7-0,1.0,10,26,10,54,7,3,0,0,16,10,14,14,-4.0,-16,-44,0.18327306746490635,-15.259776615247802
4140,4140,2022,8,NCAAF_20221022_KANSAS@BAYLOR,Kansas,Jayhawks,Baylor,Bears,5-3,4-3,1.0,3,28,23,35,3,0,7,13,14,14,0,7,1.0,-25,-12,0.1416401735443169,-18.133020894045103
4141,4141,2022,8,NCAAF_20221022_LAMON@ARMY,UL-Monroe,Warhawks,Army,Black Knights,2-6,3-4,1.0,17,14,24,48,3,14,0,7,7,7,17,17,-1.0,3,-24,0.14611144886432081,-17.79972989306998
4142,4142,2022,8,NCAAF_20221022_TNMART@TENN,UT Martin,Skyhawks,Tennessee,Volunteers,4-3,7-0,1.0,7,52,24,65,7,0,7,10,21,31,6,7,-3.0,-45,-41,0.01834209246556373,-35.30787499656299
4143,4143,2022,8,NCAAF_20221022_DUKE@MIAMI,Duke,Blue Devils,Miami (Fla.),Hurricanes,5-3,3-4,1.0,17,7,45,21,0,17,7,21,7,0,14,0,2.0,10,24,0.22612331320957058,-12.703072570327322
4144,4144,2022,8,NCAAF_20221022_BGREEN@CMICH,Bowling Green,Falcons,C. Michigan,Chippewas,4-4,2-6,1.0,17,3,34,18,7,10,0,17,3,0,7,8,2.0,14,16,0.16315148154350678,-16.588530538094574
4145,4145,2022,8,NCAAF_20221022_TOLEDO@BUFF,Toledo,Rockets,Buffalo,Bulls,5-3,5-3,1.0,20,7,27,34,7,13,7,0,0,7,3,24,0.0,13,-7,0.5462849878129571,1.965109121990281
4146,4146,2022,8,NCAAF_20221022_EMICH@BALLST,E. Michigan,Eagles,Ball St.,Cardinals,5-3,4-4,1.0,10,7,20,16,0,10,0,10,0,7,9,0,1.0,3,4,0.6367802918867401,5.9126239181546225
4147,4147,2022,8,NCAAF_20221022_NILL@OHIO,N. Illinois,Huskies,Ohio,Bobcats,2-6,5-3,0.0,6,10,17,24,0,6,11,0,7,3,7,7,-3.0,-4,-7,0.4203919368235448,-3.3949943716313555
4148,4148,2022,8,NCAAF_20221022_UNLV@ND,UNLV,Rebels,Notre Dame,Fighting Irish,4-4,4-3,0.0,7,30,21,44,7,0,7,7,23,7,0,14,0.0,-23,-23,0.018324667676724027,-35.3144238118939
4149,4149,2022,8,NCAAF_20221022_WVU@TXTECH,West Virginia,Mountaineers,Texas Tech,Red Raiders,3-4,4-3,0.0,3,17,10,48,3,0,7,0,14,3,14,17,-1.0,-14,-38,0.5915013532207833,3.9107358459511943
4150,4150,2022,8,NCAAF_20221022_BC@WAKE,Boston College,Eagles,Wake Forest,Demon Deacons,2-5,6-1,1.0,9,21,15,43,3,6,6,0,7,14,15,7,-4.0,-12,-28,0.41374839636436167,-3.682664676361128
4151,4151,2022,8,NCAAF_20221022_BYU@LIB,BYU,Cougars,Liberty,Flames,4-4,7-1,1.0,14,20,14,41,14,0,0,0,3,17,14,7,-3.0,-6,-27,0.7235110419606339,10.026649451486492
4152,4152,2022,8,NCAAF_20221022_FIU@CHARLO,FIU,Panthers,Charlotte,49ers,3-4,1-7,0.0,27,0,34,15,14,13,7,0,0,0,0,15,2.0,27,19,0.5259154653166145,1.0985845835568853
4153,4153,2022,8,NCAAF_20221022_GAS@ODU,Ga. Southern,Eagles,Old Dominion,Monarchs,5-3,3-4,1.0,14,3,28,23,7,7,7,7,3,0,13,7,2.0,11,5,0.63502642738663,5.833703091811913
4154,4154,2022,8,NCAAF_20221022_MEMP@TULANE,Memphis,Tigers,Tulane,Green Wave,4-4,7-1,0.0,0,35,28,38,0,0,14,14,21,14,0,3,-3.0,-35,-10,0.6352399961528914,5.843306477261422
4155,4155,2022,8,NCAAF_20221022_MISS@LSU,Ole Miss,Rebels,LSU,Tigers,7-1,6-2,1.0,20,17,20,45,14,6,0,0,3,14,7,21,1.0,3,-25,0.324395167513317,-7.69685145264657
4156,4156,2022,8,NCAAF_20221022_MRSHL@JMAD,Marshall,Thundering Herd,James Madison,Dukes,4-3,5-2,1.0,9,12,26,12,2,7,10,7,12,0,0,0,-1.0,-3,14,0.2740478148266987,-10.150228667184592
4157,4157,2022,8,NCAAF_20221022_NTEXAS@TXSA,North Texas,Mean Green,UTSA,Roadrunners,4-4,6-2,0.0,6,3,27,31,6,0,7,14,0,3,7,21,-2.0,3,-4,0.5210468049610388,0.8919828121513547
4158,4158,2022,8,NCAAF_20221022_NWEST@MD,Northwestern,Wildcats,Maryland,Terrapins,1-6,6-2,0.0,17,10,24,31,7,10,0,7,0,10,14,7,-5.0,7,-7,0.5694804332215742,2.9583170036200954
4159,4159,2022,8,NCAAF_20221022_PURDUE@WISC,Purdue,Boilermakers,Wisconsin,Badgers,5-3,4-4,0.0,3,21,24,35,0,3,7,14,21,0,14,0,1.0,-18,-11,0.27427997906087875,-10.138452422262617
4160,4160,2022,8,NCAAF_20221022_TEXAS@OKLAST,Texas,Longhorns,Oklahoma State,Cowboys,5-3,6-1,1.0,31,24,34,41,14,17,3,0,10,14,3,14,-1.0,7,-7,0.5141775128190647,0.6007035449717932
4161,4161,2022,8,NCAAF_20221022_UCLA@OREG,UCLA,Bruins,Oregon,Ducks,6-1,6-1,0.0,13,31,30,45,3,10,3,14,3,28,7,7,0.0,-18,-15,0.29538725319734016,-9.087200662891973
4162,4162,2022,8,NCAAF_20221022_WMICH@MIAOH,W. Michigan,Broncos,Miami-OH,RedHawks,3-5,3-5,1.0,6,3,16,10,0,6,10,0,3,0,0,7,0.0,3,6,0.5305538922186017,1.2955687859366662
4163,4163,2022,8,NCAAF_20221022_ARIZST@STNFRD,Arizona St.,Sun Devils,Stanford,Cardinal,2-5,3-4,1.0,14,6,14,15,7,7,0,0,6,0,3,6,-1.0,8,-1,0.5434858390499018,1.8457773529423775
4164,4164,2022,8,NCAAF_20221022_FAU@UTEP,FAU,Owls,UTEP,Miners,3-5,4-4,0.0,7,6,21,24,0,7,7,7,0,6,8,10,-1.0,1,-3,0.8852650189314641,20.308786975457906
4165,4165,2022,8,NCAAF_20221022_HAWAII@COLOST,Hawaii,Rainbow Warriors,Colorado St.,Rams,2-6,2-5,1.0,13,3,13,17,3,10,0,0,0,3,7,7,0.0,10,-4,0.4060768003383268,-4.016189072754969
4166,4166,2022,8,NCAAF_20221022_VANDY@MIZZOU,Vanderbilt,Commodores,Missouri,Tigers,3-5,3-4,0.0,0,17,14,17,0,0,7,7,7,10,0,0,0.0,-17,-3,0.18136485484975484,-15.381692930714507
4167,4167,2022,8,NCAAF_20221022_ARKST@UL,Arkansas St.,Red Wolves,Louisiana,Ragin' Cajuns,2-6,4-3,1.0,9,24,18,38,0,9,3,6,10,14,14,0,-2.0,-15,-20,0.350374825666668,-6.494698537858312
4168,4168,2022,8,NCAAF_20221022_USM@TXSTSM,So. Miss,Golden Eagles,Texas St.,Bobcats,4-3,3-5,0.0,13,7,20,14,3,10,0,7,0,7,0,7,1.0,6,6,0.6981845387560308,8.774085909057703
4169,4169,2022,8,NCAAF_20221022_FRESNO@NMEX,Fresno St.,Bulldogs,New Mexico,Lobos,3-4,2-6,1.0,13,6,41,9,10,3,14,14,3,3,3,0,1.0,7,32,0.8738584719077918,19.34713182877408
4170,4170,2022,8,NCAAF_20221022_BOISE@AF,Boise St.,Broncos,Air Force,Falcons,5-2,5-3,1.0,19,7,19,14,10,9,0,0,0,7,0,7,0.0,12,5,0.6100086698557527,4.720787285614506
4171,4171,2022,8,NCAAF_20221022_MISSST@BAMA,Miss. State,Bulldogs,Alabama,Crimson Tide,5-3,7-1,1.0,0,24,6,30,0,0,0,6,7,17,0,6,-2.0,-24,-24,0.10499970132989356,-21.184896478068822
4172,4172,2022,8,NCAAF_20221022_MINN@PSU,Minnesota,Golden Gophers,Penn State,Nittany Lions,4-3,6-1,0.0,10,17,17,45,3,7,0,7,0,17,21,7,-2.0,-7,-28,0.2427455236461794,-11.787504633988647
4173,4173,2022,8,NCAAF_20221022_TXAM@SC,Texas A&M,Aggies,South Carolina,Gamecocks,3-4,5-2,1.0,14,17,24,30,3,11,7,3,17,0,7,6,-2.0,-3,-6,0.6949249651141644,8.616463909895174
4174,4174,2022,8,NCAAF_20221022_UCF@ECU,UCF,Knights,East Carolina,Pirates,5-2,5-3,0.0,3,17,13,34,0,3,7,3,3,14,7,10,0.0,-14,-21,0.9165918468677448,23.36392896647635
4175,4175,2022,8,NCAAF_20221022_COLO@OREGST,Colorado,Buffaloes,Oregon State,Beavers,1-6,6-2,1.0,3,21,9,42,0,3,6,0,7,14,14,7,-5.0,-18,-33,0.4828404099338667,-0.7271258597111228
4176,4176,2022,8,NCAAF_20221022_KSTATE@TCU,Kansas State,Wildcats,TCU,Horned Frogs,5-2,7-0,1.0,28,17,28,38,7,21,0,0,10,7,14,7,-2.0,11,-10,0.4612717289128213,-1.6431630660090377
4177,4177,2022,8,NCAAF_20221022_PITT@LVILLE,Pittsburgh,Panthers,Louisville,Cardinals,4-3,4-3,0.0,7,7,10,24,7,0,3,0,0,7,0,17,0.0,0,-14,0.5887677016924959,3.79188829481177
4178,4178,2022,8,NCAAF_20221022_UTAHST@WYO,Utah St.,Aggies,Wyoming,Cowboys,3-5,5-3,0.0,7,17,14,28,0,7,7,0,7,10,3,8,-2.0,-10,-14,0.5748110356070326,3.1878941593502077
4179,4179,2022,8,NCAAF_20221022_SDGST@NEVADA,San Diego St.,Aztecs,Nevada,Wolf Pack,4-3,2-6,0.0,13,7,23,7,10,3,10,0,0,7,0,0,2.0,6,16,0.6550170168626392,6.741307958052403
4180,4180,2022,8,NCAAF_20221022_WASH@CAL,Washington,Huskies,California,Golden Bears,6-2,3-4,1.0,6,0,28,21,6,0,8,14,0,0,14,7,3.0,6,7,0.7221147890092129,9.956206947741975
4181,4181,2022,8,NCAAF_20221021_TULSA@TEMPLE,Tulsa,Golden Hurricane,Temple,Owls,3-4,2-5,0.0,14,10,27,16,0,14,0,13,10,0,0,6,1.0,4,11,0.6314665036359743,5.673901101393085
4182,4182,2022,8,NCAAF_20221021_UAB@WKY,UAB,Blazers,W. Kentucky,Hilltoppers,4-3,5-3,0.0,17,10,17,20,7,10,0,0,0,10,10,0,-1.0,7,-3,0.5484082389359032,2.055691469465046
4183,4183,2022,8,NCAAF_20221020_TROY@SALA,Troy,Trojans,South Alabama,Jaguars,6-2,5-2,0.0,7,3,10,6,0,7,0,3,0,3,0,3,1.0,4,4,0.705271723981199,9.119474266965653
4184,4184,2022,8,NCAAF_20221020_UVA@GATECH,Virginia,Cavaliers,Georgia Tech,Yellow Jackets,3-4,3-4,0.0,13,9,16,9,7,6,3,0,6,3,0,0,0.0,4,7,0.6102354497095243,4.730777008288214
4185,4185,2022,8,NCAAF_20221019_GAST@APLST,Georgia St.,Panthers,App. St.,Mountaineers,2-5,4-3,0.0,14,7,17,42,14,0,0,3,0,7,21,14,-2.0,7,-25,0.14932891688362537,-17.564118012191102
4186,4186,2022,9,NCAAF_20221029_ARK@AUBURN,Arkansas,Razorbacks,Auburn,Tigers,5-3,3-5,1.0,17,13,41,27,7,10,14,10,3,10,0,14,2.0,4,14,0.15269400548113254,-17.321144967039345
4187,4187,2022,9,NCAAF_20221029_BC@UCONN,Boston College,Eagles,UConn,Huskies,2-6,4-5,0.0,3,10,3,13,0,3,0,0,10,0,0,3,-2.0,-7,-10,0.9467110910785053,27.27194088139413
4188,4188,2022,9,NCAAF_20221029_GATECH@FSU,Georgia Tech,Yellow Jackets,Florida State,Seminoles,3-5,5-3,1.0,3,24,16,41,3,0,7,6,7,17,7,10,-2.0,-21,-25,0.37948378662720605,-5.185402932479974
4189,4189,2022,9,NCAAF_20221029_MIAOH@AKRON,Miami-OH,RedHawks,Akron,Zips,4-5,1-8,1.0,17,3,27,9,7,10,0,10,0,3,0,6,3.0,14,18,0.8280741687362491,15.996810671355888
4190,4190,2022,9,NCAAF_20221029_ND@CUSE,Notre Dame,Fighting Irish,Syracuse,Orange,5-3,6-2,0.0,21,7,41,24,7,14,3,17,7,0,10,7,-1.0,14,17,0.8612542273630308,18.352426788700086
4191,4191,2022,9,NCAAF_20221029_OHIOST@PSU,Ohio State,Buckeyes,Penn State,Nittany Lions,8-0,6-2,1.0,13,14,44,31,10,3,3,28,0,14,0,17,2.0,-1,13,0.7317653161401004,10.44663596268856
4192,4192,2022,9,NCAAF_20221029_OKLA@IOWAST,Oklahoma,Sooners,Iowa St.,Cyclones,5-3,3-5,1.0,13,6,27,13,3,10,7,7,3,3,0,7,2.0,7,14,0.6367294814121425,5.910284755479552
4193,4193,2022,9,NCAAF_20221029_SFLA@HOU,South Florida,Bulls,Houston,Cougars,1-7,5-3,1.0,14,28,27,42,14,0,7,6,14,14,7,7,-4.0,-14,-15,0.2545202223349601,-11.15931993365507
4194,4194,2022,9,NCAAF_20221029_TCU@WVU,TCU,Horned Frogs,West Virginia,Mountaineers,8-0,3-5,1.0,28,21,41,31,7,21,0,13,7,14,3,7,5.0,7,10,0.5659111053154693,2.8048770266168503
4195,4195,2022,9,NCAAF_20221029_TOLEDO@EMICH,Toledo,Rockets,E. Michigan,Eagles,6-3,5-4,0.0,10,17,27,24,0,10,7,10,7,10,7,0,1.0,-7,3,0.6295022122767296,5.585895160140581
4196,4196,2022,9,NCAAF_20221029_CHARLO@RICE,Charlotte,49ers,Rice,Owls,2-7,4-4,0.0,28,17,56,23,7,21,21,7,14,3,0,6,-2.0,11,33,0.500540845112738,0.022910681000666955
4197,4197,2022,9,NCAAF_20221029_RUT@MINN,Rutgers,Scarlet Knights,Minnesota,Golden Gophers,4-4,5-3,1.0,0,14,0,31,0,0,0,0,0,14,0,17,-1.0,-14,-31,0.17489841521175142,-15.800795178733324
4198,4198,2022,9,NCAAF_20221029_ODU@GAST,Old Dominion,Monarchs,Georgia St.,Panthers,3-5,3-5,0.0,14,14,17,31,7,7,0,3,7,7,14,3,0.0,0,-14,0.40655166352341265,-3.9954656878289825
4199,4199,2022,9,NCAAF_20221029_CINCY@UCF,Cincinnati,Bearcats,UCF,Knights,6-2,6-2,0.0,6,10,21,25,0,6,7,8,10,0,2,13,0.0,-4,-4,0.43142313443164493,-2.9194323965787135
4200,4200,2022,9,NCAAF_20221029_FLA@UGA,Florida,Gators,Georgia,Bulldogs,4-4,8-0,0.0,3,28,20,42,0,3,17,0,14,14,7,7,-4.0,-25,-22,0.20116432758388847,-14.152855586962914
4201,4201,2022,9,NCAAF_20221029_ILL@NEB,Illinois,Fighting Illini,Nebraska,Cornhuskers,7-1,3-5,1.0,20,9,26,9,6,14,3,3,3,6,0,0,4.0,11,17,0.3565054583029462,-6.215912331726258
4202,4202,2022,9,NCAAF_20221029_NMEXST@UMASS,New Mexico St.,Aggies,UMass,Minutemen,3-5,1-7,1.0,10,13,23,13,0,10,6,7,3,10,0,0,2.0,-3,10,0.687906902939283,8.279528337096735
4203,4203,2022,9,NCAAF_20221029_NTEXAS@WKY,North Texas,Mean Green,W. Kentucky,Hilltoppers,5-4,5-4,0.0,20,13,40,13,17,3,0,20,7,6,0,0,0.0,7,27,0.41496765324648377,-3.6297610886642815
4204,4204,2022,9,NCAAF_20221029_NWEST@IOWA,Northwestern,Wildcats,Iowa,Hawkeyes,1-7,4-4,0.0,0,20,13,33,0,0,7,6,10,10,3,10,-3.0,-20,-20,0.20578025748430395,-13.87707111358236
4205,4205,2022,9,NCAAF_20221029_OKLAST@KSTATE,Oklahoma State,Cowboys,Kansas State,Wildcats,6-2,6-2,0.0,0,35,0,48,0,0,0,0,14,21,3,10,0.0,-35,-48,0.6453433171825886,6.299785818418513
4206,4206,2022,9,NCAAF_20221029_OREG@CAL,Oregon,Ducks,California,Golden Bears,7-1,3-5,0.0,21,10,42,24,0,21,7,14,3,7,0,14,4.0,11,18,0.7347245181436718,10.598806454908981
4207,4207,2022,9,NCAAF_20221029_ROB@APLST,Robert Morris,Colonials,App. St.,Mountaineers,0-8,5-3,0.0,3,21,3,42,3,0,0,0,14,7,14,7,-5.0,-18,-39,0.0054963683861445345,-42.97435455459981
4208,4208,2022,9,NCAAF_20221029_SMU@TULSA,SMU,Mustangs,Tulsa,Golden Hurricane,4-4,3-5,1.0,24,7,45,34,14,10,21,0,7,0,13,14,1.0,17,11,0.6506071311149538,6.5394499761412135
4209,4209,2022,9,NCAAF_20221029_WAKE@LVILLE,Wake Forest,Demon Deacons,Louisville,Cardinals,6-2,5-3,0.0,14,13,21,48,0,14,0,7,6,7,35,0,1.0,1,-27,0.5815921336996104,3.48076934926803
4210,4210,2022,9,NCAAF_20221029_MIZZOU@SC,Missouri,Tigers,South Carolina,Gamecocks,4-4,5-3,1.0,17,7,23,10,7,10,3,3,0,7,3,0,-1.0,10,13,0.5665596801742452,2.8327360876476178
4211,4211,2022,9,NCAAF_20221029_SALA@ARKST,South Alabama,Jaguars,Arkansas St.,Red Wolves,6-2,2-7,1.0,16,3,31,3,14,2,8,7,3,0,0,0,4.0,13,28,0.3398788584416167,-6.976027033482524
4212,4212,2022,9,NCAAF_20221029_COLOST@BOISE,Colorado St.,Rams,Boise St.,Broncos,2-6,6-2,1.0,10,28,10,49,3,7,0,0,14,14,21,0,-4.0,-18,-39,0.1729452057983626,-15.929350572776684
4213,4213,2022,9,NCAAF_20221029_CSTCAR@MRSHL,C. Carolina,Chanticleers,Marshall,Thundering Herd,7-1,4-4,1.0,21,10,24,13,21,0,0,3,0,10,3,0,3.0,11,11,0.3501827988663324,-6.503401255889003
4214,4214,2022,9,NCAAF_20221029_UAB@FAU,UAB,Blazers,FAU,Owls,4-4,4-5,1.0,14,10,17,24,0,14,3,0,10,0,14,0,0.0,4,-7,0.4689179366585383,-1.3179983968877877
4215,4215,2022,9,NCAAF_20221029_UK@TENN,Kentucky,Wildcats,Tennessee,Volunteers,5-3,8-0,0.0,6,27,6,44,6,0,0,0,7,20,10,7,-3.0,-21,-38,0.5557111026825149,2.367694452721935
4216,4216,2022,9,NCAAF_20221029_USC@ARIZ,USC,Trojans,Arizona,Wildcats,7-1,3-5,1.0,17,13,45,37,10,7,14,14,10,3,16,8,4.0,4,8,0.77400925417976,12.710413163017392
4217,4217,2022,9,NCAAF_20221029_ARIZST@COLO,Arizona St.,Sun Devils,Colorado,Buffaloes,3-5,1-7,0.0,28,17,42,34,14,14,7,7,3,14,3,14,2.0,11,8,0.7279856649080613,10.253497813440163
4218,4218,2022,9,NCAAF_20221029_BAYLOR@TXTECH,Baylor,Bears,Texas Tech,Red Raiders,5-3,4-4,1.0,17,3,45,17,3,14,7,21,0,3,14,0,1.0,14,28,0.5553681862115096,2.353025829201215
4219,4219,2022,9,NCAAF_20221029_MICHST@MICH,Michigan St.,Spartans,Michigan,Wolverines,3-5,8-0,1.0,7,13,7,29,7,0,0,0,3,10,6,10,-5.0,-6,-22,0.16684027530080914,-16.337245968898287
4220,4220,2022,9,NCAAF_20221029_MISS@TXAM,Ole Miss,Rebels,Texas A&M,Aggies,8-1,3-5,1.0,10,14,31,28,7,3,14,7,14,0,0,14,5.0,-4,3,0.3959686107797723,-4.458030178404897
4221,4221,2022,9,NCAAF_20221029_PITT@UNC,Pittsburgh,Panthers,North Carolina,Tar Heels,4-4,7-1,1.0,17,14,24,42,7,10,7,0,7,7,7,21,-3.0,3,-18,0.5486880658870705,2.0676159914871732
4222,4222,2022,9,NCAAF_20221029_MTSU@UTEP,Middle Tenn.,Blue Raiders,UTEP,Miners,4-4,4-5,1.0,10,10,24,13,10,0,7,7,0,10,0,3,0.0,0,11,0.7860063386487747,13.395263595460392
4223,4223,2022,9,NCAAF_20221029_NEVADA@SJST,Nevada,Wolf Pack,San Jose St.,Spartans,2-7,5-2,0.0,14,7,28,35,7,7,7,7,0,7,14,14,-3.0,7,-7,0.6488860874365402,6.460947519687807
4224,4224,2022,9,NCAAF_20221029_SDGST@FRESNO,San Diego St.,Aztecs,Fresno St.,Bulldogs,4-4,4-4,0.0,21,10,28,32,7,14,7,0,3,7,7,15,0.0,11,-4,0.454350176542229,-1.9380060484095338
4225,4225,2022,9,NCAAF_20221029_STNFRD@UCLA,Stanford,Cardinal,UCLA,Bruins,3-5,7-1,1.0,6,24,13,38,3,3,0,7,14,10,7,7,-4.0,-18,-25,0.4965414933627309,-0.14650721379825882
4226,4226,2022,9,NCAAF_20221029_WYO@HAWAII,Wyoming,,Hawaii,,6-3,2-7,,10,10,27,20,0,10,3,14,7,3,3,7,4.0,0,7,0.6831370134368341,8.052449115304853
4227,4227,2022,9,NCAAF_20221028_ECU@BYU,East Carolina,Pirates,BYU,Cougars,6-3,4-5,1.0,17,17,27,24,7,10,7,3,3,14,7,0,2.0,0,3,0.21539526701458245,-13.314131084694964
4228,4228,2022,9,NCAAF_20221027_UL@USM,Louisiana,Ragin' Cajuns,So. Miss,Golden Eagles,4-4,5-3,0.0,11,29,24,39,5,6,6,7,20,9,0,10,-1.0,-18,-15,0.7070843344552026,9.208340288684894
4229,4229,2022,9,NCAAF_20221027_VATECH@NCST,Virginia Tech,Hokies,NC State,Wolfpack,2-6,6-2,0.0,0,3,21,22,0,0,21,0,0,3,7,12,-4.0,-3,-1,0.4419675673830009,-2.467039352090751
4230,4230,2022,9,NCAAF_20221027_UTAH@WASHST,Utah,Utes,Washington St.,Cougars,6-2,4-4,1.0,14,7,21,17,0,14,7,0,0,7,0,10,2.0,7,4,0.653022771352082,6.649874224686755
4231,4231,2022,10,NCAAF_20221105_AF@ARMY,Air Force,Falcons,Army,Black Knights,6-3,3-5,1.0,3,7,13,7,3,0,7,3,0,7,0,0,3.0,-4,6,0.5773761873518177,3.3031550821021938
4232,4232,2022,10,NCAAF_20221105_FLA@TXAM,Florida,Gators,Texas A&M,Aggies,5-4,3-6,1.0,20,24,41,24,17,3,14,7,14,10,0,0,2.0,-4,17,0.5318160041903484,1.3510699476219088
4233,4233,2022,10,NCAAF_20221105_IOWA@PURDUE,Iowa,Hawkeyes,Purdue,Boilermakers,5-4,5-4,0.0,17,3,24,3,0,17,7,0,0,3,0,0,0.0,14,21,0.6697819507721265,7.434526909229589
4234,4234,2022,10,NCAAF_20221105_MD@WISC,Maryland,Terrapins,Wisconsin,Badgers,6-3,5-4,1.0,0,17,10,23,0,0,3,7,7,10,3,3,1.0,-17,-13,0.12689233905620578,-19.3127772397645
4235,4235,2022,10,NCAAF_20221105_MINN@NEB,Minnesota,Golden Gophers,Nebraska,Cornhuskers,6-3,3-6,0.0,0,10,20,13,0,0,10,10,10,0,0,3,3.0,-10,7,0.6347784306013134,5.830635203534484
4236,4236,2022,10,NCAAF_20221105_OHIOST@NWEST,Ohio State,Buckeyes,Northwestern,Wildcats,9-0,1-8,1.0,7,7,21,7,0,7,7,7,7,0,0,0,8.0,0,14,0.9627843996541559,30.190108640016206
4237,4237,2022,10,NCAAF_20221105_TULANE@TULSA,Tulane,Green Wave,Tulsa,Golden Hurricane,8-1,3-6,1.0,17,10,27,13,10,7,7,3,3,7,3,0,5.0,7,14,0.5924096191116694,3.9557485908785566
4238,4238,2022,10,NCAAF_20221105_TXTECH@TCU,Texas Tech,Red Raiders,TCU,Horned Frogs,4-5,9-0,1.0,10,13,24,34,10,0,7,7,7,6,0,21,-5.0,-3,-10,0.36395173596049246,-5.8878288713654
4239,4239,2022,10,NCAAF_20221105_UK@MIZZOU,Kentucky,Wildcats,Missouri,Tigers,6-3,4-5,0.0,7,3,21,17,7,0,7,7,3,0,0,14,2.0,4,4,0.5135162213437104,0.5734683511564072
4240,4240,2022,10,NCAAF_20221105_UNC@UVA,North Carolina,Tar Heels,Virginia,Cavaliers,8-1,3-6,0.0,10,14,31,28,3,7,14,7,7,7,7,7,5.0,-4,3,0.5545347977711244,2.320620457306859
4241,4241,2022,10,NCAAF_20221105_WKY@CHARLO,W. Kentucky,Hilltoppers,Charlotte,49ers,6-4,2-8,1.0,35,0,59,7,21,14,7,17,0,0,7,0,4.0,35,52,0.7583701408166819,11.864299842136461
4242,4242,2022,10,NCAAF_20221105_GATECH@VATECH,Georgia Tech,Yellow Jackets,Virginia Tech,Hokies,4-5,2-7,1.0,13,20,28,27,10,3,3,12,0,20,7,0,2.0,-7,1,0.33844989605734754,-7.051830331613246
4243,4243,2022,10,NCAAF_20221105_MRSHL@ODU,Marshall,Thundering Herd,Old Dominion,Monarchs,5-4,3-6,0.0,6,0,12,0,0,6,3,3,0,0,0,0,2.0,6,12,0.8184817171238743,15.393195697074589
4244,4244,2022,10,NCAAF_20221105_SFLA@TEMPLE,South Florida,Bulls,Temple,Owls,1-8,3-6,1.0,14,16,28,54,7,7,14,0,3,13,17,21,-2.0,-2,-26,0.527414419737492,1.1638374753570133
4245,4245,2022,10,NCAAF_20221105_BAYLOR@OKLA,Baylor,Bears,Oklahoma,Sooners,6-3,5-4,0.0,24,21,38,35,14,10,7,7,14,7,7,7,1.0,3,3,0.2172837151092708,-13.223742119390863
4246,4246,2022,10,NCAAF_20221105_GAST@USM,Georgia St.,Panthers,So. Miss,Golden Eagles,4-5,5-4,1.0,28,0,42,14,14,14,7,7,0,0,14,0,-1.0,28,28,0.4603873858055383,-1.6831393668512646
4247,4247,2022,10,NCAAF_20221105_MTSU@LATECH,Middle Tenn.,Blue Raiders,Louisiana Tech,Bulldogs,4-5,3-6,0.0,21,27,24,40,7,14,0,3,14,13,13,0,1.0,-6,-16,0.5247972735249224,1.052579539861199
4248,4248,2022,10,NCAAF_20221105_CUSE@PITT,Syracuse,Orange,Pittsburgh,Panthers,6-3,5-4,1.0,6,10,9,19,3,3,0,3,0,10,7,2,1.0,-4,-10,0.3805270210500964,-5.146276984831275
4249,4249,2022,10,NCAAF_20221105_MICHST@ILL,Michigan St.,Spartans,Illinois,Fighting Illini,4-5,7-2,1.0,9,7,23,15,3,6,14,0,7,0,0,8,-3.0,2,8,0.6913261426347812,8.455021307366906
4250,4250,2022,10,NCAAF_20221105_NMEX@UTAHST,New Mexico,Lobos,Utah St.,Aggies,2-7,4-5,1.0,10,7,10,27,3,7,0,0,7,0,10,10,-2.0,3,-17,0.17250051406966027,-15.981035358839108
4251,4251,2022,10,NCAAF_20221105_OKLAST@KANSAS,Oklahoma State,Cowboys,Kansas,Jayhawks,6-3,6-3,1.0,7,24,16,37,0,7,3,6,10,14,7,6,0.0,-17,-21,0.9267184397308678,24.568665356193605
4252,4252,2022,10,NCAAF_20221105_OREG@COLO,Oregon,Ducks,Colorado,Buffaloes,8-1,1-8,1.0,28,7,49,10,14,14,14,7,0,7,3,0,7.0,21,39,0.8569736843674661,18.053969698033825
4253,4253,2022,10,NCAAF_20221105_PSU@IND,Penn State,Nittany Lions,Indiana,Hoosiers,7-2,3-6,1.0,24,7,45,14,7,17,7,14,7,0,0,7,4.0,17,31,0.8608599419085501,18.347923354231398
4254,4254,2022,10,NCAAF_20221105_TENN@UGA,Tennessee,Volunteers,Georgia,Bulldogs,8-1,9-0,0.0,6,24,13,27,3,3,0,7,14,10,3,0,-1.0,-18,-14,0.10507001720072762,-21.207756787895732
4255,4255,2022,10,NCAAF_20221105_UCF@MEMP,UCF,Knights,Memphis,Tigers,7-2,4-5,1.0,21,14,35,28,7,14,0,14,7,7,7,7,3.0,7,7,0.6629620868303874,7.117211973801432
4256,4256,2022,10,NCAAF_20221105_WASHST@STNFRD,Washington St.,Cougars,Stanford,Cardinal,5-4,3-6,1.0,42,7,52,14,21,21,3,7,7,0,7,0,2.0,35,38,0.6112884097845175,4.783812290199876
4257,4257,2022,10,NCAAF_20221105_WVU@IOWAST,West Virginia,Mountaineers,Iowa St.,Cyclones,3-6,4-5,1.0,7,10,14,31,0,7,0,7,3,7,0,21,-1.0,-3,-17,0.33169427394637874,-7.365622909683452
4258,4258,2022,10,NCAAF_20221105_FIU@NTEXAS,FIU,Panthers,North Texas,Mean Green,4-5,6-4,0.0,14,45,14,52,0,14,0,0,24,21,0,7,-2.0,-31,-38,0.3159057154408229,-8.109213137050801
4259,4259,2022,10,NCAAF_20221105_LIB@ARK,Liberty,Flames,Arkansas,Razorbacks,8-1,5-4,0.0,21,3,21,19,7,14,0,0,0,3,2,14,3.0,18,2,0.35600081511916504,-6.247504046533322
4260,4260,2022,10,NCAAF_20221105_NAVY@CINCY,Navy,Midshipmen,Cincinnati,Bearcats,3-6,7-2,0.0,3,13,10,20,0,3,7,0,6,7,7,0,-4.0,-10,-10,0.24351020155553704,-11.762529255291156
4261,4261,2022,10,NCAAF_20221105_SALA@GAS,South Alabama,Jaguars,Ga. Southern,Eagles,7-2,5-4,1.0,17,24,38,31,7,10,7,14,21,3,7,0,2.0,-7,7,0.3984536559876961,-4.355199941759338
4262,4262,2022,10,NCAAF_20221105_TROY@UL,Troy,Trojans,Louisiana,Ragin' Cajuns,7-2,4-5,1.0,0,10,23,17,0,0,7,16,0,10,7,0,3.0,-10,6,0.39468999330636345,-4.520440179807565
4263,4263,2022,10,NCAAF_20221105_TXSTSM@LAMON,Texas St.,Bobcats,UL-Monroe,Warhawks,3-6,3-6,1.0,24,17,30,31,21,3,3,3,0,17,7,7,0.0,7,-1,0.4736819370826987,-1.11722422347043
4264,4264,2022,10,NCAAF_20221105_BYU@BOISE,BYU,Cougars,Boise St.,Broncos,5-5,,1.0,7,7,31,28,7,0,10,14,7,0,7,14,,0,3,0.39477186366223416,-4.516841203084368
4265,4265,2022,10,NCAAF_20221105_HOU@SMU,Houston,Cougars,SMU,Mustangs,5-4,5-4,0.0,35,56,63,77,14,21,14,14,21,35,7,14,0.0,-21,-14,0.49708195282305767,-0.12378477471361293
4266,4266,2022,10,NCAAF_20221105_TEXAS@KSTATE,Texas,Longhorns,Kansas State,Wildcats,6-3,6-3,1.0,31,10,34,27,14,17,0,3,7,3,7,10,0.0,21,7,0.6352255921076391,5.850767858729796
4267,4267,2022,10,NCAAF_20221105_UNLV@SDGST,UNLV,Rebels,San Diego St.,Aztecs,4-5,5-4,1.0,0,7,10,14,0,0,7,3,0,7,7,0,-1.0,-7,-4,0.1898042387186667,-14.868979764032701
4268,4268,2022,10,NCAAF_20221105_ARIZ@UTAH,Arizona,Wildcats,Utah,Utes,3-6,7-2,1.0,10,28,20,45,7,3,0,10,14,14,3,14,-4.0,-18,-25,0.1392420497662925,-18.340138014367994
4269,4269,2022,10,NCAAF_20221105_CLEM@ND,Clemson,Tigers,Notre Dame,Fighting Irish,8-1,6-3,0.0,0,14,14,35,0,0,0,14,7,7,0,21,2.0,-14,-21,0.6665493626892527,7.283801861156462
4270,4270,2022,10,NCAAF_20221105_FSU@MIAMI,Florida State,Seminoles,Miami (Fla.),Hurricanes,6-3,4-5,1.0,31,3,45,3,14,17,0,14,3,0,0,0,2.0,28,42,0.37506212746916423,-5.389608025202961
4271,4271,2022,10,NCAAF_20221105_JMAD@LVILLE,James Madison,Dukes,Louisville,Cardinals,5-3,6-3,1.0,10,10,10,34,3,7,0,0,7,3,10,14,-1.0,0,-24,0.5437914730643485,1.8613822592185443
4272,4272,2022,10,NCAAF_20221105_MICH@RUT,Michigan,Wolverines,Rutgers,Scarlet Knights,9-0,4-5,1.0,14,17,52,17,14,0,28,10,7,10,0,0,5.0,-3,35,0.9617445994292766,29.97597212886467
4273,4273,2022,10,NCAAF_20221105_SC@VANDY,South Carolina,Gamecocks,Vanderbilt,Commodores,6-3,3-6,0.0,31,14,38,27,17,14,7,0,7,7,7,6,3.0,17,11,0.7610277809111974,12.008877074729753
4274,4274,2022,10,NCAAF_20221105_WAKE@NCST,Wake Forest,Demon Deacons,NC State,Wolfpack,6-3,7-2,0.0,14,17,21,30,0,14,0,7,3,14,10,3,-1.0,-3,-9,0.48803405069187766,-0.5076721532939246
4275,4275,2022,10,NCAAF_20221105_CAL@USC,California,Golden Bears,USC,Trojans,3-6,8-1,0.0,7,20,35,41,7,0,7,21,6,14,14,7,-5.0,-13,-6,0.35355428206020023,-6.358740255512657
4276,4276,2022,10,NCAAF_20221105_COLOST@SJST,Colorado St.,Rams,San Jose St.,Spartans,2-7,6-2,1.0,10,7,16,28,7,3,0,6,0,7,7,14,-4.0,3,-12,0.6019229065925673,4.3717136438162925
4277,4277,2022,10,NCAAF_20221105_HAWAII@FRESNO,Hawaii,Rainbow Warriors,Fresno St.,Bulldogs,2-8,5-4,1.0,0,31,13,55,0,0,0,13,17,14,10,14,-3.0,-31,-42,0.1963484660034085,-14.4648343068327
4278,4278,2022,10,NCAAF_20221105_UCLA@ARIZST,UCLA,Bruins,Arizona St.,Sun Devils,8-1,3-6,1.0,28,10,50,36,14,14,14,8,10,0,15,11,5.0,18,14,0.4730293870505733,-1.1449673214383438
4279,4279,2022,10,NCAAF_20221104_DUKE@BC,Duke,Blue Devils,Boston College,Eagles,6-3,2-7,1.0,24,14,38,31,10,14,7,7,7,7,7,10,4.0,10,7,0.3846079086825732,-4.965264656608042
4280,4280,2022,10,NCAAF_20221104_UMASS@UCONN,UMass,Minutemen,UConn,Huskies,1-8,5-5,1.0,10,13,10,27,3,7,0,0,7,6,7,7,-4.0,-3,-17,0.3703696264729861,-5.5994383456895775
4281,4281,2022,10,NCAAF_20221104_OREGST@WASH,Oregon State,Beavers,Washington,Huskies,6-3,7-2,1.0,14,7,21,24,7,7,7,0,0,7,7,10,-1.0,7,-3,0.1819699521651863,-15.364241393154543
4282,4282,2022,10,NCAAF_20221103_UTEP@RICE,UTEP,Miners,Rice,Owls,4-6,5-5,1.0,17,20,30,37,7,10,3,10,10,10,7,10,-1.0,-3,-7,0.4342408086386671,-2.8022608327910348
4283,4283,2022,10,NCAAF_20221103_APLST@CSTCAR,App. St.,Mountaineers,C. Carolina,Chanticleers,5-4,8-1,1.0,14,21,28,35,7,7,0,14,14,7,0,14,-3.0,-7,-7,0.7698116223454472,12.493117089573161
4284,4284,2022,10,NCAAF_20221102_CMICH@NILL,C. Michigan,Chippewas,N. Illinois,Huskies,3-6,2-7,0.0,21,0,35,22,14,7,7,7,0,0,7,15,1.0,21,13,0.4859453351624158,-0.5963227921386078
4285,4285,2022,10,NCAAF_20221102_WMICH@BGREEN,W. Michigan,Broncos,Bowling Green,Falcons,3-6,5-4,1.0,0,6,9,13,0,0,6,3,0,6,7,0,-2.0,-6,-4,0.8479736347076857,17.393292964000693
4286,4286,2022,10,NCAAF_20221101_BALLST@KENTST,Ball St.,Cardinals,Kent St.,Golden Flashes,5-4,3-6,0.0,17,13,27,20,0,17,3,7,13,0,0,7,2.0,4,7,0.5398315344237882,1.6924722722944807
4287,4287,2022,10,NCAAF_20221101_BUFF@OHIO,Buffalo,Bulls,Ohio,Bobcats,5-4,6-3,1.0,10,24,24,45,0,10,14,0,17,7,7,14,-1.0,-14,-21,0.5059186084059657,0.251076801732097
4288,4288,2022,11,NCAAF_20221112_IND@OHIOST,Indiana,Hoosiers,Ohio State,Buckeyes,3-7,10-0,0.0,7,28,14,56,7,0,0,7,21,7,14,14,-7.0,-21,-42,0.04418975684280779,-28.841997260323524
4289,4289,2022,11,NCAAF_20221112_LIB@UCONN,Liberty,Flames,UConn,Huskies,8-2,6-5,0.0,17,21,33,36,3,14,10,6,14,7,0,15,2.0,-4,-3,0.8595063500866825,18.247958890092832
4290,4290,2022,11,NCAAF_20221112_LSU@ARK,LSU,Tigers,Arkansas,Razorbacks,8-2,5-5,1.0,6,3,13,10,0,6,7,0,3,0,0,7,3.0,3,3,0.834577211241252,16.4590189731764
4291,4291,2022,11,NCAAF_20221112_MIZZOU@TENN,Missouri,Tigers,Tennessee,Volunteers,4-6,9-1,1.0,17,28,24,66,7,10,7,0,7,21,21,17,-5.0,-11,-42,0.5101687031829287,0.4314754932509004
4292,4292,2022,11,NCAAF_20221112_ND@NAVY,Notre Dame,Fighting Irish,Navy,Midshipmen,7-3,3-7,1.0,35,13,35,32,14,21,0,0,6,7,3,16,4.0,22,3,0.9096991416346835,22.66226131149847
4293,4293,2022,11,NCAAF_20221112_OKLA@WVU,Oklahoma,Sooners,West Virginia,Mountaineers,5-5,4-6,1.0,12,6,20,23,0,12,8,0,0,6,7,10,1.0,6,-3,0.7873050674240121,13.491781633873188
4294,4294,2022,11,NCAAF_20221112_PITT@UVA,Pittsburgh,Panthers,Virginia,Cavaliers,6-4,3-7,0.0,28,0,37,7,28,0,3,6,0,0,7,0,3.0,28,30,0.5883108722049599,3.777911460291307
4295,4295,2022,11,NCAAF_20221112_PURDUE@ILL,Purdue,Boilermakers,Illinois,Fighting Illini,6-4,7-3,1.0,14,14,31,24,0,14,7,10,7,7,7,3,-1.0,0,7,0.7256887954565056,10.152632305140287
4296,4296,2022,11,NCAAF_20221112_RUT@MICHST,Rutgers,Scarlet Knights,Michigan St.,Spartans,4-6,5-5,0.0,7,14,21,27,0,7,7,7,7,7,7,6,-1.0,-7,-6,0.21266438301593515,-13.49356252365078
4297,4297,2022,11,NCAAF_20221112_SMU@SFLA,SMU,Mustangs,South Florida,Bulls,6-4,1-9,1.0,17,17,41,23,10,7,21,3,0,17,0,6,5.0,0,18,0.7606501301199898,11.990280274831775
4298,4298,2022,11,NCAAF_20221112_VANDY@UK,Vanderbilt,Commodores,Kentucky,Wildcats,4-6,6-4,1.0,7,6,24,21,7,0,7,10,6,0,3,12,-2.0,1,3,0.17438774738969776,-15.859077589568415
4299,4299,2022,11,NCAAF_20221112_VATECH@DUKE,Virginia Tech,Hokies,Duke,Blue Devils,2-8,7-3,0.0,7,10,7,24,7,0,0,0,3,7,7,7,-5.0,-3,-17,0.6630189772702804,7.121036826743875
4300,4300,2022,11,NCAAF_20221112_JMAD@ODU,James Madison,Dukes,Old Dominion,Monarchs,6-3,3-7,0.0,17,3,37,3,7,10,13,7,0,3,0,0,3.0,14,34,0.8813015647394572,19.998345305219118
4301,4301,2022,11,NCAAF_20221112_LAMON@GAST,UL-Monroe,Warhawks,Georgia St.,Panthers,4-6,4-6,1.0,20,21,31,28,3,17,0,11,14,7,7,0,0.0,-1,3,0.3430657217173396,-6.839963105020161
4302,4302,2022,11,NCAAF_20221112_LAMAR@NMEXST,Lamar,Cardinals,New Mexico St.,Aggies,1-9,4-5,1.0,0,37,14,51,0,0,7,7,17,20,14,0,-3.0,-37,-37,0.032486231415047806,-31.235991690098217
4303,4303,2022,11,NCAAF_20221112_RICE@WKY,Rice,Owls,W. Kentucky,Hilltoppers,5-5,7-4,0.0,7,24,10,45,0,7,3,0,7,17,7,14,-2.0,-17,-35,0.21345921236330967,-13.447276353495909
4304,4304,2022,11,NCAAF_20221112_TEMPLE@HOU,Temple,Owls,Houston,Cougars,3-7,6-4,1.0,19,14,36,43,7,12,7,10,0,14,14,15,-3.0,5,-7,0.2431822639510336,-11.782213831020727
4305,4305,2022,11,NCAAF_20221112_UMASS@ARKST,UMass,Minutemen,Arkansas St.,Red Wolves,1-9,3-7,1.0,6,14,33,35,3,3,13,14,14,0,21,0,-2.0,-8,-2,0.11612521231969342,-20.219458667398385
4306,4306,2022,11,NCAAF_20221112_APLST@MRSHL,App. St.,Mountaineers,Marshall,Thundering Herd,5-5,6-4,0.0,7,14,21,28,0,7,7,7,7,7,14,0,-1.0,-7,-7,0.646964835748844,6.383443371529438
4307,4307,2022,11,NCAAF_20221112_ARIZST@WASHST,Arizona St.,Sun Devils,Washington St.,Cougars,3-7,6-4,0.0,0,28,18,28,0,0,6,12,13,15,0,0,-3.0,-28,-10,0.4173794180671808,-3.5307938664536778
4308,4308,2022,11,NCAAF_20221112_ARMY@TROY,Army,Black Knights,Troy,Trojans,3-6,8-2,1.0,9,0,9,10,0,9,0,0,0,0,3,7,-5.0,9,-1,0.6350350509318122,5.843163151635281
4309,4309,2022,11,NCAAF_20221112_BAMA@MISS,Alabama,Crimson Tide,Ole Miss,Rebels,8-2,8-2,0.0,14,17,30,24,0,14,10,6,7,10,7,0,0.0,-3,6,0.9307396310427805,25.07281654096937
4310,4310,2022,11,NCAAF_20221112_BC@NCST,Boston College,Eagles,NC State,Wolfpack,3-7,7-3,1.0,7,17,21,20,7,0,7,7,14,3,3,0,-4.0,-10,1,0.37705353045025947,-5.301696668792829
4311,4311,2022,11,NCAAF_20221112_CHARLO@MTSU,Charlotte,49ers,Middle Tenn.,Blue Raiders,2-9,5-5,1.0,14,7,14,24,0,14,0,0,0,7,7,10,-3.0,7,-10,0.2847403673772373,-9.62777015463098
4312,4312,2022,11,NCAAF_20221112_IOWAST@OKLAST,Iowa St.,Cyclones,Oklahoma State,Cowboys,4-6,7-3,0.0,7,10,14,20,0,7,7,0,0,10,0,10,-3.0,-3,-6,0.5384506826119886,1.633885594597814
4313,4313,2022,11,NCAAF_20221112_LATECH@TXSA,Louisiana Tech,Bulldogs,UTSA,Roadrunners,3-7,8-2,1.0,7,34,7,51,7,0,0,0,21,13,10,7,-5.0,-27,-44,0.5128886022042437,0.5469214007064238
4314,4314,2022,11,NCAAF_20221112_LVILLE@CLEM,Louisville,Cardinals,Clemson,Tigers,6-4,9-1,0.0,7,17,16,31,0,7,3,6,10,7,7,7,-3.0,-10,-15,0.09534870367915693,-22.14795109155625
4315,4315,2022,11,NCAAF_20221112_MD@PSU,Maryland,Terrapins,Penn State,Nittany Lions,6-4,8-2,1.0,0,27,0,30,0,0,0,0,14,13,3,0,-2.0,-27,-30,0.09388246121364274,-22.29522606182104
4316,4316,2022,11,NCAAF_20221112_MIAMI@GATECH,Miami (Fla.),Hurricanes,Georgia Tech,Yellow Jackets,5-5,4-6,1.0,14,7,35,14,7,7,0,21,0,7,0,7,1.0,7,21,0.7297651933036503,10.360437652429482
4317,4317,2022,11,NCAAF_20221112_NEB@MICH,Nebraska,Cornhuskers,Michigan,Wolverines,3-7,10-0,1.0,3,17,3,34,0,3,0,0,7,10,7,10,-7.0,-14,-31,0.12351858481619915,-19.593095329373227
4318,4318,2022,11,NCAAF_20221112_NMEX@AF,New Mexico,Lobos,Air Force,Falcons,2-8,7-3,1.0,0,14,3,35,0,0,3,0,14,0,14,7,-5.0,-14,-32,0.11283520009686687,-20.50729150551092
4319,4319,2022,11,NCAAF_20221112_NTEXAS@UAB,North Texas,Mean Green,UAB,Blazers,5-5,,1.0,21,17,21,41,0,21,0,0,14,3,10,14,,4,-20,0.3940301057382136,-4.550215284086335
4320,4320,2022,11,NCAAF_20221112_NWEST@MINN,Northwestern,Wildcats,Minnesota,Golden Gophers,1-9,7-3,0.0,3,14,3,31,0,3,0,0,7,7,3,14,-6.0,-11,-28,0.331546900760332,-7.373726668241034
4321,4321,2022,11,NCAAF_20221112_UCF@TULANE,UCF,Knights,Tulane,Green Wave,8-2,8-2,1.0,24,14,38,31,17,7,7,7,7,7,3,14,0.0,10,7,0.7666063776226912,12.317305742356893
4322,4322,2022,11,NCAAF_20221112_WISC@IOWA,Wisconsin,Badgers,Iowa,Hawkeyes,5-5,6-4,0.0,10,14,10,24,3,7,0,0,0,14,0,10,-1.0,-4,-14,0.5564596214455182,2.403471789467403
4323,4323,2022,11,NCAAF_20221112_SC@FLA,South Carolina,Gamecocks,Florida,Gators,6-4,6-4,0.0,6,24,6,38,0,6,0,0,21,3,7,7,0.0,-18,-32,0.2808223550741197,-9.823838501783257
4324,4324,2022,11,NCAAF_20221112_TXSTSM@SALA,Texas St.,Bobcats,South Alabama,Jaguars,3-7,8-2,0.0,0,17,21,38,0,0,7,14,10,7,7,14,-5.0,-17,-17,0.3875421862841333,-4.836269930905246
4325,4325,2022,11,NCAAF_20221112_FAU@FIU,FAU,Owls,FIU,Panthers,5-5,4-6,0.0,31,7,52,7,21,10,14,7,0,7,0,0,1.0,24,45,0.8133066321116935,15.066609399932759
4326,4326,2022,11,NCAAF_20221112_KANSAS@TXTECH,Kansas,Jayhawks,Texas Tech,Red Raiders,6-4,5-5,0.0,21,27,28,43,7,14,0,7,17,10,0,16,1.0,-6,-15,0.19744058757287464,-14.400594446708055
4327,4327,2022,11,NCAAF_20221112_KSTATE@BAYLOR,Kansas State,Wildcats,Baylor,Bears,7-3,6-4,1.0,17,3,31,3,0,17,7,7,0,3,0,0,1.0,14,28,0.5297753012525387,1.2644553464974706
4328,4328,2022,11,NCAAF_20221112_UGA@MISSST,Georgia,Bulldogs,Miss. State,Bulldogs,10-0,6-4,1.0,17,12,45,19,7,10,14,14,0,12,7,0,4.0,5,26,0.8290214638448393,16.084842488601907
4329,4329,2022,11,NCAAF_20221112_WASH@OREG,Washington,Huskies,Oregon,Ducks,8-2,8-2,1.0,13,10,37,34,7,6,14,10,3,7,21,3,0.0,3,3,0.46516101731195325,-1.4800013966280403
4330,4330,2022,11,NCAAF_20221112_WYO@COLOST,Wyoming,Cowboys,Colorado St.,Rams,7-3,2-8,1.0,7,10,14,13,0,7,0,7,7,3,0,3,5.0,-3,1,0.6108937224186279,4.767185225476851
4331,4331,2022,11,NCAAF_20221112_TCU@TEXAS,TCU,Horned Frogs,Texas,Longhorns,10-0,6-4,1.0,3,0,17,10,0,3,7,7,0,0,3,7,4.0,3,7,0.39397480780880156,-4.552647790372248
4332,4332,2022,11,NCAAF_20221112_TXAM@AUBURN,Texas A&M,Aggies,Auburn,Tigers,3-7,4-6,1.0,0,7,10,13,0,0,0,10,7,0,3,3,-1.0,-7,-3,0.40029543603494,-4.275203703950183
4333,4333,2022,11,NCAAF_20221112_UNC@WAKE,North Carolina,Tar Heels,Wake Forest,Demon Deacons,9-1,6-4,0.0,27,21,36,34,14,13,6,3,7,14,13,0,3.0,6,2,0.4657455374859071,-1.455108495914601
4334,4334,2022,11,NCAAF_20221112_USM@CSTCAR,So. Miss,Golden Eagles,C. Carolina,Chanticleers,5-5,9-1,0.0,17,17,23,26,0,17,3,3,17,0,3,6,-4.0,0,-3,0.40394662443241014,-4.115461370787671
4335,4335,2022,11,NCAAF_20221112_FSU@CUSE,Florida State,Seminoles,Syracuse,Orange,7-3,6-4,0.0,24,3,38,3,14,10,14,0,0,3,0,0,1.0,21,35,0.5637101770741271,2.7146323112965547
4336,4336,2022,11,NCAAF_20221112_CAL@OREGST,California,Golden Bears,Oregon State,Beavers,3-7,7-3,1.0,7,21,10,38,0,7,0,3,14,7,10,7,-4.0,-14,-28,0.6228972241735917,5.299502323627621
4337,4337,2022,11,NCAAF_20221112_STNFRD@UTAH,Stanford,Cardinal,Utah,Utes,3-7,8-2,0.0,7,14,7,42,7,0,0,0,0,14,21,7,-5.0,-7,-35,0.24004852455657666,-11.952214893494101
4338,4338,2022,11,NCAAF_20221112_ARIZ@UCLA,Arizona,Wildcats,UCLA,Bruins,4-6,8-2,1.0,21,14,34,28,14,7,0,13,0,14,7,7,-4.0,7,6,0.3135975839613431,-8.220579323948414
4339,4339,2022,11,NCAAF_20221112_BOISE@NEVADA,Boise St.,Broncos,Nevada,Wolf Pack,7-3,2-8,1.0,21,3,41,3,14,7,17,3,0,3,0,0,5.0,18,38,0.808662569966475,14.776006863113935
4340,4340,2022,11,NCAAF_20221112_SJST@SDGST,San Jose St.,Spartans,San Diego St.,Aztecs,6-3,6-4,1.0,14,24,27,43,14,0,6,7,7,17,14,5,0.0,-10,-16,0.225760750191901,-12.743239942008358
4341,4341,2022,11,NCAAF_20221112_UTAHST@HAWAII,Utah St.,Aggies,Hawaii,Rainbow Warriors,5-5,2-9,0.0,24,10,41,34,10,14,10,7,0,10,7,17,3.0,14,7,0.7430851022729947,11.050729012618149
4342,4342,2022,11,NCAAF_20221111_ECU@CINCY,East Carolina,Pirates,Cincinnati,Bearcats,6-4,8-2,0.0,12,24,25,27,5,7,13,0,7,17,0,3,-2.0,-12,-2,0.1326372117578818,-18.85571969378202
4343,4343,2022,11,NCAAF_20221111_COLO@USC,Colorado,Buffaloes,USC,Trojans,1-9,9-1,1.0,3,26,17,55,3,0,7,7,2,24,15,14,-8.0,-23,-38,0.2044355271284486,-13.978854180540111
4344,4344,2022,11,NCAAF_20221111_FRESNO@UNLV,Fresno St.,Bulldogs,UNLV,Rebels,6-4,4-6,0.0,14,16,37,30,7,7,10,13,10,6,3,11,2.0,-2,7,0.8448261307288534,17.171273108544483
4345,4345,2022,11,NCAAF_20221110_GAS@UL,Ga. Southern,Eagles,Louisiana,Ragin' Cajuns,5-5,5-5,1.0,7,27,17,36,0,7,7,3,7,20,3,6,0.0,-20,-19,0.30324593471723815,-8.718356309095725
4346,4346,2022,11,NCAAF_20221110_TULSA@MEMP,Tulsa,Golden Hurricane,Memphis,Tigers,3-7,5-5,0.0,3,20,10,26,3,0,0,7,10,10,3,3,-2.0,-17,-16,0.28785397047504746,-9.472874064350208
4347,4347,2022,11,NCAAF_20221109_BUFF@CMICH,Buffalo,Bulls,C. Michigan,Chippewas,5-5,4-6,1.0,24,7,27,31,7,17,0,3,7,0,17,7,1.0,17,-4,0.5932486464489617,3.993001499137563
4348,4348,2022,11,NCAAF_20221109_KENTST@BGREEN,Kent St.,Golden Flashes,Bowling Green,Falcons,4-6,5-5,1.0,20,0,40,6,0,20,3,17,0,0,6,0,-1.0,20,34,0.6798773208869429,7.910450320535574
4349,4349,2022,11,NCAAF_20221109_NILL@WMICH,N. Illinois,Huskies,W. Michigan,Broncos,3-7,3-7,1.0,10,14,24,21,3,7,7,7,7,7,7,0,0.0,-4,3,0.47157374589326095,-1.2070663871852503
4350,4350,2022,11,NCAAF_20221108_EMICH@AKRON,E. Michigan,Eagles,Akron,Zips,6-4,1-9,1.0,24,14,34,28,10,14,7,3,7,7,0,14,5.0,10,6,0.8257372689734652,15.86730654038729
4351,4351,2022,11,NCAAF_20221108_OHIO@MIAOH,Ohio,Bobcats,Miami-OH,RedHawks,7-3,4-6,0.0,10,7,37,21,7,3,14,13,0,7,7,7,3.0,3,16,0.5930021530205835,3.9822491998597798
4352,4352,2022,11,NCAAF_20221108_BALLST@TOLEDO,Ball St.,Cardinals,Toledo,Rockets,5-5,7-3,1.0,14,14,21,28,7,7,7,0,7,7,7,7,-2.0,0,-7,0.2530448287238739,-11.254734367312722
4353,4353,2022,12,NCAAF_20221119_NAVY@UCF,Navy,Midshipmen,UCF,Knights,4-7,8-3,1.0,14,6,17,14,7,7,3,0,0,6,8,0,-4.0,8,3,0.19876331422675175,-14.315413146261562
4354,4354,2022,12,NCAAF_20221119_AP@BAMA,Austin Peay,Governors,Alabama,Crimson Tide,7-4,9-2,0.0,0,17,0,34,0,0,0,0,7,10,10,7,-2.0,-17,-34,0.0002188068094149953,-59.496971134083196
4355,4355,2022,12,NCAAF_20221119_DUKE@PITT,Duke,Blue Devils,Pittsburgh,Panthers,7-4,7-4,1.0,14,20,26,28,7,7,0,12,10,10,0,8,0.0,-6,-2,0.2911395540528646,-9.307189031217376
4356,4356,2022,12,NCAAF_20221119_ETNST@MISSST,ETSU,Buccaneers,Miss. State,Bulldogs,3-8,7-4,0.0,0,35,7,56,0,0,0,7,14,21,14,7,-4.0,-35,-49,0.009240274057956688,-39.86176251541838
4357,4357,2022,12,NCAAF_20221119_FLA@VANDY,Florida,Gators,Vanderbilt,Commodores,6-5,5-6,0.0,6,14,24,31,3,3,6,12,0,14,14,3,1.0,-8,-7,0.901787720957649,21.85780635656465
4358,4358,2022,12,NCAAF_20221119_ILL@MICH,Illinois,Fighting Illini,Michigan,Wolverines,7-4,11-0,0.0,3,7,17,19,0,3,14,0,7,0,3,9,-4.0,-4,-2,0.06825411293821593,-25.193069690151333
4359,4359,2022,12,NCAAF_20221119_NWEST@PURDUE,Northwestern,Wildcats,Purdue,Boilermakers,1-10,7-4,0.0,3,14,9,17,0,3,0,6,7,7,0,3,-6.0,-11,-8,0.35184056559761223,-6.43575977226601
4360,4360,2022,12,NCAAF_20221119_TCU@BAYLOR,TCU,Horned Frogs,Baylor,Bears,11-0,6-5,0.0,14,14,29,28,7,7,6,9,7,7,0,14,5.0,0,1,0.5737381168950022,3.1454815442702966
4361,4361,2022,12,NCAAF_20221119_UCONN@ARMY,UConn,Huskies,Army,Black Knights,6-6,4-6,1.0,10,13,17,34,3,7,7,0,7,6,14,7,2.0,-3,-17,0.09339327255096608,-22.337326453701053
4362,4362,2022,12,NCAAF_20221119_UL@FSU,Louisiana,Ragin' Cajuns,Florida State,Seminoles,5-6,8-3,0.0,3,35,17,49,0,3,0,14,21,14,14,0,-3.0,-32,-32,0.3403580429842137,-6.962492274194119
4363,4363,2022,12,NCAAF_20221119_UMASS@TXAM,UMass,Minutemen,Texas A&M,Aggies,1-10,4-7,0.0,3,10,3,20,0,3,0,0,3,7,3,7,-3.0,-7,-17,0.006389282721425138,-42.12968272571493
4364,4364,2022,12,NCAAF_20221119_VATECH@LIB,Virginia Tech,Hokies,Liberty,Flames,3-8,8-3,1.0,17,17,23,22,7,10,0,6,7,10,5,0,-5.0,0,1,0.7196526809450953,9.844432952276065
4365,4365,2022,12,NCAAF_20221119_WISC@NEB,Wisconsin,Badgers,Nebraska,Cornhuskers,6-5,3-8,0.0,0,7,15,14,0,0,3,12,0,7,7,0,3.0,-7,1,0.8102245428759671,14.868323618176873
4366,4366,2022,12,NCAAF_20221119_TXSA@RICE,UTSA,Roadrunners,Rice,Owls,9-2,5-6,1.0,28,0,41,7,21,7,13,0,0,0,0,7,4.0,28,34,0.7239220131139423,10.059702398259105
4367,4367,2022,12,NCAAF_20221119_GAST@JMAD,Georgia St.,Panthers,James Madison,Dukes,4-7,7-3,1.0,34,14,40,42,10,24,0,6,7,7,21,7,-3.0,20,-2,0.16341573639523388,-16.5906796950012
4368,4368,2022,12,NCAAF_20221119_HOU@ECU,Houston,Cougars,East Carolina,Pirates,7-4,6-5,0.0,21,0,42,3,7,14,14,7,0,0,3,0,1.0,21,39,0.7541069101929945,11.632248282425508
4369,4369,2022,12,NCAAF_20221119_KSTATE@WVU,Kansas State,Wildcats,West Virginia,Mountaineers,8-3,4-7,1.0,41,25,48,31,28,13,0,7,19,6,0,6,4.0,16,17,0.549491355501118,2.1044922864857654
4370,4370,2022,12,NCAAF_20221119_NAL@MEMP,North Alabama,Lions,Memphis,Tigers,1-10,6-5,0.0,0,38,0,59,0,0,0,0,14,24,14,7,-5.0,-38,-59,0.0127897965751127,-37.77529463506107
4371,4371,2022,12,NCAAF_20221119_WASHST@ARIZ,Washington St.,Cougars,Arizona,Wildcats,7-4,4-7,1.0,21,6,31,20,7,14,10,0,0,6,0,14,3.0,15,11,0.7667546226810282,12.321414468721514
4372,4372,2022,12,NCAAF_20221119_OREGST@ARIZST,Oregon State,Beavers,Arizona St.,Sun Devils,8-3,3-8,0.0,14,7,31,7,7,7,14,3,0,7,0,0,5.0,7,24,0.3333275253305106,-7.288329440956886
4373,4373,2022,12,NCAAF_20221119_BC@ND,Boston College,Eagles,Notre Dame,Fighting Irish,3-8,8-3,0.0,0,37,0,44,0,0,0,0,17,20,7,0,-5.0,-37,-44,0.14719833963297857,-17.74142015238226
4374,4374,2022,12,NCAAF_20221119_ODU@APLST,Old Dominion,Monarchs,App. St.,Mountaineers,3-8,6-5,1.0,0,24,14,27,0,0,0,14,10,14,3,0,-3.0,-24,-13,0.09997577828002413,-21.686643976837104
4375,4375,2022,12,NCAAF_20221119_FAU@MTSU,FAU,Owls,Middle Tenn.,Blue Raiders,5-6,6-5,0.0,14,28,21,49,7,7,7,0,14,14,14,7,-1.0,-14,-28,0.6605507383303048,7.004463189355647
4376,4376,2022,12,NCAAF_20221119_LAMON@TROY,UL-Monroe,Warhawks,Troy,Trojans,4-7,9-2,0.0,3,20,16,34,0,3,7,6,3,17,7,7,-5.0,-17,-18,0.23664918092820098,-12.133972022132866
4377,4377,2022,12,NCAAF_20221119_LATECH@CHARLO,Louisiana Tech,Bulldogs,Charlotte,49ers,3-8,3-9,1.0,7,13,21,26,0,7,0,14,0,13,6,7,0.0,-6,-5,0.6921223174098018,8.491905658048836
4378,4378,2022,12,NCAAF_20221119_MIAMI@CLEM,Miami (Fla.),Hurricanes,Clemson,Tigers,5-6,10-1,0.0,0,24,10,40,0,0,3,7,14,10,2,14,-5.0,-24,-30,0.14097758408235483,-18.205246884465396
4379,4379,2022,12,NCAAF_20221119_NCST@LVILLE,NC State,Wolfpack,Louisville,Cardinals,7-4,7-4,0.0,3,13,10,25,0,3,7,0,0,13,0,12,0.0,-10,-15,0.5632348616551833,2.6933131668056376
4380,4380,2022,12,NCAAF_20221119_OHIOST@MD,Ohio State,Buckeyes,Maryland,Terrapins,11-0,6-5,1.0,10,13,43,30,7,3,17,16,6,7,0,17,5.0,-3,13,0.9732126391460241,32.66067355282735
4381,4381,2022,12,NCAAF_20221119_PSU@RUT,Penn State,Nittany Lions,Rutgers,Scarlet Knights,9-2,4-7,1.0,28,10,55,10,14,14,20,7,10,0,0,0,5.0,18,45,0.9548942178082267,28.667867192292306
4382,4382,2022,12,NCAAF_20221119_SALA@USM,South Alabama,Jaguars,So. Miss,Golden Eagles,9-2,5-6,1.0,13,10,27,20,3,10,0,14,7,3,7,3,4.0,3,7,0.41054015780725905,-3.8266351004872377
4383,4383,2022,12,NCAAF_20221119_TEXAS@KANSAS,Texas,Longhorns,Kansas,Jayhawks,7-4,6-5,1.0,31,0,55,14,14,17,10,14,0,0,7,7,1.0,31,41,0.9285998603642873,24.795805416690882
4384,4384,2022,12,NCAAF_20221119_UGA@UK,Georgia,Bulldogs,Kentucky,Wildcats,11-0,6-5,0.0,9,0,16,6,3,6,7,0,0,0,0,6,5.0,9,10,0.884471524067939,20.264505574152736
4385,4385,2022,12,NCAAF_20221119_UTTCH@BYU,Utah Tech,Trailblazers,BYU,Cougars,4-7,6-5,0.0,20,28,26,52,6,14,0,6,0,28,7,17,-2.0,-8,-26,,
4386,4386,2022,12,NCAAF_20221119_CINCY@TEMPLE,Cincinnati,Bearcats,Temple,Owls,9-2,3-8,0.0,17,3,23,3,7,10,3,3,0,3,0,0,6.0,14,20,0.8608079599338159,18.340929904338964
4387,4387,2022,12,NCAAF_20221119_FIU@UTEP,FIU,Panthers,UTEP,Miners,4-7,5-6,0.0,0,38,6,40,0,0,0,6,14,24,0,2,-1.0,-38,-34,0.5959724741348817,4.110561922911302
4388,4388,2022,12,NCAAF_20221119_IOWA@MINN,Iowa,Hawkeyes,Minnesota,Golden Gophers,7-4,7-4,0.0,10,7,13,10,10,0,0,3,0,7,3,0,0.0,3,3,0.6514022996915491,6.583865369199657
4389,4389,2022,12,NCAAF_20221119_WKY@AUBURN,W. Kentucky,Hilltoppers,Auburn,Tigers,7-5,5-6,1.0,17,17,17,41,0,17,0,0,10,7,10,14,2.0,0,-24,0.08548849056875074,-23.165173924303645
4390,4390,2022,12,NCAAF_20221119_ARKST@TXSTSM,Arkansas St.,Red Wolves,Texas St.,Bobcats,3-8,4-7,0.0,7,3,13,16,0,7,3,3,3,0,0,13,-1.0,4,-3,0.7343890767109634,10.594544380910747
4391,4391,2022,12,NCAAF_20221119_GATECH@UNC,Georgia Tech,Yellow Jackets,North Carolina,Tar Heels,5-6,9-2,1.0,7,17,21,17,0,7,7,7,7,10,0,0,-4.0,-10,4,0.3267096384791186,-7.597530132310567
4392,4392,2022,12,NCAAF_20221119_STNFRD@CAL,Stanford,Cardinal,California,Golden Bears,3-8,4-7,1.0,10,6,20,27,10,0,7,3,6,0,0,21,-1.0,4,-7,0.5114426897660145,0.4853858486394529
4393,4393,2022,12,NCAAF_20221119_MRSHL@GAS,Marshall,Thundering Herd,Ga. Southern,Eagles,7-4,5-6,1.0,20,10,23,10,6,14,3,0,3,7,0,0,2.0,10,13,0.7223605591230792,9.980783190690317
4394,4394,2022,12,NCAAF_20221119_BOISE@WYO,Boise St.,Broncos,Wyoming,Cowboys,8-3,7-4,1.0,6,10,20,17,0,6,7,7,7,3,7,0,1.0,-4,3,0.7692674946345388,12.460770054663499
4395,4395,2022,12,NCAAF_20221119_TENN@SC,Tennessee,Volunteers,South Carolina,Gamecocks,9-2,7-4,0.0,24,35,38,63,7,17,7,7,21,14,7,21,2.0,-11,-25,0.5877061773489073,3.750368845436469
4396,4396,2022,12,NCAAF_20221119_TXTECH@IOWAST,Texas Tech,Red Raiders,Iowa St.,Cyclones,6-5,4-7,1.0,7,3,14,10,0,7,0,7,0,3,0,7,2.0,4,4,0.2703300527241216,-10.35212899322255
4397,4397,2022,12,NCAAF_20221119_MISS@ARK,Ole Miss,Rebels,Arkansas,Razorbacks,8-3,6-5,1.0,6,35,27,42,3,3,0,21,14,21,7,0,2.0,-29,-15,0.6920831441350085,8.490021263149629
4398,4398,2022,12,NCAAF_20221119_NMEXST@MIZZOU,New Mexico St.,Aggies,Missouri,Tigers,4-6,5-6,1.0,0,21,14,45,0,0,7,7,7,14,14,10,-1.0,-21,-31,0.04470148725015566,-28.740162756549353
4399,4399,2022,12,NCAAF_20221119_OKLAST@OKLA,Oklahoma State,Cowboys,Oklahoma,Sooners,7-4,6-5,0.0,3,28,13,28,0,3,7,3,28,0,0,0,1.0,-25,-15,0.33881412139594236,-7.033821930695922
4400,4400,2022,12,NCAAF_20221119_CUSE@WAKE,Syracuse,Orange,Wake Forest,Demon Deacons,6-5,7-4,1.0,21,24,35,45,7,14,0,14,3,21,7,14,-1.0,-3,-10,0.37051316138875556,-5.592085092256184
4401,4401,2022,12,NCAAF_20221119_USC@UCLA,USC,Trojans,UCLA,Bruins,10-1,8-3,1.0,20,21,48,45,0,20,14,14,14,7,10,14,2.0,-1,3,0.6167005579969351,5.022411958846533
4402,4402,2022,12,NCAAF_20221119_COLO@WASH,Colorado,Buffaloes,Washington,Huskies,1-10,9-2,1.0,0,33,7,54,0,0,7,0,14,19,14,7,-8.0,-33,-47,0.14663376930720484,-17.782964277608926
4403,4403,2022,12,NCAAF_20221119_COLOST@AF,Colorado St.,Rams,Air Force,Falcons,2-9,8-3,1.0,0,17,12,24,0,0,6,6,7,10,7,0,-6.0,-17,-12,0.23801944592710167,-12.058933224159546
4404,4404,2022,12,NCAAF_20221119_UAB@LSU,UAB,Blazers,LSU,Tigers,5-6,9-2,0.0,10,28,10,41,7,3,0,0,14,14,6,7,-4.0,-18,-31,0.10601534285509628,-21.116621213735243
4405,4405,2022,12,NCAAF_20221119_SJST@UTAHST,San Jose St.,Spartans,Utah St.,Aggies,6-4,6-5,1.0,13,21,31,35,6,7,10,8,7,14,7,7,0.0,-8,-4,0.2534083844285492,-11.231773338521407
4406,4406,2022,12,NCAAF_20221119_FRESNO@NEVADA,Fresno St.,Bulldogs,Nevada,Wolf Pack,7-4,2-9,0.0,24,0,41,14,17,7,3,14,0,0,7,7,5.0,24,27,0.7193496280381203,9.829213140940738
4407,4407,2022,12,NCAAF_20221119_UTAH@OREG,Utah,Utes,Oregon,Ducks,8-3,9-2,0.0,3,17,17,20,3,0,14,0,7,10,0,3,-1.0,-14,-3,0.5367174435289596,1.5595036229831294
4408,4408,2022,12,NCAAF_20221119_UNLV@HAWAII,UNLV,Rebels,Hawaii,Rainbow Warriors,4-7,3-9,1.0,13,7,25,31,6,7,3,9,7,0,14,10,1.0,6,-6,0.45675198714957643,-1.8378873970439145
4409,4409,2022,12,NCAAF_20221118_SFLA@TULSA,South Florida,Bulls,Tulsa,Golden Hurricane,1-10,4-7,1.0,20,31,42,48,10,10,15,7,7,24,7,10,-3.0,-11,-6,0.3895369066872716,-4.746603426793399
4410,4410,2022,12,NCAAF_20221118_SDGST@NMEX,San Diego St.,Aztecs,New Mexico,Lobos,7-4,2-9,0.0,21,10,34,10,7,14,10,3,7,3,0,0,5.0,11,24,0.8531857905132649,17.769674869749224
4411,4411,2022,12,NCAAF_20221117_SMU@TULANE,SMU,Mustangs,Tulane,Green Wave,6-5,9-2,1.0,7,28,24,59,0,7,7,10,21,7,21,10,-3.0,-21,-35,0.569627792664634,2.9682810548695215
4412,4412,2022,12,NCAAF_20221116_EMICH@KENTST,E. Michigan,Eagles,Kent St.,Golden Flashes,7-4,4-7,1.0,7,17,31,24,7,0,10,14,7,10,0,7,3.0,-10,7,0.6617240095159633,7.058713087468959
4413,4413,2022,12,NCAAF_20221116_MIAOH@NILL,Miami-OH,RedHawks,N. Illinois,Huskies,5-6,3-8,1.0,16,10,29,23,2,14,10,3,10,0,13,0,2.0,6,6,0.4995349120962881,-0.019725797395949485
4414,4414,2022,12,NCAAF_20221116_WMICH@CMICH,W. Michigan,Broncos,C. Michigan,Chippewas,4-7,4-7,0.0,7,7,12,10,7,0,0,5,7,0,3,0,0.0,0,2,0.5289713825407407,1.22984650063745
4415,4415,2022,12,NCAAF_20221115_BGREEN@TOLEDO,Bowling Green,Falcons,Toledo,Rockets,6-5,7-4,0.0,21,14,42,35,14,7,6,15,0,14,0,21,-1.0,7,7,0.10328065967991673,-21.371721175673883
4416,4416,2022,12,NCAAF_20221115_OHIO@BALLST,Ohio,Bobcats,Ball St.,Cardinals,8-3,5-6,0.0,17,3,32,18,0,17,2,13,3,0,8,7,3.0,14,14,0.7241346914176959,10.07046852763824
4417,4417,2022,13,NCAAF_20221126_ARMY@UMASS,Army,Black Knights,UMass,Minutemen,5-6,1-11,0.0,28,7,44,7,7,21,0,16,7,0,0,0,4.0,21,37,0.9512359166331809,28.0306098481999
4418,4418,2022,13,NCAAF_20221126_CSTCAR@JMAD,C. Carolina,Chanticleers,James Madison,Dukes,9-2,8-3,1.0,7,20,7,47,7,0,0,0,3,17,20,7,1.0,-13,-40,0.27057649780350324,-10.337428777224886
4419,4419,2022,13,NCAAF_20221126_GAST@MRSHL,Georgia St.,Panthers,Marshall,Thundering Herd,4-8,8-4,1.0,10,14,23,28,7,3,7,6,0,14,0,14,-4.0,-4,-5,0.26374365570397695,-10.688893674088831
4420,4420,2022,13,NCAAF_20221126_GATECH@UGA,Georgia Tech,Yellow Jackets,Georgia,Bulldogs,5-7,12-0,1.0,7,10,14,37,7,0,0,7,3,7,13,14,-7.0,-3,-23,0.03302160046894642,-31.095504684571097
4421,4421,2022,13,NCAAF_20221126_MICH@OHIOST,Michigan,Wolverines,Ohio State,Buckeyes,12-0,11-1,0.0,17,20,45,23,3,14,7,21,10,10,0,3,1.0,-3,22,0.30480700002698,-8.638194423923096
4422,4422,2022,13,NCAAF_20221126_NMEXST@LIB,New Mexico St.,Aggies,Liberty,Flames,6-6,,1.0,28,7,49,14,7,21,14,7,7,0,0,7,,21,35,0.18125057585271986,-15.404708787919844
4423,4423,2022,13,NCAAF_20221126_ODU@SALA,Old Dominion,Monarchs,South Alabama,Jaguars,3-9,10-2,1.0,20,13,20,27,10,10,0,0,7,6,7,7,-7.0,7,-7,0.45033299065855437,-2.111571545819288
4424,4424,2022,13,NCAAF_20221126_RUT@MD,Rutgers,Scarlet Knights,Maryland,Terrapins,4-8,7-5,1.0,0,17,0,37,0,0,0,0,0,17,13,7,-3.0,-17,-37,0.34712150025168276,-6.650101500076289
4425,4425,2022,13,NCAAF_20221126_SC@CLEM,South Carolina,Gamecocks,Clemson,Tigers,8-4,10-2,1.0,14,23,31,30,0,14,14,3,14,9,7,0,-2.0,-9,1,0.10110662246218971,-21.573662458856916
4426,4426,2022,13,NCAAF_20221126_WVU@OKLAST,West Virginia,Mountaineers,Oklahoma State,Cowboys,5-7,7-5,0.0,7,10,24,19,7,0,14,3,0,10,9,0,-2.0,-3,5,0.3589432604042614,-6.111826980735714
4427,4427,2022,13,NCAAF_20221126_ECU@TEMPLE,East Carolina,Pirates,Temple,Owls,7-5,3-9,1.0,28,24,49,46,7,21,14,7,3,21,15,7,4.0,4,3,0.4890942254758428,-0.46251077633951354
4428,4428,2022,13,NCAAF_20221126_AKRON@NILL,Akron,Zips,N. Illinois,Huskies,2-9,3-9,0.0,20,6,44,12,0,20,7,17,6,0,3,3,-1.0,14,32,0.17844206319791178,-15.585872976221026
4429,4429,2022,13,NCAAF_20221126_RICE@NTEXAS,Rice,Owls,North Texas,Mean Green,5-7,7-5,0.0,14,14,17,21,0,14,0,3,7,7,0,7,-2.0,0,-4,0.2542584532443767,-11.184601240345728
4430,4430,2022,13,NCAAF_20221126_LVILLE@UK,Louisville,Cardinals,Kentucky,Wildcats,7-5,7-5,0.0,7,13,13,26,0,7,0,6,7,6,10,3,0.0,-6,-13,0.4056984803589553,-4.036787413549405
4431,4431,2022,13,NCAAF_20221126_AUBURN@BAMA,Auburn,Tigers,Alabama,Crimson Tide,5-7,10-2,1.0,14,35,27,49,7,7,7,6,14,21,7,7,-5.0,-21,-22,0.1680857504607638,-16.26997271885159
4432,4432,2022,13,NCAAF_20221126_HAWAII@SJST,Hawaii,Rainbow Warriors,San Jose St.,Spartans,3-10,7-4,1.0,6,14,14,27,0,6,0,8,7,7,7,6,-4.0,-8,-13,0.5056290078837501,0.23870279698553531
4433,4433,2022,13,NCAAF_20221126_ILL@NWEST,Illinois,Fighting Illini,Northwestern,Wildcats,8-4,1-11,1.0,17,0,41,3,7,10,17,7,0,0,0,3,7.0,17,38,0.42333515152277124,-3.2712012522165423
4434,4434,2022,13,NCAAF_20221126_MEMP@SMU,Memphis,Tigers,SMU,Mustangs,6-6,7-5,1.0,17,14,31,34,7,10,6,8,0,14,10,10,-1.0,3,-3,0.5717570193482027,3.0594111410350706
4435,4435,2022,13,NCAAF_20221126_MINN@WISC,Minnesota,Golden Gophers,Wisconsin,Badgers,8-4,6-6,0.0,10,6,23,16,7,3,3,10,3,3,10,0,2.0,4,7,0.31403744286233093,-8.195203127524337
4436,4436,2022,13,NCAAF_20221126_OREG@OREGST,Oregon,Ducks,Oregon State,Beavers,9-3,9-3,0.0,14,10,34,38,7,7,17,3,10,0,7,21,0.0,4,-4,0.819304263960714,15.440358531334368
4437,4437,2022,13,NCAAF_20221126_PURDUE@IND,Purdue,Boilermakers,Indiana,Hoosiers,8-4,4-8,1.0,3,7,30,16,3,0,14,13,7,0,0,9,4.0,-4,14,0.6294803522197274,5.590659215206415
4438,4438,2022,13,NCAAF_20221126_TROY@ARKST,Troy,Trojans,Arkansas St.,Red Wolves,10-2,3-9,1.0,7,13,48,19,7,0,7,34,3,10,6,0,7.0,-6,29,0.5775768866156221,3.3106144705154747
4439,4439,2022,13,NCAAF_20221126_UAB@LATECH,UAB,Blazers,Louisiana Tech,Bulldogs,6-6,3-9,0.0,17,6,37,27,0,17,20,0,3,3,14,7,3.0,11,10,0.652621646072659,6.638336456404431
4440,4440,2022,13,NCAAF_20221126_UTEP@TXSA,UTEP,Miners,UTSA,Roadrunners,5-7,10-2,0.0,24,14,31,34,14,10,7,0,0,14,17,3,-5.0,10,-3,0.2315077022222295,-12.415169191233872
4441,4441,2022,13,NCAAF_20221126_WAKE@DUKE,Wake Forest,Demon Deacons,Duke,Blue Devils,7-5,8-4,0.0,17,20,31,34,7,10,7,7,3,17,7,7,-1.0,-3,-3,0.6999638808912265,8.86948440575702
4442,4442,2022,13,NCAAF_20221126_IOWAST@TCU,Iowa St.,Cyclones,TCU,Horned Frogs,4-8,12-0,0.0,7,34,14,62,0,7,0,7,24,10,21,7,-8.0,-27,-48,0.5935219651311202,4.002784309737763
4443,4443,2022,13,NCAAF_20221126_MICHST@PSU,Michigan St.,Spartans,Penn State,Nittany Lions,5-7,10-2,1.0,3,14,16,35,0,3,7,6,7,7,7,14,-5.0,-11,-19,0.17783355167727488,-15.625361235401442
4444,4444,2022,13,NCAAF_20221126_UTAH@COLO,Utah,Utes,Colorado,Buffaloes,9-3,1-11,0.0,42,0,63,21,14,28,14,7,0,0,14,7,8.0,42,42,0.8936539982666554,21.081818976269687
4445,4445,2022,13,NCAAF_20221126_UL@TXSTSM,Louisiana,Ragin' Cajuns,Texas St.,Bobcats,6-6,4-8,0.0,20,6,41,13,7,13,7,14,3,3,7,0,2.0,14,28,0.8470225478546025,17.318642394411427
4446,4446,2022,13,NCAAF_20221126_USM@LAMON,So. Miss,Golden Eagles,UL-Monroe,Warhawks,6-6,4-8,1.0,10,7,20,10,10,0,0,10,0,7,3,0,2.0,3,10,0.6696902201302104,7.427508089274852
4447,4447,2022,13,NCAAF_20221126_MTSU@FIU,Middle Tenn.,Blue Raiders,FIU,Panthers,7-5,4-8,1.0,20,7,33,28,6,14,7,6,0,7,14,7,3.0,13,5,0.7229417372068392,10.008099311140086
4448,4448,2022,13,NCAAF_20221126_NEVADA@UNLV,Nevada,Wolf Pack,UNLV,Rebels,2-10,5-7,0.0,13,17,22,27,13,0,3,6,7,10,0,10,-3.0,-4,-5,0.6583293037340265,6.900543169566845
4449,4449,2022,13,NCAAF_20221126_LSU@TXAM,LSU,Tigers,Texas A&M,Aggies,9-3,5-7,1.0,10,17,23,38,0,10,7,6,7,10,7,14,4.0,-7,-15,0.6043598808673641,4.477037955953392
4450,4450,2022,13,NCAAF_20221126_UCF@SFLA,UCF,Knights,South Florida,Bulls,9-3,1-11,1.0,28,7,46,39,14,14,3,15,0,7,22,10,8.0,21,7,0.894230452425282,21.1350615976869
4451,4451,2022,13,NCAAF_20221126_CUSE@BC,Syracuse,Orange,Boston College,Eagles,7-5,3-9,1.0,3,10,32,23,0,3,3,26,10,0,0,13,4.0,-7,9,0.480148050902939,-0.8421583221620494
4452,4452,2022,13,NCAAF_20221126_ND@USC,Notre Dame,Fighting Irish,USC,Trojans,8-4,11-1,0.0,7,17,27,38,0,7,7,13,10,7,7,14,-3.0,-10,-11,0.7180494223032918,9.7620222082694
4453,4453,2022,13,NCAAF_20221126_TENN@VANDY,Tennessee,Volunteers,Vanderbilt,Commodores,10-2,5-7,1.0,21,0,56,0,14,7,21,14,0,0,0,0,5.0,21,56,0.8006216345318182,14.275237338439865
4454,4454,2022,13,NCAAF_20221126_TULSA@HOU,Tulsa,Golden Hurricane,Houston,Cougars,5-7,7-5,0.0,20,24,37,30,3,17,7,10,14,10,3,3,-2.0,-4,7,0.3372127581608906,-7.106494569839924
4455,4455,2022,13,NCAAF_20221126_KANSAS@KSTATE,Kansas,Jayhawks,Kansas State,Wildcats,6-6,9-3,0.0,21,30,27,47,7,14,0,6,23,7,7,10,-3.0,-9,-20,0.11942012468294849,-19.926280391370256
4456,4456,2022,13,NCAAF_20221126_PITT@MIAMI,Pittsburgh,Panthers,Miami (Fla.),Hurricanes,8-4,5-7,0.0,28,0,42,16,14,14,7,7,0,0,3,13,3.0,28,26,0.47315713654351155,-1.1391165820398328
4457,4457,2022,13,NCAAF_20221126_AF@SDGST,Air Force,Falcons,San Diego St.,Aztecs,9-3,7-5,1.0,7,0,13,3,7,0,3,3,0,0,3,0,2.0,7,10,0.5722342606252672,3.079984216225739
4458,4458,2022,13,NCAAF_20221126_WASH@WASHST,Washington,Huskies,Washington St.,Cougars,10-2,7-5,0.0,28,27,51,33,7,21,7,16,10,17,6,0,3.0,1,18,0.5926374144453727,3.9642209840648093
4459,4459,2022,13,NCAAF_20221126_BYU@STNFRD,BYU,Cougars,Stanford,Cardinal,7-5,3-9,1.0,28,12,35,26,14,14,0,7,3,9,0,14,4.0,16,9,0.4860607786307921,-0.5912050712415748
4460,4460,2022,13,NCAAF_20221125_BAYLOR@TEXAS,Baylor,Bears,Texas,Longhorns,6-6,8-4,1.0,19,17,27,38,9,10,0,8,14,3,7,14,-2.0,2,-11,0.32792006733801604,-7.539258618022814
4461,4461,2022,13,NCAAF_20221125_CMICH@EMICH,C. Michigan,Chippewas,E. Michigan,Eagles,4-8,8-4,0.0,13,14,19,38,7,6,0,6,14,0,14,10,-4.0,-1,-19,0.49933288613064153,-0.02828859720739274
4462,4462,2022,13,NCAAF_20221125_TOLEDO@WMICH,Toledo,Rockets,W. Michigan,Broncos,7-5,5-7,0.0,7,10,14,20,0,7,0,7,0,10,10,0,2.0,-3,-6,0.5919508915408747,3.9343051814671526
4463,4463,2022,13,NCAAF_20221125_TULANE@CINCY,Tulane,Green Wave,Cincinnati,Bearcats,10-2,9-3,0.0,13,10,27,24,3,10,7,7,0,10,7,7,1.0,3,3,0.3062618715036689,-8.56798502401739
4464,4464,2022,13,NCAAF_20221125_UTAHST@BOISE,Utah St.,Aggies,Boise St.,Broncos,6-6,9-3,0.0,7,21,23,42,0,7,10,6,0,21,7,14,-3.0,-14,-19,0.28115838526596404,-9.801727209782484
4465,4465,2022,13,NCAAF_20221125_ARIZST@ARIZ,Arizona St.,Sun Devils,Arizona,Wildcats,3-9,5-7,1.0,14,10,35,38,0,14,14,7,7,3,21,7,-2.0,4,-3,0.6839475006878446,8.099248884974486
4466,4466,2022,13,NCAAF_20221125_ARK@MIZZOU,Arkansas,Razorbacks,Missouri,Tigers,6-6,6-6,1.0,21,20,27,29,7,14,3,3,10,10,9,0,0.0,1,-2,0.3470706619932632,-6.652430500180799
4467,4467,2022,13,NCAAF_20221125_NMEX@COLOST,New Mexico,Lobos,Colorado St.,Rams,2-10,3-9,1.0,0,7,0,17,0,0,0,0,0,7,3,7,-1.0,-7,-17,0.29861414736225544,-8.938740878950512
4468,4468,2022,13,NCAAF_20221125_NEB@IOWA,Nebraska,Cornhuskers,Iowa,Hawkeyes,4-8,7-5,0.0,17,0,24,17,10,7,7,0,0,0,7,10,-3.0,17,7,0.22645527509350383,-12.697359107308557
4469,4469,2022,13,NCAAF_20221125_UCLA@CAL,UCLA,Bruins,California,Golden Bears,9-3,4-8,1.0,17,21,35,28,7,10,7,11,7,14,0,7,5.0,-4,7,0.5474851248150059,2.018358003911544
4470,4470,2022,13,NCAAF_20221125_FLA@FSU,Florida,Gators,Florida State,Seminoles,6-6,9-3,0.0,24,21,38,45,14,10,0,14,14,7,17,7,-3.0,3,-7,0.7192153232320203,9.820476375958833
4471,4471,2022,13,NCAAF_20221125_WYO@FRESNO,Wyoming,Cowboys,Fresno St.,Bulldogs,7-5,8-4,0.0,0,23,0,30,0,0,0,0,14,9,7,0,-1.0,-23,-30,0.3418831216076579,-6.890755096665089
4472,4472,2022,13,NCAAF_20221124_MISSST@MISS,Miss. State,Bulldogs,Ole Miss,Rebels,8-4,8-4,0.0,14,16,24,22,7,7,0,10,6,10,0,6,0.0,-2,2,0.5860655367840986,3.6783399442253994
4473,4473,2022,13,NCAAF_20221122_BALLST@MIAOH,Ball St.,Cardinals,Miami-OH,RedHawks,5-7,6-6,0.0,14,3,17,18,7,7,3,0,0,3,3,12,-1.0,11,-1,0.3615359561928846,-5.994616586887332
4474,4474,2022,13,NCAAF_20221122_BGREEN@OHIO,Bowling Green,Falcons,Ohio,Bobcats,6-6,9-3,1.0,7,28,14,38,7,0,0,7,0,28,3,7,-3.0,-21,-24,0.11886872046723163,-19.973147271140533
4475,4475,2022,14,NCAAF_20221203_TOLEDO@OHIO,Toledo,Rockets,Ohio,Bobcats,8-5,9-4,1.0,10,7,17,7,7,3,0,7,0,7,0,0,-1.0,3,10,0.5055445780425225,0.23555746608394657
4476,4476,2022,14,NCAAF_20221203_VALPO@NMEXST,Valparaiso,,New Mexico St.,,5-7,6-6,,3,35,3,65,0,3,0,0,21,14,17,13,-1.0,-32,-62,,
4477,4477,2022,14,NCAAF_20221203_CSTCAR@TROY,C. Carolina,Chanticleers,Troy,Trojans,9-3,11-2,0.0,7,31,26,45,0,7,6,13,17,14,14,0,-2.0,-24,-19,0.46769334189793654,-1.3739848199409153
4478,4478,2022,14,NCAAF_20221203_FRESNO@BOISE,Fresno St.,Bulldogs,Boise St.,Broncos,9-4,9-4,0.0,14,6,28,16,0,14,0,14,0,6,3,7,0.0,8,12,0.38304961763949796,-5.041779354930441
4479,4479,2022,14,NCAAF_20221203_LSU@UGA,LSU,Tigers,Georgia,Bulldogs,9-4,13-0,1.0,10,35,30,50,7,3,13,7,14,21,7,8,-4.0,-25,-20,0.23919600252937845,-12.014453850494874
4480,4480,2022,14,NCAAF_20221203_UCF@TULANE,UCF,Knights,Tulane,Green Wave,9-4,11-2,1.0,7,17,28,45,0,7,7,14,10,7,7,21,-2.0,-10,-17,0.7429233773213494,11.056763080518976
4481,4481,2022,14,NCAAF_20221203_CLEM@UNC,Clemson,Tigers,North Carolina,Tar Heels,11-2,9-4,1.0,24,10,39,10,14,10,15,0,7,3,0,0,2.0,14,29,0.8964486749744925,21.381426516895317
4482,4482,2022,14,NCAAF_20221203_PURDUE@MICH,Purdue,Boilermakers,Michigan,Wolverines,8-5,13-0,1.0,13,14,22,43,7,6,3,6,7,7,14,15,-5.0,-1,-21,0.18811685459679806,-14.996765344169035
4483,4483,2022,14,NCAAF_20221202_AKRON@BUFF,Akron,Zips,Buffalo,Bulls,2-10,6-6,1.0,16,10,22,23,9,7,0,6,0,10,7,6,-4.0,6,-1,0.135916189122523,-18.6236106940396
4484,4484,2022,14,NCAAF_20221202_NTEXAS@TXSA,North Texas,Mean Green,UTSA,Roadrunners,7-6,11-2,0.0,10,24,27,48,7,3,10,7,7,17,10,14,-4.0,-14,-21,0.5101643060472445,0.4318561596269319
4485,4485,2022,14,NCAAF_20221202_UTAH@USC,Utah,Utes,USC,Trojans,10-3,11-2,0.0,17,17,47,24,3,14,7,23,14,3,0,7,-1.0,0,23,0.636867344360331,5.933539298137248
